Chrom	Position	Ref	Cons	Reads1	Reads2	VarFreq	Strands1	Strands2	Qual1	Qual2	Pvalue	MapQual1	MapQual2	Reads1Plus	Reads1Minus	Reads2Plus	Reads2Minus	VarAllele
B10_BC22_191109_LF_LIB_consensus_vsearch	1	G	G	547	0	0%	2	0	93	0	1.0	1	0	365	182	0	0	
B10_BC22_191109_LF_LIB_consensus_vsearch	2	T	T	552	0	0%	2	0	93	0	1.0	1	0	367	185	0	0	
B10_BC22_191109_LF_LIB_consensus_vsearch	3	A	A	556	2	0.36%	2	1	93	93	0.24977578475354134	1	1	369	187	0	2	-G
B10_BC22_191109_LF_LIB_consensus_vsearch	4	G	G	562	2	0.35%	2	1	93	93	0.24977817213868056	1	1	369	193	2	0	A
B10_BC22_191109_LF_LIB_consensus_vsearch	5	T	T	568	2	0.35%	2	1	93	93	0.24978050921894895	1	1	370	198	2	0	+C
B10_BC22_191109_LF_LIB_consensus_vsearch	6	C	C	563	2	0.35%	2	1	93	93	0.2497785651018928	1	1	366	197	2	0	+G
B10_BC22_191109_LF_LIB_consensus_vsearch	7	A	W	561	7	1.22%	2	1	93	93	0.007668588879253857	1	1	361	200	7	0	T
B10_BC22_191109_LF_LIB_consensus_vsearch	8	T	*/-AT	572	8	1.37%	2	2	93	93	0.0038124905281564036	1	1	372	200	3	5	-AT
B10_BC22_191109_LF_LIB_consensus_vsearch	9	A	A	572	5	0.86%	2	2	93	93	0.030979321122758578	1	1	373	199	2	3	G
B10_BC22_191109_LF_LIB_consensus_vsearch	10	T	T	572	3	0.52%	2	1	93	93	0.12467362924259917	1	1	376	196	0	3	-GC
B10_BC22_191109_LF_LIB_consensus_vsearch	11	G	R	570	8	1.37%	2	2	93	93	0.003812167942212529	1	1	372	198	6	2	A
B10_BC22_191109_LF_LIB_consensus_vsearch	12	C	Y	549	20	3.41%	2	1	93	93	8.046788848063195E-7	1	1	367	182	0	20	T
B10_BC22_191109_LF_LIB_consensus_vsearch	13	T	T	584	1	0.17%	2	1	93	93	0.4999999999999138	1	1	376	208	0	1	+GT
B10_BC22_191109_LF_LIB_consensus_vsearch	14	T	T	587	2	0.34%	2	1	93	93	0.249787595581865	1	1	377	210	2	0	+AT
B10_BC22_191109_LF_LIB_consensus_vsearch	15	G	G	577	6	1.01%	2	2	93	93	0.01542433854516302	1	1	374	203	4	2	A
B10_BC22_191109_LF_LIB_consensus_vsearch	16	T	*/-C	574	14	2.36%	2	1	93	93	5.643946893550629E-5	1	1	380	194	0	14	-C
B10_BC22_191109_LF_LIB_consensus_vsearch	17	C	C	566	6	1.03%	2	1	93	93	0.015420486487683701	1	1	379	187	0	6	+T
B10_BC22_191109_LF_LIB_consensus_vsearch	18	T	*/+C	571	9	1.52%	2	2	93	93	0.0018930074497425708	1	1	372	199	5	4	+C
B10_BC22_191109_LF_LIB_consensus_vsearch	19	C	*/-A	473	57	9.68%	2	2	93	93	1.4132160724218232E-18	1	1	274	199	56	1	-A
B10_BC22_191109_LF_LIB_consensus_vsearch	20	A	R	516	11	2.08%	2	2	93	93	4.632113647208495E-4	1	1	312	204	8	3	G
B10_BC22_191109_LF_LIB_consensus_vsearch	21	A	A	585	3	0.51%	2	1	93	93	0.1246808510636648	1	1	376	209	3	0	G
B10_BC22_191109_LF_LIB_consensus_vsearch	22	A	*/-GA	575	7	1.18%	2	1	93	93	0.007672038647635164	1	1	366	209	7	0	-GA
B10_BC22_191109_LF_LIB_consensus_vsearch	23	G	*/-A	559	9	1.54%	2	1	93	93	0.0018917480811367516	1	1	351	208	9	0	-A
B10_BC22_191109_LF_LIB_consensus_vsearch	24	A	A	571	4	0.69%	2	2	93	93	0.06217377151431282	1	1	363	208	2	2	-T
B10_BC22_191109_LF_LIB_consensus_vsearch	25	T	K	581	9	1.52%	2	1	93	93	0.0018940181115188759	1	1	374	207	9	0	G
B10_BC22_191109_LF_LIB_consensus_vsearch	26	T	*/-AA	569	10	1.68%	2	1	93	93	9.390387757385067E-4	1	1	377	192	0	10	-AA
B10_BC22_191109_LF_LIB_consensus_vsearch	27	A	A	563	6	1.04%	2	2	93	93	0.015419410124154218	1	1	372	191	3	3	G
B10_BC22_191109_LF_LIB_consensus_vsearch	28	A	A	570	5	0.85%	2	2	93	93	0.030978380047692815	1	1	378	192	2	3	-G
B10_BC22_191109_LF_LIB_consensus_vsearch	29	G	G	579	6	1.02%	2	1	93	93	0.015425023382419913	1	1	373	206	6	0	A
B10_BC22_191109_LF_LIB_consensus_vsearch	30	C	C	585	3	0.51%	2	2	93	93	0.1246808510636648	1	1	382	203	1	2	T
B10_BC22_191109_LF_LIB_consensus_vsearch	31	C	C	589	3	0.5%	2	2	93	93	0.1246830092985462	1	1	383	206	1	2	T
B10_BC22_191109_LF_LIB_consensus_vsearch	32	A	A	588	4	0.67%	2	2	93	93	0.06218314350277022	1	1	380	208	3	1	G
B10_BC22_191109_LF_LIB_consensus_vsearch	33	T	T	589	2	0.34%	2	2	93	93	0.2497883149871952	1	1	382	207	1	1	+AT
B10_BC22_191109_LF_LIB_consensus_vsearch	34	G	G	588	4	0.67%	2	2	93	93	0.06218314350277022	1	1	380	208	3	1	A
B10_BC22_191109_LF_LIB_consensus_vsearch	35	C	C	589	5	0.84%	2	2	93	93	0.030987064506852544	1	1	384	205	1	4	T
B10_BC22_191109_LF_LIB_consensus_vsearch	36	A	A	589	4	0.67%	2	2	93	93	0.06218367805512527	1	1	382	207	3	1	G
B10_BC22_191109_LF_LIB_consensus_vsearch	37	T	T	593	1	0.17%	2	1	93	93	0.5000000000008233	1	1	384	209	1	0	+A
B10_BC22_191109_LF_LIB_consensus_vsearch	38	G	G	584	5	0.84%	2	1	93	93	0.030984833420659205	1	1	381	203	0	5	+T
B10_BC22_191109_LF_LIB_consensus_vsearch	39	T	T	583	4	0.67%	2	1	93	93	0.06218044340963991	1	1	374	209	4	0	+GT
B10_BC22_191109_LF_LIB_consensus_vsearch	40	C	C	581	5	0.84%	2	2	93	93	0.030983476501936075	1	1	375	206	1	4	-T
B10_BC22_191109_LF_LIB_consensus_vsearch	41	T	*/-A	555	18	3.06%	2	2	93	93	3.3310171352386134E-6	1	1	357	198	13	5	-A
B10_BC22_191109_LF_LIB_consensus_vsearch	42	A	A	567	4	0.7%	2	2	93	93	0.062171485204235814	1	1	367	200	2	2	G
B10_BC22_191109_LF_LIB_consensus_vsearch	43	A	A	584	6	1.01%	2	2	93	93	0.015426715197547503	1	1	383	201	2	4	G
B10_BC22_191109_LF_LIB_consensus_vsearch	44	G	G	583	5	0.84%	2	2	93	93	0.030984382652161722	1	1	378	205	4	1	A
B10_BC22_191109_LF_LIB_consensus_vsearch	45	T	Y	575	18	3.03%	2	2	93	93	3.346514451133258E-6	1	1	384	191	1	17	C
B10_BC22_191109_LF_LIB_consensus_vsearch	46	A	A	591	2	0.34%	2	1	93	93	0.24978902953563295	1	1	382	209	2	0	+C
B10_BC22_191109_LF_LIB_consensus_vsearch	47	T	*/-A	549	19	3.19%	2	2	93	93	1.6367082147100343E-6	1	1	355	194	10	9	-A
B10_BC22_191109_LF_LIB_consensus_vsearch	48	A	A	567	5	0.87%	2	2	93	93	0.03097695610130975	1	1	372	195	1	4	G
B10_BC22_191109_LF_LIB_consensus_vsearch	49	A	*/-G	552	26	4.38%	2	2	93	93	1.1177819472886061E-8	1	1	362	190	22	4	-G
B10_BC22_191109_LF_LIB_consensus_vsearch	50	G	R	530	21	3.76%	2	1	93	93	3.926775167322623E-7	1	1	338	192	21	0	A
B10_BC22_191109_LF_LIB_consensus_vsearch	51	C	*/+TT	559	9	1.54%	2	1	93	93	0.0018917480811367516	1	1	372	187	9	0	+TT
B10_BC22_191109_LF_LIB_consensus_vsearch	52	A	A	583	1	0.17%	2	1	93	93	0.4999999999999138	1	1	383	200	1	0	C
B10_BC22_191109_LF_LIB_consensus_vsearch	53	A	A	578	6	1.02%	2	2	93	93	0.015424681549082461	1	1	377	201	5	1	G
B10_BC22_191109_LF_LIB_consensus_vsearch	54	C	C	585	3	0.5%	2	2	93	93	0.1246808510636648	1	1	377	208	1	2	T
B10_BC22_191109_LF_LIB_consensus_vsearch	55	T	T	587	5	0.84%	2	2	93	93	0.030986176592841308	1	1	383	204	1	4	C
B10_BC22_191109_LF_LIB_consensus_vsearch	56	A	A	588	4	0.67%	2	1	93	93	0.06218314350277022	1	1	377	211	4	0	G
B10_BC22_191109_LF_LIB_consensus_vsearch	57	T	T	584	3	0.51%	2	1	93	93	0.12468030690531334	1	1	378	206	0	3	+A
B10_BC22_191109_LF_LIB_consensus_vsearch	58	A	R	561	25	4.23%	2	2	93	93	2.294565527161393E-8	1	1	356	205	24	1	G
B10_BC22_191109_LF_LIB_consensus_vsearch	59	C	*/+G	560	11	1.85%	2	2	93	93	4.6511414231246333E-4	1	1	370	190	1	10	+G
B10_BC22_191109_LF_LIB_consensus_vsearch	60	G	R	552	35	5.93%	2	2	93	93	1.7264135703207897E-11	1	1	346	206	34	1	A
B10_BC22_191109_LF_LIB_consensus_vsearch	61	G	G	587	5	0.84%	2	1	93	93	0.030986176592841308	1	1	376	211	5	0	T
B10_BC22_191109_LF_LIB_consensus_vsearch	62	T	T	582	3	0.5%	2	1	93	93	0.12467921300240917	1	1	372	210	3	0	+G
B10_BC22_191109_LF_LIB_consensus_vsearch	63	G	*/+A	568	12	2.01%	2	2	93	93	2.3050606703904357E-4	1	1	369	199	5	7	+A
B10_BC22_191109_LF_LIB_consensus_vsearch	64	A	A	582	4	0.68%	2	1	93	93	0.0621798978595429	1	1	374	208	4	0	+G
B10_BC22_191109_LF_LIB_consensus_vsearch	65	A	A	587	3	0.5%	2	2	93	93	0.12468193384235185	1	1	377	210	2	1	+G
B10_BC22_191109_LF_LIB_consensus_vsearch	66	A	R	578	12	2.01%	2	1	93	93	2.3073291313309075E-4	1	1	371	207	12	0	G
B10_BC22_191109_LF_LIB_consensus_vsearch	67	C	C	583	5	0.84%	2	1	93	93	0.030984382652161722	1	1	374	209	5	0	+T
B10_BC22_191109_LF_LIB_consensus_vsearch	68	T	T	580	5	0.84%	2	2	93	93	0.030983021104337604	1	1	380	200	2	3	C
B10_BC22_191109_LF_LIB_consensus_vsearch	69	G	R	578	12	2.02%	2	2	93	93	2.3073291313309075E-4	1	1	375	203	9	3	A
B10_BC22_191109_LF_LIB_consensus_vsearch	70	C	*/+A	534	29	4.89%	2	2	93	93	1.286627481399863E-9	1	1	346	188	28	1	+A
B10_BC22_191109_LF_LIB_consensus_vsearch	71	G	*/-A	550	26	4.4%	2	1	93	93	1.1166412049019235E-8	1	1	350	200	26	0	-A
B10_BC22_191109_LF_LIB_consensus_vsearch	72	A	A	559	5	0.88%	2	2	93	93	0.0309730848861656	1	1	351	208	3	2	G
B10_BC22_191109_LF_LIB_consensus_vsearch	73	A	A	588	4	0.67%	2	1	93	93	0.06218314350277022	1	1	378	210	4	0	G
B10_BC22_191109_LF_LIB_consensus_vsearch	74	T	T	582	6	1.01%	2	2	93	93	0.015426041918236095	1	1	377	205	3	3	-G
B10_BC22_191109_LF_LIB_consensus_vsearch	75	G	R	554	36	6.09%	2	1	93	93	8.391134416070887E-12	1	1	346	208	36	0	A
B10_BC22_191109_LF_LIB_consensus_vsearch	76	G	G	582	5	0.84%	2	1	93	93	0.030983930348565846	1	1	381	201	0	5	+C
B10_BC22_191109_LF_LIB_consensus_vsearch	77	C	C	592	3	0.5%	2	2	93	93	0.1246846089151382	1	1	383	209	2	1	A
B10_BC22_191109_LF_LIB_consensus_vsearch	78	T	Y	573	13	2.18%	2	2	93	93	1.1412856168272655E-4	1	1	382	191	1	12	C
B10_BC22_191109_LF_LIB_consensus_vsearch	79	C	C	588	1	0.17%	2	1	93	93	0.4999999999990043	1	1	385	203	1	0	+GAA
B10_BC22_191109_LF_LIB_consensus_vsearch	80	A	A	592	2	0.33%	2	1	93	93	0.24978938500452047	1	1	384	208	0	2	-T
B10_BC22_191109_LF_LIB_consensus_vsearch	81	T	T	592	3	0.5%	2	2	93	93	0.1246846089151382	1	1	384	208	2	1	A
B10_BC22_191109_LF_LIB_consensus_vsearch	82	T	*/+A	577	7	1.17%	2	2	93	93	0.007672518016675552	1	1	371	206	6	1	+A
B10_BC22_191109_LF_LIB_consensus_vsearch	83	A	A	586	3	0.51%	2	1	93	93	0.12468139337307069	1	1	377	209	3	0	G
B10_BC22_191109_LF_LIB_consensus_vsearch	84	A	A	597	1	0.17%	2	1	93	93	0.4999999999999138	1	1	385	212	0	1	+TAA
B10_BC22_191109_LF_LIB_consensus_vsearch	85	A	A	596	4	0.67%	2	2	93	93	0.062187370009836374	1	1	386	210	1	3	-T
B10_BC22_191109_LF_LIB_consensus_vsearch	86	T	*/+C	577	9	1.51%	2	1	93	93	0.0018936179518815892	1	1	370	207	9	0	+C
B10_BC22_191109_LF_LIB_consensus_vsearch	87	C	C	584	6	1%	2	1	93	93	0.015426715197547503	1	1	378	206	6	0	+G
B10_BC22_191109_LF_LIB_consensus_vsearch	88	A	R	562	25	4.22%	2	1	93	93	2.2956097360645657E-8	1	1	356	206	25	0	G
B10_BC22_191109_LF_LIB_consensus_vsearch	89	G	G	585	3	0.51%	2	1	93	93	0.1246808510636648	1	1	376	209	3	0	+A
B10_BC22_191109_LF_LIB_consensus_vsearch	90	T	Y	586	10	1.67%	2	2	93	93	9.400973019723426E-4	1	1	382	204	2	8	C
B10_BC22_191109_LF_LIB_consensus_vsearch	91	T	T	597	2	0.33%	2	1	93	93	0.24979114452852993	1	1	387	210	0	2	C
B10_BC22_191109_LF_LIB_consensus_vsearch	92	A	A	598	1	0.17%	2	1	93	93	0.5000000000008233	1	1	387	211	0	1	+T
B10_BC22_191109_LF_LIB_consensus_vsearch	93	T	T	594	1	0.17%	2	1	93	93	0.5000000000008233	1	1	382	212	1	0	+C
B10_BC22_191109_LF_LIB_consensus_vsearch	94	C	C	594	1	0.17%	2	1	93	93	0.5000000000008233	1	1	385	209	0	1	+G
B10_BC22_191109_LF_LIB_consensus_vsearch	95	G	G	589	5	0.84%	2	2	93	93	0.030987064506852544	1	1	380	209	4	1	-T
B10_BC22_191109_LF_LIB_consensus_vsearch	96	T	T	588	5	0.84%	2	1	93	93	0.0309866212982286	1	1	383	205	0	5	C
B10_BC22_191109_LF_LIB_consensus_vsearch	97	T	T	595	5	0.83%	2	2	93	93	0.03098969274732699	1	1	385	210	2	3	C
B10_BC22_191109_LF_LIB_consensus_vsearch	98	T	T	591	3	0.5%	2	1	93	93	0.12468407750622149	1	1	379	212	3	0	-A
B10_BC22_191109_LF_LIB_consensus_vsearch	99	A	R	572	8	1.35%	2	2	93	93	0.0038124905281564036	1	1	365	207	5	3	G
B10_BC22_191109_LF_LIB_consensus_vsearch	100	T	T	585	2	0.34%	2	1	93	93	0.2497868712706135	1	1	373	212	2	0	G
B10_BC22_191109_LF_LIB_consensus_vsearch	101	T	T	589	3	0.5%	2	2	93	93	0.1246830092985462	1	1	378	211	2	1	C
B10_BC22_191109_LF_LIB_consensus_vsearch	102	T	T	582	4	0.67%	2	1	93	93	0.0621798978595429	1	1	369	213	4	0	-G
B10_BC22_191109_LF_LIB_consensus_vsearch	103	G	G	588	2	0.34%	2	1	93	93	0.2497879558944788	1	1	375	213	2	0	-A
B10_BC22_191109_LF_LIB_consensus_vsearch	104	A	A	584	4	0.67%	2	1	93	93	0.062180987103355005	1	1	371	213	4	0	+T
B10_BC22_191109_LF_LIB_consensus_vsearch	105	T	T	583	4	0.67%	2	1	93	93	0.06218044340963991	1	1	375	208	4	0	+G
B10_BC22_191109_LF_LIB_consensus_vsearch	106	A	A	585	5	0.84%	2	2	93	93	0.030985282661769052	1	1	380	205	2	3	-G
B10_BC22_191109_LF_LIB_consensus_vsearch	107	G	G	583	2	0.34%	2	2	93	93	0.24978614200168656	1	1	378	205	1	1	A
B10_BC22_191109_LF_LIB_consensus_vsearch	108	T	T	585	5	0.84%	2	1	93	93	0.030985282661769052	1	1	382	203	0	5	C
B10_BC22_191109_LF_LIB_consensus_vsearch	109	A	*/-C	567	10	1.68%	2	2	93	93	9.389101896133754E-4	1	1	367	200	3	7	-C
B10_BC22_191109_LF_LIB_consensus_vsearch	110	C	C	574	3	0.51%	2	1	93	93	0.12467476149184535	1	1	375	199	0	3	+T
B10_BC22_191109_LF_LIB_consensus_vsearch	111	C	*/-T	536	41	6.89%	2	1	93	93	2.1770980511348615E-13	1	1	377	159	0	41	-T
B10_BC22_191109_LF_LIB_consensus_vsearch	112	T	T	543	4	0.72%	2	2	93	93	0.062157064831361374	1	1	378	165	1	3	A
B10_BC22_191109_LF_LIB_consensus_vsearch	113	T	*/-AC	571	9	1.52%	2	2	93	93	0.0018930074497425708	1	1	372	199	6	3	-AC
B10_BC22_191109_LF_LIB_consensus_vsearch	114	A	R	572	11	1.88%	2	2	93	93	4.655839782704286E-4	1	1	365	207	8	3	G
B10_BC22_191109_LF_LIB_consensus_vsearch	115	C	M	564	7	1.19%	2	1	93	93	0.007669342305605016	1	1	369	195	0	7	A
B10_BC22_191109_LF_LIB_consensus_vsearch	116	T	T	582	5	0.85%	2	2	93	93	0.030983930348565846	1	1	375	207	2	3	C
B10_BC22_191109_LF_LIB_consensus_vsearch	117	A	A	581	3	0.51%	2	1	93	93	0.1246786632393088	1	1	370	211	3	0	G
B10_BC22_191109_LF_LIB_consensus_vsearch	118	C	C	586	2	0.34%	2	1	93	93	0.24978723404299805	1	1	377	209	2	0	+GC
B10_BC22_191109_LF_LIB_consensus_vsearch	119	A	R	582	8	1.34%	2	1	93	93	0.00381407083625578	1	1	371	211	8	0	G
B10_BC22_191109_LF_LIB_consensus_vsearch	120	T	T	586	4	0.67%	2	1	93	93	0.062182068959449006	1	1	380	206	0	4	-G
B10_BC22_191109_LF_LIB_consensus_vsearch	121	G	G	594	1	0.17%	2	1	93	93	0.5000000000008233	1	1	385	209	1	0	A
B10_BC22_191109_LF_LIB_consensus_vsearch	122	G	G	597	2	0.33%	2	1	93	93	0.24979114452852993	1	1	383	214	2	0	A
B10_BC22_191109_LF_LIB_consensus_vsearch	123	A	A	587	4	0.67%	2	1	93	93	0.062182607140620794	1	1	376	211	4	0	+C
B10_BC22_191109_LF_LIB_consensus_vsearch	124	T	*/+A	581	8	1.34%	2	1	93	93	0.0038139152066312184	1	1	380	201	0	8	+A
B10_BC22_191109_LF_LIB_consensus_vsearch	125	A	A	594	3	0.5%	2	2	93	93	0.12468566638724124	1	1	383	211	1	2	G
B10_BC22_191109_LF_LIB_consensus_vsearch	126	A	R	577	9	1.5%	2	1	93	93	0.0018936179518815892	1	1	364	213	9	0	G
B10_BC22_191109_LF_LIB_consensus_vsearch	127	C	Y	586	7	1.17%	2	1	93	93	0.007674635299574334	1	1	379	207	0	7	T
B10_BC22_191109_LF_LIB_consensus_vsearch	128	C	C	584	6	1%	2	2	93	93	0.015426715197547503	1	1	375	209	4	2	+A
B10_BC22_191109_LF_LIB_consensus_vsearch	129	G	G	586	6	1%	2	1	93	93	0.015427383935577244	1	1	376	210	6	0	A
B10_BC22_191109_LF_LIB_consensus_vsearch	130	T	T	580	6	1.01%	2	2	93	93	0.01542536405110175	1	1	374	206	3	3	-G
B10_BC22_191109_LF_LIB_consensus_vsearch	131	G	R	574	8	1.35%	2	2	93	93	0.0038128109095927364	1	1	364	210	7	1	A
B10_BC22_191109_LF_LIB_consensus_vsearch	132	G	G	587	5	0.83%	2	1	93	93	0.030986176592841308	1	1	374	213	5	0	A
B10_BC22_191109_LF_LIB_consensus_vsearch	133	T	Y	572	14	2.35%	2	2	93	93	5.642421556871879E-5	1	1	369	203	6	8	C
B10_BC22_191109_LF_LIB_consensus_vsearch	134	A	A	594	3	0.5%	2	2	93	93	0.12468566638724124	1	1	381	213	2	1	C
B10_BC22_191109_LF_LIB_consensus_vsearch	135	A	A	596	2	0.33%	2	1	93	93	0.24979079497935539	1	1	385	211	0	2	-T
B10_BC22_191109_LF_LIB_consensus_vsearch	136	T	T	597	2	0.33%	2	1	93	93	0.24979114452852993	1	1	386	211	0	2	C
B10_BC22_191109_LF_LIB_consensus_vsearch	137	T	*/-C	574	20	3.32%	2	2	93	93	8.105500460828035E-7	1	1	383	191	2	18	-C
B10_BC22_191109_LF_LIB_consensus_vsearch	138	C	C	573	4	0.69%	2	1	93	93	0.062174902776938816	1	1	378	195	4	0	-TA
B10_BC22_191109_LF_LIB_consensus_vsearch	139	T	*/+A	548	23	3.87%	2	1	93	93	9.50945607031125E-8	1	1	349	199	23	0	+A
B10_BC22_191109_LF_LIB_consensus_vsearch	140	A	A	565	5	0.85%	2	2	93	93	0.030975998480304686	1	1	371	194	4	1	-G
B10_BC22_191109_LF_LIB_consensus_vsearch	141	G	G	578	6	1.01%	2	1	93	93	0.015424681549082461	1	1	369	209	6	0	+A
B10_BC22_191109_LF_LIB_consensus_vsearch	142	A	*/-G	574	10	1.69%	2	2	93	93	9.393564316164558E-4	1	1	367	207	9	1	-G
B10_BC22_191109_LF_LIB_consensus_vsearch	143	G	R	572	10	1.7%	2	2	93	93	9.39230016764963E-4	1	1	364	208	9	1	A
B10_BC22_191109_LF_LIB_consensus_vsearch	144	C	C	584	6	1%	2	2	93	93	0.015426715197547503	1	1	378	206	1	5	-T
B10_BC22_191109_LF_LIB_consensus_vsearch	145	T	Y	563	13	2.2%	2	2	93	93	1.13993881752923E-4	1	1	372	191	3	10	C
B10_BC22_191109_LF_LIB_consensus_vsearch	146	A	A	577	4	0.68%	2	2	93	93	0.06217714192710672	1	1	373	204	1	3	C
B10_BC22_191109_LF_LIB_consensus_vsearch	147	A	M	577	7	1.17%	2	2	93	93	0.007672518016675552	1	1	375	202	2	5	C
B10_BC22_191109_LF_LIB_consensus_vsearch	148	T	Y	584	8	1.34%	2	2	93	93	0.0038143805269862142	1	1	377	207	2	6	C
B10_BC22_191109_LF_LIB_consensus_vsearch	149	A	A	584	6	1%	2	1	93	93	0.015426715197547503	1	1	373	211	6	0	C
B10_BC22_191109_LF_LIB_consensus_vsearch	150	C	C	592	3	0.5%	2	1	93	93	0.1246846089151382	1	1	382	210	0	3	T
B10_BC22_191109_LF_LIB_consensus_vsearch	151	A	A	587	6	1%	2	2	93	93	0.015427716615850288	1	1	375	212	5	1	G
B10_BC22_191109_LF_LIB_consensus_vsearch	152	T	T	586	6	1%	2	2	93	93	0.015427383935577244	1	1	380	206	1	5	C
B10_BC22_191109_LF_LIB_consensus_vsearch	153	G	R	583	8	1.34%	2	1	93	93	0.0038142259421648926	1	1	372	211	8	0	A
B10_BC22_191109_LF_LIB_consensus_vsearch	154	C	C	581	3	0.5%	2	1	93	93	0.1246786632393088	1	1	372	209	3	0	-T
B10_BC22_191109_LF_LIB_consensus_vsearch	155	T	*/-A	490	73	12.27%	2	2	93	93	8.721436529473336E-24	1	1	342	148	23	50	-A
B10_BC22_191109_LF_LIB_consensus_vsearch	156	A	A	508	1	0.2%	2	1	93	93	0.4999999999999138	1	1	354	154	1	0	+CA
B10_BC22_191109_LF_LIB_consensus_vsearch	157	A	A	583	2	0.34%	2	1	93	93	0.24978614200168656	1	1	377	206	2	0	G
B10_BC22_191109_LF_LIB_consensus_vsearch	158	A	A	601	1	0.17%	2	1	93	93	0.4999999999990043	1	1	388	213	0	1	G
B10_BC22_191109_LF_LIB_consensus_vsearch	159	A	A	598	3	0.5%	2	2	93	93	0.12468776019987309	1	1	385	213	2	1	G
B10_BC22_191109_LF_LIB_consensus_vsearch	160	A	R	563	22	3.65%	2	2	93	93	1.9497751589333508E-7	1	1	363	200	20	2	G
B10_BC22_191109_LF_LIB_consensus_vsearch	161	C	C	582	3	0.51%	2	2	93	93	0.12467921300240917	1	1	380	202	1	2	+T
B10_BC22_191109_LF_LIB_consensus_vsearch	162	C	*/-T	590	8	1.33%	2	1	93	93	0.003815297238788008	1	1	386	204	0	8	-T
B10_BC22_191109_LF_LIB_consensus_vsearch	163	T	T	588	4	0.67%	2	2	93	93	0.06218314350277022	1	1	385	203	2	2	C
B10_BC22_191109_LF_LIB_consensus_vsearch	164	C	C	586	3	0.5%	2	1	93	93	0.12468139337307069	1	1	375	211	3	0	+AC
B10_BC22_191109_LF_LIB_consensus_vsearch	165	G	G	598	2	0.33%	2	2	93	93	0.24979149291046765	1	1	385	213	1	1	A
B10_BC22_191109_LF_LIB_consensus_vsearch	166	A	A	600	1	0.17%	2	1	93	93	0.4999999999999138	1	1	386	214	0	1	-CT
B10_BC22_191109_LF_LIB_consensus_vsearch	167	C	*/-T	582	12	1.99%	2	2	93	93	2.3082155254131308E-4	1	1	376	206	8	4	-T
B10_BC22_191109_LF_LIB_consensus_vsearch	168	T	T	583	2	0.34%	2	1	93	93	0.24978614200168656	1	1	374	209	2	0	C
B10_BC22_191109_LF_LIB_consensus_vsearch	169	T	*/+C	561	11	1.83%	2	1	93	93	4.6515403682255657E-4	1	1	351	210	11	0	+C
B10_BC22_191109_LF_LIB_consensus_vsearch	170	C	*/-G	557	22	3.74%	2	2	93	93	1.9456380897049484E-7	1	1	373	184	1	21	-G
B10_BC22_191109_LF_LIB_consensus_vsearch	171	G	G	574	2	0.35%	2	2	93	93	0.24978279756726465	1	1	383	191	1	1	A
B10_BC22_191109_LF_LIB_consensus_vsearch	172	G	*/-A	586	9	1.5%	2	2	93	93	0.0018945108065208946	1	1	379	207	6	3	-A
B10_BC22_191109_LF_LIB_consensus_vsearch	173	A	A	588	1	0.17%	2	1	93	93	0.4999999999990043	1	1	380	208	1	0	+GA
B10_BC22_191109_LF_LIB_consensus_vsearch	174	A	*/-G	387	131	21.87%	2	2	93	93	2.929981500567758E-44	1	1	218	169	123	8	-G
B10_BC22_191109_LF_LIB_consensus_vsearch	175	G	G	414	6	1.42%	2	1	93	93	0.01534665043910028	1	1	239	175	6	0	+A
B10_BC22_191109_LF_LIB_consensus_vsearch	176	G	R	545	7	1.26%	2	2	93	93	0.007664432804486939	1	1	361	184	6	1	A
B10_BC22_191109_LF_LIB_consensus_vsearch	177	G	R	558	21	3.51%	2	1	93	93	3.9644991182852906E-7	1	1	348	210	21	0	A
B10_BC22_191109_LF_LIB_consensus_vsearch	178	G	K	582	9	1.5%	2	1	93	93	0.0018941173119931185	1	1	374	208	9	0	T
B10_BC22_191109_LF_LIB_consensus_vsearch	179	T	T	585	3	0.5%	2	2	93	93	0.1246808510636648	1	1	380	205	1	2	+A
B10_BC22_191109_LF_LIB_consensus_vsearch	180	G	G	589	3	0.5%	2	1	93	93	0.1246830092985462	1	1	381	208	0	3	A
B10_BC22_191109_LF_LIB_consensus_vsearch	181	T	T	582	6	1%	2	2	93	93	0.015426041918236095	1	1	380	202	2	4	C
B10_BC22_191109_LF_LIB_consensus_vsearch	182	A	*/-T	579	9	1.51%	2	2	93	93	0.0018938187066465067	1	1	379	200	2	7	-T
B10_BC22_191109_LF_LIB_consensus_vsearch	183	T	T	583	2	0.34%	2	1	93	93	0.24978614200168656	1	1	382	201	0	2	C
B10_BC22_191109_LF_LIB_consensus_vsearch	184	T	T	595	2	0.33%	2	2	93	93	0.24979044425840527	1	1	385	210	1	1	C
B10_BC22_191109_LF_LIB_consensus_vsearch	185	T	T	589	3	0.5%	2	2	93	93	0.1246830092985462	1	1	382	207	1	2	+G
B10_BC22_191109_LF_LIB_consensus_vsearch	186	A	A	584	5	0.83%	2	1	93	93	0.030984833420659205	1	1	377	207	5	0	G
B10_BC22_191109_LF_LIB_consensus_vsearch	187	T	T	591	3	0.5%	2	1	93	93	0.12468407750622149	1	1	383	208	3	0	G
B10_BC22_191109_LF_LIB_consensus_vsearch	188	T	+A/+A	32	534	89%	2	2	93	93	8.446479506311421E-287	1	1	25	7	349	185	+A
B10_BC22_191109_LF_LIB_consensus_vsearch	189	G	*/+A	571	25	4.16%	2	1	93	93	2.304867306955242E-8	1	1	359	212	25	0	+A
B10_BC22_191109_LF_LIB_consensus_vsearch	190	A	A	593	2	0.33%	2	1	93	93	0.24978973927711676	1	1	383	210	0	2	+C
B10_BC22_191109_LF_LIB_consensus_vsearch	191	T	*/-A	368	115	19.23%	2	2	93	93	1.0669054063285987E-38	1	1	294	74	41	74	-A
B10_BC22_191109_LF_LIB_consensus_vsearch	192	A	A	401	1	0.25%	2	1	93	93	0.5000000000008233	1	1	316	85	0	1	C
B10_BC22_191109_LF_LIB_consensus_vsearch	193	A	A	513	3	0.58%	2	2	93	93	0.12463627546097235	1	1	355	158	2	1	T
B10_BC22_191109_LF_LIB_consensus_vsearch	194	A	A	581	2	0.34%	2	1	93	93	0.24978540772560268	1	1	374	207	0	2	G
B10_BC22_191109_LF_LIB_consensus_vsearch	195	A	A	590	4	0.66%	2	1	93	93	0.062184210806914414	1	1	385	205	0	4	+C
B10_BC22_191109_LF_LIB_consensus_vsearch	196	A	A	595	3	0.5%	2	1	93	93	0.12468619246852639	1	1	386	209	0	3	C
B10_BC22_191109_LF_LIB_consensus_vsearch	197	A	*/-C	582	12	1.99%	2	2	93	93	2.3082155254131308E-4	1	1	374	208	6	6	-C
B10_BC22_191109_LF_LIB_consensus_vsearch	198	C	C	586	2	0.34%	2	1	93	93	0.24978723404299805	1	1	379	207	0	2	+AA
B10_BC22_191109_LF_LIB_consensus_vsearch	199	C	*/+A	568	18	2.99%	2	1	93	93	3.341204460471138E-6	1	1	380	188	0	18	+A
B10_BC22_191109_LF_LIB_consensus_vsearch	200	A	A	586	2	0.34%	2	2	93	93	0.24978723404299805	1	1	379	207	1	1	G
B10_BC22_191109_LF_LIB_consensus_vsearch	201	A	*/+CA	550	11	1.83%	2	1	93	93	4.647074958288269E-4	1	1	376	174	0	11	+CA
B10_BC22_191109_LF_LIB_consensus_vsearch	202	T	Y	523	29	4.96%	2	2	93	93	1.27692477156723E-9	1	1	380	143	1	28	C
B10_BC22_191109_LF_LIB_consensus_vsearch	203	G	R	500	43	7.34%	2	2	93	93	4.783949199067298E-14	1	1	362	138	10	33	A
B10_BC22_191109_LF_LIB_consensus_vsearch	204	C	Y	553	13	2.23%	2	2	93	93	1.1385455693595117E-4	1	1	373	180	1	12	T
B10_BC22_191109_LF_LIB_consensus_vsearch	205	C	Y	576	17	2.83%	2	1	93	93	6.791797557940805E-6	1	1	386	190	0	17	T
B10_BC22_191109_LF_LIB_consensus_vsearch	206	C	*/-T	574	16	2.66%	2	1	93	93	1.3764655753705977E-5	1	1	386	188	0	16	-T
B10_BC22_191109_LF_LIB_consensus_vsearch	207	T	T	580	4	0.68%	2	2	93	93	0.06217880115194425	1	1	387	193	1	3	C
B10_BC22_191109_LF_LIB_consensus_vsearch	208	T	*/+C	576	13	2.16%	2	2	93	93	1.141680944483324E-4	1	1	366	210	12	1	+C
B10_BC22_191109_LF_LIB_consensus_vsearch	209	C	*/-G	529	28	4.71%	2	2	93	93	2.6305727306574877E-9	1	1	344	185	14	14	-G
B10_BC22_191109_LF_LIB_consensus_vsearch	210	G	R	459	106	18.63%	2	2	93	93	5.340500740917049E-35	1	1	265	194	104	2	A
B10_BC22_191109_LF_LIB_consensus_vsearch	211	G	R	578	17	2.85%	2	2	93	93	6.79449051358913E-6	1	1	372	206	13	4	A
B10_BC22_191109_LF_LIB_consensus_vsearch	212	G	R	578	15	2.51%	2	2	93	93	2.7901261387207864E-5	1	1	375	203	9	6	A
B10_BC22_191109_LF_LIB_consensus_vsearch	213	G	G	582	6	1%	2	2	93	93	0.015426041918236095	1	1	383	199	4	2	A
B10_BC22_191109_LF_LIB_consensus_vsearch	214	C	*/-T	560	28	4.67%	2	1	93	93	2.6804600811283658E-9	1	1	382	178	0	28	-T
B10_BC22_191109_LF_LIB_consensus_vsearch	215	T	*/-C	545	18	3.14%	2	2	93	93	3.3228779155975013E-6	1	1	370	175	11	7	-C
B10_BC22_191109_LF_LIB_consensus_vsearch	216	C	C	562	5	0.86%	2	1	93	93	0.03097454938768609	1	1	364	198	5	0	+G
B10_BC22_191109_LF_LIB_consensus_vsearch	217	C	M	522	20	3.33%	2	1	93	93	7.97773510015569E-7	1	1	356	166	20	0	A
B10_BC22_191109_LF_LIB_consensus_vsearch	218	T	K	557	19	3.25%	2	1	93	93	1.6402477468452338E-6	1	1	354	203	19	0	G
B10_BC22_191109_LF_LIB_consensus_vsearch	219	T	Y	538	29	4.89%	2	2	93	93	1.2900775863284771E-9	1	1	351	187	24	5	C
B10_BC22_191109_LF_LIB_consensus_vsearch	220	G	R	506	33	5.7%	2	2	93	93	7.02500770579947E-11	1	1	322	184	31	2	A
B10_BC22_191109_LF_LIB_consensus_vsearch	221	G	R	575	16	2.67%	2	2	93	93	1.3767088119335913E-5	1	1	379	196	8	8	A
B10_BC22_191109_LF_LIB_consensus_vsearch	222	T	Y	559	16	2.67%	2	2	93	93	1.37271954373405E-5	1	1	371	188	4	12	C
B10_BC22_191109_LF_LIB_consensus_vsearch	223	G	*/-A	578	14	2.35%	2	1	93	93	5.646967505352899E-5	1	1	370	208	14	0	-A
B10_BC22_191109_LF_LIB_consensus_vsearch	224	A	A	578	4	0.68%	2	1	93	93	0.06217769690336766	1	1	365	213	4	0	+G
B10_BC22_191109_LF_LIB_consensus_vsearch	225	A	A	592	5	0.83%	2	2	93	93	0.03098838522787931	1	1	382	210	3	2	G
B10_BC22_191109_LF_LIB_consensus_vsearch	226	T	T	591	4	0.67%	2	2	93	93	0.06218474176725347	1	1	380	211	3	1	-C
B10_BC22_191109_LF_LIB_consensus_vsearch	227	C	C	587	3	0.5%	2	2	93	93	0.12468193384235185	1	1	375	212	2	1	+G
B10_BC22_191109_LF_LIB_consensus_vsearch	228	A	A	580	6	1%	2	2	93	93	0.01542536405110175	1	1	366	214	5	1	C
B10_BC22_191109_LF_LIB_consensus_vsearch	229	T	Y	576	9	1.5%	2	2	93	93	0.001893517063995506	1	1	367	209	8	1	C
B10_BC22_191109_LF_LIB_consensus_vsearch	230	A	A	576	4	0.68%	2	1	93	93	0.0621765850361776	1	1	367	209	4	0	+G
B10_BC22_191109_LF_LIB_consensus_vsearch	231	A	*/-TAA	551	30	5.02%	2	2	93	93	6.342583583591341E-10	1	1	342	209	26	4	-TAA
B10_BC22_191109_LF_LIB_consensus_vsearch	232	T	*/-A	549	7	1.24%	2	1	93	93	0.007665494166045835	1	1	343	206	7	0	-A
B10_BC22_191109_LF_LIB_consensus_vsearch	233	A	A	555	3	0.54%	2	1	93	93	0.12466367713011399	1	1	347	208	3	0	C
B10_BC22_191109_LF_LIB_consensus_vsearch	234	A	R	533	13	2.28%	2	1	93	93	1.1356097757884097E-4	1	1	343	190	13	0	G
B10_BC22_191109_LF_LIB_consensus_vsearch	235	C	*/-T	574	13	2.18%	2	2	93	93	1.1414178313129473E-4	1	1	378	196	4	9	-T
B10_BC22_191109_LF_LIB_consensus_vsearch	236	T	Y	568	7	1.21%	2	2	93	93	0.007670334687803565	1	1	376	192	3	4	C
B10_BC22_191109_LF_LIB_consensus_vsearch	237	T	T	578	6	1%	2	1	93	93	0.015424681549082461	1	1	368	210	6	0	A
B10_BC22_191109_LF_LIB_consensus_vsearch	238	C	*/+A	575	8	1.34%	2	1	93	93	0.0038129702806793094	1	1	372	203	0	8	+A
B10_BC22_191109_LF_LIB_consensus_vsearch	239	A	A	586	5	0.84%	2	2	93	93	0.030985730383315414	1	1	376	210	2	3	G
B10_BC22_191109_LF_LIB_consensus_vsearch	240	C	Y	575	17	2.83%	2	2	93	93	6.790444562646919E-6	1	1	371	204	6	11	T
B10_BC22_191109_LF_LIB_consensus_vsearch	241	G	G	586	5	0.83%	2	2	93	93	0.030985730383315414	1	1	373	213	4	1	+A
B10_BC22_191109_LF_LIB_consensus_vsearch	242	A	A	595	1	0.17%	2	1	93	93	0.4999999999999138	1	1	380	215	1	0	G
B10_BC22_191109_LF_LIB_consensus_vsearch	243	A	A	591	4	0.66%	2	1	93	93	0.06218474176725347	1	1	382	209	0	4	+C
B10_BC22_191109_LF_LIB_consensus_vsearch	244	T	T	591	5	0.83%	2	2	93	93	0.030987946464272845	1	1	381	210	2	3	-C
B10_BC22_191109_LF_LIB_consensus_vsearch	245	C	*/-GC	563	25	4.18%	2	1	93	93	2.296650789566818E-8	1	1	353	210	25	0	-GC
B10_BC22_191109_LF_LIB_consensus_vsearch	246	G	G	570	2	0.35%	2	2	93	93	0.2497812773401183	1	1	357	213	1	1	A
B10_BC22_191109_LF_LIB_consensus_vsearch	247	C	*/+A	556	10	1.74%	2	2	93	93	9.381869124860784E-4	1	1	356	200	1	9	+A
B10_BC22_191109_LF_LIB_consensus_vsearch	248	A	A	583	6	1%	2	2	93	93	0.015426379128433065	1	1	378	205	4	2	G
B10_BC22_191109_LF_LIB_consensus_vsearch	249	T	Y	573	10	1.67%	2	2	93	93	9.392933313754103E-4	1	1	381	192	2	8	C
B10_BC22_191109_LF_LIB_consensus_vsearch	250	G	G	580	4	0.67%	2	1	93	93	0.06217880115194425	1	1	381	199	0	4	A
B10_BC22_191109_LF_LIB_consensus_vsearch	251	G	*/-C	570	10	1.67%	2	2	93	93	9.39102740052465E-4	1	1	374	196	8	2	-C
B10_BC22_191109_LF_LIB_consensus_vsearch	252	C	C	573	6	1.02%	2	1	93	93	0.015422954702023957	1	1	374	199	0	6	T
B10_BC22_191109_LF_LIB_consensus_vsearch	253	C	*/+T	568	9	1.5%	2	2	93	93	0.0018926974773018042	1	1	376	192	1	8	+T
B10_BC22_191109_LF_LIB_consensus_vsearch	254	T	T	584	3	0.51%	2	2	93	93	0.12468030690531334	1	1	380	204	1	2	C
B10_BC22_191109_LF_LIB_consensus_vsearch	255	T	T	590	4	0.67%	2	2	93	93	0.062184210806914414	1	1	382	208	3	1	-G
B10_BC22_191109_LF_LIB_consensus_vsearch	256	G	G	589	4	0.67%	2	1	93	93	0.06218367805512527	1	1	379	210	4	0	A
B10_BC22_191109_LF_LIB_consensus_vsearch	257	C	*/-GC	577	10	1.66%	2	2	93	93	9.395444569434851E-4	1	1	373	204	7	3	-GC
B10_BC22_191109_LF_LIB_consensus_vsearch	258	G	G	578	5	0.85%	2	2	93	93	0.030982105624386143	1	1	367	211	4	1	A
B10_BC22_191109_LF_LIB_consensus_vsearch	259	C	C	584	4	0.68%	2	1	93	93	0.062180987103355005	1	1	373	211	4	0	T
B10_BC22_191109_LF_LIB_consensus_vsearch	260	C	C	590	4	0.66%	2	1	93	93	0.062184210806914414	1	1	381	209	0	4	-G
B10_BC22_191109_LF_LIB_consensus_vsearch	261	G	G	591	2	0.33%	2	1	93	93	0.24978902953563295	1	1	382	209	2	0	+A
B10_BC22_191109_LF_LIB_consensus_vsearch	262	G	R	590	11	1.82%	2	2	93	93	4.6625406138871647E-4	1	1	379	211	8	3	A
B10_BC22_191109_LF_LIB_consensus_vsearch	263	C	C	588	6	1%	2	2	93	93	0.015428048177952706	1	1	380	208	1	5	T
B10_BC22_191109_LF_LIB_consensus_vsearch	264	G	G	594	2	0.33%	2	1	93	93	0.24979009235977778	1	1	381	213	2	0	-A
B10_BC22_191109_LF_LIB_consensus_vsearch	265	A	A	591	4	0.67%	2	2	93	93	0.06218474176725347	1	1	378	213	3	1	G
B10_BC22_191109_LF_LIB_consensus_vsearch	266	T	*/-G	587	7	1.16%	2	2	93	93	0.007674866606290045	1	1	379	208	1	6	-G
B10_BC22_191109_LF_LIB_consensus_vsearch	267	G	R	559	34	5.7%	2	1	93	93	3.577254212584259E-11	1	1	350	209	34	0	A
B10_BC22_191109_LF_LIB_consensus_vsearch	268	G	*/+A	572	14	2.32%	2	1	93	93	5.642421556871879E-5	1	1	357	215	14	0	+A
B10_BC22_191109_LF_LIB_consensus_vsearch	269	T	T	595	5	0.83%	2	1	93	93	0.03098969274732699	1	1	387	208	0	5	+C
B10_BC22_191109_LF_LIB_consensus_vsearch	270	T	T	591	5	0.83%	2	1	93	93	0.030987946464272845	1	1	382	209	5	0	+C
B10_BC22_191109_LF_LIB_consensus_vsearch	271	C	*/-A	577	7	1.17%	2	2	93	93	0.007672518016675552	1	1	371	206	6	1	-A
B10_BC22_191109_LF_LIB_consensus_vsearch	272	A	*/+T	575	8	1.35%	2	1	93	93	0.0038129702806793094	1	1	363	212	8	0	+T
B10_BC22_191109_LF_LIB_consensus_vsearch	273	T	T	585	6	1.01%	2	1	93	93	0.015427050131369397	1	1	372	213	6	0	G
B10_BC22_191109_LF_LIB_consensus_vsearch	274	T	*/+G	577	8	1.33%	2	1	93	93	0.0038132873975118887	1	1	365	212	8	0	+G
B10_BC22_191109_LF_LIB_consensus_vsearch	275	C	*/-A	565	11	1.85%	2	1	93	93	4.6531225052335137E-4	1	1	352	213	11	0	-A
B10_BC22_191109_LF_LIB_consensus_vsearch	276	A	A	581	3	0.51%	2	1	93	93	0.1246786632393088	1	1	368	213	3	0	G
B10_BC22_191109_LF_LIB_consensus_vsearch	277	A	A	592	2	0.34%	2	1	93	93	0.24978938500452047	1	1	379	213	2	0	G
B10_BC22_191109_LF_LIB_consensus_vsearch	278	A	*/-T	558	36	5.99%	2	2	93	93	8.423273398633119E-12	1	1	366	192	14	22	-T
B10_BC22_191109_LF_LIB_consensus_vsearch	279	T	T	557	3	0.53%	2	2	93	93	0.12466487935656913	1	1	367	190	2	1	C
B10_BC22_191109_LF_LIB_consensus_vsearch	280	T	Y	586	9	1.51%	2	2	93	93	0.0018945108065208946	1	1	383	203	2	7	C
B10_BC22_191109_LF_LIB_consensus_vsearch	281	T	*/-CT	584	7	1.16%	2	2	93	93	0.007674170345963	1	1	381	203	2	5	-CT
B10_BC22_191109_LF_LIB_consensus_vsearch	282	C	C	583	6	1.01%	2	1	93	93	0.015426379128433065	1	1	384	199	0	6	-T
B10_BC22_191109_LF_LIB_consensus_vsearch	283	T	T	576	5	0.85%	2	2	93	93	0.030981183844570895	1	1	380	196	1	4	-G
B10_BC22_191109_LF_LIB_consensus_vsearch	284	G	*/-C	536	46	7.72%	2	2	93	93	5.631661287832055E-15	1	1	331	205	43	3	-C
B10_BC22_191109_LF_LIB_consensus_vsearch	285	C	C	542	2	0.36%	2	2	93	93	0.24977000919972706	1	1	333	209	1	1	A
B10_BC22_191109_LF_LIB_consensus_vsearch	286	C	C	586	6	1.01%	2	2	93	93	0.015427383935577244	1	1	377	209	1	5	T
B10_BC22_191109_LF_LIB_consensus_vsearch	287	C	*/+T	583	10	1.66%	2	1	93	93	9.399148640318375E-4	1	1	382	201	0	10	+T
B10_BC22_191109_LF_LIB_consensus_vsearch	288	T	Y	577	18	3%	2	2	93	93	3.3480098182809704E-6	1	1	383	194	2	16	C
B10_BC22_191109_LF_LIB_consensus_vsearch	289	A	A	595	3	0.5%	2	1	93	93	0.12468619246852639	1	1	385	210	0	3	+TT
B10_BC22_191109_LF_LIB_consensus_vsearch	290	T	T	593	3	0.5%	2	2	93	93	0.12468513853935516	1	1	382	211	2	1	-C
B10_BC22_191109_LF_LIB_consensus_vsearch	291	C	C	594	3	0.5%	2	1	93	93	0.12468566638724124	1	1	386	208	0	3	-A
B10_BC22_191109_LF_LIB_consensus_vsearch	292	A	A	594	4	0.67%	2	2	93	93	0.062186323989038686	1	1	385	209	3	1	G
B10_BC22_191109_LF_LIB_consensus_vsearch	293	A	R	583	13	2.16%	2	1	93	93	1.1425882511188655E-4	1	1	374	209	13	0	G
B10_BC22_191109_LF_LIB_consensus_vsearch	294	C	*/-T	556	30	4.98%	2	2	93	93	6.363950277686408E-10	1	1	374	182	4	26	-T
B10_BC22_191109_LF_LIB_consensus_vsearch	295	T	T	554	6	1.07%	2	2	93	93	0.01541611196434416	1	1	375	179	3	3	C
B10_BC22_191109_LF_LIB_consensus_vsearch	296	T	T	587	3	0.51%	2	1	93	93	0.12468193384235185	1	1	381	206	0	3	C
B10_BC22_191109_LF_LIB_consensus_vsearch	297	T	T	584	5	0.83%	2	1	93	93	0.030984833420659205	1	1	379	205	0	5	-C
B10_BC22_191109_LF_LIB_consensus_vsearch	298	C	C	578	4	0.67%	2	1	93	93	0.06217769690336766	1	1	384	194	0	4	+G
B10_BC22_191109_LF_LIB_consensus_vsearch	299	G	G	592	6	1%	2	1	93	93	0.01542936335614873	1	1	380	212	6	0	-A
B10_BC22_191109_LF_LIB_consensus_vsearch	300	A	A	589	5	0.84%	2	2	93	93	0.030987064506852544	1	1	378	211	3	2	G
B10_BC22_191109_LF_LIB_consensus_vsearch	301	T	*/-G	588	11	1.82%	2	2	93	93	4.661815676446506E-4	1	1	383	205	4	7	-G
B10_BC22_191109_LF_LIB_consensus_vsearch	302	G	G	584	2	0.34%	2	1	93	93	0.2497865072588101	1	1	380	204	2	0	+A
B10_BC22_191109_LF_LIB_consensus_vsearch	303	G	G	593	2	0.33%	2	1	93	93	0.24978973927711676	1	1	380	213	2	0	-TAGG
B10_BC22_191109_LF_LIB_consensus_vsearch	304	T	Y	561	20	3.34%	2	2	93	93	8.075558512578247E-7	1	1	375	186	3	17	C
B10_BC22_191109_LF_LIB_consensus_vsearch	305	A	*/+G	566	7	1.19%	2	1	93	93	0.007669840222466952	1	1	378	188	0	7	+G
B10_BC22_191109_LF_LIB_consensus_vsearch	306	G	G	586	2	0.34%	2	1	93	93	0.24978723404299805	1	1	383	203	0	2	+TG
B10_BC22_191109_LF_LIB_consensus_vsearch	307	G	G	598	1	0.17%	2	1	93	93	0.5000000000008233	1	1	383	215	1	0	-A
B10_BC22_191109_LF_LIB_consensus_vsearch	308	A	A	595	3	0.5%	2	1	93	93	0.12468619246852639	1	1	383	212	3	0	G
B10_BC22_191109_LF_LIB_consensus_vsearch	309	T	*/-A	490	94	15.67%	2	2	93	93	8.59530412370605E-31	1	1	288	202	89	5	-A
B10_BC22_191109_LF_LIB_consensus_vsearch	310	A	*/+G	488	8	1.58%	2	2	93	93	0.0037967169586205873	1	1	288	200	2	6	+G
B10_BC22_191109_LF_LIB_consensus_vsearch	311	G	*/-A	579	9	1.51%	2	2	93	93	0.0018938187066465067	1	1	369	210	8	1	-A
B10_BC22_191109_LF_LIB_consensus_vsearch	312	A	*/-G	563	14	2.37%	2	2	93	93	5.6354304075806794E-5	1	1	360	203	7	7	-G
B10_BC22_191109_LF_LIB_consensus_vsearch	313	G	G	578	4	0.68%	2	2	93	93	0.06217769690336766	1	1	373	205	3	1	T
B10_BC22_191109_LF_LIB_consensus_vsearch	314	G	*/+C	559	19	3.16%	2	1	93	93	1.6411182396607268E-6	1	1	347	212	19	0	+C
B10_BC22_191109_LF_LIB_consensus_vsearch	315	C	*/+T	568	11	1.85%	2	2	93	93	4.6542949773112336E-4	1	1	369	199	1	10	+T
B10_BC22_191109_LF_LIB_consensus_vsearch	316	C	*/-T	576	16	2.66%	2	2	93	93	1.3769512585367692E-5	1	1	373	203	4	12	-T
B10_BC22_191109_LF_LIB_consensus_vsearch	317	T	T	574	3	0.51%	2	2	93	93	0.12467476149184535	1	1	375	199	1	2	C
B10_BC22_191109_LF_LIB_consensus_vsearch	318	A	A	581	6	1.01%	2	2	93	93	0.015425703561055139	1	1	369	212	4	2	G
B10_BC22_191109_LF_LIB_consensus_vsearch	319	C	C	582	4	0.67%	2	1	93	93	0.0621798978595429	1	1	375	207	0	4	+T
B10_BC22_191109_LF_LIB_consensus_vsearch	320	C	C	593	1	0.17%	2	1	93	93	0.5000000000008233	1	1	378	215	1	0	+A
B10_BC22_191109_LF_LIB_consensus_vsearch	321	A	A	592	3	0.5%	2	2	93	93	0.1246846089151382	1	1	382	210	2	1	G
B10_BC22_191109_LF_LIB_consensus_vsearch	322	T	*/-G	584	8	1.33%	2	2	93	93	0.0038143805269862142	1	1	378	206	3	5	-G
B10_BC22_191109_LF_LIB_consensus_vsearch	323	G	R	576	16	2.69%	2	2	93	93	1.3769512585367692E-5	1	1	368	208	15	1	A
B10_BC22_191109_LF_LIB_consensus_vsearch	324	G	*/+A	564	11	1.83%	2	1	93	93	4.6527290034786725E-4	1	1	356	208	11	0	+A
B10_BC22_191109_LF_LIB_consensus_vsearch	325	T	T	586	5	0.84%	2	2	93	93	0.030985730383315414	1	1	379	207	1	4	C
B10_BC22_191109_LF_LIB_consensus_vsearch	326	T	T	592	5	0.83%	2	2	93	93	0.03098838522787931	1	1	383	209	1	4	C
B10_BC22_191109_LF_LIB_consensus_vsearch	327	T	*/+C	579	10	1.66%	2	2	93	93	9.396687550389984E-4	1	1	370	209	9	1	+C
B10_BC22_191109_LF_LIB_consensus_vsearch	328	C	C	593	4	0.67%	2	2	93	93	0.06218579834936829	1	1	385	208	1	3	-A
B10_BC22_191109_LF_LIB_consensus_vsearch	329	A	A	589	3	0.5%	2	1	93	93	0.1246830092985462	1	1	378	211	3	0	G
B10_BC22_191109_LF_LIB_consensus_vsearch	330	A	R	537	55	9.15%	2	2	93	93	7.449786462571192E-18	1	1	326	211	53	2	G
B10_BC22_191109_LF_LIB_consensus_vsearch	331	C	*/+TT	569	12	2.01%	2	1	93	93	2.305290963962864E-4	1	1	371	198	12	0	+TT
B10_BC22_191109_LF_LIB_consensus_vsearch	332	G	R	515	69	11.71%	2	1	93	93	2.0029829126460695E-22	1	1	313	202	69	0	A
B10_BC22_191109_LF_LIB_consensus_vsearch	333	G	G	587	6	1%	2	1	93	93	0.015427716615850288	1	1	374	213	6	0	+A
B10_BC22_191109_LF_LIB_consensus_vsearch	334	G	G	598	2	0.33%	2	1	93	93	0.24979149291046765	1	1	387	211	0	2	-T
B10_BC22_191109_LF_LIB_consensus_vsearch	335	T	Y	570	24	4.01%	2	1	93	93	4.702624602573014E-8	1	1	388	182	0	24	C
B10_BC22_191109_LF_LIB_consensus_vsearch	336	A	A	597	2	0.33%	2	1	93	93	0.24979114452852993	1	1	386	211	2	0	G
B10_BC22_191109_LF_LIB_consensus_vsearch	337	A	A	586	4	0.67%	2	2	93	93	0.062182068959449006	1	1	381	205	2	2	-C
B10_BC22_191109_LF_LIB_consensus_vsearch	338	C	*/-G	398	166	27.85%	2	2	93	93	6.588956405779423E-57	1	1	233	165	132	34	-G
B10_BC22_191109_LF_LIB_consensus_vsearch	339	G	R	335	65	15.4%	2	2	93	93	1.5969213258981931E-21	1	1	164	171	64	1	A
B10_BC22_191109_LF_LIB_consensus_vsearch	340	G	R	576	12	2.03%	2	2	93	93	2.306881496410543E-4	1	1	368	208	10	2	A
B10_BC22_191109_LF_LIB_consensus_vsearch	341	G	G	592	6	1%	2	2	93	93	0.01542936335614873	1	1	380	212	5	1	A
B10_BC22_191109_LF_LIB_consensus_vsearch	342	G	*/-A	556	32	5.32%	2	1	93	93	1.5093958882482914E-10	1	1	345	211	32	0	-A
B10_BC22_191109_LF_LIB_consensus_vsearch	343	A	A	557	6	1.06%	2	2	93	93	0.0154172230461365	1	1	347	210	3	3	G
B10_BC22_191109_LF_LIB_consensus_vsearch	344	A	*/-T	582	11	1.84%	2	2	93	93	4.659611953509893E-4	1	1	378	204	2	9	-T
B10_BC22_191109_LF_LIB_consensus_vsearch	345	T	K	551	35	5.97%	2	1	93	93	1.7248285829158596E-11	1	1	347	204	35	0	G
B10_BC22_191109_LF_LIB_consensus_vsearch	346	T	*/-A	557	26	4.33%	2	2	93	93	1.1206037812215373E-8	1	1	347	210	24	2	-A
B10_BC22_191109_LF_LIB_consensus_vsearch	347	A	*/-G	456	62	10.86%	2	2	93	93	3.110566370491019E-20	1	1	314	142	11	51	-G
B10_BC22_191109_LF_LIB_consensus_vsearch	348	G	G	527	2	0.38%	2	1	93	93	0.24976348155137792	1	1	368	159	2	0	+A
B10_BC22_191109_LF_LIB_consensus_vsearch	349	G	G	596	1	0.17%	2	1	93	93	0.4999999999999138	1	1	386	210	0	1	+C
B10_BC22_191109_LF_LIB_consensus_vsearch	350	G	G	589	5	0.83%	2	1	93	93	0.030987064506852544	1	1	380	209	5	0	+T
B10_BC22_191109_LF_LIB_consensus_vsearch	351	T	T	586	6	1%	2	1	93	93	0.015427383935577244	1	1	385	201	0	6	+C
B10_BC22_191109_LF_LIB_consensus_vsearch	352	T	Y	582	10	1.66%	2	2	93	93	9.398536450879837E-4	1	1	378	204	6	4	C
B10_BC22_191109_LF_LIB_consensus_vsearch	353	C	C	577	6	1.01%	2	2	93	93	0.01542433854516302	1	1	375	202	3	3	+T
B10_BC22_191109_LF_LIB_consensus_vsearch	354	G	G	593	2	0.33%	2	1	93	93	0.24978973927711676	1	1	381	212	2	0	-A
B10_BC22_191109_LF_LIB_consensus_vsearch	355	A	*/+C	586	9	1.5%	2	2	93	93	0.0018945108065208946	1	1	380	206	1	8	+C
B10_BC22_191109_LF_LIB_consensus_vsearch	356	C	*/-T	579	16	2.66%	2	2	93	93	1.3776738968811594E-5	1	1	384	195	1	15	-T
B10_BC22_191109_LF_LIB_consensus_vsearch	357	T	*/-C	461	110	18.9%	2	2	93	93	2.292507607750374E-36	1	1	310	151	69	41	-C
B10_BC22_191109_LF_LIB_consensus_vsearch	358	C	C	483	2	0.41%	2	2	93	93	0.24974200206373065	1	1	317	166	1	1	T
B10_BC22_191109_LF_LIB_consensus_vsearch	359	C	*/-G	577	11	1.83%	2	2	93	93	4.6577416695331333E-4	1	1	382	195	1	10	-G
B10_BC22_191109_LF_LIB_consensus_vsearch	360	G	*/+A	558	29	4.9%	2	1	93	93	1.306733778080878E-9	1	1	385	173	0	29	+A
B10_BC22_191109_LF_LIB_consensus_vsearch	361	G	G	597	2	0.33%	2	1	93	93	0.24979114452852993	1	1	385	212	2	0	-A
B10_BC22_191109_LF_LIB_consensus_vsearch	362	A	A	591	4	0.67%	2	2	93	93	0.06218474176725347	1	1	382	209	1	3	+G
B10_BC22_191109_LF_LIB_consensus_vsearch	363	G	*/-A	494	77	12.81%	2	2	93	93	4.236774979288493E-25	1	1	309	185	49	28	-A
B10_BC22_191109_LF_LIB_consensus_vsearch	364	A	*/+G	198	272	54.4%	2	2	93	93	2.9527769515419024E-107	1	1	136	62	153	119	+G
B10_BC22_191109_LF_LIB_consensus_vsearch	365	G	G	558	4	0.71%	2	2	93	93	0.06216622196028118	1	1	347	211	3	1	+AGG
B10_BC22_191109_LF_LIB_consensus_vsearch	366	G	*/-A	573	17	2.84%	2	2	93	93	6.7877254318091535E-6	1	1	363	210	13	4	-A
B10_BC22_191109_LF_LIB_consensus_vsearch	367	A	A	568	5	0.87%	2	2	93	93	0.03097743240611924	1	1	359	209	4	1	G
B10_BC22_191109_LF_LIB_consensus_vsearch	368	G	*/-C	578	8	1.34%	2	1	93	93	0.003813445148774959	1	1	366	212	8	0	-C
B10_BC22_191109_LF_LIB_consensus_vsearch	369	C	C	580	6	1.01%	2	2	93	93	0.01542536405110175	1	1	375	205	2	4	T
B10_BC22_191109_LF_LIB_consensus_vsearch	370	C	*/-T	578	12	1.99%	2	2	93	93	2.3073291313309075E-4	1	1	374	204	6	6	-T
B10_BC22_191109_LF_LIB_consensus_vsearch	371	T	Y	548	21	3.58%	2	2	93	93	3.951419568508571E-7	1	1	369	179	4	17	C
B10_BC22_191109_LF_LIB_consensus_vsearch	372	G	*/-A	576	14	2.34%	2	2	93	93	5.645462176707094E-5	1	1	364	212	12	2	-A
B10_BC22_191109_LF_LIB_consensus_vsearch	373	A	*/-GA	537	23	3.94%	2	1	93	93	9.466465233641151E-8	1	1	326	211	23	0	-GA
B10_BC22_191109_LF_LIB_consensus_vsearch	374	G	*/-A	549	10	1.75%	2	2	93	93	9.37712000234479E-4	1	1	340	209	9	1	-A
B10_BC22_191109_LF_LIB_consensus_vsearch	375	A	R	549	7	1.25%	2	2	93	93	0.007665494166045835	1	1	341	208	3	4	G
B10_BC22_191109_LF_LIB_consensus_vsearch	376	A	M	583	7	1.18%	2	1	93	93	0.007673936691127849	1	1	369	214	7	0	C
B10_BC22_191109_LF_LIB_consensus_vsearch	377	A	R	565	14	2.35%	2	1	93	93	5.6370022462689414E-5	1	1	353	212	14	0	G
B10_BC22_191109_LF_LIB_consensus_vsearch	378	C	Y	575	8	1.34%	2	2	93	93	0.0038129702806793094	1	1	366	209	7	1	T
B10_BC22_191109_LF_LIB_consensus_vsearch	379	G	R	551	37	6.26%	2	2	93	93	4.055235280077959E-12	1	1	339	212	36	1	A
B10_BC22_191109_LF_LIB_consensus_vsearch	380	G	G	588	5	0.83%	2	2	93	93	0.0309866212982286	1	1	380	208	2	3	A
B10_BC22_191109_LF_LIB_consensus_vsearch	381	C	C	589	4	0.67%	2	2	93	93	0.06218367805512527	1	1	377	212	2	2	T
B10_BC22_191109_LF_LIB_consensus_vsearch	382	T	Y	586	8	1.33%	2	2	93	93	0.00381468814385855	1	1	377	209	4	4	C
B10_BC22_191109_LF_LIB_consensus_vsearch	383	A	*/-C	580	7	1.17%	2	2	93	93	0.0076732309665896	1	1	367	213	5	2	-C
B10_BC22_191109_LF_LIB_consensus_vsearch	384	C	C	586	2	0.34%	2	2	93	93	0.24978723404299805	1	1	375	211	1	1	T
B10_BC22_191109_LF_LIB_consensus_vsearch	385	C	C	584	6	1.01%	2	2	93	93	0.015426715197547503	1	1	375	209	1	5	T
B10_BC22_191109_LF_LIB_consensus_vsearch	386	A	A	581	6	1.01%	2	2	93	93	0.015425703561055139	1	1	369	212	4	2	G
B10_BC22_191109_LF_LIB_consensus_vsearch	387	C	C	594	2	0.33%	2	2	93	93	0.24979009235977778	1	1	382	212	1	1	T
B10_BC22_191109_LF_LIB_consensus_vsearch	388	A	*/+CA	588	7	1.17%	2	2	93	93	0.007675097138165556	1	1	375	213	6	1	+CA
B10_BC22_191109_LF_LIB_consensus_vsearch	389	T	*/-C	550	51	8.49%	2	2	93	93	1.4670431360972715E-16	1	1	336	214	50	1	-C
B10_BC22_191109_LF_LIB_consensus_vsearch	390	C	Y	539	9	1.63%	2	2	93	93	0.0018895276491797967	1	1	333	206	1	8	T
B10_BC22_191109_LF_LIB_consensus_vsearch	391	C	*/-A	508	47	7.79%	2	2	93	93	2.5704473615168496E-15	1	1	325	183	22	25	-A
B10_BC22_191109_LF_LIB_consensus_vsearch	392	A	A	539	5	0.91%	2	2	93	93	0.03096290894901055	1	1	360	179	2	3	G
B10_BC22_191109_LF_LIB_consensus_vsearch	393	A	*/-G	530	38	6.38%	2	2	93	93	1.91811026846358E-12	1	1	338	192	34	4	-G
B10_BC22_191109_LF_LIB_consensus_vsearch	394	G	*/+C	511	17	3.06%	2	1	93	93	6.6937275308251885E-6	1	1	340	171	0	17	+C
B10_BC22_191109_LF_LIB_consensus_vsearch	395	G	*/+A	488	71	11.95%	2	1	93	93	3.942829772234266E-23	1	1	293	195	71	0	+A
B10_BC22_191109_LF_LIB_consensus_vsearch	396	A	A	567	1	0.18%	2	1	93	93	0.4999999999999138	1	1	366	201	0	1	C
B10_BC22_191109_LF_LIB_consensus_vsearch	397	A	*/-G	566	15	2.53%	2	2	93	93	2.784900299453663E-5	1	1	381	185	3	12	-G
B10_BC22_191109_LF_LIB_consensus_vsearch	398	G	*/+C	556	8	1.39%	2	1	93	93	0.0038098461564736973	1	1	379	177	0	8	+C
B10_BC22_191109_LF_LIB_consensus_vsearch	399	G	G	589	1	0.17%	2	1	93	93	0.5000000000008233	1	1	385	204	0	1	+TG
B10_BC22_191109_LF_LIB_consensus_vsearch	400	C	C	587	3	0.5%	2	2	93	93	0.12468193384235185	1	1	379	208	2	1	-A
B10_BC22_191109_LF_LIB_consensus_vsearch	401	A	R	581	8	1.34%	2	2	93	93	0.0038139152066312184	1	1	373	208	7	1	G
B10_BC22_191109_LF_LIB_consensus_vsearch	402	G	R	571	17	2.83%	2	2	93	93	6.784988638479219E-6	1	1	364	207	16	1	A
B10_BC22_191109_LF_LIB_consensus_vsearch	403	C	C	583	2	0.34%	2	1	93	93	0.24978614200168656	1	1	376	207	2	0	+G
B10_BC22_191109_LF_LIB_consensus_vsearch	404	A	A	575	5	0.84%	2	2	93	93	0.030980720571722742	1	1	372	203	4	1	-G
B10_BC22_191109_LF_LIB_consensus_vsearch	405	G	G	584	2	0.34%	2	1	93	93	0.2497865072588101	1	1	377	207	2	0	+A
B10_BC22_191109_LF_LIB_consensus_vsearch	406	G	G	593	2	0.33%	2	1	93	93	0.24978973927711676	1	1	384	209	0	2	-C
B10_BC22_191109_LF_LIB_consensus_vsearch	407	C	C	590	2	0.34%	2	1	93	93	0.2497886728654613	1	1	383	207	0	2	T
B10_BC22_191109_LF_LIB_consensus_vsearch	408	G	R	592	8	1.33%	2	2	93	93	0.003815598757548882	1	1	378	214	7	1	A
B10_BC22_191109_LF_LIB_consensus_vsearch	409	C	*/-GC	512	62	10.33%	2	2	93	93	3.800738982865329E-20	1	1	336	176	37	25	-GC
B10_BC22_191109_LF_LIB_consensus_vsearch	410	G	R	497	8	1.53%	2	1	93	93	0.003798656332526351	1	1	323	174	8	0	A
B10_BC22_191109_LF_LIB_consensus_vsearch	411	C	*/-A	432	63	12%	2	2	93	93	1.3180763460532245E-20	1	1	311	121	15	48	-A
B10_BC22_191109_LF_LIB_consensus_vsearch	412	A	A	509	2	0.39%	2	1	93	93	0.2497551420178245	1	1	361	148	2	0	+G
B10_BC22_191109_LF_LIB_consensus_vsearch	413	A	A	584	3	0.51%	2	2	93	93	0.12468030690531334	1	1	376	208	2	1	G
B10_BC22_191109_LF_LIB_consensus_vsearch	414	A	*/-T	587	7	1.16%	2	2	93	93	0.007674866606290045	1	1	378	209	2	5	-T
B10_BC22_191109_LF_LIB_consensus_vsearch	415	T	K	569	16	2.68%	2	1	93	93	1.3752374071037443E-5	1	1	369	200	16	0	G
B10_BC22_191109_LF_LIB_consensus_vsearch	416	T	*/-AC	551	37	6.14%	2	1	93	93	4.055235280077959E-12	1	1	347	204	37	0	-AC
B10_BC22_191109_LF_LIB_consensus_vsearch	417	A	*/-C	537	10	1.78%	2	2	93	93	9.368699288806099E-4	1	1	326	211	7	3	-C
B10_BC22_191109_LF_LIB_consensus_vsearch	418	C	C	540	5	0.91%	2	1	93	93	0.03096343547541017	1	1	334	206	0	5	+T
B10_BC22_191109_LF_LIB_consensus_vsearch	419	C	S	553	40	6.7%	2	1	93	93	4.605508280541371E-13	1	1	339	214	40	0	G
B10_BC22_191109_LF_LIB_consensus_vsearch	420	C	Y	575	11	1.83%	2	2	93	93	4.65698475176409E-4	1	1	372	203	6	5	T
B10_BC22_191109_LF_LIB_consensus_vsearch	421	A	A	590	1	0.17%	2	1	93	93	0.5000000000008233	1	1	381	209	0	1	+G
B10_BC22_191109_LF_LIB_consensus_vsearch	422	A	*/-T	583	10	1.66%	2	1	93	93	9.399148640318375E-4	1	1	383	200	0	10	-T
B10_BC22_191109_LF_LIB_consensus_vsearch	423	T	*/-C	567	15	2.53%	2	2	93	93	2.7853437407917936E-5	1	1	365	202	13	2	-C
B10_BC22_191109_LF_LIB_consensus_vsearch	424	C	C	579	3	0.51%	2	2	93	93	0.12467755803936205	1	1	367	212	2	1	G
B10_BC22_191109_LF_LIB_consensus_vsearch	425	C	C	589	5	0.83%	2	2	93	93	0.030987064506852544	1	1	380	209	2	3	T
B10_BC22_191109_LF_LIB_consensus_vsearch	426	C	Y	570	18	2.99%	2	2	93	93	3.3427338331157792E-6	1	1	377	193	1	17	T
B10_BC22_191109_LF_LIB_consensus_vsearch	427	G	G	586	4	0.67%	2	2	93	93	0.062182068959449006	1	1	375	211	3	1	-A
B10_BC22_191109_LF_LIB_consensus_vsearch	428	A	R	580	7	1.17%	2	2	93	93	0.0076732309665896	1	1	371	209	6	1	G
B10_BC22_191109_LF_LIB_consensus_vsearch	429	C	Y	580	7	1.17%	2	2	93	93	0.0076732309665896	1	1	370	210	6	1	T
B10_BC22_191109_LF_LIB_consensus_vsearch	430	A	*/+C	574	8	1.34%	2	1	93	93	0.0038128109095927364	1	1	363	211	8	0	+C
B10_BC22_191109_LF_LIB_consensus_vsearch	431	C	*/-G	463	88	14.69%	2	2	93	93	7.389332128537317E-29	1	1	295	168	57	31	-G
B10_BC22_191109_LF_LIB_consensus_vsearch	432	G	R	459	20	3.99%	2	2	93	93	7.788800107151764E-7	1	1	286	173	19	1	A
B10_BC22_191109_LF_LIB_consensus_vsearch	433	G	R	573	15	2.54%	2	2	93	93	2.7879737666977125E-5	1	1	365	208	14	1	A
B10_BC22_191109_LF_LIB_consensus_vsearch	434	G	R	570	21	3.51%	2	2	93	93	3.97965376405317E-7	1	1	359	211	18	3	A
B10_BC22_191109_LF_LIB_consensus_vsearch	435	G	R	560	17	2.82%	2	2	93	93	6.769612738577898E-6	1	1	346	214	16	1	A
B10_BC22_191109_LF_LIB_consensus_vsearch	436	A	*/-G	564	22	3.71%	2	2	93	93	1.9504571214644284E-7	1	1	350	214	21	1	-G
B10_BC22_191109_LF_LIB_consensus_vsearch	437	G	*/+A	514	28	4.87%	2	1	93	93	2.6047047336301037E-9	1	1	306	208	28	0	+A
B10_BC22_191109_LF_LIB_consensus_vsearch	438	G	R	572	9	1.51%	2	1	93	93	0.0018931100684577166	1	1	360	212	9	0	A
B10_BC22_191109_LF_LIB_consensus_vsearch	439	T	Y	582	8	1.34%	2	2	93	93	0.00381407083625578	1	1	375	207	2	6	C
B10_BC22_191109_LF_LIB_consensus_vsearch	440	A	R	586	8	1.34%	2	1	93	93	0.00381468814385855	1	1	373	213	8	0	G
B10_BC22_191109_LF_LIB_consensus_vsearch	441	G	G	587	5	0.83%	2	2	93	93	0.030986176592841308	1	1	377	210	2	3	-TG
B10_BC22_191109_LF_LIB_consensus_vsearch	442	T	T	581	5	0.84%	2	1	93	93	0.030983476501936075	1	1	380	201	0	5	+G
B10_BC22_191109_LF_LIB_consensus_vsearch	443	G	G	594	1	0.17%	2	1	93	93	0.5000000000008233	1	1	384	210	1	0	-A
B10_BC22_191109_LF_LIB_consensus_vsearch	444	A	A	593	4	0.67%	2	2	93	93	0.06218579834936829	1	1	381	212	3	1	G
B10_BC22_191109_LF_LIB_consensus_vsearch	445	C	*/-A	579	17	2.83%	2	1	93	93	6.795830515697058E-6	1	1	384	195	0	17	-A
B10_BC22_191109_LF_LIB_consensus_vsearch	446	A	A	580	3	0.51%	2	2	93	93	0.12467811158812642	1	1	385	195	2	1	G
B10_BC22_191109_LF_LIB_consensus_vsearch	447	A	A	591	6	1%	2	1	93	93	0.015429036211008771	1	1	386	205	0	6	-T
B10_BC22_191109_LF_LIB_consensus_vsearch	448	T	Y	570	13	2.19%	2	2	93	93	1.1408863153197961E-4	1	1	377	193	2	11	C
B10_BC22_191109_LF_LIB_consensus_vsearch	449	A	A	581	6	1.01%	2	2	93	93	0.015425703561055139	1	1	376	205	1	5	C
B10_BC22_191109_LF_LIB_consensus_vsearch	450	A	A	595	2	0.33%	2	2	93	93	0.24979044425840527	1	1	385	210	1	1	C
B10_BC22_191109_LF_LIB_consensus_vsearch	451	A	A	600	1	0.17%	2	1	93	93	0.4999999999999138	1	1	387	213	0	1	-TA
B10_BC22_191109_LF_LIB_consensus_vsearch	452	T	T	589	5	0.83%	2	2	93	93	0.030987064506852544	1	1	382	207	1	4	C
B10_BC22_191109_LF_LIB_consensus_vsearch	453	A	R	579	12	2%	2	1	93	93	2.3075518337962257E-4	1	1	370	209	12	0	G
B10_BC22_191109_LF_LIB_consensus_vsearch	454	C	C	585	4	0.67%	2	2	93	93	0.06218152895025356	1	1	376	209	3	1	-T
B10_BC22_191109_LF_LIB_consensus_vsearch	455	T	*/+G	561	13	2.18%	2	2	93	93	1.1396639596224394E-4	1	1	378	183	1	12	+G
B10_BC22_191109_LF_LIB_consensus_vsearch	456	G	G	599	0	0%	2	0	93	0	1.0	1	0	386	213	0	0	
B10_BC22_191109_LF_LIB_consensus_vsearch	457	A	A	596	3	0.5%	2	1	93	93	0.1246867167922604	1	1	387	209	0	3	-TA
B10_BC22_191109_LF_LIB_consensus_vsearch	458	T	T	590	2	0.33%	2	2	93	93	0.2497886728654613	1	1	382	208	1	1	-A
B10_BC22_191109_LF_LIB_consensus_vsearch	459	A	A	592	3	0.5%	2	2	93	93	0.1246846089151382	1	1	382	210	2	1	-C
B10_BC22_191109_LF_LIB_consensus_vsearch	460	C	C	588	2	0.34%	2	2	93	93	0.2497879558944788	1	1	376	212	1	1	+G
B10_BC22_191109_LF_LIB_consensus_vsearch	461	A	*/-G	564	19	3.17%	2	2	93	93	1.643269896857881E-6	1	1	365	199	8	11	-G
B10_BC22_191109_LF_LIB_consensus_vsearch	462	G	*/+A	568	9	1.55%	2	1	93	93	0.0018926974773018042	1	1	366	202	9	0	+A
B10_BC22_191109_LF_LIB_consensus_vsearch	463	G	*/+A	584	7	1.16%	2	1	93	93	0.007674170345963	1	1	370	214	7	0	+A
B10_BC22_191109_LF_LIB_consensus_vsearch	464	G	R	589	10	1.66%	2	1	93	93	9.402779326998115E-4	1	1	378	211	10	0	A
B10_BC22_191109_LF_LIB_consensus_vsearch	465	C	*/-T	583	11	1.83%	2	1	93	93	4.65998228714525E-4	1	1	382	201	0	11	-T
B10_BC22_191109_LF_LIB_consensus_vsearch	466	T	T	580	5	0.84%	2	2	93	93	0.030983021104337604	1	1	382	198	1	4	+C
B10_BC22_191109_LF_LIB_consensus_vsearch	467	C	*/-T	387	129	21.46%	2	2	93	93	1.5316111921214376E-43	1	1	329	58	25	104	-T
B10_BC22_191109_LF_LIB_consensus_vsearch	468	T	T	454	4	0.87%	2	1	93	93	0.06209038837901774	1	1	360	94	0	4	C
B10_BC22_191109_LF_LIB_consensus_vsearch	469	T	T	584	4	0.68%	2	2	93	93	0.062180987103355005	1	1	385	199	1	3	C
B10_BC22_191109_LF_LIB_consensus_vsearch	470	T	T	598	2	0.33%	2	1	93	93	0.24979149291046765	1	1	385	213	2	0	C
B10_BC22_191109_LF_LIB_consensus_vsearch	471	T	*/-G	572	17	2.82%	2	2	93	93	6.786359253675274E-6	1	1	375	197	7	10	-G
B10_BC22_191109_LF_LIB_consensus_vsearch	472	G	R	557	20	3.42%	2	2	93	93	8.066092562534995E-7	1	1	363	194	18	2	A
B10_BC22_191109_LF_LIB_consensus_vsearch	473	G	G	594	4	0.67%	2	2	93	93	0.062186323989038686	1	1	383	211	2	2	A
B10_BC22_191109_LF_LIB_consensus_vsearch	474	G	G	593	6	1%	2	2	93	93	0.015429689410799249	1	1	382	211	5	1	A
B10_BC22_191109_LF_LIB_consensus_vsearch	475	T	Y	582	8	1.33%	2	2	93	93	0.00381407083625578	1	1	376	206	3	5	C
B10_BC22_191109_LF_LIB_consensus_vsearch	476	C	C	590	4	0.67%	2	2	93	93	0.062184210806914414	1	1	380	210	2	2	+T
B10_BC22_191109_LF_LIB_consensus_vsearch	477	T	Y	587	7	1.17%	2	2	93	93	0.007674866606290045	1	1	376	211	6	1	C
B10_BC22_191109_LF_LIB_consensus_vsearch	478	T	T	586	3	0.5%	2	1	93	93	0.12468139337307069	1	1	377	209	3	0	-GTA
B10_BC22_191109_LF_LIB_consensus_vsearch	479	G	G	579	5	0.84%	2	2	93	93	0.03098256414789269	1	1	374	205	4	1	A
B10_BC22_191109_LF_LIB_consensus_vsearch	480	T	*/-A	546	35	5.93%	2	2	93	93	1.716841489217194E-11	1	1	346	200	30	5	-A
B10_BC22_191109_LF_LIB_consensus_vsearch	481	A	A	550	5	0.9%	2	2	93	93	0.030968596430799897	1	1	349	201	2	3	G
B10_BC22_191109_LF_LIB_consensus_vsearch	482	A	A	583	6	1.01%	2	2	93	93	0.015426379128433065	1	1	375	208	4	2	G
B10_BC22_191109_LF_LIB_consensus_vsearch	483	T	K	555	29	4.87%	2	2	93	93	1.3042966153050208E-9	1	1	356	199	28	1	G
B10_BC22_191109_LF_LIB_consensus_vsearch	484	T	*/-G	544	54	9%	2	2	93	93	1.5856977780010353E-17	1	1	382	162	4	50	-G
B10_BC22_191109_LF_LIB_consensus_vsearch	485	G	G	543	4	0.73%	2	1	93	93	0.062157064831361374	1	1	379	164	4	0	A
B10_BC22_191109_LF_LIB_consensus_vsearch	486	G	G	595	3	0.5%	2	1	93	93	0.12468619246852639	1	1	385	210	0	3	+A
B10_BC22_191109_LF_LIB_consensus_vsearch	487	A	A	595	3	0.5%	2	1	93	93	0.12468619246852639	1	1	381	214	3	0	+G
B10_BC22_191109_LF_LIB_consensus_vsearch	488	A	A	597	2	0.33%	2	1	93	93	0.24979114452852993	1	1	382	215	2	0	G
B10_BC22_191109_LF_LIB_consensus_vsearch	489	T	*/-G	552	35	5.82%	2	1	93	93	1.7264135703207897E-11	1	1	342	210	35	0	-G
B10_BC22_191109_LF_LIB_consensus_vsearch	490	G	*/+A	536	18	3.17%	2	1	93	93	3.3153152137650307E-6	1	1	323	213	18	0	+A
B10_BC22_191109_LF_LIB_consensus_vsearch	491	A	*/-G	578	14	2.34%	2	2	93	93	5.646967505352899E-5	1	1	367	211	12	2	-G
B10_BC22_191109_LF_LIB_consensus_vsearch	492	G	G	572	4	0.68%	2	2	93	93	0.06217433812810566	1	1	364	208	3	1	+C
B10_BC22_191109_LF_LIB_consensus_vsearch	493	T	T	591	2	0.33%	2	1	93	93	0.24978902953563295	1	1	385	206	0	2	+A
B10_BC22_191109_LF_LIB_consensus_vsearch	494	A	R	583	7	1.17%	2	2	93	93	0.007673936691127849	1	1	376	207	4	3	G
B10_BC22_191109_LF_LIB_consensus_vsearch	495	C	C	586	4	0.67%	2	2	93	93	0.062182068959449006	1	1	379	207	2	2	-A
B10_BC22_191109_LF_LIB_consensus_vsearch	496	A	A	589	5	0.84%	2	2	93	93	0.030987064506852544	1	1	380	209	3	2	G
B10_BC22_191109_LF_LIB_consensus_vsearch	497	A	A	586	6	1%	2	2	93	93	0.015427383935577244	1	1	377	209	5	1	G
B10_BC22_191109_LF_LIB_consensus_vsearch	498	T	T	596	2	0.33%	2	2	93	93	0.24979079497935539	1	1	384	212	1	1	C
B10_BC22_191109_LF_LIB_consensus_vsearch	499	T	T	599	1	0.17%	2	1	93	93	0.4999999999990043	1	1	387	212	1	0	+C
B10_BC22_191109_LF_LIB_consensus_vsearch	500	T	*/-A	570	11	1.82%	2	2	93	93	4.6550699991566706E-4	1	1	363	207	8	3	-A
B10_BC22_191109_LF_LIB_consensus_vsearch	501	A	A	582	3	0.51%	2	2	93	93	0.12467921300240917	1	1	374	208	1	2	G
B10_BC22_191109_LF_LIB_consensus_vsearch	502	A	A	599	2	0.33%	2	2	93	93	0.24979184013288794	1	1	387	212	1	1	G
B10_BC22_191109_LF_LIB_consensus_vsearch	503	A	A	587	5	0.83%	2	1	93	93	0.030986176592841308	1	1	387	200	0	5	+C
B10_BC22_191109_LF_LIB_consensus_vsearch	504	T	*/-C	499	80	13.45%	2	2	93	93	4.4051932185936017E-26	1	1	308	191	64	16	-C
B10_BC22_191109_LF_LIB_consensus_vsearch	505	C	C	509	0	0%	2	0	93	0	1.0	1	0	314	195	0	0	
B10_BC22_191109_LF_LIB_consensus_vsearch	506	C	C	584	3	0.51%	2	1	93	93	0.12468030690531334	1	1	374	210	3	0	+A
B10_BC22_191109_LF_LIB_consensus_vsearch	507	C	*/+T	557	16	2.66%	2	2	93	93	1.3722058466540388E-5	1	1	379	178	1	15	+T
B10_BC22_191109_LF_LIB_consensus_vsearch	508	T	W	570	18	3.05%	2	1	93	93	3.3427338331157792E-6	1	1	364	206	18	0	A
B10_BC22_191109_LF_LIB_consensus_vsearch	509	T	T	592	6	1%	2	2	93	93	0.01542936335614873	1	1	382	210	3	3	C
B10_BC22_191109_LF_LIB_consensus_vsearch	510	A	A	596	3	0.5%	2	2	93	93	0.1246867167922604	1	1	383	213	2	1	G
B10_BC22_191109_LF_LIB_consensus_vsearch	511	A	A	596	5	0.83%	2	1	93	93	0.030990125687592227	1	1	381	215	5	0	G
B10_BC22_191109_LF_LIB_consensus_vsearch	512	C	C	583	6	1%	2	2	93	93	0.015426379128433065	1	1	372	211	2	4	T
B10_BC22_191109_LF_LIB_consensus_vsearch	513	G	G	589	4	0.67%	2	2	93	93	0.06218367805512527	1	1	378	211	3	1	A
B10_BC22_191109_LF_LIB_consensus_vsearch	514	A	*/+G	583	8	1.34%	2	2	93	93	0.0038142259421648926	1	1	373	210	7	1	+G
B10_BC22_191109_LF_LIB_consensus_vsearch	515	G	G	590	3	0.5%	2	1	93	93	0.12468354430400949	1	1	381	209	0	3	T
B10_BC22_191109_LF_LIB_consensus_vsearch	516	G	G	591	3	0.5%	2	1	93	93	0.12468407750622149	1	1	380	211	0	3	+A
B10_BC22_191109_LF_LIB_consensus_vsearch	517	A	A	592	2	0.34%	2	2	93	93	0.24978938500452047	1	1	378	214	1	1	T
B10_BC22_191109_LF_LIB_consensus_vsearch	518	A	R	584	9	1.51%	2	2	93	93	0.0018943147174077597	1	1	377	207	6	3	G
B10_BC22_191109_LF_LIB_consensus_vsearch	519	C	C	586	5	0.83%	2	2	93	93	0.030985730383315414	1	1	379	207	3	2	T
B10_BC22_191109_LF_LIB_consensus_vsearch	520	A	A	589	6	1.01%	2	2	93	93	0.015428378627452975	1	1	379	210	4	2	G
B10_BC22_191109_LF_LIB_consensus_vsearch	521	A	R	587	8	1.33%	2	1	93	93	0.003814841181091788	1	1	377	210	8	0	G
B10_BC22_191109_LF_LIB_consensus_vsearch	522	T	K	586	8	1.34%	2	1	93	93	0.00381468814385855	1	1	375	211	8	0	G
B10_BC22_191109_LF_LIB_consensus_vsearch	523	T	*/-G	482	115	19.17%	2	1	93	93	5.488287417120387E-38	1	1	388	94	0	115	-G
B10_BC22_191109_LF_LIB_consensus_vsearch	524	G	G	474	5	1.03%	2	1	93	93	0.030923971617295393	1	1	386	88	0	5	+A
B10_BC22_191109_LF_LIB_consensus_vsearch	525	G	G	593	3	0.5%	2	1	93	93	0.12468513853935516	1	1	384	209	3	0	-AG
B10_BC22_191109_LF_LIB_consensus_vsearch	526	A	*/-G	551	28	4.7%	2	2	93	93	2.6664461318157962E-9	1	1	355	196	20	8	-G
B10_BC22_191109_LF_LIB_consensus_vsearch	527	G	*/+A	544	13	2.29%	2	1	93	93	1.1372499157560235E-4	1	1	347	197	13	0	+A
B10_BC22_191109_LF_LIB_consensus_vsearch	528	G	*/+A	562	27	4.51%	2	1	93	93	5.4928393990070045E-9	1	1	352	210	27	0	+A
B10_BC22_191109_LF_LIB_consensus_vsearch	529	G	R	578	7	1.16%	2	2	93	93	0.007672756476313913	1	1	368	210	6	1	A
B10_BC22_191109_LF_LIB_consensus_vsearch	530	C	*/-A	568	11	1.84%	2	2	93	93	4.6542949773112336E-4	1	1	369	199	7	4	-A
B10_BC22_191109_LF_LIB_consensus_vsearch	531	A	R	572	7	1.2%	2	2	93	93	0.00767131340646626	1	1	372	200	4	3	G
B10_BC22_191109_LF_LIB_consensus_vsearch	532	A	A	585	4	0.67%	2	2	93	93	0.06218152895025356	1	1	381	204	3	1	-G
B10_BC22_191109_LF_LIB_consensus_vsearch	533	G	R	584	7	1.17%	2	1	93	93	0.007674170345963	1	1	376	208	7	0	A
B10_BC22_191109_LF_LIB_consensus_vsearch	534	T	Y	585	10	1.67%	2	2	93	93	9.400366914624269E-4	1	1	381	204	4	6	C
B10_BC22_191109_LF_LIB_consensus_vsearch	535	C	*/-T	587	7	1.16%	2	2	93	93	0.007674866606290045	1	1	383	204	1	6	-T
B10_BC22_191109_LF_LIB_consensus_vsearch	536	T	*/-G	551	29	4.87%	2	2	93	93	1.301014053098754E-9	1	1	377	174	3	26	-G
B10_BC22_191109_LF_LIB_consensus_vsearch	537	G	G	551	6	1.05%	2	2	93	93	0.015414988935831313	1	1	377	174	1	5	A
B10_BC22_191109_LF_LIB_consensus_vsearch	538	G	S	571	8	1.33%	2	2	93	93	0.0038123295121620672	1	1	375	196	1	7	C
B10_BC22_191109_LF_LIB_consensus_vsearch	539	T	Y	551	22	3.7%	2	1	93	93	1.9414217689001658E-7	1	1	384	167	0	22	C
B10_BC22_191109_LF_LIB_consensus_vsearch	540	G	R	574	8	1.34%	2	2	93	93	0.0038128109095927364	1	1	371	203	6	2	A
B10_BC22_191109_LF_LIB_consensus_vsearch	541	C	M	581	9	1.51%	2	2	93	93	0.0018940181115188759	1	1	380	201	3	6	A
B10_BC22_191109_LF_LIB_consensus_vsearch	542	C	C	592	3	0.5%	2	2	93	93	0.1246846089151382	1	1	381	211	1	2	-A
B10_BC22_191109_LF_LIB_consensus_vsearch	543	A	A	590	3	0.5%	2	2	93	93	0.12468354430400949	1	1	380	210	2	1	-G
B10_BC22_191109_LF_LIB_consensus_vsearch	544	G	G	591	5	0.83%	2	1	93	93	0.030987946464272845	1	1	379	212	5	0	A
B10_BC22_191109_LF_LIB_consensus_vsearch	545	C	C	585	5	0.83%	2	1	93	93	0.030985282661769052	1	1	373	212	5	0	+T
B10_BC22_191109_LF_LIB_consensus_vsearch	546	A	A	582	6	1%	2	1	93	93	0.015426041918236095	1	1	368	214	6	0	G
B10_BC22_191109_LF_LIB_consensus_vsearch	547	G	*/-C	558	21	3.52%	2	1	93	93	3.9644991182852906E-7	1	1	344	214	21	0	-C
B10_BC22_191109_LF_LIB_consensus_vsearch	548	C	C	562	3	0.52%	2	1	93	93	0.12466784765272246	1	1	350	212	3	0	T
B10_BC22_191109_LF_LIB_consensus_vsearch	549	C	Y	566	13	2.16%	2	2	93	93	1.1403476275553268E-4	1	1	353	213	12	1	T
B10_BC22_191109_LF_LIB_consensus_vsearch	550	G	R	550	26	4.35%	2	1	93	93	1.1166412049019235E-8	1	1	338	212	26	0	A
B10_BC22_191109_LF_LIB_consensus_vsearch	551	C	Y	552	17	2.83%	2	2	93	93	6.758074282435316E-6	1	1	348	204	15	2	T
B10_BC22_191109_LF_LIB_consensus_vsearch	552	G	R	541	38	6.43%	2	2	93	93	1.9423775137038687E-12	1	1	336	205	36	2	A
B10_BC22_191109_LF_LIB_consensus_vsearch	553	G	R	566	19	3.17%	2	2	93	93	1.6441208717700983E-6	1	1	354	212	18	1	A
B10_BC22_191109_LF_LIB_consensus_vsearch	554	T	*/-A	566	11	1.85%	2	2	93	93	4.653514663553586E-4	1	1	359	207	9	2	-A
B10_BC22_191109_LF_LIB_consensus_vsearch	555	A	A	583	2	0.34%	2	2	93	93	0.24978614200168656	1	1	372	211	1	1	C
B10_BC22_191109_LF_LIB_consensus_vsearch	556	A	A	590	3	0.5%	2	2	93	93	0.12468354430400949	1	1	383	207	2	1	+T
B10_BC22_191109_LF_LIB_consensus_vsearch	557	T	T	588	3	0.5%	2	2	93	93	0.12468247248078299	1	1	383	205	2	1	C
B10_BC22_191109_LF_LIB_consensus_vsearch	558	T	*/-C	568	25	4.17%	2	2	93	93	2.301809219374687E-8	1	1	361	207	24	1	-C
B10_BC22_191109_LF_LIB_consensus_vsearch	559	C	C	573	2	0.35%	2	1	93	93	0.249782419495127	1	1	363	210	0	2	G
B10_BC22_191109_LF_LIB_consensus_vsearch	560	C	Y	588	7	1.16%	2	2	93	93	0.007675097138165556	1	1	379	209	2	5	T
B10_BC22_191109_LF_LIB_consensus_vsearch	561	A	A	589	5	0.83%	2	1	93	93	0.030987064506852544	1	1	378	211	5	0	G
B10_BC22_191109_LF_LIB_consensus_vsearch	562	G	R	587	7	1.17%	2	1	93	93	0.007674866606290045	1	1	376	211	7	0	A
B10_BC22_191109_LF_LIB_consensus_vsearch	563	C	*/-T	580	14	2.33%	2	2	93	93	5.648462977218392E-5	1	1	382	198	1	13	-T
B10_BC22_191109_LF_LIB_consensus_vsearch	564	T	*/-C	481	94	16.04%	2	2	93	93	8.01761310050073E-31	1	1	284	197	93	1	-C
B10_BC22_191109_LF_LIB_consensus_vsearch	565	C	C	504	1	0.2%	2	1	93	93	0.4999999999999138	1	1	290	214	1	0	A
B10_BC22_191109_LF_LIB_consensus_vsearch	566	C	C	592	6	1%	2	2	93	93	0.01542936335614873	1	1	384	208	1	5	-A
B10_BC22_191109_LF_LIB_consensus_vsearch	567	A	A	588	2	0.34%	2	1	93	93	0.2497879558944788	1	1	380	208	2	0	G
B10_BC22_191109_LF_LIB_consensus_vsearch	568	A	A	594	2	0.33%	2	2	93	93	0.24979009235977778	1	1	382	212	1	1	G
B10_BC22_191109_LF_LIB_consensus_vsearch	569	T	Y	586	8	1.34%	2	2	93	93	0.00381468814385855	1	1	379	207	3	5	C
B10_BC22_191109_LF_LIB_consensus_vsearch	570	A	R	588	9	1.5%	2	1	93	93	0.0018947055924330373	1	1	376	212	9	0	G
B10_BC22_191109_LF_LIB_consensus_vsearch	571	G	G	595	2	0.33%	2	2	93	93	0.24979044425840527	1	1	385	210	1	1	-CG
B10_BC22_191109_LF_LIB_consensus_vsearch	572	C	C	594	3	0.5%	2	2	93	93	0.12468566638724124	1	1	384	210	1	2	T
B10_BC22_191109_LF_LIB_consensus_vsearch	573	G	G	595	2	0.33%	2	2	93	93	0.24979044425840527	1	1	384	211	1	1	T
B10_BC22_191109_LF_LIB_consensus_vsearch	574	T	T	593	5	0.83%	2	2	93	93	0.03098882252468081	1	1	384	209	2	3	C
B10_BC22_191109_LF_LIB_consensus_vsearch	575	A	A	600	1	0.17%	2	1	93	93	0.4999999999999138	1	1	387	213	1	0	C
B10_BC22_191109_LF_LIB_consensus_vsearch	576	T	T	590	5	0.83%	2	1	93	93	0.030987506226370864	1	1	384	206	0	5	-AT
B10_BC22_191109_LF_LIB_consensus_vsearch	577	A	*/-T	580	9	1.51%	2	1	93	93	0.001893918576967777	1	1	382	198	0	9	-T
B10_BC22_191109_LF_LIB_consensus_vsearch	578	T	T	568	6	1.03%	2	1	93	93	0.015421197823763643	1	1	379	189	0	6	A
B10_BC22_191109_LF_LIB_consensus_vsearch	579	T	*/+A	531	25	4.17%	2	2	93	93	2.261698068654656E-8	1	1	337	194	23	2	+A
B10_BC22_191109_LF_LIB_consensus_vsearch	580	A	A	577	5	0.85%	2	2	93	93	0.030981645525998008	1	1	373	204	2	3	G
B10_BC22_191109_LF_LIB_consensus_vsearch	581	A	A	590	5	0.83%	2	2	93	93	0.030987506226370864	1	1	380	210	2	3	G
B10_BC22_191109_LF_LIB_consensus_vsearch	582	A	R	590	8	1.33%	2	2	93	93	0.003815297238788008	1	1	379	211	6	2	G
B10_BC22_191109_LF_LIB_consensus_vsearch	583	G	G	592	3	0.5%	2	1	93	93	0.1246846089151382	1	1	379	213	3	0	+A
B10_BC22_191109_LF_LIB_consensus_vsearch	584	T	T	595	6	1%	2	1	93	93	0.01543033827052791	1	1	387	208	0	6	C
B10_BC22_191109_LF_LIB_consensus_vsearch	585	T	*/+A	576	19	3.16%	2	1	93	93	1.6482949361380827E-6	1	1	366	210	19	0	+A
B10_BC22_191109_LF_LIB_consensus_vsearch	586	G	K	565	19	3.16%	2	1	93	93	1.6436960696383207E-6	1	1	356	209	19	0	T
B10_BC22_191109_LF_LIB_consensus_vsearch	587	T	Y	581	17	2.84%	2	2	93	93	6.7984976718225545E-6	1	1	387	194	1	16	C
B10_BC22_191109_LF_LIB_consensus_vsearch	588	T	T	593	3	0.5%	2	2	93	93	0.12468513853935516	1	1	384	209	2	1	C
B10_BC22_191109_LF_LIB_consensus_vsearch	589	G	G	586	4	0.67%	2	2	93	93	0.062182068959449006	1	1	378	208	2	2	-C
B10_BC22_191109_LF_LIB_consensus_vsearch	590	C	C	586	3	0.5%	2	1	93	93	0.12468139337307069	1	1	381	205	0	3	-AGT
B10_BC22_191109_LF_LIB_consensus_vsearch	591	A	A	586	3	0.5%	2	1	93	93	0.12468139337307069	1	1	378	208	3	0	-G
B10_BC22_191109_LF_LIB_consensus_vsearch	592	G	G	584	2	0.34%	2	2	93	93	0.2497865072588101	1	1	380	204	1	1	-T
B10_BC22_191109_LF_LIB_consensus_vsearch	593	T	T	586	5	0.84%	2	1	93	93	0.030985730383315414	1	1	385	201	0	5	C
B10_BC22_191109_LF_LIB_consensus_vsearch	594	T	*/-A	385	134	22.37%	2	2	93	93	2.3318779549947025E-45	1	1	243	142	84	50	-A
B10_BC22_191109_LF_LIB_consensus_vsearch	595	A	A	427	3	0.69%	2	2	93	93	0.12456344586746677	1	1	271	156	2	1	C
B10_BC22_191109_LF_LIB_consensus_vsearch	596	A	A	563	3	0.53%	2	1	93	93	0.12466843501340043	1	1	357	206	0	3	C
B10_BC22_191109_LF_LIB_consensus_vsearch	597	A	A	594	1	0.17%	2	1	93	93	0.5000000000008233	1	1	383	211	1	0	+A
B10_BC22_191109_LF_LIB_consensus_vsearch	598	A	A	593	6	1%	2	2	93	93	0.015429689410799249	1	1	384	209	2	4	G
B10_BC22_191109_LF_LIB_consensus_vsearch	599	A	A	591	4	0.66%	2	2	93	93	0.06218474176725347	1	1	380	211	2	2	G
B10_BC22_191109_LF_LIB_consensus_vsearch	600	G	*/+C	581	8	1.34%	2	1	93	93	0.0038139152066312184	1	1	383	198	0	8	+C
B10_BC22_191109_LF_LIB_consensus_vsearch	601	C	C	579	5	0.84%	2	1	93	93	0.03098256414789269	1	1	381	198	0	5	+T
B10_BC22_191109_LF_LIB_consensus_vsearch	602	T	*/-C	580	9	1.51%	2	2	93	93	0.001893918576967777	1	1	379	201	2	7	-C
B10_BC22_191109_LF_LIB_consensus_vsearch	603	C	*/+A	566	7	1.18%	2	2	93	93	0.007669840222466952	1	1	370	196	2	5	+A
B10_BC22_191109_LF_LIB_consensus_vsearch	604	G	G	588	3	0.5%	2	1	93	93	0.12468247248078299	1	1	379	209	3	0	A
B10_BC22_191109_LF_LIB_consensus_vsearch	605	T	T	583	4	0.67%	2	1	93	93	0.06218044340963991	1	1	381	202	0	4	A
B10_BC22_191109_LF_LIB_consensus_vsearch	606	A	R	585	7	1.17%	2	2	93	93	0.007674403214110395	1	1	380	205	3	4	G
B10_BC22_191109_LF_LIB_consensus_vsearch	607	G	G	597	2	0.33%	2	1	93	93	0.24979114452852993	1	1	385	212	2	0	+A
B10_BC22_191109_LF_LIB_consensus_vsearch	608	T	Y	591	7	1.16%	2	1	93	93	0.007675784123381086	1	1	387	204	0	7	C
B10_BC22_191109_LF_LIB_consensus_vsearch	609	T	T	592	4	0.66%	2	2	93	93	0.06218527094514562	1	1	384	208	2	2	C
B10_BC22_191109_LF_LIB_consensus_vsearch	610	G	G	597	2	0.33%	2	1	93	93	0.24979114452852993	1	1	386	211	0	2	A
B10_BC22_191109_LF_LIB_consensus_vsearch	611	A	R	594	7	1.16%	2	2	93	93	0.0076764642733761	1	1	381	213	5	2	G
B10_BC22_191109_LF_LIB_consensus_vsearch	612	A	*/-C	582	15	2.49%	2	2	93	93	2.791822927094248E-5	1	1	371	211	12	3	-C
B10_BC22_191109_LF_LIB_consensus_vsearch	613	C	C	581	3	0.51%	2	1	93	93	0.1246786632393088	1	1	375	206	0	3	+T
B10_BC22_191109_LF_LIB_consensus_vsearch	614	C	*/-T	522	52	8.62%	2	2	93	93	6.622984875375523E-17	1	1	368	154	9	43	-T
B10_BC22_191109_LF_LIB_consensus_vsearch	615	T	T	532	5	0.93%	2	2	93	93	0.030959168383112096	1	1	364	168	4	1	C
B10_BC22_191109_LF_LIB_consensus_vsearch	616	T	*/-G	541	18	3.05%	2	1	93	93	3.319545137624332E-6	1	1	366	175	0	18	-G
B10_BC22_191109_LF_LIB_consensus_vsearch	617	G	R	539	33	5.69%	2	2	93	93	7.238961275772269E-11	1	1	358	181	29	4	A
B10_BC22_191109_LF_LIB_consensus_vsearch	618	G	R	577	10	1.67%	2	2	93	93	9.395444569434851E-4	1	1	377	200	2	8	A
B10_BC22_191109_LF_LIB_consensus_vsearch	619	G	*/-C	580	17	2.82%	2	2	93	93	6.79716622826512E-6	1	1	372	208	15	2	-C
B10_BC22_191109_LF_LIB_consensus_vsearch	620	C	Y	571	10	1.71%	2	1	93	93	9.391664866947025E-4	1	1	372	199	0	10	T
B10_BC22_191109_LF_LIB_consensus_vsearch	621	C	C	595	2	0.33%	2	2	93	93	0.24979044425840527	1	1	384	211	1	1	-T
B10_BC22_191109_LF_LIB_consensus_vsearch	622	T	T	586	5	0.83%	2	2	93	93	0.030985730383315414	1	1	381	205	3	2	-G
B10_BC22_191109_LF_LIB_consensus_vsearch	623	G	G	589	3	0.5%	2	1	93	93	0.1246830092985462	1	1	379	210	3	0	+TA
B10_BC22_191109_LF_LIB_consensus_vsearch	624	G	G	592	4	0.66%	2	1	93	93	0.06218527094514562	1	1	379	213	4	0	+C
B10_BC22_191109_LF_LIB_consensus_vsearch	625	C	C	590	4	0.67%	2	2	93	93	0.062184210806914414	1	1	378	212	3	1	-T
B10_BC22_191109_LF_LIB_consensus_vsearch	626	T	*/-G	581	8	1.34%	2	2	93	93	0.0038139152066312184	1	1	377	204	1	7	-G
B10_BC22_191109_LF_LIB_consensus_vsearch	627	G	G	585	3	0.51%	2	2	93	93	0.1246808510636648	1	1	383	202	1	2	A
B10_BC22_191109_LF_LIB_consensus_vsearch	628	G	*/-C	552	26	4.34%	2	2	93	93	1.1177819472886061E-8	1	1	349	203	25	1	-C
B10_BC22_191109_LF_LIB_consensus_vsearch	629	C	Y	557	12	2.1%	2	2	93	93	2.3024750486166557E-4	1	1	358	199	2	10	T
B10_BC22_191109_LF_LIB_consensus_vsearch	630	C	Y	572	11	1.84%	2	2	93	93	4.655839782704286E-4	1	1	373	199	5	6	T
B10_BC22_191109_LF_LIB_consensus_vsearch	631	G	R	540	39	6.63%	2	1	93	93	9.382377097463086E-13	1	1	336	204	39	0	A
B10_BC22_191109_LF_LIB_consensus_vsearch	632	G	G	583	6	1.01%	2	2	93	93	0.015426379128433065	1	1	377	206	2	4	A
B10_BC22_191109_LF_LIB_consensus_vsearch	633	T	*/-C	554	21	3.52%	2	1	93	93	3.9593177226547966E-7	1	1	344	210	21	0	-C
B10_BC22_191109_LF_LIB_consensus_vsearch	634	C	C	573	4	0.69%	2	2	93	93	0.062174902776938816	1	1	362	211	2	2	T
B10_BC22_191109_LF_LIB_consensus_vsearch	635	C	C	578	4	0.67%	2	1	93	93	0.06217769690336766	1	1	373	205	4	0	+AC
B10_BC22_191109_LF_LIB_consensus_vsearch	636	G	*/-C	553	19	3.2%	2	2	93	93	1.6384896061410626E-6	1	1	368	185	2	17	-C
B10_BC22_191109_LF_LIB_consensus_vsearch	637	C	C	569	3	0.52%	2	1	93	93	0.12467191601031084	1	1	378	191	0	3	+TC
B10_BC22_191109_LF_LIB_consensus_vsearch	638	C	C	588	5	0.83%	2	2	93	93	0.0309866212982286	1	1	383	205	2	3	-T
B10_BC22_191109_LF_LIB_consensus_vsearch	639	T	Y	581	8	1.34%	2	2	93	93	0.0038139152066312184	1	1	378	203	1	7	C
B10_BC22_191109_LF_LIB_consensus_vsearch	640	C	C	588	6	1%	2	1	93	93	0.015428048177952706	1	1	378	210	6	0	-AC
B10_BC22_191109_LF_LIB_consensus_vsearch	641	A	A	588	4	0.67%	2	2	93	93	0.06218314350277022	1	1	375	213	3	1	G
B10_BC22_191109_LF_LIB_consensus_vsearch	642	C	C	588	2	0.34%	2	1	93	93	0.2497879558944788	1	1	378	210	0	2	T
B10_BC22_191109_LF_LIB_consensus_vsearch	643	C	Y	578	15	2.49%	2	2	93	93	2.7901261387207864E-5	1	1	375	203	6	9	T
B10_BC22_191109_LF_LIB_consensus_vsearch	644	G	*/-CG	580	7	1.17%	2	1	93	93	0.0076732309665896	1	1	369	211	7	0	-CG
B10_BC22_191109_LF_LIB_consensus_vsearch	645	C	C	584	3	0.51%	2	2	93	93	0.12468030690531334	1	1	375	209	2	1	T
B10_BC22_191109_LF_LIB_consensus_vsearch	646	G	G	580	5	0.84%	2	1	93	93	0.030983021104337604	1	1	370	210	5	0	+CG
B10_BC22_191109_LF_LIB_consensus_vsearch	647	T	*/-GT	537	57	9.52%	2	2	93	93	1.6922160594836822E-18	1	1	383	154	2	55	-GT
B10_BC22_191109_LF_LIB_consensus_vsearch	648	G	G	537	2	0.37%	2	2	93	93	0.2497678737226224	1	1	381	156	1	1	+T
B10_BC22_191109_LF_LIB_consensus_vsearch	649	T	T	531	4	0.74%	2	2	93	93	0.062149369248170376	1	1	378	153	1	3	+GT
B10_BC22_191109_LF_LIB_consensus_vsearch	650	A	R	589	7	1.17%	2	2	93	93	0.007675326899053761	1	1	377	212	5	2	G
B10_BC22_191109_LF_LIB_consensus_vsearch	651	C	C	591	3	0.5%	2	1	93	93	0.12468407750622149	1	1	384	207	0	3	-T
B10_BC22_191109_LF_LIB_consensus_vsearch	652	T	Y	559	26	4.36%	2	2	93	93	1.1217206665689526E-8	1	1	382	177	1	25	C
B10_BC22_191109_LF_LIB_consensus_vsearch	653	G	G	590	3	0.5%	2	1	93	93	0.12468354430400949	1	1	383	207	0	3	C
B10_BC22_191109_LF_LIB_consensus_vsearch	654	G	G	597	6	1%	2	2	93	93	0.015430982833263808	1	1	385	212	3	3	A
B10_BC22_191109_LF_LIB_consensus_vsearch	655	T	*/-C	519	74	12.27%	2	1	93	93	4.662337598410157E-24	1	1	306	213	74	0	-C
B10_BC22_191109_LF_LIB_consensus_vsearch	656	C	C	520	4	0.76%	2	1	93	93	0.062142005182288046	1	1	305	215	4	0	T
B10_BC22_191109_LF_LIB_consensus_vsearch	657	C	*/-G	581	7	1.16%	2	2	93	93	0.007673467005464533	1	1	376	205	1	6	-G
B10_BC22_191109_LF_LIB_consensus_vsearch	658	G	R	541	49	8.26%	2	1	93	93	6.280835813175175E-16	1	1	332	209	49	0	A
B10_BC22_191109_LF_LIB_consensus_vsearch	659	G	*/-C	551	38	6.33%	2	1	93	93	1.9638777482066626E-12	1	1	341	210	38	0	-C
B10_BC22_191109_LF_LIB_consensus_vsearch	660	C	C	554	4	0.71%	2	2	93	93	0.06216382821860171	1	1	344	210	3	1	A
B10_BC22_191109_LF_LIB_consensus_vsearch	661	C	*/-G	576	13	2.16%	2	2	93	93	1.141680944483324E-4	1	1	377	199	1	12	-G
B10_BC22_191109_LF_LIB_consensus_vsearch	662	G	R	559	17	2.9%	2	2	93	93	6.768187150907897E-6	1	1	361	198	16	1	A
B10_BC22_191109_LF_LIB_consensus_vsearch	663	G	*/+A	577	10	1.67%	2	2	93	93	9.395444569434851E-4	1	1	371	206	8	2	+A
B10_BC22_191109_LF_LIB_consensus_vsearch	664	G	R	580	10	1.66%	2	2	93	93	9.39730591623294E-4	1	1	372	208	8	2	A
B10_BC22_191109_LF_LIB_consensus_vsearch	665	C	*/+G	542	45	7.54%	2	1	93	93	1.1827561836353122E-14	1	1	331	211	45	0	+G
B10_BC22_191109_LF_LIB_consensus_vsearch	666	C	*/-T	515	35	5.8%	2	2	93	93	1.6648981567472462E-11	1	1	331	184	11	24	-T
B10_BC22_191109_LF_LIB_consensus_vsearch	667	T	Y	519	7	1.32%	2	2	93	93	0.0076571420055722055	1	1	337	182	3	4	C
B10_BC22_191109_LF_LIB_consensus_vsearch	668	T	T	559	4	0.71%	2	1	93	93	0.062166815078796796	1	1	347	212	4	0	C
B10_BC22_191109_LF_LIB_consensus_vsearch	669	T	*/+C	547	27	4.49%	2	2	93	93	5.448221407061866E-9	1	1	353	194	14	13	+C
B10_BC22_191109_LF_LIB_consensus_vsearch	670	C	*/+G	576	7	1.18%	2	1	93	93	0.007672278741851824	1	1	368	208	7	0	+G
B10_BC22_191109_LF_LIB_consensus_vsearch	671	C	*/-T	551	41	6.82%	2	2	93	93	2.2195963080724788E-13	1	1	376	175	4	37	-T
B10_BC22_191109_LF_LIB_consensus_vsearch	672	T	T	552	4	0.72%	2	2	93	93	0.06216261842595227	1	1	379	173	1	3	C
B10_BC22_191109_LF_LIB_consensus_vsearch	673	T	*/+C	577	12	2%	2	2	93	93	2.3071056867786312E-4	1	1	368	209	9	3	+C
B10_BC22_191109_LF_LIB_consensus_vsearch	674	C	C	583	6	1.01%	2	1	93	93	0.015426379128433065	1	1	374	209	6	0	-T
B10_BC22_191109_LF_LIB_consensus_vsearch	675	T	*/-G	384	143	24.32%	2	2	93	93	1.2453746259331797E-48	1	1	276	108	61	82	-G
B10_BC22_191109_LF_LIB_consensus_vsearch	676	G	R	417	10	2.25%	2	1	93	93	9.258865234089794E-4	1	1	291	126	10	0	A
B10_BC22_191109_LF_LIB_consensus_vsearch	677	G	R	572	15	2.54%	2	1	93	93	2.787539038542439E-5	1	1	362	210	15	0	A
B10_BC22_191109_LF_LIB_consensus_vsearch	678	G	R	582	13	2.17%	2	2	93	93	1.1424599131191439E-4	1	1	372	210	11	2	A
B10_BC22_191109_LF_LIB_consensus_vsearch	679	G	*/-A	577	17	2.82%	2	2	93	93	6.793146201277797E-6	1	1	370	207	12	5	-A
B10_BC22_191109_LF_LIB_consensus_vsearch	680	A	A	570	4	0.69%	2	1	93	93	0.062173202925435794	1	1	366	204	4	0	-G
B10_BC22_191109_LF_LIB_consensus_vsearch	681	G	*/-C	567	12	2.03%	2	2	93	93	2.3048295964434314E-4	1	1	362	205	9	3	-C
B10_BC22_191109_LF_LIB_consensus_vsearch	682	C	C	577	5	0.85%	2	2	93	93	0.030981645525998008	1	1	376	201	1	4	T
B10_BC22_191109_LF_LIB_consensus_vsearch	683	C	Y	572	20	3.32%	2	2	93	93	8.10097394197934E-7	1	1	378	194	1	19	T
B10_BC22_191109_LF_LIB_consensus_vsearch	684	G	R	572	15	2.51%	2	2	93	93	2.787539038542439E-5	1	1	366	206	13	2	A
B10_BC22_191109_LF_LIB_consensus_vsearch	685	C	C	583	6	1.01%	2	2	93	93	0.015426379128433065	1	1	377	206	1	5	T
B10_BC22_191109_LF_LIB_consensus_vsearch	686	A	A	584	3	0.5%	2	2	93	93	0.12468030690531334	1	1	376	208	2	1	G
B10_BC22_191109_LF_LIB_consensus_vsearch	687	T	Y	584	13	2.17%	2	2	93	93	1.1427161689440221E-4	1	1	380	204	4	9	C
B10_BC22_191109_LF_LIB_consensus_vsearch	688	G	*/-C	559	21	3.5%	2	2	93	93	3.9657841456427714E-7	1	1	355	204	16	5	-C
B10_BC22_191109_LF_LIB_consensus_vsearch	689	C	C	574	2	0.34%	2	2	93	93	0.24978279756726465	1	1	367	207	1	1	T
B10_BC22_191109_LF_LIB_consensus_vsearch	690	C	C	597	2	0.33%	2	1	93	93	0.24979114452852993	1	1	385	212	0	2	+T
B10_BC22_191109_LF_LIB_consensus_vsearch	691	C	*/-T	586	7	1.16%	2	2	93	93	0.007674635299574334	1	1	382	204	1	6	-T
B10_BC22_191109_LF_LIB_consensus_vsearch	692	T	Y	582	7	1.18%	2	2	93	93	0.007673702245629301	1	1	381	201	4	3	C
B10_BC22_191109_LF_LIB_consensus_vsearch	693	T	T	589	5	0.83%	2	2	93	93	0.030987064506852544	1	1	382	207	3	2	C
B10_BC22_191109_LF_LIB_consensus_vsearch	694	C	C	586	5	0.84%	2	1	93	93	0.030985730383315414	1	1	378	208	5	0	-AC
B10_BC22_191109_LF_LIB_consensus_vsearch	695	A	A	578	6	1.01%	2	2	93	93	0.015424681549082461	1	1	375	203	1	5	-C
B10_BC22_191109_LF_LIB_consensus_vsearch	696	C	C	585	3	0.51%	2	1	93	93	0.1246808510636648	1	1	380	205	0	3	+A
B10_BC22_191109_LF_LIB_consensus_vsearch	697	T	*/-G	572	16	2.66%	2	2	93	93	1.3759767168944509E-5	1	1	382	190	3	13	-G
B10_BC22_191109_LF_LIB_consensus_vsearch	698	G	G	576	1	0.17%	2	1	93	93	0.5000000000008233	1	1	383	193	1	0	+A
B10_BC22_191109_LF_LIB_consensus_vsearch	699	G	R	586	7	1.17%	2	2	93	93	0.007674635299574334	1	1	383	203	5	2	A
B10_BC22_191109_LF_LIB_consensus_vsearch	700	G	G	595	3	0.5%	2	2	93	93	0.12468619246852639	1	1	385	210	2	1	-CG
B10_BC22_191109_LF_LIB_consensus_vsearch	701	C	C	593	3	0.5%	2	2	93	93	0.12468513853935516	1	1	385	208	1	2	+G
B10_BC22_191109_LF_LIB_consensus_vsearch	702	G	G	589	6	1%	2	2	93	93	0.015428378627452975	1	1	385	204	1	5	A
B10_BC22_191109_LF_LIB_consensus_vsearch	703	T	T	583	6	1%	2	2	93	93	0.015426379128433065	1	1	385	198	2	4	-GT
B10_BC22_191109_LF_LIB_consensus_vsearch	704	G	G	584	4	0.67%	2	2	93	93	0.062180987103355005	1	1	382	202	2	2	-TCG
B10_BC22_191109_LF_LIB_consensus_vsearch	705	T	*/+C	539	37	6.26%	2	1	93	93	4.004534353390011E-12	1	1	341	198	37	0	+C
B10_BC22_191109_LF_LIB_consensus_vsearch	706	C	*/-G	446	78	13.15%	2	2	93	93	1.4941684270270426E-25	1	1	269	177	58	20	-G
B10_BC22_191109_LF_LIB_consensus_vsearch	707	G	R	453	34	6.61%	2	2	93	93	3.2053287424551004E-11	1	1	269	184	33	1	A
B10_BC22_191109_LF_LIB_consensus_vsearch	708	G	R	580	10	1.68%	2	2	93	93	9.39730591623294E-4	1	1	371	209	8	2	A
B10_BC22_191109_LF_LIB_consensus_vsearch	709	G	R	584	9	1.5%	2	1	93	93	0.0018943147174077597	1	1	375	209	9	0	A
B10_BC22_191109_LF_LIB_consensus_vsearch	710	G	*/-A	573	24	3.98%	2	1	93	93	4.70834256563708E-8	1	1	362	211	24	0	-A
B10_BC22_191109_LF_LIB_consensus_vsearch	711	A	A	570	4	0.69%	2	2	93	93	0.062173202925435794	1	1	356	214	3	1	G
B10_BC22_191109_LF_LIB_consensus_vsearch	712	A	R	536	28	4.66%	2	2	93	93	2.6422448351001822E-9	1	1	326	210	25	3	G
B10_BC22_191109_LF_LIB_consensus_vsearch	713	C	C	567	6	1.04%	2	1	93	93	0.0154208427753216	1	1	353	214	6	0	G
B10_BC22_191109_LF_LIB_consensus_vsearch	714	C	*/+A	580	10	1.67%	2	1	93	93	9.39730591623294E-4	1	1	368	212	10	0	+A
B10_BC22_191109_LF_LIB_consensus_vsearch	715	A	*/-G	566	24	4%	2	2	93	93	4.6949193480367304E-8	1	1	380	186	3	21	-G
B10_BC22_191109_LF_LIB_consensus_vsearch	716	G	G	575	2	0.35%	2	1	93	93	0.24978317432825756	1	1	383	192	2	0	+A
B10_BC22_191109_LF_LIB_consensus_vsearch	717	G	G	597	4	0.66%	2	2	93	93	0.062187890408182296	1	1	383	214	3	1	-A
B10_BC22_191109_LF_LIB_consensus_vsearch	718	A	A	586	4	0.67%	2	2	93	93	0.062182068959449006	1	1	379	207	2	2	+C
B10_BC22_191109_LF_LIB_consensus_vsearch	719	C	*/+T	247	283	47.09%	2	2	93	93	1.0029033768498528E-108	1	1	173	74	153	130	+T
B10_BC22_191109_LF_LIB_consensus_vsearch	720	T	T	559	2	0.35%	2	1	93	93	0.24977698483471023	1	1	353	206	2	0	A
B10_BC22_191109_LF_LIB_consensus_vsearch	721	T	T	574	6	1.03%	2	2	93	93	0.01542330244911806	1	1	365	209	1	5	+C
B10_BC22_191109_LF_LIB_consensus_vsearch	722	T	T	578	6	1.01%	2	2	93	93	0.015424681549082461	1	1	368	210	5	1	C
B10_BC22_191109_LF_LIB_consensus_vsearch	723	A	R	578	19	3.17%	2	2	93	93	1.6491139432485052E-6	1	1	367	211	17	2	G
B10_BC22_191109_LF_LIB_consensus_vsearch	724	C	*/-TT	497	57	9.52%	2	2	93	93	1.5198017317256624E-18	1	1	309	188	53	4	-TT
B10_BC22_191109_LF_LIB_consensus_vsearch	725	T	T	505	3	0.58%	2	1	93	93	0.12463054187199403	1	1	315	190	3	0	+G
B10_BC22_191109_LF_LIB_consensus_vsearch	726	T	Y	524	7	1.29%	2	2	93	93	0.007658599319160323	1	1	316	208	6	1	C
B10_BC22_191109_LF_LIB_consensus_vsearch	727	T	W	577	14	2.33%	2	1	93	93	5.6462160792036027E-5	1	1	367	210	14	0	A
B10_BC22_191109_LF_LIB_consensus_vsearch	728	G	*/+A	317	172	28.57%	2	2	93	93	1.7497674477512066E-60	1	1	182	135	153	19	+A
B10_BC22_191109_LF_LIB_consensus_vsearch	729	A	A	538	1	0.18%	2	1	93	93	0.5000000000008233	1	1	378	160	1	0	+G
B10_BC22_191109_LF_LIB_consensus_vsearch	730	A	A	598	1	0.17%	2	1	93	93	0.5000000000008233	1	1	385	213	1	0	+G
B10_BC22_191109_LF_LIB_consensus_vsearch	731	A	A	595	5	0.83%	2	2	93	93	0.03098969274732699	1	1	382	213	3	2	+G
B10_BC22_191109_LF_LIB_consensus_vsearch	732	A	A	592	3	0.5%	2	2	93	93	0.1246846089151382	1	1	378	214	2	1	+G
B10_BC22_191109_LF_LIB_consensus_vsearch	733	A	A	589	5	0.83%	2	2	93	93	0.030987064506852544	1	1	379	210	4	1	+G
B10_BC22_191109_LF_LIB_consensus_vsearch	734	T	K	580	12	2.01%	2	1	93	93	2.3077737978553087E-4	1	1	369	211	12	0	G
B10_BC22_191109_LF_LIB_consensus_vsearch	735	T	*/+G	571	11	1.82%	2	1	93	93	4.655455542392171E-4	1	1	359	212	11	0	+G
B10_BC22_191109_LF_LIB_consensus_vsearch	736	A	R	558	14	2.36%	2	1	93	93	5.6314541018637804E-5	1	1	355	203	14	0	G
B10_BC22_191109_LF_LIB_consensus_vsearch	737	G	*/+A	571	10	1.68%	2	2	93	93	9.391664866947025E-4	1	1	361	210	9	1	+A
B10_BC22_191109_LF_LIB_consensus_vsearch	738	A	A	584	4	0.67%	2	2	93	93	0.062180987103355005	1	1	375	209	2	2	-G
B10_BC22_191109_LF_LIB_consensus_vsearch	739	G	*/-T	583	10	1.68%	2	1	93	93	9.399148640318375E-4	1	1	382	201	0	10	-T
B10_BC22_191109_LF_LIB_consensus_vsearch	740	T	T	587	3	0.51%	2	2	93	93	0.12468193384235185	1	1	386	201	2	1	+A
B10_BC22_191109_LF_LIB_consensus_vsearch	741	G	G	593	2	0.33%	2	1	93	93	0.24978973927711676	1	1	381	212	2	0	+T
B10_BC22_191109_LF_LIB_consensus_vsearch	742	T	T	596	3	0.5%	2	2	93	93	0.1246867167922604	1	1	387	209	1	2	C
B10_BC22_191109_LF_LIB_consensus_vsearch	743	T	T	593	4	0.66%	2	2	93	93	0.06218579834936829	1	1	384	209	3	1	+C
B10_BC22_191109_LF_LIB_consensus_vsearch	744	C	*/-A	540	25	4.17%	2	1	93	93	2.2718822110947697E-8	1	1	335	205	25	0	-A
B10_BC22_191109_LF_LIB_consensus_vsearch	745	A	A	566	4	0.7%	2	1	93	93	0.062170908610734946	1	1	357	209	4	0	C
B10_BC22_191109_LF_LIB_consensus_vsearch	746	A	A	592	3	0.5%	2	2	93	93	0.1246846089151382	1	1	383	209	1	2	G
B10_BC22_191109_LF_LIB_consensus_vsearch	747	A	A	593	4	0.66%	2	2	93	93	0.06218579834936829	1	1	380	213	3	1	G
B10_BC22_191109_LF_LIB_consensus_vsearch	748	G	G	591	4	0.67%	2	2	93	93	0.06218474176725347	1	1	380	211	1	3	-C
B10_BC22_191109_LF_LIB_consensus_vsearch	749	C	C	584	5	0.84%	2	2	93	93	0.030984833420659205	1	1	378	206	4	1	+G
B10_BC22_191109_LF_LIB_consensus_vsearch	750	A	R	576	11	1.83%	2	2	93	93	4.657363845851338E-4	1	1	371	205	9	2	G
B10_BC22_191109_LF_LIB_consensus_vsearch	751	G	G	589	1	0.17%	2	1	93	93	0.5000000000008233	1	1	382	207	1	0	+A
B10_BC22_191109_LF_LIB_consensus_vsearch	752	G	R	585	7	1.16%	2	2	93	93	0.007674403214110395	1	1	378	207	6	1	A
B10_BC22_191109_LF_LIB_consensus_vsearch	753	C	C	585	6	1.01%	2	1	93	93	0.015427050131369397	1	1	383	202	0	6	+T
B10_BC22_191109_LF_LIB_consensus_vsearch	754	C	*/-T	523	41	6.81%	2	2	93	93	2.1390773943992173E-13	1	1	371	152	5	36	-T
B10_BC22_191109_LF_LIB_consensus_vsearch	755	T	T	555	1	0.18%	2	1	93	93	0.5000000000008233	1	1	381	174	0	1	+C
B10_BC22_191109_LF_LIB_consensus_vsearch	756	T	T	595	2	0.33%	2	1	93	93	0.24979044425840527	1	1	384	211	2	0	C
B10_BC22_191109_LF_LIB_consensus_vsearch	757	T	T	594	5	0.83%	2	1	93	93	0.03098925836211217	1	1	379	215	5	0	-G
B10_BC22_191109_LF_LIB_consensus_vsearch	758	G	*/+C	581	9	1.51%	2	1	93	93	0.0018940181115188759	1	1	379	202	0	9	+C
B10_BC22_191109_LF_LIB_consensus_vsearch	759	C	C	593	5	0.83%	2	1	93	93	0.03098882252468081	1	1	381	212	5	0	A
B10_BC22_191109_LF_LIB_consensus_vsearch	760	T	*/+C	581	8	1.33%	2	1	93	93	0.0038139152066312184	1	1	377	204	8	0	+C
B10_BC22_191109_LF_LIB_consensus_vsearch	761	C	*/+G	563	8	1.34%	2	2	93	93	0.0038110211985538677	1	1	363	200	4	4	+G
B10_BC22_191109_LF_LIB_consensus_vsearch	762	G	*/-A	571	10	1.69%	2	1	93	93	9.391664866947025E-4	1	1	356	215	10	0	-A
B10_BC22_191109_LF_LIB_consensus_vsearch	763	A	R	579	7	1.19%	2	2	93	93	0.007672994124905477	1	1	365	214	6	1	G
B10_BC22_191109_LF_LIB_consensus_vsearch	764	A	M	578	7	1.16%	2	1	93	93	0.007672756476313913	1	1	364	214	7	0	C
B10_BC22_191109_LF_LIB_consensus_vsearch	765	T	*/-A	578	10	1.67%	2	1	93	93	9.396067104969792E-4	1	1	365	213	10	0	-A
B10_BC22_191109_LF_LIB_consensus_vsearch	766	A	A	567	5	0.84%	2	1	93	93	0.03097695610130975	1	1	356	211	5	0	+C
B10_BC22_191109_LF_LIB_consensus_vsearch	767	C	C	590	3	0.5%	2	1	93	93	0.12468354430400949	1	1	380	210	3	0	-A
B10_BC22_191109_LF_LIB_consensus_vsearch	768	A	A	593	3	0.5%	2	2	93	93	0.12468513853935516	1	1	383	210	1	2	-T
B10_BC22_191109_LF_LIB_consensus_vsearch	769	T	T	591	5	0.83%	2	1	93	93	0.030987946464272845	1	1	382	209	5	0	G
B10_BC22_191109_LF_LIB_consensus_vsearch	770	T	T	599	1	0.17%	2	1	93	93	0.4999999999990043	1	1	385	214	1	0	+A
B10_BC22_191109_LF_LIB_consensus_vsearch	771	A	R	580	12	1.99%	2	2	93	93	2.3077737978553087E-4	1	1	371	209	11	1	G
B10_BC22_191109_LF_LIB_consensus_vsearch	772	G	G	594	3	0.5%	2	1	93	93	0.12468566638724124	1	1	381	213	3	0	A
B10_BC22_191109_LF_LIB_consensus_vsearch	773	C	C	592	3	0.5%	2	2	93	93	0.1246846089151382	1	1	381	211	1	2	T
B10_BC22_191109_LF_LIB_consensus_vsearch	774	A	A	592	1	0.17%	2	1	93	93	0.4999999999999138	1	1	381	211	0	1	+GCA
B10_BC22_191109_LF_LIB_consensus_vsearch	775	T	T	588	6	1%	2	2	93	93	0.015428048177952706	1	1	381	207	3	3	+G
B10_BC22_191109_LF_LIB_consensus_vsearch	776	G	G	595	1	0.17%	2	1	93	93	0.4999999999999138	1	1	384	211	1	0	+CG
B10_BC22_191109_LF_LIB_consensus_vsearch	777	G	G	599	3	0.5%	2	2	93	93	0.12468827930162561	1	1	387	212	1	2	-A
B10_BC22_191109_LF_LIB_consensus_vsearch	778	A	A	599	1	0.17%	2	1	93	93	0.4999999999990043	1	1	386	213	1	0	T
B10_BC22_191109_LF_LIB_consensus_vsearch	779	A	A	596	4	0.66%	2	2	93	93	0.062187370009836374	1	1	382	214	3	1	G
B10_BC22_191109_LF_LIB_consensus_vsearch	780	T	*/-AAT	575	17	2.82%	2	2	93	93	6.790444562646919E-6	1	1	378	197	4	13	-AAT
B10_BC22_191109_LF_LIB_consensus_vsearch	781	A	A	580	1	0.17%	2	1	93	93	0.4999999999999138	1	1	381	199	0	1	G
B10_BC22_191109_LF_LIB_consensus_vsearch	782	A	A	581	2	0.34%	2	1	93	93	0.24978540772560268	1	1	380	201	2	0	G
B10_BC22_191109_LF_LIB_consensus_vsearch	783	T	T	568	6	1.03%	2	1	93	93	0.015421197823763643	1	1	373	195	0	6	C
B10_BC22_191109_LF_LIB_consensus_vsearch	784	A	*/+G	571	20	3.34%	2	2	93	93	8.09869995415386E-7	1	1	359	212	19	1	+G
B10_BC22_191109_LF_LIB_consensus_vsearch	785	G	G	596	2	0.33%	2	2	93	93	0.24979079497935539	1	1	382	214	1	1	-A
B10_BC22_191109_LF_LIB_consensus_vsearch	786	A	A	595	3	0.5%	2	1	93	93	0.12468619246852639	1	1	381	214	3	0	G
B10_BC22_191109_LF_LIB_consensus_vsearch	787	A	A	591	5	0.83%	2	1	93	93	0.030987946464272845	1	1	376	215	5	0	G
B10_BC22_191109_LF_LIB_consensus_vsearch	788	T	T	588	6	1%	2	2	93	93	0.015428048177952706	1	1	377	211	4	2	C
B10_BC22_191109_LF_LIB_consensus_vsearch	789	A	*/-G	553	36	6.03%	2	1	93	93	8.383048691032404E-12	1	1	379	174	0	36	-G
B10_BC22_191109_LF_LIB_consensus_vsearch	790	G	G	562	2	0.35%	2	1	93	93	0.24977817213868056	1	1	384	178	2	0	A
B10_BC22_191109_LF_LIB_consensus_vsearch	791	G	G	600	1	0.17%	2	1	93	93	0.4999999999999138	1	1	386	214	1	0	-A
B10_BC22_191109_LF_LIB_consensus_vsearch	792	A	A	597	4	0.66%	2	1	93	93	0.062187890408182296	1	1	383	214	4	0	G
B10_BC22_191109_LF_LIB_consensus_vsearch	793	C	*/+A	589	9	1.49%	2	1	93	93	0.001894802500745058	1	1	376	213	9	0	+A
B10_BC22_191109_LF_LIB_consensus_vsearch	794	G	K	577	10	1.67%	2	1	93	93	9.395444569434851E-4	1	1	366	211	10	0	T
B10_BC22_191109_LF_LIB_consensus_vsearch	795	T	*/+A	583	8	1.33%	2	2	93	93	0.0038142259421648926	1	1	372	211	7	1	+A
B10_BC22_191109_LF_LIB_consensus_vsearch	796	G	*/-TG	540	43	7.2%	2	2	93	93	5.0882431214359576E-14	1	1	358	182	13	30	-TG
B10_BC22_191109_LF_LIB_consensus_vsearch	797	T	T	555	1	0.18%	2	1	93	93	0.5000000000008233	1	1	374	181	1	0	+A
B10_BC22_191109_LF_LIB_consensus_vsearch	798	G	G	550	4	0.72%	2	2	93	93	0.06216139989452796	1	1	369	181	3	1	+TG
B10_BC22_191109_LF_LIB_consensus_vsearch	799	G	*/+T	586	8	1.33%	2	2	93	93	0.00381468814385855	1	1	375	211	7	1	+T
B10_BC22_191109_LF_LIB_consensus_vsearch	800	T	T	595	4	0.66%	2	2	93	93	0.062186847872822006	1	1	386	209	1	3	+C
B10_BC22_191109_LF_LIB_consensus_vsearch	801	T	T	592	6	1%	2	2	93	93	0.01542936335614873	1	1	380	212	5	1	+C
B10_BC22_191109_LF_LIB_consensus_vsearch	802	C	*/-T	588	8	1.33%	2	1	93	93	0.00381499370763636	1	1	386	202	0	8	-T
B10_BC22_191109_LF_LIB_consensus_vsearch	803	T	T	586	3	0.5%	2	1	93	93	0.12468139337307069	1	1	386	200	0	3	C
B10_BC22_191109_LF_LIB_consensus_vsearch	804	A	*/+T	511	47	7.83%	2	2	93	93	2.5851610042104557E-15	1	1	338	173	30	17	+T
B10_BC22_191109_LF_LIB_consensus_vsearch	805	T	T	570	4	0.7%	2	2	93	93	0.062173202925435794	1	1	376	194	1	3	C
B10_BC22_191109_LF_LIB_consensus_vsearch	806	T	T	596	2	0.33%	2	1	93	93	0.24979079497935539	1	1	385	211	0	2	+CT
B10_BC22_191109_LF_LIB_consensus_vsearch	807	T	T	598	2	0.33%	2	1	93	93	0.24979149291046765	1	1	387	211	0	2	+C
B10_BC22_191109_LF_LIB_consensus_vsearch	808	T	T	592	3	0.5%	2	1	93	93	0.1246846089151382	1	1	380	212	3	0	C
B10_BC22_191109_LF_LIB_consensus_vsearch	809	G	G	586	5	0.83%	2	1	93	93	0.030985730383315414	1	1	376	210	5	0	+T
B10_BC22_191109_LF_LIB_consensus_vsearch	810	T	Y	587	13	2.16%	2	2	93	93	1.1430974219131529E-4	1	1	386	201	1	12	C
B10_BC22_191109_LF_LIB_consensus_vsearch	811	T	T	594	6	1%	2	2	93	93	0.015430014380448172	1	1	381	213	4	2	-G
B10_BC22_191109_LF_LIB_consensus_vsearch	812	G	G	584	6	1.01%	2	2	93	93	0.015426715197547503	1	1	373	211	5	1	A
B10_BC22_191109_LF_LIB_consensus_vsearch	813	G	*/+T	541	47	7.79%	2	2	93	93	2.7278887299206375E-15	1	1	333	208	45	2	+T
B10_BC22_191109_LF_LIB_consensus_vsearch	814	T	T	588	3	0.51%	2	2	93	93	0.12468247248078299	1	1	376	212	2	1	C
B10_BC22_191109_LF_LIB_consensus_vsearch	815	T	T	596	5	0.83%	2	2	93	93	0.030990125687592227	1	1	384	212	2	3	C
B10_BC22_191109_LF_LIB_consensus_vsearch	816	T	*/+C	578	9	1.49%	2	2	93	93	0.001893718498855406	1	1	371	207	6	3	+C
B10_BC22_191109_LF_LIB_consensus_vsearch	817	C	*/-T	550	24	4.05%	2	2	93	93	4.6631359837056654E-8	1	1	377	173	1	23	-T
B10_BC22_191109_LF_LIB_consensus_vsearch	818	T	T	551	5	0.88%	2	2	93	93	0.030969102320518065	1	1	373	178	4	1	-A
B10_BC22_191109_LF_LIB_consensus_vsearch	819	A	*/-G	527	46	7.8%	2	1	93	93	5.546996393113199E-15	1	1	377	150	0	46	-G
B10_BC22_191109_LF_LIB_consensus_vsearch	820	G	G	548	1	0.18%	2	1	93	93	0.5000000000008233	1	1	387	161	0	1	+A
B10_BC22_191109_LF_LIB_consensus_vsearch	821	G	G	593	4	0.66%	2	1	93	93	0.06218579834936829	1	1	384	209	0	4	A
B10_BC22_191109_LF_LIB_consensus_vsearch	822	A	*/-C	581	7	1.17%	2	1	93	93	0.007673467005464533	1	1	370	211	7	0	-C
B10_BC22_191109_LF_LIB_consensus_vsearch	823	C	Y	584	9	1.51%	2	2	93	93	0.0018943147174077597	1	1	378	206	1	8	T
B10_BC22_191109_LF_LIB_consensus_vsearch	824	C	Y	588	8	1.33%	2	2	93	93	0.00381499370763636	1	1	381	207	5	3	T
B10_BC22_191109_LF_LIB_consensus_vsearch	825	G	R	584	9	1.5%	2	2	93	93	0.0018943147174077597	1	1	377	207	8	1	A
B10_BC22_191109_LF_LIB_consensus_vsearch	826	C	Y	587	7	1.17%	2	2	93	93	0.007674866606290045	1	1	381	206	4	3	T
B10_BC22_191109_LF_LIB_consensus_vsearch	827	C	Y	577	10	1.67%	2	2	93	93	9.395444569434851E-4	1	1	380	197	1	9	T
B10_BC22_191109_LF_LIB_consensus_vsearch	828	G	R	583	7	1.18%	2	2	93	93	0.007673936691127849	1	1	380	203	5	2	A
B10_BC22_191109_LF_LIB_consensus_vsearch	829	T	*/-A	565	14	2.36%	2	2	93	93	5.6370022462689414E-5	1	1	382	183	4	10	-A
B10_BC22_191109_LF_LIB_consensus_vsearch	830	A	A	584	2	0.34%	2	1	93	93	0.2497865072588101	1	1	381	203	2	0	G
B10_BC22_191109_LF_LIB_consensus_vsearch	831	A	A	592	6	1%	2	2	93	93	0.01542936335614873	1	1	379	213	5	1	G
B10_BC22_191109_LF_LIB_consensus_vsearch	832	T	Y	585	12	2%	2	2	93	93	2.3088726695666827E-4	1	1	383	202	1	11	C
B10_BC22_191109_LF_LIB_consensus_vsearch	833	G	G	594	3	0.5%	2	1	93	93	0.12468566638724124	1	1	381	213	3	0	A
B10_BC22_191109_LF_LIB_consensus_vsearch	834	A	A	594	3	0.5%	2	2	93	93	0.12468566638724124	1	1	383	211	1	2	-T
B10_BC22_191109_LF_LIB_consensus_vsearch	835	T	T	594	3	0.5%	2	2	93	93	0.12468566638724124	1	1	382	212	2	1	C
B10_BC22_191109_LF_LIB_consensus_vsearch	836	T	*/-AAT	586	10	1.66%	2	1	93	93	9.400973019723426E-4	1	1	385	201	0	10	-AAT
B10_BC22_191109_LF_LIB_consensus_vsearch	837	A	A	583	4	0.68%	2	1	93	93	0.06218044340963991	1	1	380	203	4	0	+GCC
B10_BC22_191109_LF_LIB_consensus_vsearch	838	A	A	582	3	0.51%	2	1	93	93	0.12467921300240917	1	1	383	199	0	3	C
B10_BC22_191109_LF_LIB_consensus_vsearch	839	T	T	572	4	0.68%	2	1	93	93	0.06217433812810566	1	1	370	202	4	0	+A
B10_BC22_191109_LF_LIB_consensus_vsearch	840	A	*/-G	487	65	10.82%	2	2	93	93	3.6600353179866846E-21	1	1	372	115	11	54	-G
B10_BC22_191109_LF_LIB_consensus_vsearch	841	G	G	489	3	0.6%	2	1	93	93	0.12461851475085987	1	1	369	120	3	0	A
B10_BC22_191109_LF_LIB_consensus_vsearch	842	G	G	556	3	0.53%	2	2	93	93	0.12466427931981025	1	1	383	173	2	1	A
B10_BC22_191109_LF_LIB_consensus_vsearch	843	G	G	601	1	0.17%	2	1	93	93	0.4999999999990043	1	1	387	214	1	0	-A
B10_BC22_191109_LF_LIB_consensus_vsearch	844	A	A	593	3	0.5%	2	2	93	93	0.12468513853935516	1	1	381	212	2	1	G
B10_BC22_191109_LF_LIB_consensus_vsearch	845	T	*/+G	577	9	1.5%	2	1	93	93	0.0018936179518815892	1	1	373	204	9	0	+G
B10_BC22_191109_LF_LIB_consensus_vsearch	846	A	*/-G	580	12	2%	2	2	93	93	2.3077737978553087E-4	1	1	370	210	9	3	-G
B10_BC22_191109_LF_LIB_consensus_vsearch	847	G	R	579	8	1.36%	2	2	93	93	0.003813602365568841	1	1	375	204	1	7	A
B10_BC22_191109_LF_LIB_consensus_vsearch	848	T	T	586	5	0.83%	2	1	93	93	0.030985730383315414	1	1	381	205	0	5	-C
B10_BC22_191109_LF_LIB_consensus_vsearch	849	C	*/-G	410	125	21.04%	2	2	93	93	6.32560213413599E-42	1	1	247	163	101	24	-G
B10_BC22_191109_LF_LIB_consensus_vsearch	850	G	R	385	59	13%	2	2	93	93	2.201265346699876E-19	1	1	224	161	57	2	A
B10_BC22_191109_LF_LIB_consensus_vsearch	851	G	R	541	41	7.04%	2	2	93	93	2.1914244866795488E-13	1	1	348	193	38	3	A
B10_BC22_191109_LF_LIB_consensus_vsearch	852	G	R	566	18	3.07%	2	2	93	93	3.339665159154707E-6	1	1	373	193	15	3	A
B10_BC22_191109_LF_LIB_consensus_vsearch	853	G	R	578	23	3.81%	2	2	93	93	9.619429474812937E-8	1	1	381	197	7	16	A
B10_BC22_191109_LF_LIB_consensus_vsearch	854	G	G	595	5	0.83%	2	2	93	93	0.03098969274732699	1	1	383	212	4	1	A
B10_BC22_191109_LF_LIB_consensus_vsearch	855	C	C	592	5	0.83%	2	2	93	93	0.03098838522787931	1	1	384	208	1	4	T
B10_BC22_191109_LF_LIB_consensus_vsearch	856	A	A	592	3	0.5%	2	2	93	93	0.1246846089151382	1	1	381	211	2	1	G
B10_BC22_191109_LF_LIB_consensus_vsearch	857	T	*/+C	584	8	1.33%	2	1	93	93	0.0038143805269862142	1	1	372	212	8	0	+C
B10_BC22_191109_LF_LIB_consensus_vsearch	858	C	C	592	2	0.34%	2	1	93	93	0.24978938500452047	1	1	378	214	2	0	G
B10_BC22_191109_LF_LIB_consensus_vsearch	859	C	*/+A	579	7	1.16%	2	2	93	93	0.007672994124905477	1	1	377	202	3	4	+A
B10_BC22_191109_LF_LIB_consensus_vsearch	860	G	R	586	7	1.18%	2	2	93	93	0.007674635299574334	1	1	379	207	6	1	A
B10_BC22_191109_LF_LIB_consensus_vsearch	861	T	Y	583	11	1.84%	2	2	93	93	4.65998228714525E-4	1	1	385	198	2	9	C
B10_BC22_191109_LF_LIB_consensus_vsearch	862	A	A	594	3	0.5%	2	1	93	93	0.12468566638724124	1	1	384	210	0	3	+T
B10_BC22_191109_LF_LIB_consensus_vsearch	863	T	T	599	0	0%	2	0	93	0	1.0	1	0	386	213	0	0	
B10_BC22_191109_LF_LIB_consensus_vsearch	864	T	*/+C	586	11	1.83%	2	2	93	93	4.661085952376518E-4	1	1	375	211	10	1	+C
B10_BC22_191109_LF_LIB_consensus_vsearch	865	C	*/-A	585	10	1.66%	2	2	93	93	9.400366914624269E-4	1	1	373	212	8	2	-A
B10_BC22_191109_LF_LIB_consensus_vsearch	866	A	A	590	2	0.34%	2	1	93	93	0.2497886728654613	1	1	377	213	2	0	C
B10_BC22_191109_LF_LIB_consensus_vsearch	867	A	A	597	2	0.33%	2	2	93	93	0.24979114452852993	1	1	383	214	1	1	+T
B10_BC22_191109_LF_LIB_consensus_vsearch	868	T	K	590	8	1.33%	2	1	93	93	0.003815297238788008	1	1	377	213	8	0	G
B10_BC22_191109_LF_LIB_consensus_vsearch	869	T	T	597	3	0.5%	2	2	93	93	0.12468723936635923	1	1	384	213	1	2	C
B10_BC22_191109_LF_LIB_consensus_vsearch	870	G	G	589	5	0.83%	2	2	93	93	0.030987064506852544	1	1	378	211	4	1	A
B10_BC22_191109_LF_LIB_consensus_vsearch	871	T	Y	582	7	1.17%	2	2	93	93	0.007673702245629301	1	1	370	212	5	2	C
B10_BC22_191109_LF_LIB_consensus_vsearch	872	C	*/+A	562	11	1.84%	2	1	93	93	4.6519379419598136E-4	1	1	353	209	11	0	+A
B10_BC22_191109_LF_LIB_consensus_vsearch	873	A	*/+G	551	19	3.22%	2	2	93	93	1.6376018454363662E-6	1	1	359	192	4	15	+G
B10_BC22_191109_LF_LIB_consensus_vsearch	874	G	*/-A	567	12	2.04%	2	2	93	93	2.3048295964434314E-4	1	1	353	214	11	1	-A
B10_BC22_191109_LF_LIB_consensus_vsearch	875	A	*/-G	562	16	2.72%	2	1	93	93	1.3734836880775204E-5	1	1	350	212	16	0	-G
B10_BC22_191109_LF_LIB_consensus_vsearch	876	G	*/+A	544	18	3.07%	2	1	93	93	3.322048927234526E-6	1	1	332	212	18	0	+A
B10_BC22_191109_LF_LIB_consensus_vsearch	877	G	K	577	12	1.99%	2	1	93	93	2.3071056867786312E-4	1	1	365	212	12	0	T
B10_BC22_191109_LF_LIB_consensus_vsearch	878	T	T	585	4	0.67%	2	2	93	93	0.06218152895025356	1	1	378	207	3	1	+A
B10_BC22_191109_LF_LIB_consensus_vsearch	879	G	G	582	5	0.84%	2	2	93	93	0.030983930348565846	1	1	375	207	3	2	+A
B10_BC22_191109_LF_LIB_consensus_vsearch	880	A	A	578	6	1.01%	2	2	93	93	0.015424681549082461	1	1	369	209	2	4	G
B10_BC22_191109_LF_LIB_consensus_vsearch	881	A	A	595	4	0.67%	2	2	93	93	0.062186847872822006	1	1	381	214	3	1	G
B10_BC22_191109_LF_LIB_consensus_vsearch	882	A	R	584	10	1.66%	2	2	93	93	9.39975879151716E-4	1	1	376	208	8	2	G
B10_BC22_191109_LF_LIB_consensus_vsearch	883	T	T	594	3	0.5%	2	1	93	93	0.12468566638724124	1	1	382	212	3	0	G
B10_BC22_191109_LF_LIB_consensus_vsearch	884	T	*/-C	565	14	2.33%	2	2	93	93	5.6370022462689414E-5	1	1	373	192	3	11	-C
B10_BC22_191109_LF_LIB_consensus_vsearch	885	C	*/-T	554	21	3.6%	2	2	93	93	3.9593177226547966E-7	1	1	381	173	3	18	-T
B10_BC22_191109_LF_LIB_consensus_vsearch	886	T	T	568	3	0.52%	2	2	93	93	0.12467134092879167	1	1	380	188	2	1	C
B10_BC22_191109_LF_LIB_consensus_vsearch	887	T	*/-G	575	13	2.17%	2	2	93	93	1.14154960647074E-4	1	1	377	198	2	11	-G
B10_BC22_191109_LF_LIB_consensus_vsearch	888	G	G	580	3	0.51%	2	1	93	93	0.12467811158812642	1	1	379	201	3	0	A
B10_BC22_191109_LF_LIB_consensus_vsearch	889	G	G	594	6	1%	2	1	93	93	0.015430014380448172	1	1	379	215	6	0	-AT
B10_BC22_191109_LF_LIB_consensus_vsearch	890	A	*/-T	565	19	3.2%	2	2	93	93	1.6436960696383207E-6	1	1	360	205	16	3	-T
B10_BC22_191109_LF_LIB_consensus_vsearch	891	T	T	571	6	1.04%	2	2	93	93	0.015422255598111148	1	1	364	207	2	4	C
B10_BC22_191109_LF_LIB_consensus_vsearch	892	T	T	595	5	0.83%	2	2	93	93	0.03098969274732699	1	1	385	210	2	3	C
B10_BC22_191109_LF_LIB_consensus_vsearch	893	T	*/-A	572	21	3.49%	2	1	93	93	3.982124321700297E-7	1	1	361	211	21	0	-A
B10_BC22_191109_LF_LIB_consensus_vsearch	894	A	A	568	3	0.52%	2	2	93	93	0.12467134092879167	1	1	357	211	2	1	-T
B10_BC22_191109_LF_LIB_consensus_vsearch	895	T	K	567	21	3.54%	2	1	93	93	3.975918764851043E-7	1	1	356	211	21	0	G
B10_BC22_191109_LF_LIB_consensus_vsearch	896	T	T	589	2	0.33%	2	2	93	93	0.2497883149871952	1	1	379	210	1	1	-G
B10_BC22_191109_LF_LIB_consensus_vsearch	897	G	G	587	4	0.67%	2	1	93	93	0.062182607140620794	1	1	375	212	4	0	-A
B10_BC22_191109_LF_LIB_consensus_vsearch	898	A	A	586	6	1.01%	2	1	93	93	0.015427383935577244	1	1	374	212	6	0	+G
B10_BC22_191109_LF_LIB_consensus_vsearch	899	A	*/-GA	588	9	1.5%	2	1	93	93	0.0018947055924330373	1	1	374	214	9	0	-GA
B10_BC22_191109_LF_LIB_consensus_vsearch	900	G	G	588	1	0.17%	2	1	93	93	0.4999999999990043	1	1	374	214	1	0	+A
B10_BC22_191109_LF_LIB_consensus_vsearch	901	A	R	581	7	1.18%	2	2	93	93	0.007673467005464533	1	1	367	214	6	1	G
B10_BC22_191109_LF_LIB_consensus_vsearch	902	C	C	583	4	0.67%	2	2	93	93	0.06218044340963991	1	1	372	211	3	1	-G
B10_BC22_191109_LF_LIB_consensus_vsearch	903	G	*/+A	576	12	2.02%	2	1	93	93	2.306881496410543E-4	1	1	379	197	0	12	+A
B10_BC22_191109_LF_LIB_consensus_vsearch	904	A	A	588	4	0.67%	2	2	93	93	0.06218314350277022	1	1	378	210	3	1	G
B10_BC22_191109_LF_LIB_consensus_vsearch	905	A	A	584	5	0.83%	2	1	93	93	0.030984833420659205	1	1	380	204	0	5	+C
B10_BC22_191109_LF_LIB_consensus_vsearch	906	C	C	584	4	0.67%	2	2	93	93	0.062180987103355005	1	1	377	207	1	3	+T
B10_BC22_191109_LF_LIB_consensus_vsearch	907	T	Y	459	116	19.4%	2	2	93	93	1.881634453565931E-38	1	1	372	87	1	115	C
B10_BC22_191109_LF_LIB_consensus_vsearch	908	A	*/+T	537	34	5.76%	2	1	93	93	3.508770285345225E-11	1	1	364	173	0	34	+T
B10_BC22_191109_LF_LIB_consensus_vsearch	909	C	*/-T	518	28	4.76%	2	1	93	93	2.611720175727813E-9	1	1	374	144	0	28	-T
B10_BC22_191109_LF_LIB_consensus_vsearch	910	T	T	549	3	0.54%	2	2	93	93	0.1246600181323542	1	1	373	176	2	1	A
B10_BC22_191109_LF_LIB_consensus_vsearch	911	G	G	580	6	1.01%	2	2	93	93	0.01542536405110175	1	1	377	203	1	5	-CG
B10_BC22_191109_LF_LIB_consensus_vsearch	912	C	*/-GAA	534	15	2.54%	2	1	93	93	2.769887539390586E-5	1	1	337	197	15	0	-GAA
B10_BC22_191109_LF_LIB_consensus_vsearch	913	G	*/-A	530	8	1.43%	2	1	93	93	0.0038052156524719656	1	1	331	199	8	0	-A
B10_BC22_191109_LF_LIB_consensus_vsearch	914	A	A	552	2	0.36%	2	2	93	93	0.24977416440874464	1	1	346	206	1	1	T
B10_BC22_191109_LF_LIB_consensus_vsearch	915	A	A	574	1	0.17%	2	1	93	93	0.5000000000008233	1	1	368	206	0	1	T
B10_BC22_191109_LF_LIB_consensus_vsearch	916	A	*/-G	582	10	1.67%	2	2	93	93	9.398536450879837E-4	1	1	374	208	9	1	-G
B10_BC22_191109_LF_LIB_consensus_vsearch	917	G	G	585	2	0.34%	2	1	93	93	0.2497868712706135	1	1	376	209	0	2	-C
B10_BC22_191109_LF_LIB_consensus_vsearch	918	C	C	590	3	0.5%	2	1	93	93	0.12468354430400949	1	1	383	207	0	3	T
B10_BC22_191109_LF_LIB_consensus_vsearch	919	A	*/-T	543	39	6.52%	2	2	93	93	9.415561569949972E-13	1	1	342	201	35	4	-T
B10_BC22_191109_LF_LIB_consensus_vsearch	920	T	T	552	2	0.36%	2	1	93	93	0.24977416440874464	1	1	347	205	2	0	+G
B10_BC22_191109_LF_LIB_consensus_vsearch	921	T	T	594	5	0.83%	2	2	93	93	0.03098925836211217	1	1	384	210	3	2	C
B10_BC22_191109_LF_LIB_consensus_vsearch	922	T	*/-G	587	7	1.16%	2	2	93	93	0.007674866606290045	1	1	382	205	5	2	-G
B10_BC22_191109_LF_LIB_consensus_vsearch	923	G	R	543	23	3.87%	2	1	93	93	9.490102072483946E-8	1	1	333	210	23	0	A
B10_BC22_191109_LF_LIB_consensus_vsearch	924	C	C	559	6	1.04%	2	1	93	93	0.015417957224098422	1	1	351	208	6	0	+T
B10_BC22_191109_LF_LIB_consensus_vsearch	925	C	*/-A	525	47	7.87%	2	2	93	93	2.6527541797478075E-15	1	1	323	202	40	7	-A
B10_BC22_191109_LF_LIB_consensus_vsearch	926	A	R	523	11	2.01%	2	2	93	93	4.635347125797556E-4	1	1	318	205	10	1	G
B10_BC22_191109_LF_LIB_consensus_vsearch	927	A	*/-G	572	19	3.19%	2	2	93	93	1.646641266904007E-6	1	1	360	212	18	1	-G
B10_BC22_191109_LF_LIB_consensus_vsearch	928	G	*/+A	561	7	1.2%	2	1	93	93	0.007668588879253857	1	1	358	203	7	0	+A
B10_BC22_191109_LF_LIB_consensus_vsearch	929	G	G	594	5	0.83%	2	1	93	93	0.03098925836211217	1	1	381	213	5	0	A
B10_BC22_191109_LF_LIB_consensus_vsearch	930	A	A	591	6	1%	2	2	93	93	0.015429036211008771	1	1	381	210	2	4	G
B10_BC22_191109_LF_LIB_consensus_vsearch	931	T	*/-G	586	7	1.17%	2	2	93	93	0.007674635299574334	1	1	376	210	5	2	-G
B10_BC22_191109_LF_LIB_consensus_vsearch	932	G	*/-T	506	34	5.71%	2	2	93	93	3.405077877782199E-11	1	1	300	206	28	6	-T
B10_BC22_191109_LF_LIB_consensus_vsearch	933	T	W	554	7	1.23%	2	2	93	93	0.007666799661120067	1	1	351	203	5	2	A
B10_BC22_191109_LF_LIB_consensus_vsearch	934	T	T	596	4	0.66%	2	2	93	93	0.062187370009836374	1	1	387	209	1	3	C
B10_BC22_191109_LF_LIB_consensus_vsearch	935	T	T	596	3	0.5%	2	1	93	93	0.1246867167922604	1	1	385	211	0	3	G
B10_BC22_191109_LF_LIB_consensus_vsearch	936	T	T	593	3	0.5%	2	2	93	93	0.12468513853935516	1	1	385	208	1	2	-C
B10_BC22_191109_LF_LIB_consensus_vsearch	937	C	C	596	2	0.33%	2	1	93	93	0.24979079497935539	1	1	387	209	0	2	+T
B10_BC22_191109_LF_LIB_consensus_vsearch	938	A	A	596	3	0.5%	2	1	93	93	0.1246867167922604	1	1	384	212	3	0	G
B10_BC22_191109_LF_LIB_consensus_vsearch	939	T	T	595	4	0.67%	2	2	93	93	0.062186847872822006	1	1	386	209	1	3	C
B10_BC22_191109_LF_LIB_consensus_vsearch	940	T	T	597	2	0.33%	2	1	93	93	0.24979114452852993	1	1	385	212	2	0	-A
B10_BC22_191109_LF_LIB_consensus_vsearch	941	A	A	597	2	0.33%	2	1	93	93	0.24979114452852993	1	1	385	212	0	2	T
B10_BC22_191109_LF_LIB_consensus_vsearch	942	A	A	597	3	0.5%	2	2	93	93	0.12468723936635923	1	1	386	211	2	1	G
B10_BC22_191109_LF_LIB_consensus_vsearch	943	T	*/+C	571	22	3.66%	2	2	93	93	1.9551717699649296E-7	1	1	361	210	21	1	+C
B10_BC22_191109_LF_LIB_consensus_vsearch	944	C	C	594	3	0.5%	2	1	93	93	0.12468566638724124	1	1	381	213	3	0	+G
B10_BC22_191109_LF_LIB_consensus_vsearch	945	A	R	585	9	1.5%	2	2	93	93	0.0018944129256754595	1	1	377	208	8	1	G
B10_BC22_191109_LF_LIB_consensus_vsearch	946	G	G	597	1	0.17%	2	1	93	93	0.4999999999999138	1	1	385	212	1	0	+A
B10_BC22_191109_LF_LIB_consensus_vsearch	947	T	T	592	5	0.83%	2	2	93	93	0.03098838522787931	1	1	381	211	1	4	C
B10_BC22_191109_LF_LIB_consensus_vsearch	948	G	G	596	4	0.66%	2	2	93	93	0.062187370009836374	1	1	383	213	3	1	-A
B10_BC22_191109_LF_LIB_consensus_vsearch	949	A	A	594	2	0.33%	2	1	93	93	0.24979009235977778	1	1	380	214	2	0	G
B10_BC22_191109_LF_LIB_consensus_vsearch	950	A	A	595	3	0.5%	2	1	93	93	0.12468619246852639	1	1	384	211	0	3	+T
B10_BC22_191109_LF_LIB_consensus_vsearch	951	C	C	583	4	0.66%	2	1	93	93	0.06218044340963991	1	1	376	207	4	0	-GAA
B10_BC22_191109_LF_LIB_consensus_vsearch	952	G	*/-AA	538	32	5.35%	2	2	93	93	1.488292526237391E-10	1	1	361	177	3	29	-AA
B10_BC22_191109_LF_LIB_consensus_vsearch	953	A	*/+G	535	7	1.28%	2	2	93	93	0.00766171111974148	1	1	356	179	6	1	+G
B10_BC22_191109_LF_LIB_consensus_vsearch	954	A	R	539	21	3.74%	2	2	93	93	3.9392798623314776E-7	1	1	358	181	20	1	G
B10_BC22_191109_LF_LIB_consensus_vsearch	955	A	*/-G	569	21	3.51%	2	1	93	93	3.978412670926488E-7	1	1	360	209	21	0	-G
B10_BC22_191109_LF_LIB_consensus_vsearch	956	G	*/+A	564	7	1.2%	2	1	93	93	0.007669342305605016	1	1	355	209	7	0	+A
B10_BC22_191109_LF_LIB_consensus_vsearch	957	T	T	587	4	0.67%	2	2	93	93	0.062182607140620794	1	1	382	205	1	3	C
B10_BC22_191109_LF_LIB_consensus_vsearch	958	T	*/-A	562	22	3.67%	2	2	93	93	1.9490910563964625E-7	1	1	360	202	16	6	-A
B10_BC22_191109_LF_LIB_consensus_vsearch	959	A	*/-G	401	120	20.76%	2	2	93	93	3.2030851148155364E-40	1	1	327	74	29	91	-G
B10_BC22_191109_LF_LIB_consensus_vsearch	960	G	*/+AG	422	8	1.84%	2	1	93	93	0.003780033413733114	1	1	338	84	8	0	+AG
B10_BC22_191109_LF_LIB_consensus_vsearch	961	G	R	540	16	2.87%	2	1	93	93	1.3676963566354365E-5	1	1	363	177	16	0	A
B10_BC22_191109_LF_LIB_consensus_vsearch	962	G	R	580	10	1.69%	2	2	93	93	9.39730591623294E-4	1	1	378	202	9	1	A
B10_BC22_191109_LF_LIB_consensus_vsearch	963	G	*/-A	593	9	1.49%	2	1	93	93	0.0018951869403117238	1	1	378	215	9	0	-A
B10_BC22_191109_LF_LIB_consensus_vsearch	964	A	A	589	3	0.51%	2	1	93	93	0.1246830092985462	1	1	379	210	0	3	+C
B10_BC22_191109_LF_LIB_consensus_vsearch	965	T	T	590	5	0.83%	2	2	93	93	0.030987506226370864	1	1	381	209	2	3	-C
B10_BC22_191109_LF_LIB_consensus_vsearch	966	C	C	575	5	0.84%	2	1	93	93	0.030980720571722742	1	1	374	201	0	5	+G
B10_BC22_191109_LF_LIB_consensus_vsearch	967	G	*/-A	577	11	1.85%	2	2	93	93	4.6577416695331333E-4	1	1	365	212	10	1	-A
B10_BC22_191109_LF_LIB_consensus_vsearch	968	A	A	582	3	0.51%	2	2	93	93	0.12467921300240917	1	1	369	213	2	1	G
B10_BC22_191109_LF_LIB_consensus_vsearch	969	A	A	592	5	0.83%	2	2	93	93	0.03098838522787931	1	1	381	211	4	1	-GA
B10_BC22_191109_LF_LIB_consensus_vsearch	970	G	G	587	3	0.5%	2	2	93	93	0.12468193384235185	1	1	376	211	2	1	-A
B10_BC22_191109_LF_LIB_consensus_vsearch	971	A	R	573	8	1.35%	2	1	93	93	0.0038126509930167373	1	1	369	204	8	0	G
B10_BC22_191109_LF_LIB_consensus_vsearch	972	C	Y	585	8	1.35%	2	2	93	93	0.0038145345933480535	1	1	382	203	2	6	T
B10_BC22_191109_LF_LIB_consensus_vsearch	973	G	G	593	4	0.67%	2	2	93	93	0.06218579834936829	1	1	385	208	1	3	A
B10_BC22_191109_LF_LIB_consensus_vsearch	974	A	A	590	5	0.83%	2	1	93	93	0.030987506226370864	1	1	381	209	5	0	G
B10_BC22_191109_LF_LIB_consensus_vsearch	975	T	*/+C	568	25	4.17%	2	1	93	93	2.301809219374687E-8	1	1	356	212	25	0	+C
B10_BC22_191109_LF_LIB_consensus_vsearch	976	C	*/+G	581	12	1.99%	2	1	93	93	2.3079950271826945E-4	1	1	371	210	12	0	+G
B10_BC22_191109_LF_LIB_consensus_vsearch	977	A	*/-G	571	10	1.67%	2	1	93	93	9.391664866947025E-4	1	1	366	205	10	0	-G
B10_BC22_191109_LF_LIB_consensus_vsearch	978	G	*/+A	584	7	1.18%	2	1	93	93	0.007674170345963	1	1	370	214	7	0	+A
B10_BC22_191109_LF_LIB_consensus_vsearch	979	A	A	596	3	0.5%	2	1	93	93	0.1246867167922604	1	1	382	214	3	0	-TA
B10_BC22_191109_LF_LIB_consensus_vsearch	980	T	T	596	2	0.33%	2	1	93	93	0.24979079497935539	1	1	383	213	0	2	-AC
B10_BC22_191109_LF_LIB_consensus_vsearch	981	A	R	583	10	1.67%	2	2	93	93	9.399148640318375E-4	1	1	372	211	9	1	G
B10_BC22_191109_LF_LIB_consensus_vsearch	982	C	C	591	4	0.67%	2	1	93	93	0.06218474176725347	1	1	381	210	4	0	+A
B10_BC22_191109_LF_LIB_consensus_vsearch	983	C	Y	574	22	3.65%	2	1	93	93	1.9571612128286045E-7	1	1	383	191	0	22	T
B10_BC22_191109_LF_LIB_consensus_vsearch	984	G	R	596	7	1.16%	2	2	93	93	0.007676913959545329	1	1	383	213	5	2	A
B10_BC22_191109_LF_LIB_consensus_vsearch	985	T	Y	588	10	1.66%	2	2	93	93	9.402179215996255E-4	1	1	382	206	4	6	C
B10_BC22_191109_LF_LIB_consensus_vsearch	986	C	*/+A	584	7	1.17%	2	2	93	93	0.007674170345963	1	1	377	207	2	5	+A
B10_BC22_191109_LF_LIB_consensus_vsearch	987	G	R	577	15	2.5%	2	2	93	93	2.7896984770005455E-5	1	1	369	208	12	3	A
B10_BC22_191109_LF_LIB_consensus_vsearch	988	T	T	576	6	1%	2	2	93	93	0.015423994364567683	1	1	379	197	3	3	-A
B10_BC22_191109_LF_LIB_consensus_vsearch	989	A	A	587	5	0.84%	2	2	93	93	0.030986176592841308	1	1	380	207	3	2	G
B10_BC22_191109_LF_LIB_consensus_vsearch	990	G	G	593	4	0.67%	2	1	93	93	0.06218579834936829	1	1	384	209	0	4	+T
B10_BC22_191109_LF_LIB_consensus_vsearch	991	T	T	591	6	1%	2	2	93	93	0.015429036211008771	1	1	379	212	3	3	-C
B10_BC22_191109_LF_LIB_consensus_vsearch	992	C	*/-T	576	11	1.85%	2	2	93	93	4.657363845851338E-4	1	1	376	200	4	7	-T
B10_BC22_191109_LF_LIB_consensus_vsearch	993	T	T	580	3	0.51%	2	1	93	93	0.12467811158812642	1	1	375	205	0	3	C
B10_BC22_191109_LF_LIB_consensus_vsearch	994	T	Y	590	7	1.16%	2	2	93	93	0.007675555892850146	1	1	379	211	4	3	C
B10_BC22_191109_LF_LIB_consensus_vsearch	995	A	A	599	1	0.17%	2	1	93	93	0.4999999999990043	1	1	384	215	1	0	C
B10_BC22_191109_LF_LIB_consensus_vsearch	996	A	A	590	5	0.83%	2	2	93	93	0.030987506226370864	1	1	377	213	4	1	-C
B10_BC22_191109_LF_LIB_consensus_vsearch	997	C	C	594	2	0.34%	2	2	93	93	0.24979009235977778	1	1	381	213	1	1	+T
B10_BC22_191109_LF_LIB_consensus_vsearch	998	C	Y	587	8	1.33%	2	2	93	93	0.003814841181091788	1	1	380	207	1	7	T
B10_BC22_191109_LF_LIB_consensus_vsearch	999	A	R	578	10	1.67%	2	2	93	93	9.396067104969792E-4	1	1	365	213	9	1	G
B10_BC22_191109_LF_LIB_consensus_vsearch	1000	T	Y	571	13	2.17%	2	2	93	93	1.1410198610539891E-4	1	1	368	203	11	2	C
B10_BC22_191109_LF_LIB_consensus_vsearch	1001	A	A	591	2	0.34%	2	1	93	93	0.24978902953563295	1	1	381	210	2	0	C
B10_BC22_191109_LF_LIB_consensus_vsearch	1002	A	A	598	3	0.5%	2	1	93	93	0.12468776019987309	1	1	383	215	3	0	G
B10_BC22_191109_LF_LIB_consensus_vsearch	1003	A	R	591	8	1.33%	2	1	93	93	0.0038154482484643428	1	1	378	213	8	0	G
B10_BC22_191109_LF_LIB_consensus_vsearch	1004	C	C	600	2	0.33%	2	2	93	93	0.249792186200784	1	1	386	214	1	1	-T
B10_BC22_191109_LF_LIB_consensus_vsearch	1005	T	Y	591	8	1.33%	2	2	93	93	0.0038154482484643428	1	1	383	208	3	5	C
B10_BC22_191109_LF_LIB_consensus_vsearch	1006	A	A	591	3	0.5%	2	1	93	93	0.12468407750622149	1	1	384	207	0	3	-TG
B10_BC22_191109_LF_LIB_consensus_vsearch	1007	T	T	587	3	0.5%	2	2	93	93	0.12468193384235185	1	1	379	208	2	1	+A
B10_BC22_191109_LF_LIB_consensus_vsearch	1008	G	R	577	10	1.68%	2	2	93	93	9.395444569434851E-4	1	1	370	207	9	1	A
B10_BC22_191109_LF_LIB_consensus_vsearch	1009	C	C	590	2	0.34%	2	1	93	93	0.2497886728654613	1	1	380	210	0	2	+A
B10_BC22_191109_LF_LIB_consensus_vsearch	1010	C	Y	585	10	1.66%	2	2	93	93	9.400366914624269E-4	1	1	379	206	2	8	T
B10_BC22_191109_LF_LIB_consensus_vsearch	1011	G	G	593	4	0.67%	2	2	93	93	0.06218579834936829	1	1	382	211	3	1	A
B10_BC22_191109_LF_LIB_consensus_vsearch	1012	A	*/+C	586	7	1.17%	2	1	93	93	0.007674635299574334	1	1	372	214	7	0	+C
B10_BC22_191109_LF_LIB_consensus_vsearch	1013	C	C	589	5	0.83%	2	1	93	93	0.030987064506852544	1	1	375	214	5	0	+T
B10_BC22_191109_LF_LIB_consensus_vsearch	1014	T	*/+A	559	11	1.83%	2	1	93	93	4.6507410995373774E-4	1	1	348	211	11	0	+A
B10_BC22_191109_LF_LIB_consensus_vsearch	1015	A	*/-G	465	109	18.23%	2	2	93	93	5.298151668129617E-36	1	1	357	108	17	92	-G
B10_BC22_191109_LF_LIB_consensus_vsearch	1016	G	G	478	4	0.83%	2	1	93	93	0.06211079450593869	1	1	367	111	4	0	A
B10_BC22_191109_LF_LIB_consensus_vsearch	1017	G	G	587	6	1.01%	2	2	93	93	0.015427716615850288	1	1	384	203	4	2	A
B10_BC22_191109_LF_LIB_consensus_vsearch	1018	G	G	599	1	0.17%	2	1	93	93	0.4999999999990043	1	1	388	211	0	1	-A
B10_BC22_191109_LF_LIB_consensus_vsearch	1019	A	A	597	1	0.17%	2	1	93	93	0.4999999999999138	1	1	386	211	1	0	+G
B10_BC22_191109_LF_LIB_consensus_vsearch	1020	T	T	593	6	1%	2	1	93	93	0.015429689410799249	1	1	380	213	6	0	+C
B10_BC22_191109_LF_LIB_consensus_vsearch	1021	C	*/-G	582	11	1.83%	2	2	93	93	4.659611953509893E-4	1	1	382	200	1	10	-G
B10_BC22_191109_LF_LIB_consensus_vsearch	1022	G	R	582	7	1.18%	2	1	93	93	0.007673702245629301	1	1	380	202	7	0	A
B10_BC22_191109_LF_LIB_consensus_vsearch	1023	G	G	597	3	0.5%	2	1	93	93	0.12468723936635923	1	1	384	213	3	0	T
B10_BC22_191109_LF_LIB_consensus_vsearch	1024	T	Y	588	7	1.16%	2	1	93	93	0.007675097138165556	1	1	388	200	0	7	C
B10_BC22_191109_LF_LIB_consensus_vsearch	1025	G	G	593	2	0.34%	2	1	93	93	0.24978973927711676	1	1	387	206	0	2	A
B10_BC22_191109_LF_LIB_consensus_vsearch	1026	G	G	596	2	0.33%	2	1	93	93	0.24979079497935539	1	1	384	212	2	0	A
B10_BC22_191109_LF_LIB_consensus_vsearch	1027	A	A	589	6	1%	2	1	93	93	0.015428378627452975	1	1	384	205	0	6	-T
B10_BC22_191109_LF_LIB_consensus_vsearch	1028	T	T	582	4	0.67%	2	1	93	93	0.0621798978595429	1	1	380	202	0	4	C
B10_BC22_191109_LF_LIB_consensus_vsearch	1029	G	R	577	12	2%	2	1	93	93	2.3071056867786312E-4	1	1	367	210	12	0	A
B10_BC22_191109_LF_LIB_consensus_vsearch	1030	T	Y	555	36	6.06%	2	1	93	93	8.399199675591037E-12	1	1	382	173	0	36	C
B10_BC22_191109_LF_LIB_consensus_vsearch	1031	T	T	586	5	0.83%	2	1	93	93	0.030985730383315414	1	1	376	210	5	0	-A
B10_BC22_191109_LF_LIB_consensus_vsearch	1032	A	R	582	9	1.51%	2	2	93	93	0.0018941173119931185	1	1	377	205	4	5	G
B10_BC22_191109_LF_LIB_consensus_vsearch	1033	T	T	587	5	0.83%	2	1	93	93	0.030986176592841308	1	1	378	209	5	0	G
B10_BC22_191109_LF_LIB_consensus_vsearch	1034	T	*/-ATT	576	15	2.49%	2	2	93	93	2.789269415844126E-5	1	1	373	203	5	10	-ATT
B10_BC22_191109_LF_LIB_consensus_vsearch	1035	A	*/-T	497	61	10.5%	2	2	93	93	7.652238494761042E-20	1	1	306	191	51	10	-T
B10_BC22_191109_LF_LIB_consensus_vsearch	1036	T	T	513	5	0.96%	2	2	93	93	0.03094850606322197	1	1	322	191	2	3	C
B10_BC22_191109_LF_LIB_consensus_vsearch	1037	T	T	577	4	0.68%	2	2	93	93	0.06217714192710672	1	1	374	203	3	1	C
B10_BC22_191109_LF_LIB_consensus_vsearch	1038	T	W	581	7	1.16%	2	1	93	93	0.007673467005464533	1	1	367	214	7	0	A
B10_BC22_191109_LF_LIB_consensus_vsearch	1039	T	Y	583	15	2.49%	2	2	93	93	2.792243693155423E-5	1	1	369	214	14	1	C
B10_BC22_191109_LF_LIB_consensus_vsearch	1040	G	G	596	3	0.5%	2	1	93	93	0.1246867167922604	1	1	381	215	3	0	-AC
B10_BC22_191109_LF_LIB_consensus_vsearch	1041	A	R	583	11	1.84%	2	2	93	93	4.65998228714525E-4	1	1	371	212	10	1	G
B10_BC22_191109_LF_LIB_consensus_vsearch	1042	C	C	593	3	0.5%	2	2	93	93	0.12468513853935516	1	1	382	211	2	1	-TC
B10_BC22_191109_LF_LIB_consensus_vsearch	1043	T	*/-C	569	22	3.69%	2	2	93	93	1.9538351813160615E-7	1	1	374	195	8	14	-C
B10_BC22_191109_LF_LIB_consensus_vsearch	1044	C	C	576	1	0.17%	2	1	93	93	0.5000000000008233	1	1	376	200	1	0	+TG
B10_BC22_191109_LF_LIB_consensus_vsearch	1045	C	C	601	1	0.17%	2	1	93	93	0.4999999999990043	1	1	387	214	1	0	A
B10_BC22_191109_LF_LIB_consensus_vsearch	1046	A	A	599	1	0.17%	2	1	93	93	0.4999999999990043	1	1	386	213	1	0	+C
B10_BC22_191109_LF_LIB_consensus_vsearch	1047	T	T	595	3	0.5%	2	1	93	93	0.12468619246852639	1	1	381	214	3	0	C
B10_BC22_191109_LF_LIB_consensus_vsearch	1048	C	C	596	2	0.33%	2	1	93	93	0.24979079497935539	1	1	385	211	0	2	-G
B10_BC22_191109_LF_LIB_consensus_vsearch	1049	G	R	591	8	1.33%	2	2	93	93	0.0038154482484643428	1	1	382	209	6	2	A
B10_BC22_191109_LF_LIB_consensus_vsearch	1050	G	G	595	6	1%	2	2	93	93	0.01543033827052791	1	1	383	212	5	1	A
B10_BC22_191109_LF_LIB_consensus_vsearch	1051	C	*/+T	576	14	2.33%	2	1	93	93	5.645462176707094E-5	1	1	370	206	14	0	+T
B10_BC22_191109_LF_LIB_consensus_vsearch	1052	A	R	569	20	3.34%	2	1	93	93	8.094130352074406E-7	1	1	361	208	20	0	G
B10_BC22_191109_LF_LIB_consensus_vsearch	1053	C	Y	581	7	1.18%	2	1	93	93	0.007673467005464533	1	1	380	201	0	7	T
B10_BC22_191109_LF_LIB_consensus_vsearch	1054	C	*/-T	546	21	3.49%	2	2	93	93	3.9487525801563396E-7	1	1	360	186	9	12	-T
B10_BC22_191109_LF_LIB_consensus_vsearch	1055	T	T	564	2	0.35%	2	1	93	93	0.24977895667588107	1	1	362	202	2	0	A
B10_BC22_191109_LF_LIB_consensus_vsearch	1056	T	Y	569	13	2.21%	2	2	93	93	1.1407523213728538E-4	1	1	357	212	11	2	C
B10_BC22_191109_LF_LIB_consensus_vsearch	1057	A	R	571	21	3.52%	2	2	93	93	3.980890974934442E-7	1	1	358	213	20	1	G
B10_BC22_191109_LF_LIB_consensus_vsearch	1058	C	Y	574	7	1.17%	2	2	93	93	0.007671797729860669	1	1	363	211	6	1	T
B10_BC22_191109_LF_LIB_consensus_vsearch	1059	G	G	589	2	0.34%	2	1	93	93	0.2497883149871952	1	1	374	215	2	0	+A
B10_BC22_191109_LF_LIB_consensus_vsearch	1060	A	*/-GA	503	61	10.23%	2	2	93	93	7.80308897328395E-20	1	1	294	209	60	1	-GA
B10_BC22_191109_LF_LIB_consensus_vsearch	1061	G	*/+A	501	16	3.08%	2	1	93	93	1.356280107073375E-5	1	1	290	211	16	0	+A
B10_BC22_191109_LF_LIB_consensus_vsearch	1062	A	A	525	4	0.75%	2	2	93	93	0.062145390468482414	1	1	317	208	2	2	G
B10_BC22_191109_LF_LIB_consensus_vsearch	1063	A	A	597	1	0.17%	2	1	93	93	0.4999999999999138	1	1	382	215	1	0	+G
B10_BC22_191109_LF_LIB_consensus_vsearch	1064	A	A	595	4	0.66%	2	2	93	93	0.062186847872822006	1	1	384	211	3	1	G
B10_BC22_191109_LF_LIB_consensus_vsearch	1065	T	T	593	3	0.5%	2	2	93	93	0.12468513853935516	1	1	383	210	2	1	-C
B10_BC22_191109_LF_LIB_consensus_vsearch	1066	C	*/-A	566	27	4.5%	2	2	93	93	5.504406649712377E-9	1	1	357	209	24	3	-A
B10_BC22_191109_LF_LIB_consensus_vsearch	1067	A	A	570	3	0.52%	2	2	93	93	0.12467248908296241	1	1	360	210	2	1	G
B10_BC22_191109_LF_LIB_consensus_vsearch	1068	A	A	600	1	0.17%	2	1	93	93	0.4999999999999138	1	1	387	213	1	0	+G
B10_BC22_191109_LF_LIB_consensus_vsearch	1069	A	A	601	1	0.17%	2	1	93	93	0.4999999999990043	1	1	386	215	1	0	+G
B10_BC22_191109_LF_LIB_consensus_vsearch	1070	G	*/-T	382	186	30.85%	2	2	93	93	1.2490532980596042E-64	1	1	193	189	164	22	-T
B10_BC22_191109_LF_LIB_consensus_vsearch	1071	T	T	413	1	0.24%	2	1	93	93	0.5000000000008233	1	1	223	190	0	1	C
B10_BC22_191109_LF_LIB_consensus_vsearch	1072	T	T	597	4	0.67%	2	1	93	93	0.062187890408182296	1	1	388	209	0	4	C
B10_BC22_191109_LF_LIB_consensus_vsearch	1073	T	T	600	1	0.17%	2	1	93	93	0.4999999999999138	1	1	388	212	0	1	+C
B10_BC22_191109_LF_LIB_consensus_vsearch	1074	T	T	599	1	0.17%	2	1	93	93	0.4999999999990043	1	1	388	211	0	1	+C
B10_BC22_191109_LF_LIB_consensus_vsearch	1075	T	*/-G	574	15	2.49%	2	2	93	93	2.7884070676335E-5	1	1	381	193	2	13	-G
B10_BC22_191109_LF_LIB_consensus_vsearch	1076	G	R	574	8	1.37%	2	2	93	93	0.0038128109095927364	1	1	378	196	7	1	A
B10_BC22_191109_LF_LIB_consensus_vsearch	1077	G	G	591	6	1%	2	1	93	93	0.015429036211008771	1	1	381	210	6	0	+A
B10_BC22_191109_LF_LIB_consensus_vsearch	1078	G	G	595	4	0.66%	2	1	93	93	0.062186847872822006	1	1	384	211	0	4	-T
B10_BC22_191109_LF_LIB_consensus_vsearch	1079	T	T	592	6	1%	2	2	93	93	0.01542936335614873	1	1	385	207	2	4	C
B10_BC22_191109_LF_LIB_consensus_vsearch	1080	T	T	597	3	0.5%	2	1	93	93	0.12468723936635923	1	1	386	211	0	3	C
B10_BC22_191109_LF_LIB_consensus_vsearch	1081	C	C	592	3	0.5%	2	1	93	93	0.1246846089151382	1	1	382	210	0	3	+T
B10_BC22_191109_LF_LIB_consensus_vsearch	1082	T	*/-G	356	147	24.5%	2	2	93	93	1.99429482893698E-50	1	1	232	124	95	52	-G
B10_BC22_191109_LF_LIB_consensus_vsearch	1083	G	G	398	4	0.99%	2	1	93	93	0.06203329275530562	1	1	249	149	0	4	T
B10_BC22_191109_LF_LIB_consensus_vsearch	1084	G	G	551	1	0.18%	2	1	93	93	0.4999999999990043	1	1	345	206	1	0	+A
B10_BC22_191109_LF_LIB_consensus_vsearch	1085	G	G	585	4	0.67%	2	2	93	93	0.06218152895025356	1	1	371	214	3	1	A
B10_BC22_191109_LF_LIB_consensus_vsearch	1086	G	R	585	11	1.83%	2	1	93	93	4.6607192805233423E-4	1	1	371	214	11	0	A
B10_BC22_191109_LF_LIB_consensus_vsearch	1087	G	R	408	105	17.41%	2	1	93	93	6.502189440305915E-35	1	1	198	210	105	0	A
B10_BC22_191109_LF_LIB_consensus_vsearch	1088	A	*/-G	565	17	2.88%	2	1	93	93	6.776670548088378E-6	1	1	357	208	17	0	-G
B10_BC22_191109_LF_LIB_consensus_vsearch	1089	G	R	519	43	7.43%	2	1	93	93	4.931761655672432E-14	1	1	312	207	43	0	A
B10_BC22_191109_LF_LIB_consensus_vsearch	1090	T	T	584	5	0.83%	2	2	93	93	0.030984833420659205	1	1	378	206	3	2	A
B10_BC22_191109_LF_LIB_consensus_vsearch	1091	A	A	595	2	0.33%	2	1	93	93	0.24979044425840527	1	1	384	211	2	0	G
B10_BC22_191109_LF_LIB_consensus_vsearch	1092	T	T	588	5	0.83%	2	2	93	93	0.0309866212982286	1	1	383	205	1	4	-G
B10_BC22_191109_LF_LIB_consensus_vsearch	1093	G	G	586	4	0.67%	2	2	93	93	0.062182068959449006	1	1	380	206	3	1	A
B10_BC22_191109_LF_LIB_consensus_vsearch	1094	G	G	591	6	1%	2	2	93	93	0.015429036211008771	1	1	383	208	2	4	A
B10_BC22_191109_LF_LIB_consensus_vsearch	1095	T	T	583	5	0.83%	2	2	93	93	0.030984382652161722	1	1	377	206	2	3	-C
B10_BC22_191109_LF_LIB_consensus_vsearch	1096	C	*/+A	576	8	1.34%	2	2	93	93	0.0038131291090651434	1	1	371	205	6	2	+A
B10_BC22_191109_LF_LIB_consensus_vsearch	1097	G	R	573	13	2.18%	2	2	93	93	1.1412856168272655E-4	1	1	364	209	11	2	A
B10_BC22_191109_LF_LIB_consensus_vsearch	1098	C	*/+A	561	14	2.34%	2	2	93	93	5.633847946619086E-5	1	1	352	209	11	3	+A
B10_BC22_191109_LF_LIB_consensus_vsearch	1099	A	A	587	3	0.51%	2	1	93	93	0.12468193384235185	1	1	372	215	3	0	G
B10_BC22_191109_LF_LIB_consensus_vsearch	1100	A	A	594	4	0.66%	2	1	93	93	0.062186323989038686	1	1	381	213	4	0	G
B10_BC22_191109_LF_LIB_consensus_vsearch	1101	G	G	596	4	0.67%	2	2	93	93	0.062187370009836374	1	1	384	212	2	2	A
B10_BC22_191109_LF_LIB_consensus_vsearch	1102	G	G	599	1	0.17%	2	1	93	93	0.4999999999990043	1	1	384	215	1	0	+A
B10_BC22_191109_LF_LIB_consensus_vsearch	1103	C	Y	584	12	1.99%	2	2	93	93	2.3086543430195892E-4	1	1	381	203	2	10	T
B10_BC22_191109_LF_LIB_consensus_vsearch	1104	T	*/+G	585	8	1.33%	2	2	93	93	0.0038145345933480535	1	1	377	208	4	4	+G
B10_BC22_191109_LF_LIB_consensus_vsearch	1105	G	*/-A	588	7	1.16%	2	2	93	93	0.007675097138165556	1	1	382	206	3	4	-A
B10_BC22_191109_LF_LIB_consensus_vsearch	1106	A	A	591	4	0.67%	2	2	93	93	0.06218474176725347	1	1	382	209	2	2	G
B10_BC22_191109_LF_LIB_consensus_vsearch	1107	A	A	599	3	0.5%	2	1	93	93	0.12468827930162561	1	1	384	215	3	0	G
B10_BC22_191109_LF_LIB_consensus_vsearch	1108	A	R	568	33	5.47%	2	2	93	93	7.411597801770009E-11	1	1	354	214	32	1	G
B10_BC22_191109_LF_LIB_consensus_vsearch	1109	C	*/-T	556	17	2.82%	2	2	93	93	6.763881916699506E-6	1	1	354	202	5	12	-T
B10_BC22_191109_LF_LIB_consensus_vsearch	1110	T	Y	544	10	1.79%	2	2	93	93	9.373655173650468E-4	1	1	344	200	7	3	C
B10_BC22_191109_LF_LIB_consensus_vsearch	1111	T	*/+A	522	17	2.96%	2	2	93	93	6.71190474743033E-6	1	1	312	210	15	2	+A
B10_BC22_191109_LF_LIB_consensus_vsearch	1112	A	A	570	2	0.35%	2	1	93	93	0.2497812773401183	1	1	355	215	2	0	+C
B10_BC22_191109_LF_LIB_consensus_vsearch	1113	A	A	597	1	0.17%	2	1	93	93	0.4999999999999138	1	1	382	215	1	0	G
B10_BC22_191109_LF_LIB_consensus_vsearch	1114	A	*/+G	569	11	1.83%	2	1	93	93	4.654683146367026E-4	1	1	357	212	11	0	+G
B10_BC22_191109_LF_LIB_consensus_vsearch	1115	G	*/-A	571	10	1.71%	2	2	93	93	9.391664866947025E-4	1	1	360	211	8	2	-A
B10_BC22_191109_LF_LIB_consensus_vsearch	1116	A	A	570	3	0.52%	2	1	93	93	0.12467248908296241	1	1	360	210	3	0	+G
B10_BC22_191109_LF_LIB_consensus_vsearch	1117	A	A	591	4	0.67%	2	1	93	93	0.06218474176725347	1	1	377	214	4	0	G
B10_BC22_191109_LF_LIB_consensus_vsearch	1118	A	A	593	6	1%	2	2	93	93	0.015429689410799249	1	1	383	210	2	4	G
B10_BC22_191109_LF_LIB_consensus_vsearch	1119	T	K	588	13	2.16%	2	1	93	93	1.1432236795092524E-4	1	1	375	213	13	0	G
B10_BC22_191109_LF_LIB_consensus_vsearch	1120	T	*/+C	586	7	1.16%	2	1	93	93	0.007674635299574334	1	1	386	200	0	7	+C
B10_BC22_191109_LF_LIB_consensus_vsearch	1121	G	G	600	1	0.17%	2	1	93	93	0.4999999999999138	1	1	386	214	0	1	+T
B10_BC22_191109_LF_LIB_consensus_vsearch	1122	A	A	592	4	0.66%	2	2	93	93	0.06218527094514562	1	1	381	211	3	1	G
B10_BC22_191109_LF_LIB_consensus_vsearch	1123	C	*/-G	575	7	1.16%	2	2	93	93	0.007672038647635164	1	1	371	204	4	3	-G
B10_BC22_191109_LF_LIB_consensus_vsearch	1124	G	G	590	1	0.17%	2	1	93	93	0.5000000000008233	1	1	378	212	1	0	A
B10_BC22_191109_LF_LIB_consensus_vsearch	1125	G	*/+A	572	12	2%	2	1	93	93	2.3059772017075368E-4	1	1	360	212	12	0	+A
B10_BC22_191109_LF_LIB_consensus_vsearch	1126	A	A	586	1	0.17%	2	1	93	93	0.4999999999999138	1	1	372	214	1	0	C
B10_BC22_191109_LF_LIB_consensus_vsearch	1127	A	*/-G	553	20	3.34%	2	2	93	93	8.056503478234861E-7	1	1	351	202	9	11	-G
B10_BC22_191109_LF_LIB_consensus_vsearch	1128	G	*/+A	539	18	3.13%	2	1	93	93	3.3178617815960446E-6	1	1	341	198	18	0	+A
B10_BC22_191109_LF_LIB_consensus_vsearch	1129	G	*/+A	574	15	2.52%	2	2	93	93	2.7884070676335E-5	1	1	361	213	14	1	+A
B10_BC22_191109_LF_LIB_consensus_vsearch	1130	G	G	596	3	0.5%	2	1	93	93	0.1246867167922604	1	1	382	214	3	0	-C
B10_BC22_191109_LF_LIB_consensus_vsearch	1131	C	C	592	3	0.5%	2	1	93	93	0.1246846089151382	1	1	381	211	0	3	+A
B10_BC22_191109_LF_LIB_consensus_vsearch	1132	A	A	588	6	1%	2	2	93	93	0.015428048177952706	1	1	378	210	5	1	T
B10_BC22_191109_LF_LIB_consensus_vsearch	1133	C	C	592	4	0.67%	2	2	93	93	0.06218527094514562	1	1	380	212	3	1	T
B10_BC22_191109_LF_LIB_consensus_vsearch	1134	C	*/-A	573	11	1.82%	2	1	93	93	4.656222726659411E-4	1	1	370	203	11	0	-A
B10_BC22_191109_LF_LIB_consensus_vsearch	1135	A	*/-CCA	568	8	1.37%	2	2	93	93	0.003811843128951762	1	1	360	208	3	5	-CCA
B10_BC22_191109_LF_LIB_consensus_vsearch	1136	C	Y	556	10	1.71%	2	1	93	93	9.381869124860784E-4	1	1	365	191	0	10	T
B10_BC22_191109_LF_LIB_consensus_vsearch	1137	C	Y	554	33	5.55%	2	2	93	93	7.329940356389606E-11	1	1	373	181	7	26	T
B10_BC22_191109_LF_LIB_consensus_vsearch	1138	A	R	561	20	3.37%	2	1	93	93	8.075558512578247E-7	1	1	359	202	20	0	G
B10_BC22_191109_LF_LIB_consensus_vsearch	1139	G	G	590	3	0.5%	2	1	93	93	0.12468354430400949	1	1	379	211	3	0	+A
B10_BC22_191109_LF_LIB_consensus_vsearch	1140	G	G	595	4	0.66%	2	1	93	93	0.062186847872822006	1	1	387	208	0	4	-CG
B10_BC22_191109_LF_LIB_consensus_vsearch	1141	C	C	581	4	0.67%	2	1	93	93	0.062179350443499135	1	1	376	205	0	4	T
B10_BC22_191109_LF_LIB_consensus_vsearch	1142	G	*/-TG	551	34	5.7%	2	1	93	93	3.552813140888366E-11	1	1	381	170	0	34	-TG
B10_BC22_191109_LF_LIB_consensus_vsearch	1143	T	*/+G	538	13	2.3%	2	2	93	93	1.136363211850464E-4	1	1	377	161	4	9	+G
B10_BC22_191109_LF_LIB_consensus_vsearch	1144	G	G	556	5	0.89%	2	1	93	93	0.03097160472858764	1	1	380	176	5	0	A
B10_BC22_191109_LF_LIB_consensus_vsearch	1145	G	*/-A	586	14	2.32%	2	1	93	93	5.652891210314472E-5	1	1	372	214	14	0	-A
B10_BC22_191109_LF_LIB_consensus_vsearch	1146	A	A	577	5	0.85%	2	1	93	93	0.030981645525998008	1	1	362	215	5	0	-G
B10_BC22_191109_LF_LIB_consensus_vsearch	1147	G	G	583	4	0.67%	2	1	93	93	0.06218044340963991	1	1	372	211	4	0	A
B10_BC22_191109_LF_LIB_consensus_vsearch	1148	C	C	595	2	0.33%	2	1	93	93	0.24979044425840527	1	1	383	212	0	2	+T
B10_BC22_191109_LF_LIB_consensus_vsearch	1149	C	C	588	3	0.5%	2	1	93	93	0.12468247248078299	1	1	382	206	0	3	+T
B10_BC22_191109_LF_LIB_consensus_vsearch	1150	T	Y	582	10	1.67%	2	2	93	93	9.398536450879837E-4	1	1	382	200	4	6	C
B10_BC22_191109_LF_LIB_consensus_vsearch	1151	G	G	592	3	0.5%	2	2	93	93	0.1246846089151382	1	1	385	207	2	1	+C
B10_BC22_191109_LF_LIB_consensus_vsearch	1152	C	S	562	11	1.83%	2	1	93	93	4.6519379419598136E-4	1	1	372	190	0	11	G
B10_BC22_191109_LF_LIB_consensus_vsearch	1153	G	R	547	33	5.55%	2	1	93	93	7.287945041975721E-11	1	1	344	203	33	0	A
B10_BC22_191109_LF_LIB_consensus_vsearch	1154	G	G	590	5	0.83%	2	2	93	93	0.030987506226370864	1	1	378	212	4	1	A
B10_BC22_191109_LF_LIB_consensus_vsearch	1155	C	*/-TT	477	88	14.72%	2	2	93	93	8.180480226114033E-29	1	1	277	200	87	1	-TT
B10_BC22_191109_LF_LIB_consensus_vsearch	1156	T	Y	483	7	1.42%	2	2	93	93	0.007645775038504135	1	1	273	210	6	1	C
B10_BC22_191109_LF_LIB_consensus_vsearch	1157	T	*/-A	451	28	5.49%	2	2	93	93	2.481473539681886E-9	1	1	244	207	26	2	-A
B10_BC22_191109_LF_LIB_consensus_vsearch	1158	A	A	543	3	0.55%	2	2	93	93	0.12465627864354664	1	1	334	209	2	1	+G
B10_BC22_191109_LF_LIB_consensus_vsearch	1159	A	*/-T	551	22	3.78%	2	2	93	93	1.9414217689001658E-7	1	1	339	212	21	1	-T
B10_BC22_191109_LF_LIB_consensus_vsearch	1160	T	K	545	23	4%	2	1	93	93	9.497880655335579E-8	1	1	337	208	23	0	G
B10_BC22_191109_LF_LIB_consensus_vsearch	1161	T	K	552	35	5.85%	2	1	93	93	1.7264135703207897E-11	1	1	345	207	35	0	G
B10_BC22_191109_LF_LIB_consensus_vsearch	1162	T	Y	584	10	1.66%	2	2	93	93	9.39975879151716E-4	1	1	380	204	4	6	C
B10_BC22_191109_LF_LIB_consensus_vsearch	1163	G	G	594	3	0.5%	2	2	93	93	0.12468566638724124	1	1	383	211	1	2	-A
B10_BC22_191109_LF_LIB_consensus_vsearch	1164	A	*/+C	582	8	1.33%	2	1	93	93	0.00381407083625578	1	1	379	203	0	8	+C
B10_BC22_191109_LF_LIB_consensus_vsearch	1165	C	C	595	4	0.67%	2	2	93	93	0.062186847872822006	1	1	384	211	2	2	-T
B10_BC22_191109_LF_LIB_consensus_vsearch	1166	T	*/+C	574	9	1.5%	2	2	93	93	0.0018933142585401675	1	1	377	197	3	6	+C
B10_BC22_191109_LF_LIB_consensus_vsearch	1167	C	C	586	3	0.51%	2	2	93	93	0.12468139337307069	1	1	380	206	2	1	T
B10_BC22_191109_LF_LIB_consensus_vsearch	1168	A	A	595	1	0.17%	2	1	93	93	0.4999999999999138	1	1	383	212	1	0	C
B10_BC22_191109_LF_LIB_consensus_vsearch	1169	A	R	583	14	2.33%	2	2	93	93	5.650687914175413E-5	1	1	373	210	13	1	G
B10_BC22_191109_LF_LIB_consensus_vsearch	1170	C	C	587	3	0.5%	2	1	93	93	0.12468193384235185	1	1	376	211	3	0	-A
B10_BC22_191109_LF_LIB_consensus_vsearch	1171	A	W	569	9	1.52%	2	1	93	93	0.0018928011559758858	1	1	361	208	9	0	T
B10_BC22_191109_LF_LIB_consensus_vsearch	1172	C	*/-G	52	281	47.63%	2	2	93	93	9.862026952850573E-135	1	1	39	13	138	143	-G
B10_BC22_191109_LF_LIB_consensus_vsearch	1173	G	*/+C	49	7	10%	2	1	93	93	0.0064016258391640735	1	1	35	14	7	0	+C
B10_BC22_191109_LF_LIB_consensus_vsearch	1174	G	R	327	14	3.97%	2	1	93	93	5.326690455636738E-5	1	1	170	157	14	0	A
B10_BC22_191109_LF_LIB_consensus_vsearch	1175	G	G	545	3	0.54%	2	1	93	93	0.12465753424651009	1	1	334	211	3	0	A
B10_BC22_191109_LF_LIB_consensus_vsearch	1176	G	G	585	3	0.51%	2	2	93	93	0.1246808510636648	1	1	376	209	2	1	A
B10_BC22_191109_LF_LIB_consensus_vsearch	1177	G	*/-A	583	7	1.17%	2	2	93	93	0.007673936691127849	1	1	380	203	2	5	-A
B10_BC22_191109_LF_LIB_consensus_vsearch	1178	A	A	591	0	0%	2	0	93	0	1.0	1	0	382	209	0	0	
B10_BC22_191109_LF_LIB_consensus_vsearch	1179	A	A	594	3	0.5%	2	2	93	93	0.12468566638724124	1	1	381	213	2	1	G
B10_BC22_191109_LF_LIB_consensus_vsearch	1180	A	R	584	8	1.33%	2	1	93	93	0.0038143805269862142	1	1	376	208	8	0	G
B10_BC22_191109_LF_LIB_consensus_vsearch	1181	C	C	588	6	1%	2	1	93	93	0.015428048177952706	1	1	385	203	0	6	+T
B10_BC22_191109_LF_LIB_consensus_vsearch	1182	T	Y	583	7	1.17%	2	2	93	93	0.007673936691127849	1	1	381	202	3	4	C
B10_BC22_191109_LF_LIB_consensus_vsearch	1183	C	+A/+A	32	547	91.32%	2	2	93	93	2.5801617967051206E-294	1	1	27	5	343	204	+A
B10_BC22_191109_LF_LIB_consensus_vsearch	1184	C	M	562	19	3.16%	2	2	93	93	1.6424134127886282E-6	1	1	360	202	16	3	A
B10_BC22_191109_LF_LIB_consensus_vsearch	1185	C	C	585	4	0.66%	2	2	93	93	0.06218152895025356	1	1	375	210	2	2	-A
B10_BC22_191109_LF_LIB_consensus_vsearch	1186	A	R	560	24	4.01%	2	1	93	93	4.683183782910104E-8	1	1	353	207	24	0	G
B10_BC22_191109_LF_LIB_consensus_vsearch	1187	G	G	589	5	0.84%	2	1	93	93	0.030987064506852544	1	1	378	211	5	0	+A
B10_BC22_191109_LF_LIB_consensus_vsearch	1188	G	G	598	4	0.66%	2	2	93	93	0.06218840907720501	1	1	384	214	3	1	A
B10_BC22_191109_LF_LIB_consensus_vsearch	1189	T	*/-C	513	83	13.79%	2	2	93	93	4.7999341657375625E-27	1	1	302	211	82	1	-C
B10_BC22_191109_LF_LIB_consensus_vsearch	1190	C	C	517	2	0.38%	2	1	93	93	0.24975891996195723	1	1	304	213	2	0	+G
B10_BC22_191109_LF_LIB_consensus_vsearch	1191	C	C	591	5	0.83%	2	1	93	93	0.030987946464272845	1	1	376	215	5	0	G
B10_BC22_191109_LF_LIB_consensus_vsearch	1192	A	*/-G	578	11	1.83%	2	1	93	93	4.658118229180549E-4	1	1	369	209	11	0	-G
B10_BC22_191109_LF_LIB_consensus_vsearch	1193	G	G	583	3	0.51%	2	2	93	93	0.12467976088783492	1	1	372	211	2	1	-A
B10_BC22_191109_LF_LIB_consensus_vsearch	1194	A	A	590	3	0.5%	2	1	93	93	0.12468354430400949	1	1	378	212	3	0	-C
B10_BC22_191109_LF_LIB_consensus_vsearch	1195	C	C	591	2	0.33%	2	1	93	93	0.24978902953563295	1	1	378	213	2	0	+T
B10_BC22_191109_LF_LIB_consensus_vsearch	1196	A	A	592	3	0.5%	2	2	93	93	0.1246846089151382	1	1	381	211	2	1	-CA
B10_BC22_191109_LF_LIB_consensus_vsearch	1197	C	*/-A	571	11	1.84%	2	2	93	93	4.655455542392171E-4	1	1	364	207	8	3	-A
B10_BC22_191109_LF_LIB_consensus_vsearch	1198	A	A	572	6	1.02%	2	2	93	93	0.015422605753746292	1	1	366	206	4	2	G
B10_BC22_191109_LF_LIB_consensus_vsearch	1199	A	A	591	3	0.5%	2	1	93	93	0.12468407750622149	1	1	380	211	3	0	C
B10_BC22_191109_LF_LIB_consensus_vsearch	1200	G	G	590	3	0.5%	2	1	93	93	0.12468354430400949	1	1	380	210	3	0	A
B10_BC22_191109_LF_LIB_consensus_vsearch	1201	T	T	591	3	0.5%	2	1	93	93	0.12468407750622149	1	1	383	208	3	0	-AG
B10_BC22_191109_LF_LIB_consensus_vsearch	1202	A	*/+G	557	22	3.67%	2	1	93	93	1.9456380897049484E-7	1	1	381	176	0	22	+G
B10_BC22_191109_LF_LIB_consensus_vsearch	1203	G	R	564	13	2.23%	2	2	93	93	1.1400755487644202E-4	1	1	370	194	12	1	A
B10_BC22_191109_LF_LIB_consensus_vsearch	1204	G	*/-A	583	17	2.82%	2	1	93	93	6.801147833448181E-6	1	1	370	213	17	0	-A
B10_BC22_191109_LF_LIB_consensus_vsearch	1205	A	A	576	4	0.68%	2	2	93	93	0.0621765850361776	1	1	365	211	2	2	+T
B10_BC22_191109_LF_LIB_consensus_vsearch	1206	T	T	594	2	0.33%	2	1	93	93	0.24979009235977778	1	1	381	213	2	0	C
B10_BC22_191109_LF_LIB_consensus_vsearch	1207	T	T	592	4	0.66%	2	2	93	93	0.06218527094514562	1	1	384	208	3	1	C
B10_BC22_191109_LF_LIB_consensus_vsearch	1208	G	G	598	2	0.33%	2	1	93	93	0.24979149291046765	1	1	386	212	2	0	+A
B10_BC22_191109_LF_LIB_consensus_vsearch	1209	A	A	590	5	0.83%	2	2	93	93	0.030987506226370864	1	1	380	210	4	1	G
B10_BC22_191109_LF_LIB_consensus_vsearch	1210	C	C	593	3	0.5%	2	2	93	93	0.12468513853935516	1	1	384	209	1	2	T
B10_BC22_191109_LF_LIB_consensus_vsearch	1211	A	A	589	6	1%	2	2	93	93	0.015428378627452975	1	1	380	209	4	2	G
B10_BC22_191109_LF_LIB_consensus_vsearch	1212	G	G	595	4	0.66%	2	1	93	93	0.062186847872822006	1	1	383	212	4	0	-A
B10_BC22_191109_LF_LIB_consensus_vsearch	1213	A	A	592	4	0.67%	2	1	93	93	0.06218527094514562	1	1	379	213	4	0	G
B10_BC22_191109_LF_LIB_consensus_vsearch	1214	T	T	594	3	0.5%	2	1	93	93	0.12468566638724124	1	1	382	212	3	0	G
B10_BC22_191109_LF_LIB_consensus_vsearch	1215	T	*/+G	562	23	3.82%	2	2	93	93	9.562050648761614E-8	1	1	370	192	1	22	+G
B10_BC22_191109_LF_LIB_consensus_vsearch	1216	G	G	590	2	0.34%	2	2	93	93	0.2497886728654613	1	1	376	214	1	1	-A
B10_BC22_191109_LF_LIB_consensus_vsearch	1217	A	*/+G	578	13	2.16%	2	1	93	93	1.1419423177491619E-4	1	1	364	214	13	0	+G
B10_BC22_191109_LF_LIB_consensus_vsearch	1218	G	*/-AG	517	63	10.54%	2	2	93	93	1.8275348423825053E-20	1	1	311	206	57	6	-AG
B10_BC22_191109_LF_LIB_consensus_vsearch	1219	A	A	524	3	0.56%	2	1	93	93	0.12464387464392387	1	1	318	206	3	0	-G
B10_BC22_191109_LF_LIB_consensus_vsearch	1220	G	*/+C	518	11	2.06%	2	1	93	93	4.633046086710839E-4	1	1	324	194	0	11	+C
B10_BC22_191109_LF_LIB_consensus_vsearch	1221	C	C	590	5	0.83%	2	2	93	93	0.030987506226370864	1	1	384	206	1	4	-T
B10_BC22_191109_LF_LIB_consensus_vsearch	1222	T	T	583	6	1.01%	2	2	93	93	0.015426379128433065	1	1	383	200	2	4	C
B10_BC22_191109_LF_LIB_consensus_vsearch	1223	C	*/+T	517	33	5.53%	2	2	93	93	7.098540293732135E-11	1	1	380	137	4	29	+T
B10_BC22_191109_LF_LIB_consensus_vsearch	1224	T	T	568	5	0.87%	2	2	93	93	0.03097743240611924	1	1	383	185	3	2	C
B10_BC22_191109_LF_LIB_consensus_vsearch	1225	T	T	597	3	0.5%	2	1	93	93	0.12468723936635923	1	1	387	210	0	3	+C
B10_BC22_191109_LF_LIB_consensus_vsearch	1226	T	*/-C	586	9	1.49%	2	1	93	93	0.0018945108065208946	1	1	382	204	0	9	-C
B10_BC22_191109_LF_LIB_consensus_vsearch	1227	C	*/-T	545	24	4.05%	2	2	93	93	4.6528755717029375E-8	1	1	384	161	1	23	-T
B10_BC22_191109_LF_LIB_consensus_vsearch	1228	T	T	557	5	0.88%	2	1	93	93	0.030972099869438472	1	1	381	176	0	5	+C
B10_BC22_191109_LF_LIB_consensus_vsearch	1229	T	*/+G	574	7	1.18%	2	1	93	93	0.007671797729860669	1	1	384	190	0	7	+G
B10_BC22_191109_LF_LIB_consensus_vsearch	1230	G	G	596	3	0.5%	2	1	93	93	0.1246867167922604	1	1	383	213	3	0	-A
B10_BC22_191109_LF_LIB_consensus_vsearch	1231	A	*/-T	542	25	4.18%	2	2	93	93	2.2741065425231576E-8	1	1	341	201	23	2	-T
B10_BC22_191109_LF_LIB_consensus_vsearch	1232	T	T	574	1	0.17%	2	1	93	93	0.5000000000008233	1	1	361	213	1	0	+GAT
B10_BC22_191109_LF_LIB_consensus_vsearch	1233	T	T	599	2	0.33%	2	1	93	93	0.24979184013288794	1	1	385	214	2	0	C
B10_BC22_191109_LF_LIB_consensus_vsearch	1234	T	T	603	0	0%	2	0	93	0	1.0	1	0	388	215	0	0	
B10_BC22_191109_LF_LIB_consensus_vsearch	1235	T	T	594	2	0.33%	2	2	93	93	0.24979009235977778	1	1	384	210	1	1	+A
B10_BC22_191109_LF_LIB_consensus_vsearch	1236	G	G	595	3	0.5%	2	2	93	93	0.12468619246852639	1	1	385	210	1	2	-T
B10_BC22_191109_LF_LIB_consensus_vsearch	1237	T	*/-G	562	20	3.36%	2	2	93	93	8.077906037109274E-7	1	1	370	192	13	7	-G
B10_BC22_191109_LF_LIB_consensus_vsearch	1238	G	R	561	15	2.6%	2	2	93	93	2.782660779890985E-5	1	1	363	198	10	5	A
B10_BC22_191109_LF_LIB_consensus_vsearch	1239	G	G	589	6	1%	2	1	93	93	0.015428378627452975	1	1	382	207	6	0	+A
B10_BC22_191109_LF_LIB_consensus_vsearch	1240	G	G	595	3	0.5%	2	2	93	93	0.12468619246852639	1	1	385	210	1	2	-TG
B10_BC22_191109_LF_LIB_consensus_vsearch	1241	T	T	588	4	0.67%	2	1	93	93	0.06218314350277022	1	1	384	204	0	4	-G
B10_BC22_191109_LF_LIB_consensus_vsearch	1242	G	G	589	4	0.67%	2	2	93	93	0.06218367805512527	1	1	382	207	3	1	A
B10_BC22_191109_LF_LIB_consensus_vsearch	1243	G	G	599	1	0.17%	2	1	93	93	0.4999999999990043	1	1	386	213	0	1	+C
B10_BC22_191109_LF_LIB_consensus_vsearch	1244	T	*/-GGT	578	11	1.83%	2	2	93	93	4.658118229180549E-4	1	1	379	199	4	7	-GGT
B10_BC22_191109_LF_LIB_consensus_vsearch	1245	G	G	581	4	0.68%	2	2	93	93	0.062179350443499135	1	1	380	201	1	3	A
B10_BC22_191109_LF_LIB_consensus_vsearch	1246	G	*/-TG	576	11	1.86%	2	1	93	93	4.657363845851338E-4	1	1	380	196	0	11	-TG
B10_BC22_191109_LF_LIB_consensus_vsearch	1247	T	T	568	4	0.69%	2	1	93	93	0.062172059780916195	1	1	380	188	0	4	-GC
B10_BC22_191109_LF_LIB_consensus_vsearch	1248	G	G	579	3	0.51%	2	1	93	93	0.12467755803936205	1	1	383	196	3	0	-CA
B10_BC22_191109_LF_LIB_consensus_vsearch	1249	C	Y	581	7	1.18%	2	2	93	93	0.007673467005464533	1	1	378	203	2	5	T
B10_BC22_191109_LF_LIB_consensus_vsearch	1250	A	A	581	6	1.01%	2	2	93	93	0.015425703561055139	1	1	374	207	3	3	G
B10_BC22_191109_LF_LIB_consensus_vsearch	1251	T	T	580	4	0.67%	2	1	93	93	0.06217880115194425	1	1	380	200	0	4	+G
B10_BC22_191109_LF_LIB_consensus_vsearch	1252	G	R	579	9	1.52%	2	2	93	93	0.0018938187066465067	1	1	375	204	8	1	A
B10_BC22_191109_LF_LIB_consensus_vsearch	1253	G	*/+C	580	9	1.5%	2	1	93	93	0.001893918576967777	1	1	371	209	9	0	+C
B10_BC22_191109_LF_LIB_consensus_vsearch	1254	C	Y	579	10	1.68%	2	2	93	93	9.396687550389984E-4	1	1	379	200	1	9	T
B10_BC22_191109_LF_LIB_consensus_vsearch	1255	C	C	591	4	0.66%	2	1	93	93	0.06218474176725347	1	1	385	206	0	4	T
B10_BC22_191109_LF_LIB_consensus_vsearch	1256	G	*/+T	584	10	1.67%	2	1	93	93	9.39975879151716E-4	1	1	374	210	10	0	+T
B10_BC22_191109_LF_LIB_consensus_vsearch	1257	T	T	594	4	0.66%	2	1	93	93	0.062186323989038686	1	1	387	207	0	4	C
B10_BC22_191109_LF_LIB_consensus_vsearch	1258	T	T	586	3	0.5%	2	2	93	93	0.12468139337307069	1	1	378	208	2	1	+GTT
B10_BC22_191109_LF_LIB_consensus_vsearch	1259	C	*/-T	587	8	1.34%	2	2	93	93	0.003814841181091788	1	1	385	202	1	7	-T
B10_BC22_191109_LF_LIB_consensus_vsearch	1260	T	T	585	4	0.68%	2	2	93	93	0.06218152895025356	1	1	382	203	3	1	C
B10_BC22_191109_LF_LIB_consensus_vsearch	1261	T	T	590	4	0.67%	2	2	93	93	0.062184210806914414	1	1	381	209	3	1	C
B10_BC22_191109_LF_LIB_consensus_vsearch	1262	A	R	575	19	3.17%	2	2	93	93	1.647883484990673E-6	1	1	366	209	18	1	G
B10_BC22_191109_LF_LIB_consensus_vsearch	1263	G	G	588	4	0.67%	2	1	93	93	0.06218314350277022	1	1	378	210	4	0	+A
B10_BC22_191109_LF_LIB_consensus_vsearch	1264	T	Y	591	8	1.33%	2	2	93	93	0.0038154482484643428	1	1	384	207	1	7	C
B10_BC22_191109_LF_LIB_consensus_vsearch	1265	T	T	587	6	1%	2	1	93	93	0.015427716615850288	1	1	379	208	0	6	-G
B10_BC22_191109_LF_LIB_consensus_vsearch	1266	G	G	582	5	0.84%	2	1	93	93	0.030983930348565846	1	1	373	209	5	0	A
B10_BC22_191109_LF_LIB_consensus_vsearch	1267	G	G	594	5	0.83%	2	2	93	93	0.03098925836211217	1	1	386	208	1	4	A
B10_BC22_191109_LF_LIB_consensus_vsearch	1268	T	*/+G	574	10	1.66%	2	2	93	93	9.393564316164558E-4	1	1	379	195	2	8	+G
B10_BC22_191109_LF_LIB_consensus_vsearch	1269	G	G	587	5	0.84%	2	2	93	93	0.030986176592841308	1	1	379	208	3	2	A
B10_BC22_191109_LF_LIB_consensus_vsearch	1270	G	*/-A	553	38	6.31%	2	2	93	93	1.968115354143208E-12	1	1	341	212	37	1	-A
B10_BC22_191109_LF_LIB_consensus_vsearch	1271	A	A	554	3	0.53%	2	1	93	93	0.12466307277640029	1	1	343	211	3	0	-G
B10_BC22_191109_LF_LIB_consensus_vsearch	1272	G	*/-T	574	19	3.18%	2	2	93	93	1.64747072722603E-6	1	1	381	193	1	18	-T
B10_BC22_191109_LF_LIB_consensus_vsearch	1273	T	*/+G	561	9	1.54%	2	1	93	93	0.0018919616270182597	1	1	381	180	0	9	+G
B10_BC22_191109_LF_LIB_consensus_vsearch	1274	G	*/-A	580	11	1.84%	2	2	93	93	4.658867581677564E-4	1	1	370	210	10	1	-A
B10_BC22_191109_LF_LIB_consensus_vsearch	1275	A	*/-T	565	12	2.03%	2	2	93	93	2.3043650914873222E-4	1	1	365	200	3	9	-T
B10_BC22_191109_LF_LIB_consensus_vsearch	1276	T	K	576	11	1.87%	2	2	93	93	4.657363845851338E-4	1	1	372	204	10	1	G
B10_BC22_191109_LF_LIB_consensus_vsearch	1277	T	T	595	6	1%	2	2	93	93	0.01543033827052791	1	1	386	209	2	4	C
B10_BC22_191109_LF_LIB_consensus_vsearch	1278	T	T	586	6	1%	2	1	93	93	0.015427383935577244	1	1	387	199	0	6	G
B10_BC22_191109_LF_LIB_consensus_vsearch	1279	G	G	594	4	0.67%	2	2	93	93	0.062186323989038686	1	1	387	207	1	3	A
B10_BC22_191109_LF_LIB_consensus_vsearch	1280	T	T	598	1	0.17%	2	1	93	93	0.5000000000008233	1	1	386	212	1	0	-CT
B10_BC22_191109_LF_LIB_consensus_vsearch	1281	C	C	593	6	1%	2	2	93	93	0.015429689410799249	1	1	383	210	2	4	-T
B10_BC22_191109_LF_LIB_consensus_vsearch	1282	T	Y	576	7	1.18%	2	2	93	93	0.007672278741851824	1	1	375	201	2	5	C
B10_BC22_191109_LF_LIB_consensus_vsearch	1283	G	*/-CT	557	36	6%	2	1	93	93	8.415269093437331E-12	1	1	346	211	36	0	-CT
B10_BC22_191109_LF_LIB_consensus_vsearch	1284	C	Y	528	14	2.49%	2	1	93	93	5.6061022914751345E-5	1	1	338	190	0	14	T
B10_BC22_191109_LF_LIB_consensus_vsearch	1285	T	T	548	2	0.36%	2	1	93	93	0.24977252047319246	1	1	340	208	0	2	C
B10_BC22_191109_LF_LIB_consensus_vsearch	1286	T	*/-A	572	20	3.35%	2	1	93	93	8.10097394197934E-7	1	1	359	213	20	0	-A
B10_BC22_191109_LF_LIB_consensus_vsearch	1287	A	A	581	1	0.17%	2	1	93	93	0.4999999999999138	1	1	366	215	1	0	G
B10_BC22_191109_LF_LIB_consensus_vsearch	1288	A	A	593	3	0.5%	2	2	93	93	0.12468513853935516	1	1	381	212	2	1	G
B10_BC22_191109_LF_LIB_consensus_vsearch	1289	T	K	580	18	3%	2	1	93	93	3.3502350698224374E-6	1	1	369	211	18	0	G
B10_BC22_191109_LF_LIB_consensus_vsearch	1290	T	T	593	4	0.66%	2	1	93	93	0.06218579834936829	1	1	385	208	0	4	+G
B10_BC22_191109_LF_LIB_consensus_vsearch	1291	G	R	586	14	2.32%	2	2	93	93	5.652891210314472E-5	1	1	373	213	13	1	A
B10_BC22_191109_LF_LIB_consensus_vsearch	1292	C	Y	591	8	1.33%	2	2	93	93	0.0038154482484643428	1	1	384	207	1	7	T
B10_BC22_191109_LF_LIB_consensus_vsearch	1293	G	G	598	2	0.33%	2	1	93	93	0.24979149291046765	1	1	385	213	2	0	-A
B10_BC22_191109_LF_LIB_consensus_vsearch	1294	A	A	592	6	1%	2	2	93	93	0.01542936335614873	1	1	382	210	3	3	G
B10_BC22_191109_LF_LIB_consensus_vsearch	1295	T	T	592	2	0.33%	2	1	93	93	0.24978938500452047	1	1	380	212	0	2	+A
B10_BC22_191109_LF_LIB_consensus_vsearch	1296	A	A	594	2	0.33%	2	2	93	93	0.24979009235977778	1	1	380	214	1	1	C
B10_BC22_191109_LF_LIB_consensus_vsearch	1297	A	A	589	5	0.83%	2	1	93	93	0.030987064506852544	1	1	377	212	5	0	G
B10_BC22_191109_LF_LIB_consensus_vsearch	1298	C	*/+G	567	10	1.67%	2	1	93	93	9.389101896133754E-4	1	1	358	209	10	0	+G
B10_BC22_191109_LF_LIB_consensus_vsearch	1299	G	*/-A	588	7	1.17%	2	1	93	93	0.007675097138165556	1	1	375	213	7	0	-A
B10_BC22_191109_LF_LIB_consensus_vsearch	1300	A	A	584	5	0.84%	2	1	93	93	0.030984833420659205	1	1	370	214	5	0	G
B10_BC22_191109_LF_LIB_consensus_vsearch	1301	A	R	581	19	3.15%	2	1	93	93	1.6503328075403642E-6	1	1	367	214	19	0	G
B10_BC22_191109_LF_LIB_consensus_vsearch	1302	C	*/+A	578	14	2.33%	2	1	93	93	5.646967505352899E-5	1	1	367	211	14	0	+A
B10_BC22_191109_LF_LIB_consensus_vsearch	1303	G	*/-A	587	7	1.17%	2	2	93	93	0.007674866606290045	1	1	378	209	5	2	-A
B10_BC22_191109_LF_LIB_consensus_vsearch	1304	A	A	583	5	0.84%	2	2	93	93	0.030984382652161722	1	1	374	209	4	1	G
B10_BC22_191109_LF_LIB_consensus_vsearch	1305	G	G	595	2	0.33%	2	2	93	93	0.24979044425840527	1	1	384	211	1	1	+T
B10_BC22_191109_LF_LIB_consensus_vsearch	1306	A	*/-C	573	13	2.17%	2	2	93	93	1.1412856168272655E-4	1	1	369	204	5	8	-C
B10_BC22_191109_LF_LIB_consensus_vsearch	1307	C	C	579	4	0.68%	2	2	93	93	0.0621782499750882	1	1	375	204	1	3	T
B10_BC22_191109_LF_LIB_consensus_vsearch	1308	C	*/-T	509	49	8.14%	2	2	93	93	5.901055707715091E-16	1	1	373	136	6	43	-T
B10_BC22_191109_LF_LIB_consensus_vsearch	1309	T	T	541	5	0.91%	2	2	93	93	0.030963960074036706	1	1	374	167	4	1	C
B10_BC22_191109_LF_LIB_consensus_vsearch	1310	T	Y	580	15	2.5%	2	2	93	93	2.790977291101727E-5	1	1	381	199	4	11	C
B10_BC22_191109_LF_LIB_consensus_vsearch	1311	A	A	593	3	0.5%	2	1	93	93	0.12468513853935516	1	1	385	208	0	3	C
B10_BC22_191109_LF_LIB_consensus_vsearch	1312	A	*/-C	572	11	1.83%	2	2	93	93	4.655839782704286E-4	1	1	381	191	2	9	-C
B10_BC22_191109_LF_LIB_consensus_vsearch	1313	C	*/+T	534	46	7.77%	2	1	93	93	5.612973417561892E-15	1	1	380	154	0	46	+T
B10_BC22_191109_LF_LIB_consensus_vsearch	1314	C	*/-T	549	30	4.98%	2	2	93	93	6.333951262748303E-10	1	1	384	165	1	29	-T
B10_BC22_191109_LF_LIB_consensus_vsearch	1315	T	Y	520	20	3.5%	2	2	93	93	7.972365233821818E-7	1	1	383	137	1	19	C
B10_BC22_191109_LF_LIB_consensus_vsearch	1316	G	R	571	9	1.52%	2	2	93	93	0.0018930074497425708	1	1	369	202	7	2	A
B10_BC22_191109_LF_LIB_consensus_vsearch	1317	C	Y	541	23	3.86%	2	1	93	93	9.482273627816588E-8	1	1	375	166	0	23	T
B10_BC22_191109_LF_LIB_consensus_vsearch	1318	T	*/-A	534	17	2.94%	2	2	93	93	6.730946741652701E-6	1	1	373	161	8	9	-A
B10_BC22_191109_LF_LIB_consensus_vsearch	1319	A	M	558	9	1.57%	2	2	93	93	0.0018916407480847996	1	1	374	184	1	8	C
B10_BC22_191109_LF_LIB_consensus_vsearch	1320	A	A	594	5	0.83%	2	2	93	93	0.03098925836211217	1	1	383	211	3	2	C
B10_BC22_191109_LF_LIB_consensus_vsearch	1321	A	A	592	3	0.5%	2	2	93	93	0.1246846089151382	1	1	383	209	2	1	G
B10_BC22_191109_LF_LIB_consensus_vsearch	1322	T	Y	571	17	2.85%	2	1	93	93	6.784988638479219E-6	1	1	379	192	0	17	C
B10_BC22_191109_LF_LIB_consensus_vsearch	1323	A	A	585	5	0.84%	2	2	93	93	0.030985282661769052	1	1	377	208	3	2	G
B10_BC22_191109_LF_LIB_consensus_vsearch	1324	G	G	581	5	0.84%	2	2	93	93	0.030983476501936075	1	1	371	210	4	1	-C
B10_BC22_191109_LF_LIB_consensus_vsearch	1325	C	C	590	2	0.34%	2	1	93	93	0.2497886728654613	1	1	379	211	2	0	G
B10_BC22_191109_LF_LIB_consensus_vsearch	1326	C	C	589	3	0.5%	2	1	93	93	0.1246830092985462	1	1	376	213	3	0	+G
B10_BC22_191109_LF_LIB_consensus_vsearch	1327	A	*/+G	571	8	1.34%	2	1	93	93	0.0038123295121620672	1	1	374	197	0	8	+G
B10_BC22_191109_LF_LIB_consensus_vsearch	1328	G	G	590	2	0.34%	2	2	93	93	0.2497886728654613	1	1	383	207	1	1	+T
B10_BC22_191109_LF_LIB_consensus_vsearch	1329	G	*/-C	551	34	5.66%	2	2	93	93	3.552813140888366E-11	1	1	343	208	31	3	-C
B10_BC22_191109_LF_LIB_consensus_vsearch	1330	C	Y	550	8	1.41%	2	2	93	93	0.003808815651854499	1	1	353	197	1	7	T
B10_BC22_191109_LF_LIB_consensus_vsearch	1331	C	C	590	5	0.83%	2	1	93	93	0.030987506226370864	1	1	385	205	0	5	T
B10_BC22_191109_LF_LIB_consensus_vsearch	1332	C	Y	549	24	3.98%	2	2	93	93	4.6610967308022154E-8	1	1	359	190	1	23	T
B10_BC22_191109_LF_LIB_consensus_vsearch	1333	G	R	563	9	1.57%	2	1	93	93	0.0018921736921997058	1	1	351	212	9	0	A
B10_BC22_191109_LF_LIB_consensus_vsearch	1334	C	*/-T	526	28	4.84%	2	2	93	93	2.6254939567174794E-9	1	1	347	179	2	26	-T
B10_BC22_191109_LF_LIB_consensus_vsearch	1335	T	T	556	6	1.06%	2	1	93	93	0.015416854001135672	1	1	380	176	0	6	C
B10_BC22_191109_LF_LIB_consensus_vsearch	1336	T	T	588	2	0.34%	2	2	93	93	0.2497879558944788	1	1	381	207	1	1	G
B10_BC22_191109_LF_LIB_consensus_vsearch	1337	T	T	588	5	0.83%	2	2	93	93	0.0309866212982286	1	1	382	206	4	1	-G
B10_BC22_191109_LF_LIB_consensus_vsearch	1338	G	G	589	3	0.5%	2	1	93	93	0.1246830092985462	1	1	380	209	3	0	+TG
B10_BC22_191109_LF_LIB_consensus_vsearch	1339	G	G	588	4	0.66%	2	1	93	93	0.06218314350277022	1	1	379	209	4	0	+C
B10_BC22_191109_LF_LIB_consensus_vsearch	1340	C	*/-G	546	38	6.38%	2	2	93	93	1.953193191973232E-12	1	1	355	191	21	17	-G
B10_BC22_191109_LF_LIB_consensus_vsearch	1341	G	R	501	46	8.2%	2	2	93	93	5.293987996861837E-15	1	1	307	194	44	2	A
B10_BC22_191109_LF_LIB_consensus_vsearch	1342	G	*/+A	521	52	8.65%	2	2	93	93	6.608349542336785E-17	1	1	308	213	51	1	+A
B10_BC22_191109_LF_LIB_consensus_vsearch	1343	G	R	581	14	2.33%	2	2	93	93	5.6492070470485533E-5	1	1	369	212	13	1	A
B10_BC22_191109_LF_LIB_consensus_vsearch	1344	T	T	589	6	1%	2	2	93	93	0.015428378627452975	1	1	378	211	5	1	-C
B10_BC22_191109_LF_LIB_consensus_vsearch	1345	C	C	586	3	0.5%	2	2	93	93	0.12468139337307069	1	1	374	212	2	1	+AT
B10_BC22_191109_LF_LIB_consensus_vsearch	1346	G	*/-C	579	8	1.33%	2	2	93	93	0.003813602365568841	1	1	369	210	7	1	-C
B10_BC22_191109_LF_LIB_consensus_vsearch	1347	C	Y	574	11	1.85%	2	2	93	93	4.6566043808442384E-4	1	1	369	205	5	6	T
B10_BC22_191109_LF_LIB_consensus_vsearch	1348	C	C	581	6	1%	2	1	93	93	0.015425703561055139	1	1	370	211	6	0	-G
B10_BC22_191109_LF_LIB_consensus_vsearch	1349	G	R	576	9	1.52%	2	2	93	93	0.001893517063995506	1	1	366	210	8	1	A
B10_BC22_191109_LF_LIB_consensus_vsearch	1350	G	*/-C	561	20	3.33%	2	2	93	93	8.075558512578247E-7	1	1	368	193	1	19	-C
B10_BC22_191109_LF_LIB_consensus_vsearch	1351	C	*/-T	537	17	2.92%	2	2	93	93	6.735584540454959E-6	1	1	352	185	16	1	-T
B10_BC22_191109_LF_LIB_consensus_vsearch	1352	T	T	565	4	0.7%	2	2	93	93	0.06217032998972652	1	1	355	210	3	1	C
B10_BC22_191109_LF_LIB_consensus_vsearch	1353	T	*/-CT	524	23	3.89%	2	1	93	93	9.41364943436732E-8	1	1	356	168	0	23	-CT
B10_BC22_191109_LF_LIB_consensus_vsearch	1354	C	*/-T	520	14	2.56%	2	2	93	93	5.5988755288454006E-5	1	1	366	154	4	10	-T
B10_BC22_191109_LF_LIB_consensus_vsearch	1355	T	T	527	4	0.74%	2	2	93	93	0.06214672672359405	1	1	366	161	3	1	A
B10_BC22_191109_LF_LIB_consensus_vsearch	1356	T	*/+A	552	14	2.41%	2	1	93	93	5.626592492019193E-5	1	1	362	190	14	0	+A
B10_BC22_191109_LF_LIB_consensus_vsearch	1357	A	*/+G	566	11	1.86%	2	2	93	93	4.653514663553586E-4	1	1	376	190	1	10	+G
B10_BC22_191109_LF_LIB_consensus_vsearch	1358	G	G	589	5	0.83%	2	2	93	93	0.030987064506852544	1	1	381	208	1	4	-AG
B10_BC22_191109_LF_LIB_consensus_vsearch	1359	A	*/-G	427	151	25.55%	2	2	93	93	4.3108259846468496E-51	1	1	236	191	138	13	-G
B10_BC22_191109_LF_LIB_consensus_vsearch	1360	G	G	436	3	0.68%	2	1	93	93	0.12457240592922707	1	1	241	195	3	0	A
B10_BC22_191109_LF_LIB_consensus_vsearch	1361	G	G	593	3	0.5%	2	1	93	93	0.12468513853935516	1	1	380	213	3	0	A
B10_BC22_191109_LF_LIB_consensus_vsearch	1362	G	G	598	4	0.66%	2	1	93	93	0.06218840907720501	1	1	383	215	4	0	-A
B10_BC22_191109_LF_LIB_consensus_vsearch	1363	A	A	589	5	0.83%	2	2	93	93	0.030987064506852544	1	1	378	211	2	3	T
B10_BC22_191109_LF_LIB_consensus_vsearch	1364	C	C	588	3	0.5%	2	1	93	93	0.12468247248078299	1	1	376	212	3	0	+GC
B10_BC22_191109_LF_LIB_consensus_vsearch	1365	T	Y	580	13	2.18%	2	1	93	93	1.1422019683041178E-4	1	1	380	200	0	13	C
B10_BC22_191109_LF_LIB_consensus_vsearch	1366	A	A	591	3	0.5%	2	2	93	93	0.12468407750622149	1	1	382	209	1	2	+C
B10_BC22_191109_LF_LIB_consensus_vsearch	1367	T	T	592	2	0.33%	2	1	93	93	0.24978938500452047	1	1	380	212	2	0	-C
B10_BC22_191109_LF_LIB_consensus_vsearch	1368	C	*/-G	579	10	1.68%	2	2	93	93	9.396687550389984E-4	1	1	377	202	4	6	-G
B10_BC22_191109_LF_LIB_consensus_vsearch	1369	G	G	582	6	1.02%	2	1	93	93	0.015426041918236095	1	1	376	206	6	0	A
B10_BC22_191109_LF_LIB_consensus_vsearch	1370	G	G	584	5	0.83%	2	1	93	93	0.030984833420659205	1	1	380	204	5	0	-C
B10_BC22_191109_LF_LIB_consensus_vsearch	1371	C	*/-T	513	76	12.77%	2	1	93	93	9.958076652064088E-25	1	1	377	136	0	76	-T
B10_BC22_191109_LF_LIB_consensus_vsearch	1372	T	*/+C	496	8	1.53%	2	1	93	93	0.003798444244463843	1	1	373	123	8	0	+C
B10_BC22_191109_LF_LIB_consensus_vsearch	1373	C	*/-A	482	71	12.05%	2	2	93	93	3.835668368974802E-23	1	1	375	107	3	68	-A
B10_BC22_191109_LF_LIB_consensus_vsearch	1374	A	A	480	4	0.81%	2	1	93	93	0.0621124036200781	1	1	378	102	0	4	G
B10_BC22_191109_LF_LIB_consensus_vsearch	1375	A	W	486	66	11.62%	2	1	93	93	1.7155314724346022E-21	1	1	384	102	0	66	T
B10_BC22_191109_LF_LIB_consensus_vsearch	1376	G	R	583	8	1.34%	2	1	93	93	0.0038142259421648926	1	1	373	210	8	0	A
B10_BC22_191109_LF_LIB_consensus_vsearch	1377	C	C	596	2	0.33%	2	1	93	93	0.24979079497935539	1	1	386	210	0	2	T
B10_BC22_191109_LF_LIB_consensus_vsearch	1378	C	C	595	4	0.67%	2	2	93	93	0.062186847872822006	1	1	385	210	1	3	T
B10_BC22_191109_LF_LIB_consensus_vsearch	1379	G	G	596	5	0.83%	2	2	93	93	0.030990125687592227	1	1	382	214	4	1	-A
B10_BC22_191109_LF_LIB_consensus_vsearch	1380	A	A	587	3	0.5%	2	1	93	93	0.12468193384235185	1	1	379	208	0	3	-TGG
B10_BC22_191109_LF_LIB_consensus_vsearch	1381	T	*/-G	578	12	2%	2	2	93	93	2.3073291313309075E-4	1	1	375	203	9	3	-G
B10_BC22_191109_LF_LIB_consensus_vsearch	1382	G	G	586	2	0.34%	2	2	93	93	0.24978723404299805	1	1	378	208	1	1	A
B10_BC22_191109_LF_LIB_consensus_vsearch	1383	G	G	591	5	0.83%	2	1	93	93	0.030987946464272845	1	1	383	208	5	0	-A
B10_BC22_191109_LF_LIB_consensus_vsearch	1384	A	R	580	11	1.85%	2	2	93	93	4.658867581677564E-4	1	1	371	209	10	1	G
B10_BC22_191109_LF_LIB_consensus_vsearch	1385	A	A	590	6	1%	2	1	93	93	0.01542870796997642	1	1	377	213	6	0	G
B10_BC22_191109_LF_LIB_consensus_vsearch	1386	G	*/-T	564	24	4.01%	2	2	93	93	4.6910313999698796E-8	1	1	357	207	20	4	-T
B10_BC22_191109_LF_LIB_consensus_vsearch	1387	T	Y	568	9	1.56%	2	2	93	93	0.0018926974773018042	1	1	363	205	3	6	C
B10_BC22_191109_LF_LIB_consensus_vsearch	1388	T	T	598	5	0.83%	2	2	93	93	0.03099098726211932	1	1	386	212	2	3	C
B10_BC22_191109_LF_LIB_consensus_vsearch	1389	T	T	586	4	0.66%	2	1	93	93	0.062182068959449006	1	1	379	207	4	0	+A
B10_BC22_191109_LF_LIB_consensus_vsearch	1390	G	*/+A	517	65	10.82%	2	1	93	93	4.083135312251155E-21	1	1	306	211	65	0	+A
B10_BC22_191109_LF_LIB_consensus_vsearch	1391	A	*/-G	499	84	14.17%	2	1	93	93	2.0583623924192154E-27	1	1	289	210	84	0	-G
B10_BC22_191109_LF_LIB_consensus_vsearch	1392	G	G	498	4	0.78%	2	2	93	93	0.062126308387585344	1	1	289	209	2	2	+T
B10_BC22_191109_LF_LIB_consensus_vsearch	1393	G	R	581	9	1.5%	2	1	93	93	0.0018940181115188759	1	1	368	213	9	0	A
B10_BC22_191109_LF_LIB_consensus_vsearch	1394	C	*/-A	560	29	4.85%	2	2	93	93	1.3083469130058672E-9	1	1	378	182	4	25	-A
B10_BC22_191109_LF_LIB_consensus_vsearch	1395	A	A	557	5	0.88%	2	2	93	93	0.030972099869438472	1	1	377	180	4	1	G
B10_BC22_191109_LF_LIB_consensus_vsearch	1396	A	A	577	6	1%	2	1	93	93	0.01542433854516302	1	1	380	197	0	6	-T
B10_BC22_191109_LF_LIB_consensus_vsearch	1397	T	Y	557	26	4.43%	2	2	93	93	1.1206037812215373E-8	1	1	383	174	2	24	C
B10_BC22_191109_LF_LIB_consensus_vsearch	1398	A	A	583	6	1.02%	2	1	93	93	0.015426379128433065	1	1	384	199	0	6	C
B10_BC22_191109_LF_LIB_consensus_vsearch	1399	A	A	588	5	0.84%	2	1	93	93	0.0309866212982286	1	1	381	207	5	0	G
B10_BC22_191109_LF_LIB_consensus_vsearch	1400	C	C	585	4	0.67%	2	1	93	93	0.06218152895025356	1	1	376	209	4	0	-A
B10_BC22_191109_LF_LIB_consensus_vsearch	1401	A	R	575	17	2.84%	2	1	93	93	6.790444562646919E-6	1	1	363	212	17	0	G
B10_BC22_191109_LF_LIB_consensus_vsearch	1402	G	G	594	2	0.33%	2	2	93	93	0.24979009235977778	1	1	384	210	1	1	T
B10_BC22_191109_LF_LIB_consensus_vsearch	1403	G	G	594	4	0.66%	2	2	93	93	0.062186323989038686	1	1	384	210	1	3	A
B10_BC22_191109_LF_LIB_consensus_vsearch	1404	T	T	586	5	0.83%	2	2	93	93	0.030985730383315414	1	1	379	207	4	1	C
B10_BC22_191109_LF_LIB_consensus_vsearch	1405	C	C	592	1	0.17%	2	1	93	93	0.4999999999999138	1	1	381	211	1	0	+A
B10_BC22_191109_LF_LIB_consensus_vsearch	1406	T	T	591	4	0.67%	2	2	93	93	0.06218474176725347	1	1	379	212	1	3	A
B10_BC22_191109_LF_LIB_consensus_vsearch	1407	G	G	587	6	1%	2	2	93	93	0.015427716615850288	1	1	380	207	2	4	-T
B10_BC22_191109_LF_LIB_consensus_vsearch	1408	T	Y	580	9	1.51%	2	2	93	93	0.001893918576967777	1	1	376	204	8	1	C
B10_BC22_191109_LF_LIB_consensus_vsearch	1409	G	G	596	3	0.5%	2	1	93	93	0.1246867167922604	1	1	383	213	3	0	-A
B10_BC22_191109_LF_LIB_consensus_vsearch	1410	A	A	591	4	0.67%	2	1	93	93	0.06218474176725347	1	1	379	212	4	0	G
B10_BC22_191109_LF_LIB_consensus_vsearch	1411	T	T	596	2	0.33%	2	1	93	93	0.24979079497935539	1	1	387	209	0	2	-GC
B10_BC22_191109_LF_LIB_consensus_vsearch	1412	G	*/-C	576	15	2.51%	2	2	93	93	2.789269415844126E-5	1	1	374	202	12	3	-C
B10_BC22_191109_LF_LIB_consensus_vsearch	1413	C	C	579	2	0.34%	2	1	93	93	0.24978466838924643	1	1	376	203	0	2	+T
B10_BC22_191109_LF_LIB_consensus_vsearch	1414	C	C	598	2	0.33%	2	2	93	93	0.24979149291046765	1	1	386	212	1	1	T
B10_BC22_191109_LF_LIB_consensus_vsearch	1415	C	*/+T	567	20	3.32%	2	2	93	93	8.089531686060739E-7	1	1	383	184	1	19	+T
B10_BC22_191109_LF_LIB_consensus_vsearch	1416	T	T	590	4	0.67%	2	2	93	93	0.062184210806914414	1	1	383	207	3	1	C
B10_BC22_191109_LF_LIB_consensus_vsearch	1417	T	T	592	3	0.5%	2	1	93	93	0.1246846089151382	1	1	380	212	3	0	-A
B10_BC22_191109_LF_LIB_consensus_vsearch	1418	A	A	587	5	0.83%	2	1	93	93	0.030986176592841308	1	1	378	209	0	5	+G
B10_BC22_191109_LF_LIB_consensus_vsearch	1419	G	G	597	1	0.17%	2	1	93	93	0.4999999999999138	1	1	383	214	1	0	+A
B10_BC22_191109_LF_LIB_consensus_vsearch	1420	A	A	598	2	0.33%	2	2	93	93	0.24979149291046765	1	1	384	214	1	1	G
B10_BC22_191109_LF_LIB_consensus_vsearch	1421	T	T	593	3	0.5%	2	1	93	93	0.12468513853935516	1	1	383	210	3	0	+A
B10_BC22_191109_LF_LIB_consensus_vsearch	1422	G	G	584	5	0.83%	2	1	93	93	0.030984833420659205	1	1	374	210	5	0	+T
B10_BC22_191109_LF_LIB_consensus_vsearch	1423	T	T	592	4	0.67%	2	2	93	93	0.06218527094514562	1	1	384	208	1	3	C
B10_BC22_191109_LF_LIB_consensus_vsearch	1424	T	T	588	5	0.83%	2	1	93	93	0.0309866212982286	1	1	375	213	5	0	+C
B10_BC22_191109_LF_LIB_consensus_vsearch	1425	C	*/+T	579	10	1.67%	2	1	93	93	9.396687550389984E-4	1	1	379	200	0	10	+T
B10_BC22_191109_LF_LIB_consensus_vsearch	1426	T	*/+G	572	7	1.18%	2	1	93	93	0.00767131340646626	1	1	374	198	0	7	+G
B10_BC22_191109_LF_LIB_consensus_vsearch	1427	G	R	576	13	2.19%	2	2	93	93	1.141680944483324E-4	1	1	370	206	11	2	A
B10_BC22_191109_LF_LIB_consensus_vsearch	1428	G	*/+A	580	10	1.66%	2	1	93	93	9.39730591623294E-4	1	1	369	211	10	0	+A
B10_BC22_191109_LF_LIB_consensus_vsearch	1429	G	G	574	6	1%	2	1	93	93	0.01542330244911806	1	1	364	210	6	0	A
B10_BC22_191109_LF_LIB_consensus_vsearch	1430	C	*/+G	570	8	1.34%	2	2	93	93	0.003812167942212529	1	1	367	203	6	2	+G
B10_BC22_191109_LF_LIB_consensus_vsearch	1431	C	C	586	3	0.5%	2	2	93	93	0.12468139337307069	1	1	382	204	1	2	-A
B10_BC22_191109_LF_LIB_consensus_vsearch	1432	A	G	73	518	86.77%	2	2	93	93	2.5111739892844284E-256	1	1	56	17	326	192	G
B10_BC22_191109_LF_LIB_consensus_vsearch	1433	C	*/-AC	582	8	1.33%	2	2	93	93	0.00381407083625578	1	1	379	203	6	2	-AC
B10_BC22_191109_LF_LIB_consensus_vsearch	1434	A	R	546	31	5.25%	2	2	93	93	3.0782227333251367E-10	1	1	357	189	20	11	G
B10_BC22_191109_LF_LIB_consensus_vsearch	1435	C	C	576	2	0.34%	2	1	93	93	0.24978354978355208	1	1	375	201	0	2	+G
B10_BC22_191109_LF_LIB_consensus_vsearch	1436	G	R	585	7	1.17%	2	2	93	93	0.007674403214110395	1	1	379	206	2	5	A
B10_BC22_191109_LF_LIB_consensus_vsearch	1437	C	*/-GC	537	26	4.36%	2	2	93	93	1.1090539773406887E-8	1	1	349	188	22	4	-GC
B10_BC22_191109_LF_LIB_consensus_vsearch	1438	G	*/-C	517	13	2.28%	2	2	93	93	1.1331057001453964E-4	1	1	339	178	2	11	-C
B10_BC22_191109_LF_LIB_consensus_vsearch	1439	C	*/+GC	258	244	43.34%	2	2	93	93	2.075342012499091E-91	1	1	144	114	179	65	+GC
B10_BC22_191109_LF_LIB_consensus_vsearch	1440	T	Y	562	8	1.36%	2	2	93	93	0.003810855092140287	1	1	365	197	1	7	C
B10_BC22_191109_LF_LIB_consensus_vsearch	1441	A	R	548	36	5.99%	2	2	93	93	8.3423104729881E-12	1	1	346	202	33	3	G
B10_BC22_191109_LF_LIB_consensus_vsearch	1442	C	*/+T	566	12	2%	2	1	93	93	2.3045977381397776E-4	1	1	356	210	12	0	+T
B10_BC22_191109_LF_LIB_consensus_vsearch	1443	A	R	560	15	2.54%	2	2	93	93	2.782208360962169E-5	1	1	349	211	14	1	G
B10_BC22_191109_LF_LIB_consensus_vsearch	1444	C	C	573	4	0.68%	2	1	93	93	0.062174902776938816	1	1	364	209	4	0	-T
B10_BC22_191109_LF_LIB_consensus_vsearch	1445	T	Y	570	14	2.35%	2	1	93	93	5.6408860663304025E-5	1	1	377	193	0	14	C
B10_BC22_191109_LF_LIB_consensus_vsearch	1446	G	G	591	6	1%	2	2	93	93	0.015429036211008771	1	1	379	212	5	1	-A
B10_BC22_191109_LF_LIB_consensus_vsearch	1447	A	R	579	13	2.18%	2	2	93	93	1.1420723572987618E-4	1	1	369	210	11	2	G
B10_BC22_191109_LF_LIB_consensus_vsearch	1448	C	C	590	3	0.5%	2	1	93	93	0.12468354430400949	1	1	377	213	3	0	+T
B10_BC22_191109_LF_LIB_consensus_vsearch	1449	A	*/-CA	567	22	3.65%	2	2	93	93	1.95249026854527E-7	1	1	363	204	15	7	-CA
B10_BC22_191109_LF_LIB_consensus_vsearch	1450	C	C	569	4	0.69%	2	2	93	93	0.06217263235112447	1	1	363	206	3	1	-A
B10_BC22_191109_LF_LIB_consensus_vsearch	1451	A	*/-G	552	7	1.22%	2	1	93	93	0.007666280255386365	1	1	354	198	7	0	-G
B10_BC22_191109_LF_LIB_consensus_vsearch	1452	G	R	560	16	2.7%	2	1	93	93	1.3729751077540724E-5	1	1	346	214	16	0	A
B10_BC22_191109_LF_LIB_consensus_vsearch	1453	C	C	579	4	0.68%	2	1	93	93	0.0621782499750882	1	1	368	211	4	0	A
B10_BC22_191109_LF_LIB_consensus_vsearch	1454	C	Y	580	16	2.66%	2	2	93	93	1.3779132218050288E-5	1	1	372	208	13	3	T
B10_BC22_191109_LF_LIB_consensus_vsearch	1455	A	A	596	4	0.67%	2	2	93	93	0.062187370009836374	1	1	384	212	2	2	G
B10_BC22_191109_LF_LIB_consensus_vsearch	1456	A	R	587	8	1.33%	2	2	93	93	0.003814841181091788	1	1	376	211	6	2	G
B10_BC22_191109_LF_LIB_consensus_vsearch	1457	C	*/+A	572	15	2.5%	2	1	93	93	2.787539038542439E-5	1	1	361	211	15	0	+A
B10_BC22_191109_LF_LIB_consensus_vsearch	1458	G	*/-A	574	18	3.02%	2	1	93	93	3.3457631735446256E-6	1	1	360	214	18	0	-A
B10_BC22_191109_LF_LIB_consensus_vsearch	1459	A	R	568	9	1.54%	2	1	93	93	0.0018926974773018042	1	1	353	215	9	0	G
B10_BC22_191109_LF_LIB_consensus_vsearch	1460	G	G	592	2	0.33%	2	1	93	93	0.24978938500452047	1	1	378	214	2	0	+AG
B10_BC22_191109_LF_LIB_consensus_vsearch	1461	T	T	596	2	0.33%	2	1	93	93	0.24979079497935539	1	1	386	210	0	2	C
B10_BC22_191109_LF_LIB_consensus_vsearch	1462	T	T	590	6	1%	2	2	93	93	0.01542870796997642	1	1	379	211	4	2	C
B10_BC22_191109_LF_LIB_consensus_vsearch	1463	C	C	594	1	0.17%	2	1	93	93	0.5000000000008233	1	1	382	212	0	1	+A
B10_BC22_191109_LF_LIB_consensus_vsearch	1464	A	A	592	4	0.66%	2	1	93	93	0.06218527094514562	1	1	381	211	4	0	C
B10_BC22_191109_LF_LIB_consensus_vsearch	1465	T	T	595	4	0.67%	2	2	93	93	0.062186847872822006	1	1	384	211	2	2	-C
B10_BC22_191109_LF_LIB_consensus_vsearch	1466	C	C	594	2	0.33%	2	1	93	93	0.24979009235977778	1	1	385	209	0	2	+A
B10_BC22_191109_LF_LIB_consensus_vsearch	1467	A	A	593	2	0.33%	2	1	93	93	0.24978973927711676	1	1	381	212	2	0	-C
B10_BC22_191109_LF_LIB_consensus_vsearch	1468	C	*/+AC	586	8	1.34%	2	1	93	93	0.00381468814385855	1	1	374	212	8	0	+AC
B10_BC22_191109_LF_LIB_consensus_vsearch	1469	C	*/-T	561	32	5.33%	2	2	93	93	1.5150746497344735E-10	1	1	379	182	4	28	-T
B10_BC22_191109_LF_LIB_consensus_vsearch	1470	T	T	562	2	0.35%	2	1	93	93	0.24977817213868056	1	1	379	183	0	2	C
B10_BC22_191109_LF_LIB_consensus_vsearch	1471	T	Y	589	8	1.33%	2	1	93	93	0.003815145726019033	1	1	385	204	0	8	C
B10_BC22_191109_LF_LIB_consensus_vsearch	1472	A	A	600	2	0.33%	2	2	93	93	0.249792186200784	1	1	386	214	1	1	C
B10_BC22_191109_LF_LIB_consensus_vsearch	1473	A	R	588	8	1.33%	2	2	93	93	0.00381499370763636	1	1	375	213	7	1	G
B10_BC22_191109_LF_LIB_consensus_vsearch	1474	C	C	594	2	0.34%	2	2	93	93	0.24979009235977778	1	1	381	213	1	1	+T
B10_BC22_191109_LF_LIB_consensus_vsearch	1475	C	*/+G	564	16	2.65%	2	1	93	93	1.3739888995429954E-5	1	1	383	181	0	16	+G
B10_BC22_191109_LF_LIB_consensus_vsearch	1476	G	*/-A	467	112	18.6%	2	2	93	93	5.013213240156895E-37	1	1	260	207	109	3	-A
B10_BC22_191109_LF_LIB_consensus_vsearch	1477	A	A	471	3	0.63%	2	1	93	93	0.12460401267143939	1	1	261	210	3	0	G
B10_BC22_191109_LF_LIB_consensus_vsearch	1478	A	R	575	7	1.19%	2	2	93	93	0.007672038647635164	1	1	366	209	3	4	G
B10_BC22_191109_LF_LIB_consensus_vsearch	1479	A	*/-G	584	12	2%	2	1	93	93	2.3086543430195892E-4	1	1	371	213	12	0	-G
B10_BC22_191109_LF_LIB_consensus_vsearch	1480	G	G	586	3	0.51%	2	2	93	93	0.12468139337307069	1	1	374	212	2	1	A
B10_BC22_191109_LF_LIB_consensus_vsearch	1481	G	*/-T	583	10	1.66%	2	2	93	93	9.399148640318375E-4	1	1	373	210	8	2	-T
B10_BC22_191109_LF_LIB_consensus_vsearch	1482	T	T	585	4	0.68%	2	2	93	93	0.06218152895025356	1	1	378	207	1	3	C
B10_BC22_191109_LF_LIB_consensus_vsearch	1483	T	T	599	1	0.17%	2	1	93	93	0.4999999999990043	1	1	387	212	1	0	C
B10_BC22_191109_LF_LIB_consensus_vsearch	1484	T	*/-G	581	11	1.83%	2	2	93	93	4.659240387073297E-4	1	1	377	204	5	6	-G
B10_BC22_191109_LF_LIB_consensus_vsearch	1485	G	R	570	15	2.56%	2	1	93	93	2.786665272293345E-5	1	1	366	204	15	0	A
B10_BC22_191109_LF_LIB_consensus_vsearch	1486	G	G	585	5	0.84%	2	1	93	93	0.030985282661769052	1	1	373	212	5	0	+A
B10_BC22_191109_LF_LIB_consensus_vsearch	1487	G	G	591	5	0.83%	2	2	93	93	0.030987946464272845	1	1	379	212	3	2	-T
B10_BC22_191109_LF_LIB_consensus_vsearch	1488	T	*/-A	576	10	1.68%	2	2	93	93	9.394819933234852E-4	1	1	372	204	8	2	-A
B10_BC22_191109_LF_LIB_consensus_vsearch	1489	A	A	585	3	0.51%	2	1	93	93	0.1246808510636648	1	1	375	210	3	0	G
B10_BC22_191109_LF_LIB_consensus_vsearch	1490	A	A	590	4	0.67%	2	2	93	93	0.062184210806914414	1	1	382	208	1	3	-T
B10_BC22_191109_LF_LIB_consensus_vsearch	1491	T	T	586	5	0.84%	2	2	93	93	0.030985730383315414	1	1	379	207	3	2	C
B10_BC22_191109_LF_LIB_consensus_vsearch	1492	C	*/-T	585	12	2.01%	2	2	93	93	2.3088726695666827E-4	1	1	383	202	2	10	-T
B10_BC22_191109_LF_LIB_consensus_vsearch	1493	T	T	587	2	0.34%	2	2	93	93	0.249787595581865	1	1	384	203	1	1	C
B10_BC22_191109_LF_LIB_consensus_vsearch	1494	T	T	592	5	0.83%	2	1	93	93	0.03098838522787931	1	1	378	214	5	0	+G
B10_BC22_191109_LF_LIB_consensus_vsearch	1495	G	G	592	3	0.5%	2	2	93	93	0.1246846089151382	1	1	381	211	2	1	+A
B10_BC22_191109_LF_LIB_consensus_vsearch	1496	T	K	575	15	2.5%	2	2	93	93	2.7888389483588588E-5	1	1	367	208	14	1	G
B10_BC22_191109_LF_LIB_consensus_vsearch	1497	T	*/-A	586	8	1.33%	2	2	93	93	0.00381468814385855	1	1	377	209	5	3	-A
B10_BC22_191109_LF_LIB_consensus_vsearch	1498	A	A	591	1	0.17%	2	1	93	93	0.5000000000008233	1	1	381	210	0	1	+TA
B10_BC22_191109_LF_LIB_consensus_vsearch	1499	A	A	599	1	0.17%	2	1	93	93	0.4999999999990043	1	1	385	214	1	0	G
B10_BC22_191109_LF_LIB_consensus_vsearch	1500	A	A	593	5	0.83%	2	2	93	93	0.03098882252468081	1	1	382	211	4	1	G
B10_BC22_191109_LF_LIB_consensus_vsearch	1501	C	C	593	3	0.5%	2	1	93	93	0.12468513853935516	1	1	380	213	3	0	+T
B10_BC22_191109_LF_LIB_consensus_vsearch	1502	T	T	592	6	1%	2	1	93	93	0.01542936335614873	1	1	386	206	0	6	C
B10_BC22_191109_LF_LIB_consensus_vsearch	1503	G	G	597	2	0.33%	2	2	93	93	0.24979114452852993	1	1	384	213	1	1	+C
B10_BC22_191109_LF_LIB_consensus_vsearch	1504	T	*/-GT	576	17	2.83%	2	2	93	93	6.791797557940805E-6	1	1	371	205	15	2	-GT
B10_BC22_191109_LF_LIB_consensus_vsearch	1505	G	G	581	1	0.17%	2	1	93	93	0.4999999999999138	1	1	372	209	0	1	+CG
B10_BC22_191109_LF_LIB_consensus_vsearch	1506	T	Y	572	7	1.19%	2	2	93	93	0.00767131340646626	1	1	366	206	1	6	C
B10_BC22_191109_LF_LIB_consensus_vsearch	1507	C	C	591	6	1%	2	2	93	93	0.015429036211008771	1	1	380	211	5	1	+A
B10_BC22_191109_LF_LIB_consensus_vsearch	1508	G	*/-TG	582	7	1.17%	2	1	93	93	0.007673702245629301	1	1	377	205	0	7	-TG
B10_BC22_191109_LF_LIB_consensus_vsearch	1509	T	T	585	4	0.67%	2	2	93	93	0.06218152895025356	1	1	384	201	1	3	C
B10_BC22_191109_LF_LIB_consensus_vsearch	1510	G	G	587	3	0.5%	2	2	93	93	0.12468193384235185	1	1	382	205	2	1	A
B10_BC22_191109_LF_LIB_consensus_vsearch	1511	C	C	591	4	0.67%	2	2	93	93	0.06218474176725347	1	1	379	212	3	1	-T
B10_BC22_191109_LF_LIB_consensus_vsearch	1512	T	*/-G	545	39	6.54%	2	2	93	93	9.437552945306233E-13	1	1	350	195	25	14	-G
B10_BC22_191109_LF_LIB_consensus_vsearch	1513	G	R	544	7	1.25%	2	2	93	93	0.007664165065188001	1	1	351	193	5	2	A
B10_BC22_191109_LF_LIB_consensus_vsearch	1514	G	R	590	12	1.99%	2	2	93	93	2.3099536208476528E-4	1	1	378	212	10	2	A
B10_BC22_191109_LF_LIB_consensus_vsearch	1515	G	R	575	17	2.82%	2	2	93	93	6.790444562646919E-6	1	1	363	212	16	1	A
B10_BC22_191109_LF_LIB_consensus_vsearch	1516	G	R	576	17	2.82%	2	1	93	93	6.791797557940805E-6	1	1	361	215	17	0	A
B10_BC22_191109_LF_LIB_consensus_vsearch	1517	A	A	589	1	0.17%	2	1	93	93	0.5000000000008233	1	1	376	213	1	0	+GA
B10_BC22_191109_LF_LIB_consensus_vsearch	1518	T	*/+G	520	48	8%	2	1	93	93	1.2599781324534536E-15	1	1	312	208	48	0	+G
B10_BC22_191109_LF_LIB_consensus_vsearch	1519	A	*/-G	507	60	10.24%	2	1	93	93	1.668901555974037E-19	1	1	302	205	60	0	-G
B10_BC22_191109_LF_LIB_consensus_vsearch	1520	G	*/+A	517	17	3.14%	2	1	93	93	6.7037305813230395E-6	1	1	306	211	17	0	+A
B10_BC22_191109_LF_LIB_consensus_vsearch	1521	A	*/-G	576	11	1.84%	2	2	93	93	4.657363845851338E-4	1	1	365	211	9	2	-G
B10_BC22_191109_LF_LIB_consensus_vsearch	1522	G	R	499	81	13.71%	2	1	93	93	2.0505623308304097E-26	1	1	289	210	81	0	A
B10_BC22_191109_LF_LIB_consensus_vsearch	1523	C	C	587	6	1%	2	1	93	93	0.015427716615850288	1	1	379	208	6	0	-A
B10_BC22_191109_LF_LIB_consensus_vsearch	1524	A	*/-T	579	8	1.34%	2	2	93	93	0.003813602365568841	1	1	373	206	2	6	-T
B10_BC22_191109_LF_LIB_consensus_vsearch	1525	T	K	580	7	1.18%	2	2	93	93	0.0076732309665896	1	1	379	201	6	1	G
B10_BC22_191109_LF_LIB_consensus_vsearch	1526	T	Y	594	7	1.16%	2	2	93	93	0.0076764642733761	1	1	385	209	3	4	C
B10_BC22_191109_LF_LIB_consensus_vsearch	1527	G	R	576	20	3.32%	2	2	93	93	8.109998594276505E-7	1	1	371	205	14	6	A
B10_BC22_191109_LF_LIB_consensus_vsearch	1528	C	*/-A	571	18	3.02%	2	2	93	93	3.343494826100154E-6	1	1	375	196	8	10	-A
B10_BC22_191109_LF_LIB_consensus_vsearch	1529	A	A	574	2	0.34%	2	2	93	93	0.24978279756726465	1	1	375	199	1	1	C
B10_BC22_191109_LF_LIB_consensus_vsearch	1530	A	R	589	7	1.17%	2	2	93	93	0.007675326899053761	1	1	379	210	6	1	G
B10_BC22_191109_LF_LIB_consensus_vsearch	1531	T	Y	579	13	2.17%	2	1	93	93	1.1420723572987618E-4	1	1	379	200	0	13	C
B10_BC22_191109_LF_LIB_consensus_vsearch	1532	T	*/-A	536	61	10.13%	2	1	93	93	8.623476574106035E-20	1	1	325	211	61	0	-A
B10_BC22_191109_LF_LIB_consensus_vsearch	1533	A	R	520	11	2.04%	2	2	93	93	4.633971617249264E-4	1	1	315	205	9	2	G
B10_BC22_191109_LF_LIB_consensus_vsearch	1534	T	K	527	64	10.76%	2	1	93	93	8.930607221622375E-21	1	1	320	207	64	0	G
B10_BC22_191109_LF_LIB_consensus_vsearch	1535	T	Y	588	7	1.17%	2	2	93	93	0.007675097138165556	1	1	378	210	6	1	C
B10_BC22_191109_LF_LIB_consensus_vsearch	1536	G	*/+C	581	11	1.84%	2	1	93	93	4.659240387073297E-4	1	1	380	201	0	11	+C
B10_BC22_191109_LF_LIB_consensus_vsearch	1537	C	C	588	6	1%	2	1	93	93	0.015428048177952706	1	1	382	206	0	6	-T
B10_BC22_191109_LF_LIB_consensus_vsearch	1538	T	*/-C	573	14	2.35%	2	2	93	93	5.643185488140275E-5	1	1	378	195	1	13	-C
B10_BC22_191109_LF_LIB_consensus_vsearch	1539	C	*/+T	566	13	2.22%	2	1	93	93	1.1403476275553268E-4	1	1	382	184	0	13	+T
B10_BC22_191109_LF_LIB_consensus_vsearch	1540	T	T	593	1	0.17%	2	1	93	93	0.5000000000008233	1	1	381	212	1	0	A
B10_BC22_191109_LF_LIB_consensus_vsearch	1541	T	T	594	3	0.5%	2	2	93	93	0.12468566638724124	1	1	382	212	1	2	C
B10_BC22_191109_LF_LIB_consensus_vsearch	1542	C	C	588	4	0.67%	2	1	93	93	0.06218314350277022	1	1	382	206	0	4	+A
B10_BC22_191109_LF_LIB_consensus_vsearch	1543	A	A	591	3	0.5%	2	1	93	93	0.12468407750622149	1	1	380	211	3	0	G
B10_BC22_191109_LF_LIB_consensus_vsearch	1544	A	R	589	9	1.5%	2	1	93	93	0.001894802500745058	1	1	377	212	9	0	G
B10_BC22_191109_LF_LIB_consensus_vsearch	1545	C	C	587	4	0.67%	2	2	93	93	0.062182607140620794	1	1	378	209	2	2	-G
B10_BC22_191109_LF_LIB_consensus_vsearch	1546	G	*/-A	587	10	1.67%	2	2	93	93	9.40157711688526E-4	1	1	377	210	7	3	-A
B10_BC22_191109_LF_LIB_consensus_vsearch	1547	A	*/-G	526	46	7.77%	2	2	93	93	5.537498268746005E-15	1	1	320	206	44	2	-G
B10_BC22_191109_LF_LIB_consensus_vsearch	1548	G	G	543	2	0.36%	2	1	93	93	0.2497704315888469	1	1	335	208	0	2	+T
B10_BC22_191109_LF_LIB_consensus_vsearch	1549	G	G	584	6	1.01%	2	2	93	93	0.015426715197547503	1	1	371	213	5	1	-A
B10_BC22_191109_LF_LIB_consensus_vsearch	1550	A	A	582	3	0.51%	2	1	93	93	0.12467921300240917	1	1	369	213	3	0	T
B10_BC22_191109_LF_LIB_consensus_vsearch	1551	A	A	589	5	0.83%	2	2	93	93	0.030987064506852544	1	1	377	212	4	1	G
B10_BC22_191109_LF_LIB_consensus_vsearch	1552	T	T	591	3	0.5%	2	2	93	93	0.12468407750622149	1	1	381	210	2	1	-G
B10_BC22_191109_LF_LIB_consensus_vsearch	1553	G	*/+C	551	23	3.87%	2	2	93	93	9.520921926797758E-8	1	1	345	206	21	2	+C
B10_BC22_191109_LF_LIB_consensus_vsearch	1554	C	*/+T	554	13	2.23%	2	1	93	93	1.138687052715257E-4	1	1	367	187	0	13	+T
B10_BC22_191109_LF_LIB_consensus_vsearch	1555	C	Y	571	13	2.16%	2	2	93	93	1.1410198610539891E-4	1	1	383	188	2	11	T
B10_BC22_191109_LF_LIB_consensus_vsearch	1556	T	Y	559	9	1.52%	2	2	93	93	0.0018917480811367516	1	1	367	192	4	5	C
B10_BC22_191109_LF_LIB_consensus_vsearch	1557	A	R	573	9	1.51%	2	2	93	93	0.0018932123374629899	1	1	374	199	4	5	G
B10_BC22_191109_LF_LIB_consensus_vsearch	1558	G	R	573	8	1.35%	2	2	93	93	0.0038126509930167373	1	1	370	203	7	1	A
B10_BC22_191109_LF_LIB_consensus_vsearch	1559	T	*/-A	526	48	8.09%	2	1	93	93	1.2743099821980223E-15	1	1	333	193	48	0	-A
B10_BC22_191109_LF_LIB_consensus_vsearch	1560	A	A	533	4	0.74%	2	2	93	93	0.06215067574099081	1	1	333	200	1	3	G
B10_BC22_191109_LF_LIB_consensus_vsearch	1561	A	A	581	6	1.01%	2	2	93	93	0.015425703561055139	1	1	379	202	4	2	G
B10_BC22_191109_LF_LIB_consensus_vsearch	1562	G	G	592	2	0.34%	2	1	93	93	0.24978938500452047	1	1	383	209	2	0	+C
B10_BC22_191109_LF_LIB_consensus_vsearch	1563	C	C	591	4	0.67%	2	2	93	93	0.06218474176725347	1	1	383	208	2	2	-GC
B10_BC22_191109_LF_LIB_consensus_vsearch	1564	G	G	591	2	0.33%	2	2	93	93	0.24978902953563295	1	1	381	210	1	1	-CA
B10_BC22_191109_LF_LIB_consensus_vsearch	1565	C	C	585	5	0.84%	2	2	93	93	0.030985282661769052	1	1	380	205	1	4	T
B10_BC22_191109_LF_LIB_consensus_vsearch	1566	A	A	588	3	0.5%	2	2	93	93	0.12468247248078299	1	1	382	206	2	1	G
B10_BC22_191109_LF_LIB_consensus_vsearch	1567	T	Y	587	9	1.49%	2	2	93	93	0.001894608361560784	1	1	381	206	3	6	C
B10_BC22_191109_LF_LIB_consensus_vsearch	1568	G	G	594	4	0.67%	2	2	93	93	0.062186323989038686	1	1	384	210	3	1	A
B10_BC22_191109_LF_LIB_consensus_vsearch	1569	T	T	594	2	0.33%	2	1	93	93	0.24979009235977778	1	1	382	212	2	0	C
B10_BC22_191109_LF_LIB_consensus_vsearch	1570	C	C	599	1	0.17%	2	1	93	93	0.4999999999990043	1	1	385	214	0	1	+A
B10_BC22_191109_LF_LIB_consensus_vsearch	1571	A	A	589	6	1%	2	2	93	93	0.015428378627452975	1	1	381	208	4	2	G
B10_BC22_191109_LF_LIB_consensus_vsearch	1572	T	T	584	4	0.67%	2	1	93	93	0.062180987103355005	1	1	375	209	4	0	C
B10_BC22_191109_LF_LIB_consensus_vsearch	1573	C	C	593	1	0.17%	2	1	93	93	0.5000000000008233	1	1	383	210	0	1	-A
B10_BC22_191109_LF_LIB_consensus_vsearch	1574	A	R	575	18	3.02%	2	1	93	93	3.346514451133258E-6	1	1	367	208	18	0	G
B10_BC22_191109_LF_LIB_consensus_vsearch	1575	G	G	599	2	0.33%	2	2	93	93	0.24979184013288794	1	1	386	213	1	1	A
B10_BC22_191109_LF_LIB_consensus_vsearch	1576	C	C	595	5	0.83%	2	1	93	93	0.03098969274732699	1	1	386	209	0	5	T
B10_BC22_191109_LF_LIB_consensus_vsearch	1577	A	A	593	4	0.67%	2	1	93	93	0.06218579834936829	1	1	382	211	4	0	-T
B10_BC22_191109_LF_LIB_consensus_vsearch	1578	T	T	592	3	0.5%	2	1	93	93	0.1246846089151382	1	1	380	212	3	0	-G
B10_BC22_191109_LF_LIB_consensus_vsearch	1579	G	G	586	4	0.67%	2	1	93	93	0.062182068959449006	1	1	378	208	0	4	-CG
B10_BC22_191109_LF_LIB_consensus_vsearch	1580	C	*/-GT	564	19	3.19%	2	2	93	93	1.643269896857881E-6	1	1	380	184	1	18	-GT
B10_BC22_191109_LF_LIB_consensus_vsearch	1581	G	R	557	7	1.22%	2	2	93	93	0.007667571887622288	1	1	374	183	5	2	A
B10_BC22_191109_LF_LIB_consensus_vsearch	1582	T	Y	551	20	3.48%	2	2	93	93	8.051662009551136E-7	1	1	380	171	1	19	C
B10_BC22_191109_LF_LIB_consensus_vsearch	1583	T	Y	583	7	1.16%	2	1	93	93	0.007673936691127849	1	1	382	201	0	7	C
B10_BC22_191109_LF_LIB_consensus_vsearch	1584	G	G	596	5	0.83%	2	1	93	93	0.030990125687592227	1	1	381	215	5	0	-A
B10_BC22_191109_LF_LIB_consensus_vsearch	1585	A	*/-T	578	12	2.01%	2	2	93	93	2.3073291313309075E-4	1	1	371	207	5	7	-T
B10_BC22_191109_LF_LIB_consensus_vsearch	1586	T	T	587	3	0.51%	2	1	93	93	0.12468193384235185	1	1	379	208	3	0	G
B10_BC22_191109_LF_LIB_consensus_vsearch	1587	T	*/-AC	583	7	1.16%	2	2	93	93	0.007673936691127849	1	1	376	207	2	5	-AC
B10_BC22_191109_LF_LIB_consensus_vsearch	1588	A	R	561	14	2.36%	2	2	93	93	5.633847946619086E-5	1	1	354	207	13	1	G
B10_BC22_191109_LF_LIB_consensus_vsearch	1589	C	*/+AC	572	7	1.18%	2	1	93	93	0.00767131340646626	1	1	369	203	7	0	+AC
B10_BC22_191109_LF_LIB_consensus_vsearch	1590	G	R	555	22	3.67%	2	2	93	93	1.9442415664388025E-7	1	1	346	209	21	1	A
B10_BC22_191109_LF_LIB_consensus_vsearch	1591	T	*/-C	442	127	21.17%	2	2	93	93	2.112981868742147E-42	1	1	247	195	119	8	-C
B10_BC22_191109_LF_LIB_consensus_vsearch	1592	C	C	469	2	0.42%	2	2	93	93	0.2497343251864999	1	1	263	206	1	1	T
B10_BC22_191109_LF_LIB_consensus_vsearch	1593	C	C	590	4	0.67%	2	1	93	93	0.062184210806914414	1	1	378	212	4	0	+A
B10_BC22_191109_LF_LIB_consensus_vsearch	1594	C	*/-T	587	11	1.82%	2	2	93	93	4.661451415700126E-4	1	1	376	211	8	3	-T
B10_BC22_191109_LF_LIB_consensus_vsearch	1595	T	Y	581	10	1.69%	2	2	93	93	9.397922212937875E-4	1	1	374	207	6	4	C
B10_BC22_191109_LF_LIB_consensus_vsearch	1596	G	*/-C	570	14	2.33%	2	2	93	93	5.6408860663304025E-5	1	1	361	209	13	1	-C
B10_BC22_191109_LF_LIB_consensus_vsearch	1597	C	C	580	6	1.02%	2	1	93	93	0.01542536405110175	1	1	373	207	0	6	+T
B10_BC22_191109_LF_LIB_consensus_vsearch	1598	C	*/+T	582	7	1.16%	2	1	93	93	0.007673702245629301	1	1	378	204	0	7	+T
B10_BC22_191109_LF_LIB_consensus_vsearch	1599	C	*/-T	494	89	14.76%	2	2	93	93	4.247937078426972E-29	1	1	374	120	1	88	-T
B10_BC22_191109_LF_LIB_consensus_vsearch	1600	T	Y	490	7	1.38%	2	1	93	93	0.007648113721449173	1	1	376	114	0	7	C
B10_BC22_191109_LF_LIB_consensus_vsearch	1601	T	Y	585	8	1.34%	2	1	93	93	0.0038145345933480535	1	1	375	210	8	0	C
B10_BC22_191109_LF_LIB_consensus_vsearch	1602	T	T	583	5	0.83%	2	2	93	93	0.030984382652161722	1	1	371	212	4	1	+G
B10_BC22_191109_LF_LIB_consensus_vsearch	1603	G	G	578	5	0.83%	2	2	93	93	0.030982105624386143	1	1	369	209	4	1	+C
B10_BC22_191109_LF_LIB_consensus_vsearch	1604	T	Y	570	17	2.86%	2	2	93	93	6.783613564613483E-6	1	1	367	203	12	5	C
B10_BC22_191109_LF_LIB_consensus_vsearch	1605	A	A	581	5	0.84%	2	2	93	93	0.030983476501936075	1	1	376	205	3	2	G
B10_BC22_191109_LF_LIB_consensus_vsearch	1606	C	C	590	4	0.67%	2	1	93	93	0.062184210806914414	1	1	379	211	4	0	-ACAC
B10_BC22_191109_LF_LIB_consensus_vsearch	1607	A	A	592	2	0.34%	2	1	93	93	0.24978938500452047	1	1	378	214	2	0	G
B10_BC22_191109_LF_LIB_consensus_vsearch	1608	C	*/-AC	522	68	11.39%	2	2	93	93	4.366516716200332E-22	1	1	332	190	46	22	-AC
B10_BC22_191109_LF_LIB_consensus_vsearch	1609	A	*/+C	504	9	1.71%	2	1	93	93	0.0018852292225910899	1	1	328	176	0	9	+C
B10_BC22_191109_LF_LIB_consensus_vsearch	1610	C	*/+AC	501	17	3.25%	2	2	93	93	6.6765672903935056E-6	1	1	318	183	14	3	+AC
B10_BC22_191109_LF_LIB_consensus_vsearch	1611	C	Y	578	11	1.83%	2	2	93	93	4.658118229180549E-4	1	1	380	198	2	9	T
B10_BC22_191109_LF_LIB_consensus_vsearch	1612	G	*/-C	569	16	2.66%	2	1	93	93	1.3752374071037443E-5	1	1	357	212	16	0	-C
B10_BC22_191109_LF_LIB_consensus_vsearch	1613	C	C	581	4	0.68%	2	2	93	93	0.062179350443499135	1	1	369	212	2	2	T
B10_BC22_191109_LF_LIB_consensus_vsearch	1614	C	C	598	1	0.17%	2	1	93	93	0.5000000000008233	1	1	385	213	0	1	+G
B10_BC22_191109_LF_LIB_consensus_vsearch	1615	C	C	595	5	0.83%	2	2	93	93	0.03098969274732699	1	1	383	212	4	1	-G
B10_BC22_191109_LF_LIB_consensus_vsearch	1616	G	G	593	3	0.5%	2	1	93	93	0.12468513853935516	1	1	382	211	0	3	+C
B10_BC22_191109_LF_LIB_consensus_vsearch	1617	T	T	593	4	0.66%	2	2	93	93	0.06218579834936829	1	1	382	211	2	2	-C
B10_BC22_191109_LF_LIB_consensus_vsearch	1618	C	*/-G	584	7	1.17%	2	1	93	93	0.007674170345963	1	1	372	212	7	0	-G
B10_BC22_191109_LF_LIB_consensus_vsearch	1619	G	R	580	9	1.52%	2	1	93	93	0.001893918576967777	1	1	367	213	9	0	A
B10_BC22_191109_LF_LIB_consensus_vsearch	1620	C	*/+TT	582	8	1.33%	2	1	93	93	0.00381407083625578	1	1	369	213	8	0	+TT
B10_BC22_191109_LF_LIB_consensus_vsearch	1621	T	T	585	5	0.83%	2	2	93	93	0.030985282661769052	1	1	378	207	3	2	-A
B10_BC22_191109_LF_LIB_consensus_vsearch	1622	A	A	591	2	0.33%	2	1	93	93	0.24978902953563295	1	1	380	211	0	2	+G
B10_BC22_191109_LF_LIB_consensus_vsearch	1623	C	*/-TAC	575	17	2.82%	2	2	93	93	6.790444562646919E-6	1	1	371	204	12	5	-TAC
B10_BC22_191109_LF_LIB_consensus_vsearch	1624	T	T	574	3	0.52%	2	2	93	93	0.12467476149184535	1	1	369	205	1	2	C
B10_BC22_191109_LF_LIB_consensus_vsearch	1625	A	R	571	12	2.05%	2	2	93	93	2.3057492257149773E-4	1	1	363	208	11	1	G
B10_BC22_191109_LF_LIB_consensus_vsearch	1626	C	C	576	4	0.68%	2	2	93	93	0.0621765850361776	1	1	372	204	2	2	T
B10_BC22_191109_LF_LIB_consensus_vsearch	1627	C	Y	582	7	1.16%	2	2	93	93	0.007673702245629301	1	1	383	199	1	6	T
B10_BC22_191109_LF_LIB_consensus_vsearch	1628	G	G	594	5	0.83%	2	1	93	93	0.03098925836211217	1	1	380	214	5	0	-A
B10_BC22_191109_LF_LIB_consensus_vsearch	1629	A	A	594	3	0.5%	2	2	93	93	0.12468566638724124	1	1	381	213	1	2	+T
B10_BC22_191109_LF_LIB_consensus_vsearch	1630	T	T	596	5	0.83%	2	1	93	93	0.030990125687592227	1	1	383	213	5	0	G
B10_BC22_191109_LF_LIB_consensus_vsearch	1631	T	T	591	4	0.66%	2	2	93	93	0.06218474176725347	1	1	382	209	2	2	C
B10_BC22_191109_LF_LIB_consensus_vsearch	1632	G	*/-A	592	8	1.33%	2	2	93	93	0.003815598757548882	1	1	383	209	3	5	-A
B10_BC22_191109_LF_LIB_consensus_vsearch	1633	A	A	590	2	0.34%	2	2	93	93	0.2497886728654613	1	1	382	208	1	1	G
B10_BC22_191109_LF_LIB_consensus_vsearch	1634	A	A	594	3	0.5%	2	2	93	93	0.12468566638724124	1	1	382	212	1	2	G
B10_BC22_191109_LF_LIB_consensus_vsearch	1635	T	T	582	6	1%	2	2	93	93	0.015426041918236095	1	1	379	203	2	4	-G
B10_BC22_191109_LF_LIB_consensus_vsearch	1636	G	G	590	2	0.34%	2	1	93	93	0.2497886728654613	1	1	381	209	2	0	+AA
B10_BC22_191109_LF_LIB_consensus_vsearch	1637	G	R	590	9	1.49%	2	2	93	93	0.0018948990881047542	1	1	381	209	6	3	A
B10_BC22_191109_LF_LIB_consensus_vsearch	1638	C	C	590	4	0.66%	2	2	93	93	0.062184210806914414	1	1	381	209	1	3	-T
B10_BC22_191109_LF_LIB_consensus_vsearch	1639	T	*/+C	558	27	4.52%	2	1	93	93	5.481135075254361E-9	1	1	352	206	27	0	+C
B10_BC22_191109_LF_LIB_consensus_vsearch	1640	C	C	586	6	1.01%	2	1	93	93	0.015427383935577244	1	1	374	212	6	0	+G
B10_BC22_191109_LF_LIB_consensus_vsearch	1641	A	A	591	4	0.67%	2	2	93	93	0.06218474176725347	1	1	379	212	2	2	-G
B10_BC22_191109_LF_LIB_consensus_vsearch	1642	G	G	584	4	0.67%	2	1	93	93	0.062180987103355005	1	1	380	204	0	4	-T
B10_BC22_191109_LF_LIB_consensus_vsearch	1643	T	*/+A	568	12	2.02%	2	1	93	93	2.3050606703904357E-4	1	1	366	202	12	0	+A
B10_BC22_191109_LF_LIB_consensus_vsearch	1644	G	*/-A	566	20	3.37%	2	2	93	93	8.087221367515639E-7	1	1	363	203	17	3	-A
B10_BC22_191109_LF_LIB_consensus_vsearch	1645	A	*/-G	550	10	1.72%	2	2	93	93	9.377805631370637E-4	1	1	354	196	3	7	-G
B10_BC22_191109_LF_LIB_consensus_vsearch	1646	G	G	582	2	0.34%	2	1	93	93	0.24978577549334172	1	1	382	200	2	0	A
B10_BC22_191109_LF_LIB_consensus_vsearch	1647	G	*/-C	448	95	15.94%	2	2	93	93	2.776070234163444E-31	1	1	380	68	2	93	-C
B10_BC22_191109_LF_LIB_consensus_vsearch	1648	C	Y	436	20	4.26%	2	2	93	93	7.707932728687373E-7	1	1	379	57	2	18	T
B10_BC22_191109_LF_LIB_consensus_vsearch	1649	C	*/-T	444	63	11.09%	2	2	93	93	1.3901379600630384E-20	1	1	383	61	2	61	-T
B10_BC22_191109_LF_LIB_consensus_vsearch	1650	T	T	531	1	0.19%	2	1	93	93	0.4999999999999138	1	1	384	147	1	0	+C
B10_BC22_191109_LF_LIB_consensus_vsearch	1651	T	*/+C	402	110	18.33%	2	2	93	93	1.0785591470091142E-36	1	1	270	132	106	4	+C
B10_BC22_191109_LF_LIB_consensus_vsearch	1652	C	*/-G	470	34	6.42%	2	1	93	93	3.2727767593752444E-11	1	1	384	86	0	34	-G
B10_BC22_191109_LF_LIB_consensus_vsearch	1653	G	K	513	22	4.06%	2	1	93	93	1.912722385035204E-7	1	1	385	128	0	22	T
B10_BC22_191109_LF_LIB_consensus_vsearch	1654	G	G	592	2	0.33%	2	1	93	93	0.24978938500452047	1	1	385	207	0	2	C
B10_BC22_191109_LF_LIB_consensus_vsearch	1655	A	*/+T	580	10	1.67%	2	1	93	93	9.39730591623294E-4	1	1	382	198	0	10	+T
B10_BC22_191109_LF_LIB_consensus_vsearch	1656	C	Y	577	8	1.33%	2	2	93	93	0.0038132873975118887	1	1	377	200	1	7	T
B10_BC22_191109_LF_LIB_consensus_vsearch	1657	T	Y	554	20	3.37%	2	2	93	93	8.058912423980617E-7	1	1	370	184	6	14	C
B10_BC22_191109_LF_LIB_consensus_vsearch	1658	G	R	578	13	2.18%	2	1	93	93	1.1419423177491619E-4	1	1	367	211	13	0	A
B10_BC22_191109_LF_LIB_consensus_vsearch	1659	G	G	589	6	1%	2	1	93	93	0.015428378627452975	1	1	386	203	0	6	+C
B10_BC22_191109_LF_LIB_consensus_vsearch	1660	C	*/-T	586	7	1.16%	2	2	93	93	0.007674635299574334	1	1	383	203	1	6	-T
B10_BC22_191109_LF_LIB_consensus_vsearch	1661	T	*/+C	567	14	2.36%	2	2	93	93	5.638563569251906E-5	1	1	370	197	11	3	+C
B10_BC22_191109_LF_LIB_consensus_vsearch	1662	C	*/+A	575	7	1.17%	2	1	93	93	0.007672038647635164	1	1	372	203	7	0	+A
B10_BC22_191109_LF_LIB_consensus_vsearch	1663	A	*/-G	384	170	28.57%	2	2	93	93	1.3830096020287095E-58	1	1	274	110	92	78	-G
B10_BC22_191109_LF_LIB_consensus_vsearch	1664	G	G	403	6	1.44%	2	1	93	93	0.015339182835186115	1	1	285	118	0	6	+T
B10_BC22_191109_LF_LIB_consensus_vsearch	1665	G	G	583	3	0.51%	2	1	93	93	0.12467976088783492	1	1	379	204	3	0	+A
B10_BC22_191109_LF_LIB_consensus_vsearch	1666	G	G	590	5	0.83%	2	2	93	93	0.030987506226370864	1	1	377	213	4	1	-A
B10_BC22_191109_LF_LIB_consensus_vsearch	1667	A	*/-G	570	11	1.86%	2	2	93	93	4.6550699991566706E-4	1	1	358	212	10	1	-G
B10_BC22_191109_LF_LIB_consensus_vsearch	1668	G	G	577	3	0.51%	2	2	93	93	0.12467644521108873	1	1	367	210	2	1	A
B10_BC22_191109_LF_LIB_consensus_vsearch	1669	G	G	593	2	0.33%	2	1	93	93	0.24978973927711676	1	1	383	210	0	2	+C
B10_BC22_191109_LF_LIB_consensus_vsearch	1670	T	Y	580	14	2.33%	2	2	93	93	5.648462977218392E-5	1	1	381	199	2	12	C
B10_BC22_191109_LF_LIB_consensus_vsearch	1671	C	C	585	3	0.5%	2	1	93	93	0.1246808510636648	1	1	377	208	3	0	-G
B10_BC22_191109_LF_LIB_consensus_vsearch	1672	G	R	570	21	3.52%	2	1	93	93	3.97965376405317E-7	1	1	359	211	21	0	A
B10_BC22_191109_LF_LIB_consensus_vsearch	1673	G	G	587	6	1%	2	2	93	93	0.015427716615850288	1	1	377	210	4	2	A
B10_BC22_191109_LF_LIB_consensus_vsearch	1674	C	*/+A	577	7	1.17%	2	2	93	93	0.007672518016675552	1	1	370	207	1	6	+A
B10_BC22_191109_LF_LIB_consensus_vsearch	1675	A	A	590	3	0.51%	2	1	93	93	0.12468354430400949	1	1	376	214	3	0	G
B10_BC22_191109_LF_LIB_consensus_vsearch	1676	A	R	508	83	13.88%	2	1	93	93	4.667521820092724E-27	1	1	294	214	83	0	G
B10_BC22_191109_LF_LIB_consensus_vsearch	1677	C	*/-G	574	9	1.51%	2	2	93	93	0.0018933142585401675	1	1	365	209	8	1	-G
B10_BC22_191109_LF_LIB_consensus_vsearch	1678	G	*/-A	579	9	1.52%	2	2	93	93	0.0018938187066465067	1	1	368	211	8	1	-A
B10_BC22_191109_LF_LIB_consensus_vsearch	1679	A	*/-C	569	11	1.86%	2	2	93	93	4.654683146367026E-4	1	1	357	212	10	1	-C
B10_BC22_191109_LF_LIB_consensus_vsearch	1680	C	C	572	6	1.02%	2	2	93	93	0.015422605753746292	1	1	360	212	5	1	T
B10_BC22_191109_LF_LIB_consensus_vsearch	1681	C	*/-AC	537	41	6.82%	2	1	93	93	2.1799763479127183E-13	1	1	329	208	41	0	-AC
B10_BC22_191109_LF_LIB_consensus_vsearch	1682	A	*/-C	493	40	7.26%	2	2	93	93	4.2531842860189265E-13	1	1	291	202	31	9	-C
B10_BC22_191109_LF_LIB_consensus_vsearch	1683	C	C	498	4	0.79%	2	1	93	93	0.062126308387585344	1	1	300	198	4	0	G
B10_BC22_191109_LF_LIB_consensus_vsearch	1684	C	S	538	42	7.12%	2	1	93	93	1.0528145808332416E-13	1	1	327	211	42	0	G
B10_BC22_191109_LF_LIB_consensus_vsearch	1685	C	C	585	5	0.83%	2	1	93	93	0.030985282661769052	1	1	371	214	5	0	A
B10_BC22_191109_LF_LIB_consensus_vsearch	1686	A	*/+G	583	9	1.5%	2	2	93	93	0.0018942161800671361	1	1	372	211	7	2	+G
B10_BC22_191109_LF_LIB_consensus_vsearch	1687	G	*/-A	592	8	1.33%	2	1	93	93	0.003815598757548882	1	1	378	214	8	0	-A
B10_BC22_191109_LF_LIB_consensus_vsearch	1688	A	A	583	5	0.84%	2	1	93	93	0.030984382652161722	1	1	370	213	5	0	+G
B10_BC22_191109_LF_LIB_consensus_vsearch	1689	G	*/-C	574	16	2.67%	2	1	93	93	1.3764655753705977E-5	1	1	361	213	16	0	-C
B10_BC22_191109_LF_LIB_consensus_vsearch	1690	C	S	576	8	1.37%	2	1	93	93	0.0038131291090651434	1	1	362	214	8	0	G
B10_BC22_191109_LF_LIB_consensus_vsearch	1691	C	*/-G	537	37	6.14%	2	2	93	93	3.995934845545707E-12	1	1	331	206	33	4	-G
B10_BC22_191109_LF_LIB_consensus_vsearch	1692	G	R	548	9	1.6%	2	1	93	93	0.0018905464048331274	1	1	339	209	9	0	A
B10_BC22_191109_LF_LIB_consensus_vsearch	1693	G	*/+A	513	52	8.65%	2	2	93	93	6.490505592705398E-17	1	1	307	206	51	1	+A
B10_BC22_191109_LF_LIB_consensus_vsearch	1694	A	A	563	4	0.7%	2	1	93	93	0.062169166621763194	1	1	356	207	4	0	+G
B10_BC22_191109_LF_LIB_consensus_vsearch	1695	A	A	588	4	0.67%	2	1	93	93	0.06218314350277022	1	1	379	209	4	0	+G
B10_BC22_191109_LF_LIB_consensus_vsearch	1696	A	R	564	23	3.84%	2	2	93	93	9.569378289882198E-8	1	1	356	208	22	1	G
B10_BC22_191109_LF_LIB_consensus_vsearch	1697	G	*/+A	577	8	1.34%	2	1	93	93	0.0038132873975118887	1	1	366	211	8	0	+A
B10_BC22_191109_LF_LIB_consensus_vsearch	1698	T	W	572	13	2.18%	2	1	93	93	1.141152960809769E-4	1	1	361	211	13	0	A
B10_BC22_191109_LF_LIB_consensus_vsearch	1699	T	*/-G	582	13	2.16%	2	2	93	93	1.1424599131191439E-4	1	1	372	210	11	2	-G
B10_BC22_191109_LF_LIB_consensus_vsearch	1700	G	R	519	66	11.21%	2	1	93	93	1.9413398065503966E-21	1	1	307	212	66	0	A
B10_BC22_191109_LF_LIB_consensus_vsearch	1701	G	R	584	12	1.99%	2	2	93	93	2.3086543430195892E-4	1	1	371	213	11	1	A
B10_BC22_191109_LF_LIB_consensus_vsearch	1702	T	*/+C	572	16	2.67%	2	1	93	93	1.3759767168944509E-5	1	1	359	213	16	0	+C
B10_BC22_191109_LF_LIB_consensus_vsearch	1703	C	*/-A	578	10	1.68%	2	2	93	93	9.396067104969792E-4	1	1	372	206	4	6	-A
B10_BC22_191109_LF_LIB_consensus_vsearch	1704	A	A	586	3	0.51%	2	2	93	93	0.12468139337307069	1	1	379	207	2	1	C
B10_BC22_191109_LF_LIB_consensus_vsearch	1705	A	A	597	3	0.5%	2	1	93	93	0.12468723936635923	1	1	383	214	3	0	G
B10_BC22_191109_LF_LIB_consensus_vsearch	1706	A	R	583	10	1.66%	2	2	93	93	9.399148640318375E-4	1	1	379	204	7	3	G
B10_BC22_191109_LF_LIB_consensus_vsearch	1707	C	*/-T	585	9	1.5%	2	2	93	93	0.0018944129256754595	1	1	382	203	1	8	-T
B10_BC22_191109_LF_LIB_consensus_vsearch	1708	T	*/+C	559	18	3.04%	2	2	93	93	3.3341980066922626E-6	1	1	365	194	16	2	+C
B10_BC22_191109_LF_LIB_consensus_vsearch	1709	C	C	584	5	0.84%	2	2	93	93	0.030984833420659205	1	1	381	203	2	3	+TC
B10_BC22_191109_LF_LIB_consensus_vsearch	1710	G	G	592	5	0.83%	2	1	93	93	0.03098838522787931	1	1	381	211	5	0	A
B10_BC22_191109_LF_LIB_consensus_vsearch	1711	G	G	596	5	0.83%	2	2	93	93	0.030990125687592227	1	1	383	213	4	1	A
B10_BC22_191109_LF_LIB_consensus_vsearch	1712	T	T	597	2	0.33%	2	2	93	93	0.24979114452852993	1	1	384	213	1	1	A
B10_BC22_191109_LF_LIB_consensus_vsearch	1713	C	C	597	3	0.5%	2	1	93	93	0.12468723936635923	1	1	385	212	3	0	-A
B10_BC22_191109_LF_LIB_consensus_vsearch	1714	A	*/+T	523	63	10.52%	2	2	93	93	1.8631067641201772E-20	1	1	316	207	62	1	+T
B10_BC22_191109_LF_LIB_consensus_vsearch	1715	T	T	591	2	0.34%	2	1	93	93	0.24978902953563295	1	1	381	210	0	2	C
B10_BC22_191109_LF_LIB_consensus_vsearch	1716	T	T	598	3	0.5%	2	2	93	93	0.12468776019987309	1	1	386	212	1	2	C
B10_BC22_191109_LF_LIB_consensus_vsearch	1717	T	T	580	6	1%	2	1	93	93	0.01542536405110175	1	1	369	211	6	0	+A
B10_BC22_191109_LF_LIB_consensus_vsearch	1718	A	*/+G	560	18	3.02%	2	1	93	93	3.334986708445347E-6	1	1	368	192	0	18	+G
B10_BC22_191109_LF_LIB_consensus_vsearch	1719	G	*/-AG	568	11	1.86%	2	1	93	93	4.6542949773112336E-4	1	1	354	214	11	0	-AG
B10_BC22_191109_LF_LIB_consensus_vsearch	1720	A	*/-G	529	30	5.15%	2	2	93	93	6.244831453864281E-10	1	1	320	209	27	3	-G
B10_BC22_191109_LF_LIB_consensus_vsearch	1721	G	G	528	6	1.1%	2	1	93	93	0.015405960641249931	1	1	322	206	6	0	+AG
B10_BC22_191109_LF_LIB_consensus_vsearch	1722	G	*/-A	540	24	4.1%	2	2	93	93	4.6424525182381716E-8	1	1	327	213	23	1	-A
B10_BC22_191109_LF_LIB_consensus_vsearch	1723	A	A	561	1	0.18%	2	1	93	93	0.4999999999999138	1	1	347	214	1	0	C
B10_BC22_191109_LF_LIB_consensus_vsearch	1724	A	A	574	4	0.68%	2	1	93	93	0.06217546547116354	1	1	362	212	4	0	+T
B10_BC22_191109_LF_LIB_consensus_vsearch	1725	G	*/-T	576	8	1.35%	2	2	93	93	0.0038131291090651434	1	1	362	214	7	1	-T
B10_BC22_191109_LF_LIB_consensus_vsearch	1726	T	*/-A	488	49	8.33%	2	2	93	93	5.640453108528077E-16	1	1	322	166	20	29	-A
B10_BC22_191109_LF_LIB_consensus_vsearch	1727	A	A	530	5	0.92%	2	1	93	93	0.030958081679908694	1	1	346	184	5	0	C
B10_BC22_191109_LF_LIB_consensus_vsearch	1728	A	A	579	6	1.01%	2	1	93	93	0.015425023382419913	1	1	364	215	6	0	+G
B10_BC22_191109_LF_LIB_consensus_vsearch	1729	A	*/+G	562	23	3.81%	2	1	93	93	9.562050648761614E-8	1	1	347	215	23	0	+G
B10_BC22_191109_LF_LIB_consensus_vsearch	1730	A	*/-G	579	15	2.49%	2	2	93	93	2.7905524078281228E-5	1	1	367	212	14	1	-G
B10_BC22_191109_LF_LIB_consensus_vsearch	1731	G	R	531	17	2.9%	2	1	93	93	6.726260628736818E-6	1	1	323	208	17	0	A
B10_BC22_191109_LF_LIB_consensus_vsearch	1732	T	*/-C	586	8	1.34%	2	2	93	93	0.00381468814385855	1	1	378	208	5	3	-C
B10_BC22_191109_LF_LIB_consensus_vsearch	1733	C	*/-GT	553	21	3.55%	2	2	93	93	3.958011952909368E-7	1	1	366	187	2	19	-GT
B10_BC22_191109_LF_LIB_consensus_vsearch	1734	G	R	553	19	3.3%	2	2	93	93	1.6384896061410626E-6	1	1	361	192	18	1	A
B10_BC22_191109_LF_LIB_consensus_vsearch	1735	T	*/+A	553	7	1.2%	2	1	93	93	0.00766654042031271	1	1	372	181	0	7	+A
B10_BC22_191109_LF_LIB_consensus_vsearch	1736	A	A	582	6	1.01%	2	1	93	93	0.015426041918236095	1	1	370	212	6	0	T
B10_BC22_191109_LF_LIB_consensus_vsearch	1737	A	W	570	10	1.67%	2	2	93	93	9.39102740052465E-4	1	1	371	199	5	5	T
B10_BC22_191109_LF_LIB_consensus_vsearch	1738	C	*/+A	524	37	6.23%	2	2	93	93	3.938964108544385E-12	1	1	333	191	35	2	+A
B10_BC22_191109_LF_LIB_consensus_vsearch	1739	A	A	577	5	0.85%	2	2	93	93	0.030981645525998008	1	1	377	200	3	2	G
B10_BC22_191109_LF_LIB_consensus_vsearch	1740	A	A	577	5	0.84%	2	2	93	93	0.030981645525998008	1	1	376	201	3	2	-G
B10_BC22_191109_LF_LIB_consensus_vsearch	1741	G	G	580	5	0.85%	2	1	93	93	0.030983021104337604	1	1	379	201	0	5	T
B10_BC22_191109_LF_LIB_consensus_vsearch	1742	G	G	588	6	1%	2	1	93	93	0.015428048177952706	1	1	375	213	6	0	A
B10_BC22_191109_LF_LIB_consensus_vsearch	1743	T	*/-C	577	12	2%	2	2	93	93	2.3071056867786312E-4	1	1	380	197	1	11	-C
B10_BC22_191109_LF_LIB_consensus_vsearch	1744	C	C	581	3	0.51%	2	2	93	93	0.1246786632393088	1	1	380	201	2	1	-TC
B10_BC22_191109_LF_LIB_consensus_vsearch	1745	T	*/-C	574	14	2.34%	2	2	93	93	5.643946893550629E-5	1	1	365	209	11	3	-C
B10_BC22_191109_LF_LIB_consensus_vsearch	1746	C	C	580	1	0.17%	2	1	93	93	0.4999999999999138	1	1	370	210	1	0	+A
B10_BC22_191109_LF_LIB_consensus_vsearch	1747	C	C	586	5	0.83%	2	1	93	93	0.030985730383315414	1	1	378	208	5	0	A
B10_BC22_191109_LF_LIB_consensus_vsearch	1748	G	G	584	6	1%	2	1	93	93	0.015426715197547503	1	1	373	211	6	0	A
B10_BC22_191109_LF_LIB_consensus_vsearch	1749	T	Y	571	7	1.18%	2	2	93	93	0.007671069992311274	1	1	366	205	2	5	C
B10_BC22_191109_LF_LIB_consensus_vsearch	1750	A	*/-G	564	15	2.52%	2	2	93	93	2.784008976528302E-5	1	1	367	197	8	7	-G
B10_BC22_191109_LF_LIB_consensus_vsearch	1751	G	G	569	6	1.03%	2	1	93	93	0.015421551639459893	1	1	370	199	6	0	+A
B10_BC22_191109_LF_LIB_consensus_vsearch	1752	G	G	587	3	0.5%	2	1	93	93	0.12468193384235185	1	1	381	206	3	0	T
B10_BC22_191109_LF_LIB_consensus_vsearch	1753	T	T	582	6	1.01%	2	1	93	93	0.015426041918236095	1	1	376	206	6	0	+A
B10_BC22_191109_LF_LIB_consensus_vsearch	1754	G	*/-A	585	7	1.16%	2	1	93	93	0.007674403214110395	1	1	374	211	7	0	-A
B10_BC22_191109_LF_LIB_consensus_vsearch	1755	A	A	589	4	0.67%	2	1	93	93	0.06218367805512527	1	1	374	215	4	0	G
B10_BC22_191109_LF_LIB_consensus_vsearch	1756	A	*/-C	582	9	1.5%	2	2	93	93	0.0018941173119931185	1	1	371	211	7	2	-C
B10_BC22_191109_LF_LIB_consensus_vsearch	1757	C	C	588	1	0.17%	2	1	93	93	0.4999999999990043	1	1	377	211	0	1	+T
B10_BC22_191109_LF_LIB_consensus_vsearch	1758	C	C	588	5	0.83%	2	2	93	93	0.0309866212982286	1	1	381	207	2	3	-T
B10_BC22_191109_LF_LIB_consensus_vsearch	1759	T	Y	579	11	1.85%	2	2	93	93	4.658493531133954E-4	1	1	382	197	2	9	C
B10_BC22_191109_LF_LIB_consensus_vsearch	1760	G	G	588	4	0.67%	2	1	93	93	0.06218314350277022	1	1	381	207	4	0	-CG
B10_BC22_191109_LF_LIB_consensus_vsearch	1761	C	*/+G	568	8	1.34%	2	2	93	93	0.003811843128951762	1	1	382	186	1	7	+G
B10_BC22_191109_LF_LIB_consensus_vsearch	1762	G	G	581	5	0.84%	2	1	93	93	0.030983476501936075	1	1	381	200	0	5	+TG
B10_BC22_191109_LF_LIB_consensus_vsearch	1763	G	*/-A	591	7	1.16%	2	2	93	93	0.007675784123381086	1	1	380	211	6	1	-A
B10_BC22_191109_LF_LIB_consensus_vsearch	1764	A	*/-G	453	132	22.15%	2	2	93	93	4.351222922923468E-44	1	1	285	168	91	41	-G
B10_BC22_191109_LF_LIB_consensus_vsearch	1765	G	*/+AG	445	10	2.13%	2	1	93	93	9.289599302019507E-4	1	1	276	169	10	0	+AG
B10_BC22_191109_LF_LIB_consensus_vsearch	1766	G	G	598	1	0.17%	2	1	93	93	0.5000000000008233	1	1	385	213	0	1	+AG
B10_BC22_191109_LF_LIB_consensus_vsearch	1767	G	G	599	2	0.33%	2	1	93	93	0.24979184013288794	1	1	385	214	2	0	-A
B10_BC22_191109_LF_LIB_consensus_vsearch	1768	A	A	592	2	0.33%	2	2	93	93	0.24978938500452047	1	1	383	209	1	1	-T
B10_BC22_191109_LF_LIB_consensus_vsearch	1769	T	T	594	3	0.5%	2	2	93	93	0.12468566638724124	1	1	385	209	1	2	C
B10_BC22_191109_LF_LIB_consensus_vsearch	1770	C	*/-A	571	17	2.83%	2	1	93	93	6.784988638479219E-6	1	1	361	210	17	0	-A
B10_BC22_191109_LF_LIB_consensus_vsearch	1771	A	A	570	6	1.03%	2	2	93	93	0.015421904228749098	1	1	362	208	4	2	-T
B10_BC22_191109_LF_LIB_consensus_vsearch	1772	T	K	568	18	3.04%	2	1	93	93	3.341204460471138E-6	1	1	363	205	18	0	G
B10_BC22_191109_LF_LIB_consensus_vsearch	1773	T	T	596	3	0.5%	2	2	93	93	0.1246867167922604	1	1	387	209	1	2	C
B10_BC22_191109_LF_LIB_consensus_vsearch	1774	A	*/+C	575	8	1.33%	2	2	93	93	0.0038129702806793094	1	1	371	204	5	3	+C
B10_BC22_191109_LF_LIB_consensus_vsearch	1775	C	*/-T	567	14	2.34%	2	2	93	93	5.638563569251906E-5	1	1	363	204	9	5	-T
B10_BC22_191109_LF_LIB_consensus_vsearch	1776	T	*/-G	484	42	7.2%	2	1	93	93	9.696033099522475E-14	1	1	321	163	42	0	-G
B10_BC22_191109_LF_LIB_consensus_vsearch	1777	G	*/-A	514	30	5.41%	2	2	93	93	6.174472784437215E-10	1	1	303	211	27	3	-A
B10_BC22_191109_LF_LIB_consensus_vsearch	1778	A	A	567	2	0.35%	2	1	93	93	0.24978012313104328	1	1	356	211	2	0	-G
B10_BC22_191109_LF_LIB_consensus_vsearch	1779	G	G	590	5	0.83%	2	1	93	93	0.030987506226370864	1	1	380	210	0	5	-T
B10_BC22_191109_LF_LIB_consensus_vsearch	1780	T	Y	585	7	1.17%	2	1	93	93	0.007674403214110395	1	1	385	200	0	7	C
B10_BC22_191109_LF_LIB_consensus_vsearch	1781	G	G	593	4	0.66%	2	2	93	93	0.06218579834936829	1	1	385	208	1	3	-A
B10_BC22_191109_LF_LIB_consensus_vsearch	1782	A	*/+G	262	296	49.42%	2	2	93	93	1.8123504254692568E-113	1	1	214	48	140	156	+G
B10_BC22_191109_LF_LIB_consensus_vsearch	1783	G	G	590	0	0%	2	0	93	0	1.0	1	0	376	214	0	0	
B10_BC22_191109_LF_LIB_consensus_vsearch	1784	G	*/-A	582	11	1.84%	2	2	93	93	4.659611953509893E-4	1	1	373	209	8	3	-A
B10_BC22_191109_LF_LIB_consensus_vsearch	1785	A	*/-GA	560	14	2.39%	2	2	93	93	5.6330526991142806E-5	1	1	350	210	12	2	-GA
B10_BC22_191109_LF_LIB_consensus_vsearch	1786	G	*/-A	558	19	3.28%	2	2	93	93	1.6406837022366097E-6	1	1	361	197	4	15	-A
B10_BC22_191109_LF_LIB_consensus_vsearch	1787	A	A	560	2	0.35%	2	1	93	93	0.24977738201235208	1	1	364	196	2	0	+GA
B10_BC22_191109_LF_LIB_consensus_vsearch	1788	A	A	598	3	0.5%	2	2	93	93	0.12468776019987309	1	1	384	214	2	1	G
B10_BC22_191109_LF_LIB_consensus_vsearch	1789	A	*/-T	560	24	3.99%	2	1	93	93	4.683183782910104E-8	1	1	380	180	0	24	-T
B10_BC22_191109_LF_LIB_consensus_vsearch	1790	T	*/-CC	516	35	6.11%	2	2	93	93	1.6666418400842027E-11	1	1	337	179	34	1	-CC
B10_BC22_191109_LF_LIB_consensus_vsearch	1791	C	C	543	3	0.55%	2	2	93	93	0.12465627864354664	1	1	339	204	1	2	T
B10_BC22_191109_LF_LIB_consensus_vsearch	1792	C	Y	549	9	1.59%	2	2	93	93	0.001890657588920399	1	1	345	204	1	8	T
B10_BC22_191109_LF_LIB_consensus_vsearch	1793	C	Y	531	53	8.8%	2	2	93	93	3.2264077533925714E-17	1	1	383	148	1	52	T
B10_BC22_191109_LF_LIB_consensus_vsearch	1794	G	G	594	3	0.5%	2	1	93	93	0.12468566638724124	1	1	384	210	3	0	-A
B10_BC22_191109_LF_LIB_consensus_vsearch	1795	A	*/+C	574	10	1.67%	2	2	93	93	9.393564316164558E-4	1	1	373	201	2	8	+C
B10_BC22_191109_LF_LIB_consensus_vsearch	1796	C	C	589	3	0.5%	2	1	93	93	0.1246830092985462	1	1	385	204	0	3	T
B10_BC22_191109_LF_LIB_consensus_vsearch	1797	C	C	600	2	0.33%	2	2	93	93	0.249792186200784	1	1	387	213	1	1	-T
B10_BC22_191109_LF_LIB_consensus_vsearch	1798	T	*/-C	490	108	17.97%	2	2	93	93	1.5124017641840914E-35	1	1	279	211	105	3	-C
B10_BC22_191109_LF_LIB_consensus_vsearch	1799	C	C	488	6	1.21%	2	2	93	93	0.015388260983187537	1	1	281	207	2	4	+TC
B10_BC22_191109_LF_LIB_consensus_vsearch	1800	C	*/-A	589	12	1.99%	2	2	93	93	2.3097388431502796E-4	1	1	377	212	10	2	-A
B10_BC22_191109_LF_LIB_consensus_vsearch	1801	A	A	586	2	0.34%	2	1	93	93	0.24978723404299805	1	1	375	211	2	0	C
B10_BC22_191109_LF_LIB_consensus_vsearch	1802	A	R	481	52	8.62%	2	2	93	93	6.005548579723418E-17	1	1	291	190	50	2	G
B10_BC22_191109_LF_LIB_consensus_vsearch	1803	C	S	538	12	2.16%	2	1	93	93	2.2977702410449847E-4	1	1	340	198	12	0	G
B10_BC22_191109_LF_LIB_consensus_vsearch	1804	C	C	582	5	0.83%	2	1	93	93	0.030983930348565846	1	1	370	212	5	0	+G
B10_BC22_191109_LF_LIB_consensus_vsearch	1805	C	*/-T	484	89	14.76%	2	2	93	93	3.964824694031523E-29	1	1	324	160	40	49	-T
B10_BC22_191109_LF_LIB_consensus_vsearch	1806	T	Y	474	11	2.21%	2	2	93	93	4.610787829701709E-4	1	1	315	159	8	3	C
B10_BC22_191109_LF_LIB_consensus_vsearch	1807	T	Y	562	20	3.41%	2	2	93	93	8.077906037109274E-7	1	1	358	204	13	7	C
B10_BC22_191109_LF_LIB_consensus_vsearch	1808	T	*/+A	549	31	5.14%	2	1	93	93	3.0850004209013144E-10	1	1	349	200	31	0	+A
B10_BC22_191109_LF_LIB_consensus_vsearch	1809	G	R	548	31	5.18%	2	1	93	93	3.082747556078146E-10	1	1	346	202	31	0	A
B10_BC22_191109_LF_LIB_consensus_vsearch	1810	T	*/+A	565	13	2.2%	2	2	93	93	1.1402118179950934E-4	1	1	368	197	8	5	+A
B10_BC22_191109_LF_LIB_consensus_vsearch	1811	G	*/-A	579	9	1.52%	2	1	93	93	0.0018938187066465067	1	1	372	207	9	0	-A
B10_BC22_191109_LF_LIB_consensus_vsearch	1812	A	A	589	2	0.34%	2	1	93	93	0.2497883149871952	1	1	374	215	2	0	+G
B10_BC22_191109_LF_LIB_consensus_vsearch	1813	A	A	599	3	0.5%	2	2	93	93	0.12468827930162561	1	1	386	213	1	2	G
B10_BC22_191109_LF_LIB_consensus_vsearch	1814	C	*/-GC	586	10	1.66%	2	1	93	93	9.400973019723426E-4	1	1	373	213	10	0	-GC
B10_BC22_191109_LF_LIB_consensus_vsearch	1815	G	G	583	6	1.01%	2	1	93	93	0.015426379128433065	1	1	370	213	6	0	A
B10_BC22_191109_LF_LIB_consensus_vsearch	1816	C	C	590	2	0.34%	2	2	93	93	0.2497886728654613	1	1	376	214	1	1	T
B10_BC22_191109_LF_LIB_consensus_vsearch	1817	A	A	599	2	0.33%	2	1	93	93	0.24979184013288794	1	1	385	214	2	0	G
B10_BC22_191109_LF_LIB_consensus_vsearch	1818	T	T	591	6	1%	2	2	93	93	0.015429036211008771	1	1	381	210	4	2	C
B10_BC22_191109_LF_LIB_consensus_vsearch	1819	C	C	595	2	0.33%	2	2	93	93	0.24979044425840527	1	1	383	212	1	1	-AT
B10_BC22_191109_LF_LIB_consensus_vsearch	1820	A	A	596	1	0.17%	2	1	93	93	0.4999999999999138	1	1	383	213	1	0	+CA
B10_BC22_191109_LF_LIB_consensus_vsearch	1821	T	T	595	1	0.17%	2	1	93	93	0.4999999999999138	1	1	385	210	1	0	+A
B10_BC22_191109_LF_LIB_consensus_vsearch	1822	G	G	589	4	0.67%	2	1	93	93	0.06218367805512527	1	1	382	207	0	4	-TTG
B10_BC22_191109_LF_LIB_consensus_vsearch	1823	T	Y	555	36	6.04%	2	2	93	93	8.399199675591037E-12	1	1	380	175	2	34	C
B10_BC22_191109_LF_LIB_consensus_vsearch	1824	T	Y	584	8	1.34%	2	2	93	93	0.0038143805269862142	1	1	380	204	4	4	C
B10_BC22_191109_LF_LIB_consensus_vsearch	1825	G	G	591	4	0.67%	2	1	93	93	0.06218474176725347	1	1	384	207	0	4	-C
B10_BC22_191109_LF_LIB_consensus_vsearch	1826	C	*/-TT	555	21	3.51%	2	1	93	93	3.9606193040821893E-7	1	1	363	192	21	0	-TT
B10_BC22_191109_LF_LIB_consensus_vsearch	1827	T	T	561	2	0.36%	2	1	93	93	0.24977777777807272	1	1	363	198	0	2	C
B10_BC22_191109_LF_LIB_consensus_vsearch	1828	T	T	579	2	0.34%	2	2	93	93	0.24978466838924643	1	1	365	214	1	1	C
B10_BC22_191109_LF_LIB_consensus_vsearch	1829	T	*/-G	406	158	26.25%	2	2	93	93	7.28368166983833E-54	1	1	255	151	102	56	-G
B10_BC22_191109_LF_LIB_consensus_vsearch	1830	G	R	411	18	4.11%	2	1	93	93	3.1797854475104E-6	1	1	258	153	18	0	A
B10_BC22_191109_LF_LIB_consensus_vsearch	1831	G	R	581	13	2.18%	2	1	93	93	1.1423311528767137E-4	1	1	370	211	13	0	A
B10_BC22_191109_LF_LIB_consensus_vsearch	1832	G	R	590	11	1.82%	2	1	93	93	4.6625406138871647E-4	1	1	375	215	11	0	A
B10_BC22_191109_LF_LIB_consensus_vsearch	1833	G	R	590	8	1.33%	2	2	93	93	0.003815297238788008	1	1	380	210	6	2	A
B10_BC22_191109_LF_LIB_consensus_vsearch	1834	G	G	596	2	0.33%	2	1	93	93	0.24979079497935539	1	1	385	211	0	2	-CG
B10_BC22_191109_LF_LIB_consensus_vsearch	1835	C	C	586	5	0.83%	2	2	93	93	0.030985730383315414	1	1	381	205	3	2	T
B10_BC22_191109_LF_LIB_consensus_vsearch	1836	G	G	588	4	0.67%	2	1	93	93	0.06218314350277022	1	1	382	206	4	0	-A
B10_BC22_191109_LF_LIB_consensus_vsearch	1837	A	*/-C	541	32	5.37%	2	2	93	93	1.4918834237799374E-10	1	1	354	187	19	13	-C
B10_BC22_191109_LF_LIB_consensus_vsearch	1838	C	*/+T	551	8	1.41%	2	1	93	93	0.0038089889297735855	1	1	366	185	0	8	+T
B10_BC22_191109_LF_LIB_consensus_vsearch	1839	C	Y	578	9	1.5%	2	1	93	93	0.001893718498855406	1	1	384	194	0	9	T
B10_BC22_191109_LF_LIB_consensus_vsearch	1840	C	*/-T	562	18	2.99%	2	2	93	93	3.3365563818796594E-6	1	1	370	192	3	15	-T
B10_BC22_191109_LF_LIB_consensus_vsearch	1841	T	Y	566	7	1.21%	2	2	93	93	0.007669840222466952	1	1	380	186	1	6	C
B10_BC22_191109_LF_LIB_consensus_vsearch	1842	G	G	578	5	0.85%	2	1	93	93	0.030982105624386143	1	1	372	206	5	0	+C
B10_BC22_191109_LF_LIB_consensus_vsearch	1843	C	C	583	4	0.68%	2	1	93	93	0.06218044340963991	1	1	381	202	0	4	T
B10_BC22_191109_LF_LIB_consensus_vsearch	1844	C	Y	573	22	3.67%	2	1	93	93	1.9565001112381234E-7	1	1	384	189	0	22	T
B10_BC22_191109_LF_LIB_consensus_vsearch	1845	G	G	588	5	0.83%	2	1	93	93	0.0309866212982286	1	1	377	211	5	0	+T
B10_BC22_191109_LF_LIB_consensus_vsearch	1846	T	Y	585	11	1.84%	2	2	93	93	4.6607192805233423E-4	1	1	385	200	1	10	C
B10_BC22_191109_LF_LIB_consensus_vsearch	1847	T	T	585	6	1%	2	2	93	93	0.015427050131369397	1	1	380	205	1	5	C
B10_BC22_191109_LF_LIB_consensus_vsearch	1848	C	*/-G	584	9	1.51%	2	2	93	93	0.0018943147174077597	1	1	374	210	8	1	-G
B10_BC22_191109_LF_LIB_consensus_vsearch	1849	G	R	576	12	2.02%	2	1	93	93	2.306881496410543E-4	1	1	363	213	12	0	A
B10_BC22_191109_LF_LIB_consensus_vsearch	1850	C	Y	570	13	2.17%	2	1	93	93	1.1408863153197961E-4	1	1	365	205	13	0	T
B10_BC22_191109_LF_LIB_consensus_vsearch	1851	G	R	552	33	5.62%	2	2	93	93	7.31802271953932E-11	1	1	348	204	31	2	A
B10_BC22_191109_LF_LIB_consensus_vsearch	1852	G	R	582	9	1.52%	2	1	93	93	0.0018941173119931185	1	1	373	209	9	0	A
B10_BC22_191109_LF_LIB_consensus_vsearch	1853	C	C	583	6	1.01%	2	2	93	93	0.015426379128433065	1	1	380	203	1	5	T
B10_BC22_191109_LF_LIB_consensus_vsearch	1854	A	*/+T	562	29	4.83%	2	1	93	93	1.30995082745155E-9	1	1	354	208	29	0	+T
B10_BC22_191109_LF_LIB_consensus_vsearch	1855	T	T	591	4	0.67%	2	1	93	93	0.06218474176725347	1	1	380	211	4	0	C
B10_BC22_191109_LF_LIB_consensus_vsearch	1856	T	*/+C	190	284	47.18%	2	2	93	93	2.4107108307195463E-113	1	1	154	36	170	114	+C
B10_BC22_191109_LF_LIB_consensus_vsearch	1857	C	C	552	2	0.36%	2	1	93	93	0.24977416440874464	1	1	369	183	2	0	T
B10_BC22_191109_LF_LIB_consensus_vsearch	1858	C	C	593	1	0.17%	2	1	93	93	0.5000000000008233	1	1	383	210	0	1	+G
B10_BC22_191109_LF_LIB_consensus_vsearch	1859	C	Y	580	12	2%	2	1	93	93	2.3077737978553087E-4	1	1	380	200	0	12	T
B10_BC22_191109_LF_LIB_consensus_vsearch	1860	C	*/+T	568	9	1.49%	2	1	93	93	0.0018926974773018042	1	1	369	199	0	9	+T
B10_BC22_191109_LF_LIB_consensus_vsearch	1861	G	*/+A	507	44	7.42%	2	1	93	93	2.3250611342877612E-14	1	1	294	213	44	0	+A
B10_BC22_191109_LF_LIB_consensus_vsearch	1862	A	M	549	8	1.42%	2	2	93	93	0.003808641755461624	1	1	339	210	7	1	C
B10_BC22_191109_LF_LIB_consensus_vsearch	1863	A	*/-G	583	16	2.65%	2	1	93	93	1.3786265853415174E-5	1	1	371	212	16	0	-G
B10_BC22_191109_LF_LIB_consensus_vsearch	1864	G	G	577	4	0.68%	2	1	93	93	0.06217714192710672	1	1	365	212	4	0	A
B10_BC22_191109_LF_LIB_consensus_vsearch	1865	G	G	596	3	0.5%	2	1	93	93	0.1246867167922604	1	1	383	213	3	0	A
B10_BC22_191109_LF_LIB_consensus_vsearch	1866	T	T	596	3	0.5%	2	2	93	93	0.1246867167922604	1	1	384	212	2	1	C
B10_BC22_191109_LF_LIB_consensus_vsearch	1867	C	C	594	2	0.33%	2	1	93	93	0.24979009235977778	1	1	384	210	0	2	+A
B10_BC22_191109_LF_LIB_consensus_vsearch	1868	A	R	584	11	1.82%	2	2	93	93	4.660351394123344E-4	1	1	378	206	9	2	G
B10_BC22_191109_LF_LIB_consensus_vsearch	1869	T	T	587	6	1%	2	2	93	93	0.015427716615850288	1	1	380	207	3	3	-C
B10_BC22_191109_LF_LIB_consensus_vsearch	1870	C	*/-A	506	64	10.79%	2	2	93	93	8.323181729783114E-21	1	1	330	176	38	26	-A
B10_BC22_191109_LF_LIB_consensus_vsearch	1871	A	R	516	8	1.51%	2	2	93	93	0.0038025331739636116	1	1	334	182	7	1	G
B10_BC22_191109_LF_LIB_consensus_vsearch	1872	A	A	591	2	0.33%	2	1	93	93	0.24978902953563295	1	1	379	212	2	0	+G
B10_BC22_191109_LF_LIB_consensus_vsearch	1873	A	A	592	4	0.67%	2	1	93	93	0.06218527094514562	1	1	377	215	4	0	+C
B10_BC22_191109_LF_LIB_consensus_vsearch	1874	A	R	575	17	2.82%	2	2	93	93	6.790444562646919E-6	1	1	365	210	13	4	G
B10_BC22_191109_LF_LIB_consensus_vsearch	1875	C	*/-A	574	12	1.99%	2	1	93	93	2.3064308632724596E-4	1	1	360	214	12	0	-A
B10_BC22_191109_LF_LIB_consensus_vsearch	1876	A	A	579	6	1.02%	2	2	93	93	0.015425023382419913	1	1	368	211	3	3	G
B10_BC22_191109_LF_LIB_consensus_vsearch	1877	C	*/-T	577	8	1.34%	2	2	93	93	0.0038132873975118887	1	1	363	214	7	1	-T
B10_BC22_191109_LF_LIB_consensus_vsearch	1878	T	Y	583	7	1.19%	2	2	93	93	0.007673936691127849	1	1	373	210	3	4	C
B10_BC22_191109_LF_LIB_consensus_vsearch	1879	G	G	591	6	1%	2	1	93	93	0.015429036211008771	1	1	377	214	6	0	A
B10_BC22_191109_LF_LIB_consensus_vsearch	1880	C	C	595	3	0.5%	2	2	93	93	0.12468619246852639	1	1	385	210	1	2	T
B10_BC22_191109_LF_LIB_consensus_vsearch	1881	A	A	592	2	0.33%	2	1	93	93	0.24978938500452047	1	1	384	208	0	2	+T
B10_BC22_191109_LF_LIB_consensus_vsearch	1882	T	T	593	4	0.67%	2	2	93	93	0.06218579834936829	1	1	385	208	2	2	C
B10_BC22_191109_LF_LIB_consensus_vsearch	1883	T	T	583	5	0.83%	2	2	93	93	0.030984382652161722	1	1	381	202	1	4	-C
B10_BC22_191109_LF_LIB_consensus_vsearch	1884	C	*/-T	573	10	1.69%	2	2	93	93	9.392933313754103E-4	1	1	379	194	1	9	-T
B10_BC22_191109_LF_LIB_consensus_vsearch	1885	T	T	578	3	0.51%	2	2	93	93	0.12467700258396955	1	1	378	200	2	1	C
B10_BC22_191109_LF_LIB_consensus_vsearch	1886	T	Y	586	7	1.17%	2	2	93	93	0.007674635299574334	1	1	377	209	3	4	C
B10_BC22_191109_LF_LIB_consensus_vsearch	1887	A	A	586	5	0.83%	2	2	93	93	0.030985730383315414	1	1	375	211	4	1	G
B10_BC22_191109_LF_LIB_consensus_vsearch	1888	C	C	591	3	0.5%	2	1	93	93	0.12468407750622149	1	1	380	211	0	3	T
B10_BC22_191109_LF_LIB_consensus_vsearch	1889	G	G	596	2	0.33%	2	1	93	93	0.24979079497935539	1	1	383	213	2	0	A
B10_BC22_191109_LF_LIB_consensus_vsearch	1890	T	*/+C	587	9	1.49%	2	1	93	93	0.001894608361560784	1	1	375	212	9	0	+C
B10_BC22_191109_LF_LIB_consensus_vsearch	1891	C	C	588	5	0.83%	2	2	93	93	0.0309866212982286	1	1	378	210	4	1	-G
B10_BC22_191109_LF_LIB_consensus_vsearch	1892	G	R	556	38	6.38%	2	2	93	93	1.9744333972407125E-12	1	1	345	211	37	1	A
B10_BC22_191109_LF_LIB_consensus_vsearch	1893	G	*/-A	516	79	13.14%	2	1	93	93	1.0322717113720222E-25	1	1	303	213	79	0	-A
B10_BC22_191109_LF_LIB_consensus_vsearch	1894	A	A	513	3	0.57%	2	2	93	93	0.12463627546097235	1	1	303	210	2	1	+G
B10_BC22_191109_LF_LIB_consensus_vsearch	1895	G	G	586	5	0.83%	2	2	93	93	0.030985730383315414	1	1	380	206	2	3	-T
B10_BC22_191109_LF_LIB_consensus_vsearch	1896	T	*/+A	196	326	54.79%	2	2	93	93	4.437747121403688E-132	1	1	129	67	200	126	+A
B10_BC22_191109_LF_LIB_consensus_vsearch	1897	A	A	557	2	0.36%	2	1	93	93	0.24977618621279463	1	1	352	205	0	2	G
B10_BC22_191109_LF_LIB_consensus_vsearch	1898	A	A	583	6	1.01%	2	2	93	93	0.015426379128433065	1	1	374	209	5	1	+G
B10_BC22_191109_LF_LIB_consensus_vsearch	1899	A	A	587	6	1%	2	1	93	93	0.015427716615850288	1	1	375	212	6	0	+G
B10_BC22_191109_LF_LIB_consensus_vsearch	1900	A	A	594	4	0.66%	2	2	93	93	0.062186323989038686	1	1	381	213	3	1	+G
B10_BC22_191109_LF_LIB_consensus_vsearch	1901	G	G	585	6	1%	2	1	93	93	0.015427050131369397	1	1	373	212	6	0	+A
B10_BC22_191109_LF_LIB_consensus_vsearch	1902	T	T	595	6	1%	2	2	93	93	0.01543033827052791	1	1	387	208	1	5	C
B10_BC22_191109_LF_LIB_consensus_vsearch	1903	T	T	589	4	0.66%	2	2	93	93	0.06218367805512527	1	1	379	210	3	1	-A
B10_BC22_191109_LF_LIB_consensus_vsearch	1904	A	A	591	4	0.67%	2	2	93	93	0.06218474176725347	1	1	381	210	2	2	G
B10_BC22_191109_LF_LIB_consensus_vsearch	1905	A	A	589	4	0.66%	2	2	93	93	0.06218367805512527	1	1	381	208	2	2	-T
B10_BC22_191109_LF_LIB_consensus_vsearch	1906	T	T	592	2	0.34%	2	1	93	93	0.24978938500452047	1	1	383	209	0	2	C
B10_BC22_191109_LF_LIB_consensus_vsearch	1907	T	T	594	3	0.5%	2	2	93	93	0.12468566638724124	1	1	383	211	2	1	C
B10_BC22_191109_LF_LIB_consensus_vsearch	1908	T	*/-A	582	13	2.16%	2	2	93	93	1.1424599131191439E-4	1	1	372	210	12	1	-A
B10_BC22_191109_LF_LIB_consensus_vsearch	1909	A	A	586	2	0.34%	2	2	93	93	0.24978723404299805	1	1	374	212	1	1	G
B10_BC22_191109_LF_LIB_consensus_vsearch	1910	A	R	586	9	1.5%	2	1	93	93	0.0018945108065208946	1	1	372	214	9	0	G
B10_BC22_191109_LF_LIB_consensus_vsearch	1911	T	*/-A	535	30	5.01%	2	2	93	93	6.272113514665773E-10	1	1	366	169	9	21	-A
B10_BC22_191109_LF_LIB_consensus_vsearch	1912	A	A	561	4	0.7%	2	1	93	93	0.062167995014182846	1	1	368	193	4	0	C
B10_BC22_191109_LF_LIB_consensus_vsearch	1913	A	A	591	2	0.33%	2	1	93	93	0.24978902953563295	1	1	377	214	2	0	C
B10_BC22_191109_LF_LIB_consensus_vsearch	1914	A	A	596	4	0.66%	2	1	93	93	0.062187370009836374	1	1	381	215	4	0	G
B10_BC22_191109_LF_LIB_consensus_vsearch	1915	A	R	591	8	1.33%	2	1	93	93	0.0038154482484643428	1	1	378	213	8	0	G
B10_BC22_191109_LF_LIB_consensus_vsearch	1916	C	*/-TTT	572	9	1.5%	2	2	93	93	0.0018931100684577166	1	1	375	197	2	7	-TTT
B10_BC22_191109_LF_LIB_consensus_vsearch	1917	T	T	579	4	0.69%	2	2	93	93	0.0621782499750882	1	1	382	197	1	3	C
B10_BC22_191109_LF_LIB_consensus_vsearch	1918	T	T	584	3	0.51%	2	1	93	93	0.12468030690531334	1	1	385	199	0	3	+CT
B10_BC22_191109_LF_LIB_consensus_vsearch	1919	T	T	577	5	0.84%	2	1	93	93	0.030981645525998008	1	1	376	201	5	0	+C
B10_BC22_191109_LF_LIB_consensus_vsearch	1920	C	C	587	4	0.67%	2	1	93	93	0.062182607140620794	1	1	380	207	4	0	T
B10_BC22_191109_LF_LIB_consensus_vsearch	1921	A	A	596	2	0.33%	2	1	93	93	0.24979079497935539	1	1	383	213	2	0	+G
B10_BC22_191109_LF_LIB_consensus_vsearch	1922	A	R	583	11	1.83%	2	1	93	93	4.65998228714525E-4	1	1	372	211	11	0	G
B10_BC22_191109_LF_LIB_consensus_vsearch	1923	C	C	590	5	0.83%	2	1	93	93	0.030987506226370864	1	1	378	212	5	0	-AAC
B10_BC22_191109_LF_LIB_consensus_vsearch	1924	A	A	593	3	0.5%	2	1	93	93	0.12468513853935516	1	1	379	214	3	0	G
B10_BC22_191109_LF_LIB_consensus_vsearch	1925	A	R	583	10	1.68%	2	1	93	93	9.399148640318375E-4	1	1	370	213	10	0	G
B10_BC22_191109_LF_LIB_consensus_vsearch	1926	C	*/-G	571	8	1.34%	2	2	93	93	0.0038123295121620672	1	1	370	201	1	7	-G
B10_BC22_191109_LF_LIB_consensus_vsearch	1927	G	G	590	2	0.34%	2	1	93	93	0.2497886728654613	1	1	384	206	2	0	+A
B10_BC22_191109_LF_LIB_consensus_vsearch	1928	G	G	597	3	0.5%	2	2	93	93	0.12468723936635923	1	1	384	213	2	1	-A
B10_BC22_191109_LF_LIB_consensus_vsearch	1929	A	A	589	5	0.83%	2	1	93	93	0.030987064506852544	1	1	384	205	0	5	-T
B10_BC22_191109_LF_LIB_consensus_vsearch	1930	T	*/-C	582	7	1.18%	2	1	93	93	0.007673702245629301	1	1	386	196	0	7	-C
B10_BC22_191109_LF_LIB_consensus_vsearch	1931	C	C	589	1	0.17%	2	1	93	93	0.5000000000008233	1	1	387	202	0	1	+GA
B10_BC22_191109_LF_LIB_consensus_vsearch	1932	T	T	574	6	1.01%	2	2	93	93	0.01542330244911806	1	1	378	196	2	4	C
B10_BC22_191109_LF_LIB_consensus_vsearch	1933	C	*/-T	559	21	3.56%	2	2	93	93	3.9657841456427714E-7	1	1	377	182	5	16	-T
B10_BC22_191109_LF_LIB_consensus_vsearch	1934	T	*/+CT	562	8	1.39%	2	2	93	93	0.003810855092140287	1	1	373	189	4	4	+CT
B10_BC22_191109_LF_LIB_consensus_vsearch	1935	T	*/+A	581	8	1.33%	2	1	93	93	0.0038139152066312184	1	1	377	204	8	0	+A
B10_BC22_191109_LF_LIB_consensus_vsearch	1936	G	R	576	14	2.36%	2	1	93	93	5.645462176707094E-5	1	1	373	203	14	0	A
B10_BC22_191109_LF_LIB_consensus_vsearch	1937	G	*/+T	571	10	1.66%	2	1	93	93	9.391664866947025E-4	1	1	364	207	10	0	+T
B10_BC22_191109_LF_LIB_consensus_vsearch	1938	T	T	593	3	0.5%	2	2	93	93	0.12468513853935516	1	1	387	206	1	2	A
B10_BC22_191109_LF_LIB_consensus_vsearch	1939	T	Y	591	7	1.16%	2	2	93	93	0.007675784123381086	1	1	381	210	4	3	C
B10_BC22_191109_LF_LIB_consensus_vsearch	1940	C	C	593	3	0.5%	2	1	93	93	0.12468513853935516	1	1	383	210	3	0	+A
B10_BC22_191109_LF_LIB_consensus_vsearch	1941	T	*/-G	575	16	2.66%	2	2	93	93	1.3767088119335913E-5	1	1	376	199	2	14	-G
B10_BC22_191109_LF_LIB_consensus_vsearch	1942	G	G	575	6	1.03%	2	1	93	93	0.015423649001259471	1	1	375	200	6	0	A
B10_BC22_191109_LF_LIB_consensus_vsearch	1943	G	G	597	2	0.33%	2	1	93	93	0.24979114452852993	1	1	386	211	0	2	A
B10_BC22_191109_LF_LIB_consensus_vsearch	1944	C	Y	588	10	1.67%	2	2	93	93	9.402179215996255E-4	1	1	383	205	2	8	T
B10_BC22_191109_LF_LIB_consensus_vsearch	1945	A	A	598	4	0.66%	2	2	93	93	0.06218840907720501	1	1	384	214	3	1	G
B10_BC22_191109_LF_LIB_consensus_vsearch	1946	T	T	601	1	0.17%	2	1	93	93	0.4999999999990043	1	1	386	215	1	0	-C
B10_BC22_191109_LF_LIB_consensus_vsearch	1947	C	C	595	3	0.5%	2	1	93	93	0.12468619246852639	1	1	384	211	0	3	-G
B10_BC22_191109_LF_LIB_consensus_vsearch	1948	G	G	595	3	0.5%	2	1	93	93	0.12468619246852639	1	1	383	212	3	0	-A
B10_BC22_191109_LF_LIB_consensus_vsearch	1949	A	A	600	0	0%	2	0	93	0	1.0	1	0	385	215	0	0	
B10_BC22_191109_LF_LIB_consensus_vsearch	1950	T	T	596	4	0.66%	2	1	93	93	0.062187370009836374	1	1	383	213	4	0	+A
B10_BC22_191109_LF_LIB_consensus_vsearch	1951	G	*/+A	592	7	1.16%	2	1	93	93	0.007676011594473652	1	1	378	214	7	0	+A
B10_BC22_191109_LF_LIB_consensus_vsearch	1952	A	A	599	1	0.17%	2	1	93	93	0.4999999999990043	1	1	384	215	1	0	+G
B10_BC22_191109_LF_LIB_consensus_vsearch	1953	A	A	593	5	0.83%	2	2	93	93	0.03098882252468081	1	1	380	213	3	2	G
B10_BC22_191109_LF_LIB_consensus_vsearch	1954	G	*/-A	578	9	1.51%	2	1	93	93	0.001893718498855406	1	1	372	206	9	0	-A
B10_BC22_191109_LF_LIB_consensus_vsearch	1955	A	A	583	4	0.68%	2	2	93	93	0.06218044340963991	1	1	369	214	3	1	G
B10_BC22_191109_LF_LIB_consensus_vsearch	1956	A	A	589	4	0.67%	2	1	93	93	0.06218367805512527	1	1	376	213	4	0	-C
B10_BC22_191109_LF_LIB_consensus_vsearch	1957	C	C	588	4	0.67%	2	2	93	93	0.06218314350277022	1	1	377	211	2	2	T
B10_BC22_191109_LF_LIB_consensus_vsearch	1958	G	*/-CA	582	9	1.5%	2	2	93	93	0.0018941173119931185	1	1	370	212	8	1	-CA
B10_BC22_191109_LF_LIB_consensus_vsearch	1959	C	*/-AGC	573	7	1.18%	2	1	93	93	0.0076715559842246905	1	1	364	209	7	0	-AGC
B10_BC22_191109_LF_LIB_consensus_vsearch	1960	A	R	535	43	7.35%	2	2	93	93	5.051621451982351E-14	1	1	325	210	42	1	G
B10_BC22_191109_LF_LIB_consensus_vsearch	1961	G	G	577	4	0.68%	2	2	93	93	0.06217714192710672	1	1	373	204	1	3	A
B10_BC22_191109_LF_LIB_consensus_vsearch	1962	C	*/+G	559	8	1.35%	2	1	93	93	0.0038103532778841847	1	1	356	203	8	0	+G
B10_BC22_191109_LF_LIB_consensus_vsearch	1963	G	*/-A	569	13	2.18%	2	2	93	93	1.1407523213728538E-4	1	1	373	196	3	10	-A
B10_BC22_191109_LF_LIB_consensus_vsearch	1964	A	A	579	3	0.51%	2	2	93	93	0.12467755803936205	1	1	378	201	1	2	G
B10_BC22_191109_LF_LIB_consensus_vsearch	1965	A	A	597	2	0.33%	2	1	93	93	0.24979114452852993	1	1	383	214	2	0	G
B10_BC22_191109_LF_LIB_consensus_vsearch	1966	A	A	599	1	0.17%	2	1	93	93	0.4999999999990043	1	1	385	214	1	0	-T
B10_BC22_191109_LF_LIB_consensus_vsearch	1967	T	T	595	2	0.33%	2	1	93	93	0.24979044425840527	1	1	384	211	2	0	-G
B10_BC22_191109_LF_LIB_consensus_vsearch	1968	G	R	573	19	3.16%	2	1	93	93	1.647056656618272E-6	1	1	363	210	19	0	A
B10_BC22_191109_LF_LIB_consensus_vsearch	1969	C	C	586	4	0.67%	2	1	93	93	0.062182068959449006	1	1	378	208	4	0	+AC
B10_BC22_191109_LF_LIB_consensus_vsearch	1970	G	G	592	3	0.5%	2	1	93	93	0.1246846089151382	1	1	382	210	3	0	A
B10_BC22_191109_LF_LIB_consensus_vsearch	1971	A	A	596	1	0.17%	2	1	93	93	0.4999999999999138	1	1	384	212	1	0	+C
B10_BC22_191109_LF_LIB_consensus_vsearch	1972	T	T	581	6	1%	2	2	93	93	0.015425703561055139	1	1	374	207	3	3	-A
B10_BC22_191109_LF_LIB_consensus_vsearch	1973	A	A	584	4	0.67%	2	2	93	93	0.062180987103355005	1	1	378	206	1	3	G
B10_BC22_191109_LF_LIB_consensus_vsearch	1974	A	R	586	8	1.33%	2	2	93	93	0.00381468814385855	1	1	379	207	4	4	G
B10_BC22_191109_LF_LIB_consensus_vsearch	1975	G	G	586	5	0.84%	2	1	93	93	0.030985730383315414	1	1	374	212	5	0	A
B10_BC22_191109_LF_LIB_consensus_vsearch	1976	T	*/-A	566	15	2.5%	2	2	93	93	2.784900299453663E-5	1	1	377	189	5	10	-A
B10_BC22_191109_LF_LIB_consensus_vsearch	1977	A	A	583	0	0%	2	0	93	0	1.0	1	0	379	204	0	0	
B10_BC22_191109_LF_LIB_consensus_vsearch	1978	A	A	597	2	0.33%	2	1	93	93	0.24979114452852993	1	1	385	212	2	0	G
B10_BC22_191109_LF_LIB_consensus_vsearch	1979	T	Y	581	14	2.33%	2	2	93	93	5.6492070470485533E-5	1	1	381	200	3	11	C
B10_BC22_191109_LF_LIB_consensus_vsearch	1980	G	*/-TG	556	32	5.34%	2	2	93	93	1.5093958882482914E-10	1	1	357	199	19	13	-TG
B10_BC22_191109_LF_LIB_consensus_vsearch	1981	T	*/-GA	522	23	4.06%	2	1	93	93	9.405322557937265E-8	1	1	332	190	23	0	-GA
B10_BC22_191109_LF_LIB_consensus_vsearch	1982	G	*/-AA	482	42	7.75%	2	2	93	93	9.6632281775807E-14	1	1	286	196	41	1	-AA
B10_BC22_191109_LF_LIB_consensus_vsearch	1983	A	A	516	5	0.95%	2	1	93	93	0.030950241263123	1	1	302	214	5	0	+G
B10_BC22_191109_LF_LIB_consensus_vsearch	1984	A	A	550	2	0.36%	2	1	93	93	0.24977334542118992	1	1	338	212	2	0	+T
B10_BC22_191109_LF_LIB_consensus_vsearch	1985	T	K	529	64	10.74%	2	1	93	93	8.988244690136368E-21	1	1	317	212	64	0	G
B10_BC22_191109_LF_LIB_consensus_vsearch	1986	T	T	594	2	0.33%	2	1	93	93	0.24979009235977778	1	1	385	209	0	2	+G
B10_BC22_191109_LF_LIB_consensus_vsearch	1987	G	G	594	3	0.5%	2	1	93	93	0.12468566638724124	1	1	381	213	3	0	-C
B10_BC22_191109_LF_LIB_consensus_vsearch	1988	C	C	583	5	0.83%	2	1	93	93	0.030984382652161722	1	1	371	212	5	0	+G
B10_BC22_191109_LF_LIB_consensus_vsearch	1989	A	*/+G	567	10	1.67%	2	1	93	93	9.389101896133754E-4	1	1	356	211	10	0	+G
B10_BC22_191109_LF_LIB_consensus_vsearch	1990	G	G	579	6	1.01%	2	2	93	93	0.015425023382419913	1	1	369	210	5	1	+A
B10_BC22_191109_LF_LIB_consensus_vsearch	1991	A	A	588	2	0.34%	2	1	93	93	0.2497879558944788	1	1	376	212	2	0	+G
B10_BC22_191109_LF_LIB_consensus_vsearch	1992	A	*/-T	585	8	1.34%	2	2	93	93	0.0038145345933480535	1	1	377	208	3	5	-T
B10_BC22_191109_LF_LIB_consensus_vsearch	1993	T	T	587	2	0.34%	2	1	93	93	0.249787595581865	1	1	381	206	0	2	+C
B10_BC22_191109_LF_LIB_consensus_vsearch	1994	T	*/+C	582	10	1.66%	2	2	93	93	9.398536450879837E-4	1	1	377	205	9	1	+C
B10_BC22_191109_LF_LIB_consensus_vsearch	1995	C	C	584	4	0.67%	2	2	93	93	0.062180987103355005	1	1	377	207	2	2	-A
B10_BC22_191109_LF_LIB_consensus_vsearch	1996	A	R	574	13	2.17%	2	2	93	93	1.1414178313129473E-4	1	1	367	207	12	1	G
B10_BC22_191109_LF_LIB_consensus_vsearch	1997	G	G	582	5	0.84%	2	2	93	93	0.030983930348565846	1	1	378	204	4	1	T
B10_BC22_191109_LF_LIB_consensus_vsearch	1998	T	T	589	4	0.67%	2	2	93	93	0.06218367805512527	1	1	381	208	3	1	C
B10_BC22_191109_LF_LIB_consensus_vsearch	1999	G	G	586	4	0.67%	2	1	93	93	0.062182068959449006	1	1	381	205	4	0	-A
B10_BC22_191109_LF_LIB_consensus_vsearch	2000	A	A	592	3	0.5%	2	1	93	93	0.1246846089151382	1	1	377	215	3	0	G
B10_BC22_191109_LF_LIB_consensus_vsearch	2001	A	A	598	3	0.5%	2	1	93	93	0.12468776019987309	1	1	384	214	3	0	G
B10_BC22_191109_LF_LIB_consensus_vsearch	2002	T	T	592	4	0.66%	2	2	93	93	0.06218527094514562	1	1	380	212	3	1	C
B10_BC22_191109_LF_LIB_consensus_vsearch	2003	C	C	592	4	0.67%	2	1	93	93	0.06218527094514562	1	1	386	206	0	4	-ATC
B10_BC22_191109_LF_LIB_consensus_vsearch	2004	A	A	593	4	0.67%	2	2	93	93	0.06218579834936829	1	1	383	210	3	1	G
B10_BC22_191109_LF_LIB_consensus_vsearch	2005	T	*/+C	583	9	1.5%	2	1	93	93	0.0018942161800671361	1	1	374	209	9	0	+C
B10_BC22_191109_LF_LIB_consensus_vsearch	2006	C	*/+A	563	24	4.04%	2	2	93	93	4.6890785017411166E-8	1	1	357	206	23	1	+A
B10_BC22_191109_LF_LIB_consensus_vsearch	2007	G	*/-A	569	25	4.17%	2	2	93	93	2.3028316352755332E-8	1	1	358	211	23	2	-A
B10_BC22_191109_LF_LIB_consensus_vsearch	2008	A	A	576	2	0.35%	2	1	93	93	0.24978354978355208	1	1	363	213	2	0	+G
B10_BC22_191109_LF_LIB_consensus_vsearch	2009	A	A	595	3	0.5%	2	2	93	93	0.12468619246852639	1	1	384	211	2	1	G
B10_BC22_191109_LF_LIB_consensus_vsearch	2010	T	T	594	2	0.33%	2	1	93	93	0.24979009235977778	1	1	385	209	0	2	-C
B10_BC22_191109_LF_LIB_consensus_vsearch	2011	C	*/-T	549	35	5.83%	2	2	93	93	1.7216462232953046E-11	1	1	378	171	4	31	-T
B10_BC22_191109_LF_LIB_consensus_vsearch	2012	T	T	557	4	0.71%	2	2	93	93	0.062165626726408726	1	1	379	178	3	1	C
B10_BC22_191109_LF_LIB_consensus_vsearch	2013	T	T	591	4	0.67%	2	2	93	93	0.06218474176725347	1	1	381	210	3	1	C
B10_BC22_191109_LF_LIB_consensus_vsearch	2014	T	T	590	4	0.66%	2	2	93	93	0.062184210806914414	1	1	380	210	1	3	+G
B10_BC22_191109_LF_LIB_consensus_vsearch	2015	G	G	588	4	0.67%	2	2	93	93	0.06218314350277022	1	1	378	210	3	1	A
B10_BC22_191109_LF_LIB_consensus_vsearch	2016	A	A	588	5	0.83%	2	1	93	93	0.0309866212982286	1	1	375	213	5	0	+G
B10_BC22_191109_LF_LIB_consensus_vsearch	2017	A	R	581	7	1.16%	2	2	93	93	0.007673467005464533	1	1	376	205	5	2	G
B10_BC22_191109_LF_LIB_consensus_vsearch	2018	C	Y	566	12	2.01%	2	2	93	93	2.3045977381397776E-4	1	1	367	199	2	10	T
B10_BC22_191109_LF_LIB_consensus_vsearch	2019	G	G	581	2	0.34%	2	2	93	93	0.24978540772560268	1	1	369	212	1	1	-C
B10_BC22_191109_LF_LIB_consensus_vsearch	2020	C	Y	570	12	2.05%	2	2	93	93	2.3055204810949474E-4	1	1	370	200	1	11	T
B10_BC22_191109_LF_LIB_consensus_vsearch	2021	A	*/-CA	543	48	8.01%	2	2	93	93	1.3140982064896066E-15	1	1	333	210	45	3	-CA
B10_BC22_191109_LF_LIB_consensus_vsearch	2022	C	C	545	3	0.54%	2	1	93	93	0.12465753424651009	1	1	334	211	3	0	-A
B10_BC22_191109_LF_LIB_consensus_vsearch	2023	A	A	526	5	0.91%	2	1	93	93	0.030955883727255742	1	1	326	200	5	0	+T
B10_BC22_191109_LF_LIB_consensus_vsearch	2024	T	T	585	4	0.67%	2	2	93	93	0.06218152895025356	1	1	383	202	3	1	G
B10_BC22_191109_LF_LIB_consensus_vsearch	2025	T	T	593	2	0.34%	2	1	93	93	0.24978973927711676	1	1	386	207	2	0	-G
B10_BC22_191109_LF_LIB_consensus_vsearch	2026	G	G	584	6	1.01%	2	2	93	93	0.015426715197547503	1	1	378	206	5	1	A
B10_BC22_191109_LF_LIB_consensus_vsearch	2027	C	*/-GC	567	8	1.33%	2	1	93	93	0.0038116798798562227	1	1	363	204	8	0	-GC
B10_BC22_191109_LF_LIB_consensus_vsearch	2028	G	*/-C	303	207	35.75%	2	2	93	93	1.5096673397538574E-74	1	1	217	86	105	102	-C
B10_BC22_191109_LF_LIB_consensus_vsearch	2029	C	C	322	1	0.31%	2	1	93	93	0.4999999999999138	1	1	224	98	1	0	A
B10_BC22_191109_LF_LIB_consensus_vsearch	2030	C	C	537	1	0.19%	2	1	93	93	0.4999999999999138	1	1	337	200	0	1	+T
B10_BC22_191109_LF_LIB_consensus_vsearch	2031	C	C	575	2	0.35%	2	2	93	93	0.24978317432825756	1	1	362	213	1	1	T
B10_BC22_191109_LF_LIB_consensus_vsearch	2032	C	C	590	4	0.67%	2	2	93	93	0.062184210806914414	1	1	377	213	3	1	+T
B10_BC22_191109_LF_LIB_consensus_vsearch	2033	C	*/-T	586	7	1.16%	2	2	93	93	0.007674635299574334	1	1	378	208	3	4	-T
B10_BC22_191109_LF_LIB_consensus_vsearch	2034	T	*/-G	575	8	1.35%	2	2	93	93	0.0038129702806793094	1	1	371	204	7	1	-G
B10_BC22_191109_LF_LIB_consensus_vsearch	2035	G	*/+A	567	9	1.53%	2	2	93	93	0.0018925934416486783	1	1	358	209	7	2	+A
B10_BC22_191109_LF_LIB_consensus_vsearch	2036	G	G	587	3	0.5%	2	1	93	93	0.12468193384235185	1	1	376	211	3	0	T
B10_BC22_191109_LF_LIB_consensus_vsearch	2037	T	Y	569	12	2%	2	2	93	93	2.305290963962864E-4	1	1	371	198	2	10	C
B10_BC22_191109_LF_LIB_consensus_vsearch	2038	A	A	578	3	0.51%	2	1	93	93	0.12467700258396955	1	1	371	207	3	0	G
B10_BC22_191109_LF_LIB_consensus_vsearch	2039	T	T	589	1	0.17%	2	1	93	93	0.5000000000008233	1	1	378	211	0	1	+C
B10_BC22_191109_LF_LIB_consensus_vsearch	2040	T	*/+C	199	386	64.33%	2	2	93	93	6.727691663734405E-160	1	1	154	45	225	161	+C
B10_BC22_191109_LF_LIB_consensus_vsearch	2041	C	*/+G	430	79	13.12%	2	2	93	93	6.205002228402527E-26	1	1	261	169	63	16	+G
B10_BC22_191109_LF_LIB_consensus_vsearch	2042	G	S	484	75	12.98%	2	2	93	93	1.8485860142862124E-24	1	1	312	172	40	35	C
B10_BC22_191109_LF_LIB_consensus_vsearch	2043	G	R	583	13	2.17%	2	2	93	93	1.1425882511188655E-4	1	1	375	208	11	2	A
B10_BC22_191109_LF_LIB_consensus_vsearch	2044	G	G	594	6	1%	2	2	93	93	0.015430014380448172	1	1	381	213	5	1	A
B10_BC22_191109_LF_LIB_consensus_vsearch	2045	G	G	591	6	1%	2	1	93	93	0.015429036211008771	1	1	379	212	6	0	+A
B10_BC22_191109_LF_LIB_consensus_vsearch	2046	G	G	600	2	0.33%	2	1	93	93	0.249792186200784	1	1	387	213	0	2	A
B10_BC22_191109_LF_LIB_consensus_vsearch	2047	C	C	588	6	1%	2	2	93	93	0.015428048177952706	1	1	384	204	2	4	T
B10_BC22_191109_LF_LIB_consensus_vsearch	2048	A	A	585	5	0.84%	2	2	93	93	0.030985282661769052	1	1	382	203	3	2	G
B10_BC22_191109_LF_LIB_consensus_vsearch	2049	T	Y	578	11	1.84%	2	2	93	93	4.658118229180549E-4	1	1	381	197	3	8	C
B10_BC22_191109_LF_LIB_consensus_vsearch	2050	G	G	581	6	1%	2	2	93	93	0.015425703561055139	1	1	372	209	4	2	+TG
B10_BC22_191109_LF_LIB_consensus_vsearch	2051	C	C	587	3	0.5%	2	1	93	93	0.12468193384235185	1	1	380	207	0	3	+T
B10_BC22_191109_LF_LIB_consensus_vsearch	2052	C	*/-T	581	10	1.67%	2	2	93	93	9.397922212937875E-4	1	1	376	205	5	5	-T
B10_BC22_191109_LF_LIB_consensus_vsearch	2053	T	Y	572	7	1.19%	2	2	93	93	0.00767131340646626	1	1	372	200	1	6	C
B10_BC22_191109_LF_LIB_consensus_vsearch	2054	G	R	559	21	3.54%	2	2	93	93	3.9657841456427714E-7	1	1	350	209	17	4	A
B10_BC22_191109_LF_LIB_consensus_vsearch	2055	T	T	573	5	0.85%	2	2	93	93	0.03097978921914043	1	1	367	206	2	3	C
B10_BC22_191109_LF_LIB_consensus_vsearch	2056	T	*/-C	583	9	1.51%	2	2	93	93	0.0018942161800671361	1	1	380	203	3	6	-C
B10_BC22_191109_LF_LIB_consensus_vsearch	2057	C	C	576	5	0.84%	2	2	93	93	0.030981183844570895	1	1	373	203	4	1	+A
B10_BC22_191109_LF_LIB_consensus_vsearch	2058	G	*/-A	568	21	3.51%	2	1	93	93	3.9771676773039065E-7	1	1	358	210	21	0	-A
B10_BC22_191109_LF_LIB_consensus_vsearch	2059	A	*/-G	548	20	3.46%	2	2	93	93	8.044340285378534E-7	1	1	343	205	17	3	-G
B10_BC22_191109_LF_LIB_consensus_vsearch	2060	G	G	561	4	0.69%	2	2	93	93	0.062167995014182846	1	1	365	196	1	3	A
B10_BC22_191109_LF_LIB_consensus_vsearch	2061	C	C	580	5	0.84%	2	1	93	93	0.030983021104337604	1	1	380	200	0	5	+T
B10_BC22_191109_LF_LIB_consensus_vsearch	2062	G	*/+A	572	14	2.35%	2	1	93	93	5.642421556871879E-5	1	1	363	209	14	0	+A
B10_BC22_191109_LF_LIB_consensus_vsearch	2063	T	T	586	6	1%	2	2	93	93	0.015427383935577244	1	1	376	210	3	3	C
B10_BC22_191109_LF_LIB_consensus_vsearch	2064	C	C	591	2	0.34%	2	1	93	93	0.24978902953563295	1	1	377	214	2	0	-A
B10_BC22_191109_LF_LIB_consensus_vsearch	2065	A	R	571	9	1.5%	2	2	93	93	0.0018930074497425708	1	1	365	206	7	2	G
B10_BC22_191109_LF_LIB_consensus_vsearch	2066	T	T	584	5	0.84%	2	2	93	93	0.030984833420659205	1	1	380	204	1	4	C
B10_BC22_191109_LF_LIB_consensus_vsearch	2067	T	T	593	3	0.5%	2	2	93	93	0.12468513853935516	1	1	382	211	2	1	C
B10_BC22_191109_LF_LIB_consensus_vsearch	2068	T	T	589	3	0.5%	2	1	93	93	0.1246830092985462	1	1	379	210	3	0	C
B10_BC22_191109_LF_LIB_consensus_vsearch	2069	C	C	592	1	0.17%	2	1	93	93	0.4999999999999138	1	1	380	212	0	1	+G
B10_BC22_191109_LF_LIB_consensus_vsearch	2070	A	A	587	5	0.83%	2	1	93	93	0.030986176592841308	1	1	377	210	5	0	G
B10_BC22_191109_LF_LIB_consensus_vsearch	2071	C	C	592	2	0.33%	2	2	93	93	0.24978938500452047	1	1	380	212	1	1	+T
B10_BC22_191109_LF_LIB_consensus_vsearch	2072	C	*/-A	584	10	1.66%	2	1	93	93	9.39975879151716E-4	1	1	370	214	10	0	-A
B10_BC22_191109_LF_LIB_consensus_vsearch	2073	A	*/+C	567	11	1.87%	2	1	93	93	4.653905485314612E-4	1	1	366	201	0	11	+C
B10_BC22_191109_LF_LIB_consensus_vsearch	2074	C	*/-T	552	39	6.52%	2	2	93	93	9.513704465393965E-13	1	1	377	175	3	36	-T
B10_BC22_191109_LF_LIB_consensus_vsearch	2075	T	*/+C	526	23	4.09%	2	1	93	93	9.421921648565862E-8	1	1	359	167	23	0	+C
B10_BC22_191109_LF_LIB_consensus_vsearch	2076	C	*/-A	555	12	2.03%	2	2	93	93	2.30199436603214E-4	1	1	370	185	7	5	-A
B10_BC22_191109_LF_LIB_consensus_vsearch	2077	A	A	562	5	0.86%	2	1	93	93	0.03097454938768609	1	1	371	191	0	5	T
B10_BC22_191109_LF_LIB_consensus_vsearch	2078	A	R	568	13	2.2%	2	2	93	93	1.1406178769493562E-4	1	1	378	190	6	7	G
B10_BC22_191109_LF_LIB_consensus_vsearch	2079	G	*/-C	568	18	3.01%	2	2	93	93	3.341204460471138E-6	1	1	367	201	10	8	-C
B10_BC22_191109_LF_LIB_consensus_vsearch	2080	C	C	575	2	0.34%	2	1	93	93	0.24978317432825756	1	1	370	205	2	0	A
B10_BC22_191109_LF_LIB_consensus_vsearch	2081	C	*/-T	566	32	5.31%	2	2	93	93	1.52067666110348E-10	1	1	385	181	2	30	-T
B10_BC22_191109_LF_LIB_consensus_vsearch	2082	T	*/-C	559	8	1.4%	2	1	93	93	0.0038103532778841847	1	1	384	175	0	8	-C
B10_BC22_191109_LF_LIB_consensus_vsearch	2083	C	C	579	5	0.84%	2	1	93	93	0.03098256414789269	1	1	378	201	5	0	-G
B10_BC22_191109_LF_LIB_consensus_vsearch	2084	G	*/-C	580	12	2.01%	2	1	93	93	2.3077737978553087E-4	1	1	379	201	0	12	-C
B10_BC22_191109_LF_LIB_consensus_vsearch	2085	C	*/-T	567	9	1.53%	2	2	93	93	0.0018925934416486783	1	1	375	192	3	6	-T
B10_BC22_191109_LF_LIB_consensus_vsearch	2086	T	T	584	2	0.34%	2	2	93	93	0.2497865072588101	1	1	377	207	1	1	C
B10_BC22_191109_LF_LIB_consensus_vsearch	2087	T	*/-G	551	25	4.19%	2	2	93	93	2.2839467112974575E-8	1	1	371	180	7	18	-G
B10_BC22_191109_LF_LIB_consensus_vsearch	2088	G	G	561	4	0.7%	2	2	93	93	0.062167995014182846	1	1	373	188	3	1	A
B10_BC22_191109_LF_LIB_consensus_vsearch	2089	G	R	580	9	1.51%	2	1	93	93	0.001893918576967777	1	1	386	194	0	9	A
B10_BC22_191109_LF_LIB_consensus_vsearch	2090	T	Y	565	9	1.52%	2	2	93	93	0.0018923842920326984	1	1	373	192	2	7	C
B10_BC22_191109_LF_LIB_consensus_vsearch	2091	A	A	568	6	1.02%	2	2	93	93	0.015421197823763643	1	1	371	197	1	5	-T
B10_BC22_191109_LF_LIB_consensus_vsearch	2092	T	Y	569	9	1.54%	2	2	93	93	0.0018928011559758858	1	1	373	196	3	6	C
B10_BC22_191109_LF_LIB_consensus_vsearch	2093	T	T	578	6	1.01%	2	2	93	93	0.015424681549082461	1	1	377	201	2	4	-G
B10_BC22_191109_LF_LIB_consensus_vsearch	2094	G	G	578	4	0.68%	2	1	93	93	0.06217769690336766	1	1	374	204	4	0	A
B10_BC22_191109_LF_LIB_consensus_vsearch	2095	G	*/+A	521	66	11.02%	2	1	93	93	1.95501629020025E-21	1	1	314	207	66	0	+A
B10_BC22_191109_LF_LIB_consensus_vsearch	2096	G	G	594	3	0.5%	2	2	93	93	0.12468566638724124	1	1	384	210	1	2	A
B10_BC22_191109_LF_LIB_consensus_vsearch	2097	C	C	589	3	0.5%	2	1	93	93	0.1246830092985462	1	1	378	211	3	0	+A
B10_BC22_191109_LF_LIB_consensus_vsearch	2098	G	R	567	22	3.67%	2	2	93	93	1.95249026854527E-7	1	1	360	207	20	2	A
B10_BC22_191109_LF_LIB_consensus_vsearch	2099	T	T	589	6	1%	2	1	93	93	0.015428378627452975	1	1	378	211	6	0	+C
B10_BC22_191109_LF_LIB_consensus_vsearch	2100	C	*/-G	573	10	1.67%	2	1	93	93	9.392933313754103E-4	1	1	362	211	10	0	-G
B10_BC22_191109_LF_LIB_consensus_vsearch	2101	G	R	554	22	3.72%	2	2	93	93	1.943539976803395E-7	1	1	347	207	21	1	A
B10_BC22_191109_LF_LIB_consensus_vsearch	2102	C	Y	523	27	4.52%	2	2	93	93	5.372487197153554E-9	1	1	321	202	24	3	T
B10_BC22_191109_LF_LIB_consensus_vsearch	2103	G	*/-A	543	16	2.73%	2	2	93	93	1.3685112619426907E-5	1	1	344	199	12	4	-A
B10_BC22_191109_LF_LIB_consensus_vsearch	2104	A	R	567	8	1.37%	2	2	93	93	0.0038116798798562227	1	1	361	206	6	2	G
B10_BC22_191109_LF_LIB_consensus_vsearch	2105	G	*/-T	564	22	3.67%	2	2	93	93	1.9504571214644284E-7	1	1	376	188	6	16	-T
B10_BC22_191109_LF_LIB_consensus_vsearch	2106	T	*/-C	564	8	1.38%	2	2	93	93	0.0038111867275475823	1	1	375	189	2	6	-C
B10_BC22_191109_LF_LIB_consensus_vsearch	2107	C	*/-T	575	10	1.69%	2	2	93	93	9.394193185721279E-4	1	1	378	197	1	9	-T
B10_BC22_191109_LF_LIB_consensus_vsearch	2108	T	Y	571	13	2.2%	2	2	93	93	1.1410198610539891E-4	1	1	384	187	1	12	C
B10_BC22_191109_LF_LIB_consensus_vsearch	2109	C	*/-TC	508	57	9.5%	2	2	93	93	1.5678887069937404E-18	1	1	328	180	30	27	-TC
B10_BC22_191109_LF_LIB_consensus_vsearch	2110	T	Y	487	10	1.95%	2	2	93	93	9.329294440127185E-4	1	1	319	168	2	8	C
B10_BC22_191109_LF_LIB_consensus_vsearch	2111	C	*/-G	490	11	2.13%	2	2	93	93	4.6193262335897546E-4	1	1	312	178	9	2	-G
B10_BC22_191109_LF_LIB_consensus_vsearch	2112	G	R	550	10	1.76%	2	1	93	93	9.377805631370637E-4	1	1	338	212	10	0	A
B10_BC22_191109_LF_LIB_consensus_vsearch	2113	C	*/-G	536	10	1.73%	2	2	93	93	9.367981057926079E-4	1	1	324	212	9	1	-G
B10_BC22_191109_LF_LIB_consensus_vsearch	2114	G	*/+C	545	19	3.25%	2	1	93	93	1.634903109315917E-6	1	1	331	214	19	0	+C
B10_BC22_191109_LF_LIB_consensus_vsearch	2115	C	*/-GC	455	81	13.66%	2	2	93	93	1.5697495206912702E-26	1	1	251	204	70	11	-GC
B10_BC22_191109_LF_LIB_consensus_vsearch	2116	G	*/-C	460	19	3.75%	2	2	93	93	1.589931152311044E-6	1	1	261	199	17	2	-C
B10_BC22_191109_LF_LIB_consensus_vsearch	2117	C	Y	463	9	1.84%	2	2	93	93	0.0018793914772358292	1	1	267	196	6	3	T
B10_BC22_191109_LF_LIB_consensus_vsearch	2118	C	*/-TT	541	15	2.52%	2	2	93	93	2.7733140540321765E-5	1	1	333	208	14	1	-TT
B10_BC22_191109_LF_LIB_consensus_vsearch	2119	T	W	532	10	1.78%	2	1	93	93	9.365081955943183E-4	1	1	321	211	10	0	A
B10_BC22_191109_LF_LIB_consensus_vsearch	2120	T	*/-A	522	17	2.94%	2	2	93	93	6.71190474743033E-6	1	1	320	202	15	2	-A
B10_BC22_191109_LF_LIB_consensus_vsearch	2121	A	R	557	7	1.22%	2	1	93	93	0.007667571887622288	1	1	348	209	7	0	G
B10_BC22_191109_LF_LIB_consensus_vsearch	2122	A	*/+G	583	9	1.5%	2	1	93	93	0.0018942161800671361	1	1	371	212	9	0	+G
B10_BC22_191109_LF_LIB_consensus_vsearch	2123	A	*/-G	591	10	1.66%	2	1	93	93	9.403973623913355E-4	1	1	377	214	10	0	-G
B10_BC22_191109_LF_LIB_consensus_vsearch	2124	G	R	560	24	4.05%	2	1	93	93	4.683183782910104E-8	1	1	350	210	24	0	A
B10_BC22_191109_LF_LIB_consensus_vsearch	2125	T	*/-C	575	18	3%	2	1	93	93	3.346514451133258E-6	1	1	383	192	0	18	-C
B10_BC22_191109_LF_LIB_consensus_vsearch	2126	C	*/-TC	565	7	1.2%	2	2	93	93	0.007669591697725923	1	1	372	193	6	1	-TC
B10_BC22_191109_LF_LIB_consensus_vsearch	2127	T	*/-C	544	32	5.43%	2	2	93	93	1.4954443744982165E-10	1	1	339	205	31	1	-C
B10_BC22_191109_LF_LIB_consensus_vsearch	2128	C	C	554	4	0.72%	2	1	93	93	0.06216382821860171	1	1	342	212	4	0	+TC
B10_BC22_191109_LF_LIB_consensus_vsearch	2129	C	C	582	6	1%	2	2	93	93	0.015426041918236095	1	1	375	207	5	1	-G
B10_BC22_191109_LF_LIB_consensus_vsearch	2130	G	R	584	9	1.51%	2	1	93	93	0.0018943147174077597	1	1	371	213	9	0	A
B10_BC22_191109_LF_LIB_consensus_vsearch	2131	G	G	592	4	0.67%	2	1	93	93	0.06218527094514562	1	1	379	213	4	0	+C
B10_BC22_191109_LF_LIB_consensus_vsearch	2132	C	C	592	5	0.83%	2	2	93	93	0.03098838522787931	1	1	380	212	3	2	T
B10_BC22_191109_LF_LIB_consensus_vsearch	2133	T	Y	574	13	2.16%	2	2	93	93	1.1414178313129473E-4	1	1	379	195	2	11	C
B10_BC22_191109_LF_LIB_consensus_vsearch	2134	G	*/-A	586	9	1.49%	2	2	93	93	0.0018945108065208946	1	1	375	211	7	2	-A
B10_BC22_191109_LF_LIB_consensus_vsearch	2135	A	*/-G	570	10	1.69%	2	2	93	93	9.39102740052465E-4	1	1	361	209	7	3	-G
B10_BC22_191109_LF_LIB_consensus_vsearch	2136	G	G	581	2	0.34%	2	1	93	93	0.24978540772560268	1	1	374	207	2	0	+A
B10_BC22_191109_LF_LIB_consensus_vsearch	2137	C	C	582	5	0.83%	2	1	93	93	0.030983930348565846	1	1	379	203	5	0	+A
B10_BC22_191109_LF_LIB_consensus_vsearch	2138	G	R	590	7	1.17%	2	1	93	93	0.007675555892850146	1	1	378	212	7	0	A
B10_BC22_191109_LF_LIB_consensus_vsearch	2139	G	*/+T	566	20	3.32%	2	1	93	93	8.087221367515639E-7	1	1	355	211	20	0	+T
B10_BC22_191109_LF_LIB_consensus_vsearch	2140	T	Y	585	7	1.17%	2	1	93	93	0.007674403214110395	1	1	387	198	0	7	C
B10_BC22_191109_LF_LIB_consensus_vsearch	2141	T	T	583	6	1%	2	2	93	93	0.015426379128433065	1	1	380	203	1	5	-C
B10_BC22_191109_LF_LIB_consensus_vsearch	2142	C	C	581	2	0.34%	2	2	93	93	0.24978540772560268	1	1	382	199	1	1	+A
B10_BC22_191109_LF_LIB_consensus_vsearch	2143	G	G	582	5	0.84%	2	1	93	93	0.030983930348565846	1	1	382	200	0	5	-T
B10_BC22_191109_LF_LIB_consensus_vsearch	2144	T	Y	581	11	1.85%	2	2	93	93	4.659240387073297E-4	1	1	380	201	7	4	C
B10_BC22_191109_LF_LIB_consensus_vsearch	2145	C	*/-T	588	7	1.17%	2	1	93	93	0.007675097138165556	1	1	385	203	0	7	-T
B10_BC22_191109_LF_LIB_consensus_vsearch	2146	T	*/-C	457	73	12.31%	2	2	93	93	7.378992293409466E-24	1	1	335	122	25	48	-C
B10_BC22_191109_LF_LIB_consensus_vsearch	2147	C	C	509	2	0.39%	2	1	93	93	0.2497551420178245	1	1	344	165	2	0	+TC
B10_BC22_191109_LF_LIB_consensus_vsearch	2148	C	C	577	2	0.34%	2	2	93	93	0.24978392394086635	1	1	369	208	1	1	G
B10_BC22_191109_LF_LIB_consensus_vsearch	2149	C	C	594	2	0.33%	2	1	93	93	0.24979009235977778	1	1	386	208	0	2	A
B10_BC22_191109_LF_LIB_consensus_vsearch	2150	A	A	595	4	0.66%	2	1	93	93	0.062186847872822006	1	1	387	208	0	4	T
B10_BC22_191109_LF_LIB_consensus_vsearch	2151	G	R	586	12	1.99%	2	1	93	93	2.3090902793379252E-4	1	1	375	211	12	0	A
B10_BC22_191109_LF_LIB_consensus_vsearch	2152	C	*/+T	586	7	1.17%	2	1	93	93	0.007674635299574334	1	1	384	202	0	7	+T
B10_BC22_191109_LF_LIB_consensus_vsearch	2153	G	G	587	5	0.83%	2	1	93	93	0.030986176592841308	1	1	383	204	0	5	-T
B10_BC22_191109_LF_LIB_consensus_vsearch	2154	T	Y	587	9	1.51%	2	1	93	93	0.001894608361560784	1	1	388	199	0	9	C
B10_BC22_191109_LF_LIB_consensus_vsearch	2155	T	Y	585	9	1.49%	2	2	93	93	0.0018944129256754595	1	1	378	207	3	6	C
B10_BC22_191109_LF_LIB_consensus_vsearch	2156	G	G	573	6	1%	2	2	93	93	0.015422954702023957	1	1	374	199	2	4	-T
B10_BC22_191109_LF_LIB_consensus_vsearch	2157	T	Y	545	13	2.2%	2	2	93	93	1.1373958909834942E-4	1	1	362	183	7	6	C
B10_BC22_191109_LF_LIB_consensus_vsearch	2158	G	R	561	23	3.9%	2	2	93	93	9.558369752998525E-8	1	1	352	209	21	2	A
B10_BC22_191109_LF_LIB_consensus_vsearch	2159	G	R	587	9	1.5%	2	2	93	93	0.001894608361560784	1	1	375	212	7	2	A
B10_BC22_191109_LF_LIB_consensus_vsearch	2160	C	*/-A	570	10	1.67%	2	2	93	93	9.39102740052465E-4	1	1	366	204	5	5	-A
B10_BC22_191109_LF_LIB_consensus_vsearch	2161	A	A	580	4	0.68%	2	2	93	93	0.06217880115194425	1	1	371	209	3	1	G
B10_BC22_191109_LF_LIB_consensus_vsearch	2162	A	R	552	40	6.69%	2	2	93	93	4.600032928325088E-13	1	1	339	213	39	1	G
B10_BC22_191109_LF_LIB_consensus_vsearch	2163	C	C	587	3	0.5%	2	1	93	93	0.12468193384235185	1	1	374	213	3	0	+GC
B10_BC22_191109_LF_LIB_consensus_vsearch	2164	T	Y	583	9	1.5%	2	2	93	93	0.0018942161800671361	1	1	377	206	1	8	C
B10_BC22_191109_LF_LIB_consensus_vsearch	2165	A	R	572	12	2.01%	2	2	93	93	2.3059772017075368E-4	1	1	363	209	11	1	G
B10_BC22_191109_LF_LIB_consensus_vsearch	2166	T	T	586	4	0.67%	2	2	93	93	0.062182068959449006	1	1	375	211	3	1	C
B10_BC22_191109_LF_LIB_consensus_vsearch	2167	T	T	596	4	0.67%	2	2	93	93	0.062187370009836374	1	1	384	212	3	1	C
B10_BC22_191109_LF_LIB_consensus_vsearch	2168	T	*/+C	583	7	1.16%	2	1	93	93	0.007673936691127849	1	1	380	203	0	7	+C
B10_BC22_191109_LF_LIB_consensus_vsearch	2169	C	C	580	5	0.83%	2	2	93	93	0.030983021104337604	1	1	379	201	1	4	+T
B10_BC22_191109_LF_LIB_consensus_vsearch	2170	G	G	585	5	0.83%	2	2	93	93	0.030985282661769052	1	1	373	212	4	1	A
B10_BC22_191109_LF_LIB_consensus_vsearch	2171	C	*/+G	583	8	1.34%	2	1	93	93	0.0038142259421648926	1	1	375	208	8	0	+G
B10_BC22_191109_LF_LIB_consensus_vsearch	2172	A	R	581	12	2.01%	2	1	93	93	2.3079950271826945E-4	1	1	370	211	12	0	G
B10_BC22_191109_LF_LIB_consensus_vsearch	2173	G	G	593	3	0.5%	2	1	93	93	0.12468513853935516	1	1	383	210	0	3	-TG
B10_BC22_191109_LF_LIB_consensus_vsearch	2174	T	*/-G	578	12	2.01%	2	2	93	93	2.3073291313309075E-4	1	1	376	202	9	3	-G
B10_BC22_191109_LF_LIB_consensus_vsearch	2175	G	G	584	1	0.17%	2	1	93	93	0.4999999999999138	1	1	378	206	0	1	+A
B10_BC22_191109_LF_LIB_consensus_vsearch	2176	G	*/-A	577	19	3.16%	2	1	93	93	1.6487050868445217E-6	1	1	365	212	19	0	-A
B10_BC22_191109_LF_LIB_consensus_vsearch	2177	A	A	577	3	0.52%	2	1	93	93	0.12467644521108873	1	1	363	214	3	0	G
B10_BC22_191109_LF_LIB_consensus_vsearch	2178	G	G	589	6	1%	2	2	93	93	0.015428378627452975	1	1	378	211	5	1	+T
B10_BC22_191109_LF_LIB_consensus_vsearch	2179	T	T	592	5	0.83%	2	2	93	93	0.03098838522787931	1	1	383	209	3	2	C
B10_BC22_191109_LF_LIB_consensus_vsearch	2180	T	*/+C	581	10	1.66%	2	2	93	93	9.397922212937875E-4	1	1	375	206	9	1	+C
B10_BC22_191109_LF_LIB_consensus_vsearch	2181	C	*/-G	541	32	5.38%	2	1	93	93	1.4918834237799374E-10	1	1	343	198	32	0	-G
B10_BC22_191109_LF_LIB_consensus_vsearch	2182	G	*/-A	559	7	1.23%	2	2	93	93	0.007668082173792139	1	1	347	212	5	2	-A
B10_BC22_191109_LF_LIB_consensus_vsearch	2183	A	*/+G	579	8	1.34%	2	1	93	93	0.003813602365568841	1	1	369	210	8	0	+G
B10_BC22_191109_LF_LIB_consensus_vsearch	2184	G	G	591	4	0.67%	2	1	93	93	0.06218474176725347	1	1	384	207	0	4	+C
B10_BC22_191109_LF_LIB_consensus_vsearch	2185	T	Y	586	7	1.17%	2	2	93	93	0.007674635299574334	1	1	382	204	1	6	C
B10_BC22_191109_LF_LIB_consensus_vsearch	2186	C	C	591	3	0.5%	2	2	93	93	0.12468407750622149	1	1	385	206	1	2	+A
B10_BC22_191109_LF_LIB_consensus_vsearch	2187	G	G	587	5	0.83%	2	1	93	93	0.030986176592841308	1	1	382	205	5	0	A
B10_BC22_191109_LF_LIB_consensus_vsearch	2188	T	T	582	5	0.84%	2	2	93	93	0.030983930348565846	1	1	379	203	4	1	-C
B10_BC22_191109_LF_LIB_consensus_vsearch	2189	C	C	582	3	0.51%	2	2	93	93	0.12467921300240917	1	1	379	203	2	1	-G
B10_BC22_191109_LF_LIB_consensus_vsearch	2190	G	R	560	20	3.36%	2	2	93	93	8.073203439334524E-7	1	1	363	197	17	3	A
B10_BC22_191109_LF_LIB_consensus_vsearch	2191	C	Y	556	15	2.53%	2	2	93	93	2.7803833808386893E-5	1	1	367	189	11	4	T
B10_BC22_191109_LF_LIB_consensus_vsearch	2192	G	R	564	17	2.9%	2	2	93	93	6.775268260038078E-6	1	1	367	197	15	2	A
B10_BC22_191109_LF_LIB_consensus_vsearch	2193	G	R	563	16	2.66%	2	1	93	93	1.3737367128226719E-5	1	1	361	202	16	0	A
B10_BC22_191109_LF_LIB_consensus_vsearch	2194	C	M	581	11	1.85%	2	2	93	93	4.659240387073297E-4	1	1	380	201	2	9	A
B10_BC22_191109_LF_LIB_consensus_vsearch	2195	C	C	591	5	0.83%	2	1	93	93	0.030987946464272845	1	1	386	205	0	5	T
B10_BC22_191109_LF_LIB_consensus_vsearch	2196	G	G	592	6	1%	2	1	93	93	0.01542936335614873	1	1	381	211	6	0	A
B10_BC22_191109_LF_LIB_consensus_vsearch	2197	T	T	588	6	1%	2	2	93	93	0.015428048177952706	1	1	382	206	2	4	C
B10_BC22_191109_LF_LIB_consensus_vsearch	2198	T	*/+A	579	7	1.17%	2	1	93	93	0.007672994124905477	1	1	374	205	7	0	+A
B10_BC22_191109_LF_LIB_consensus_vsearch	2199	A	A	592	2	0.33%	2	2	93	93	0.24978938500452047	1	1	382	210	1	1	C
B10_BC22_191109_LF_LIB_consensus_vsearch	2200	A	A	599	2	0.33%	2	1	93	93	0.24979184013288794	1	1	387	212	0	2	+C
B10_BC22_191109_LF_LIB_consensus_vsearch	2201	A	A	593	4	0.66%	2	1	93	93	0.06218579834936829	1	1	384	209	4	0	G
B10_BC22_191109_LF_LIB_consensus_vsearch	2202	T	T	587	5	0.83%	2	1	93	93	0.030986176592841308	1	1	381	206	5	0	+G
B10_BC22_191109_LF_LIB_consensus_vsearch	2203	C	*/+T	363	170	28.33%	2	2	93	93	6.6673663191968885E-59	1	1	308	55	39	131	+T
B10_BC22_191109_LF_LIB_consensus_vsearch	2204	T	T	559	2	0.36%	2	2	93	93	0.24977698483471023	1	1	352	207	1	1	C
B10_BC22_191109_LF_LIB_consensus_vsearch	2205	T	T	576	4	0.68%	2	2	93	93	0.0621765850361776	1	1	362	214	3	1	C
B10_BC22_191109_LF_LIB_consensus_vsearch	2206	T	*/-A	450	88	14.72%	2	1	93	93	6.688634569384141E-29	1	1	241	209	88	0	-A
B10_BC22_191109_LF_LIB_consensus_vsearch	2207	A	W	442	28	5.49%	2	1	93	93	2.4616592701604195E-9	1	1	230	212	28	0	T
B10_BC22_191109_LF_LIB_consensus_vsearch	2208	A	*/+G	584	9	1.5%	2	1	93	93	0.0018943147174077597	1	1	372	212	9	0	+G
B10_BC22_191109_LF_LIB_consensus_vsearch	2209	A	*/-G	560	31	5.15%	2	2	93	93	3.1093698562724354E-10	1	1	352	208	29	2	-G
B10_BC22_191109_LF_LIB_consensus_vsearch	2210	G	*/+A	549	19	3.33%	2	1	93	93	1.6367082147100343E-6	1	1	337	212	19	0	+A
B10_BC22_191109_LF_LIB_consensus_vsearch	2211	G	G	592	4	0.66%	2	1	93	93	0.06218527094514562	1	1	379	213	4	0	+A
B10_BC22_191109_LF_LIB_consensus_vsearch	2212	T	Y	586	15	2.49%	2	2	93	93	2.7934978628824662E-5	1	1	386	200	1	14	C
B10_BC22_191109_LF_LIB_consensus_vsearch	2213	T	T	594	4	0.66%	2	1	93	93	0.062186323989038686	1	1	387	207	0	4	+G
B10_BC22_191109_LF_LIB_consensus_vsearch	2214	G	G	601	2	0.33%	2	1	93	93	0.2497925311200579	1	1	388	213	0	2	A
B10_BC22_191109_LF_LIB_consensus_vsearch	2215	A	*/-C	569	20	3.32%	2	2	93	93	8.094130352074406E-7	1	1	379	190	3	17	-C
B10_BC22_191109_LF_LIB_consensus_vsearch	2216	C	C	577	4	0.69%	2	1	93	93	0.06217714192710672	1	1	380	197	4	0	+T
B10_BC22_191109_LF_LIB_consensus_vsearch	2217	C	C	592	5	0.83%	2	2	93	93	0.03098838522787931	1	1	384	208	3	2	-T
B10_BC22_191109_LF_LIB_consensus_vsearch	2218	T	*/+C	527	53	8.94%	2	1	93	93	3.197713735195892E-17	1	1	323	204	53	0	+C
B10_BC22_191109_LF_LIB_consensus_vsearch	2219	C	*/-G	543	45	7.55%	2	1	93	93	1.1845914230394268E-14	1	1	380	163	0	45	-G
B10_BC22_191109_LF_LIB_consensus_vsearch	2220	G	G	543	5	0.9%	2	1	93	93	0.03096500353015945	1	1	377	166	5	0	+A
B10_BC22_191109_LF_LIB_consensus_vsearch	2221	G	G	598	3	0.5%	2	2	93	93	0.12468776019987309	1	1	384	214	2	1	A
B10_BC22_191109_LF_LIB_consensus_vsearch	2222	A	A	595	2	0.33%	2	1	93	93	0.24979044425840527	1	1	385	210	0	2	G
B10_BC22_191109_LF_LIB_consensus_vsearch	2223	T	*/+C	568	27	4.49%	2	1	93	93	5.510139615106973E-9	1	1	356	212	27	0	+C
B10_BC22_191109_LF_LIB_consensus_vsearch	2224	C	*/-A	584	8	1.33%	2	2	93	93	0.0038143805269862142	1	1	376	208	6	2	-A
B10_BC22_191109_LF_LIB_consensus_vsearch	2225	A	R	556	15	2.53%	2	2	93	93	2.7803833808386893E-5	1	1	363	193	12	3	G
B10_BC22_191109_LF_LIB_consensus_vsearch	2226	G	G	578	5	0.85%	2	1	93	93	0.030982105624386143	1	1	376	202	5	0	+A
B10_BC22_191109_LF_LIB_consensus_vsearch	2227	G	G	592	3	0.5%	2	1	93	93	0.1246846089151382	1	1	382	210	0	3	-TAGGG
B10_BC22_191109_LF_LIB_consensus_vsearch	2228	T	*/+A	568	9	1.5%	2	1	93	93	0.0018926974773018042	1	1	361	207	9	0	+A
B10_BC22_191109_LF_LIB_consensus_vsearch	2229	A	*/-G	530	49	8.25%	2	2	93	93	6.152602482304839E-16	1	1	363	167	15	34	-G
B10_BC22_191109_LF_LIB_consensus_vsearch	2230	G	R	530	12	2.21%	2	1	93	93	2.295692589828977E-4	1	1	360	170	12	0	A
B10_BC22_191109_LF_LIB_consensus_vsearch	2231	G	G	589	4	0.67%	2	2	93	93	0.06218367805512527	1	1	384	205	3	1	A
B10_BC22_191109_LF_LIB_consensus_vsearch	2232	G	G	593	4	0.67%	2	1	93	93	0.06218579834936829	1	1	382	211	4	0	A
B10_BC22_191109_LF_LIB_consensus_vsearch	2233	A	A	592	2	0.33%	2	1	93	93	0.24978938500452047	1	1	380	212	2	0	+C
B10_BC22_191109_LF_LIB_consensus_vsearch	2234	T	T	589	5	0.83%	2	2	93	93	0.030987064506852544	1	1	379	210	3	2	C
B10_BC22_191109_LF_LIB_consensus_vsearch	2235	A	*/-C	552	31	5.18%	2	2	93	93	3.0917211430238037E-10	1	1	347	205	23	8	-C
B10_BC22_191109_LF_LIB_consensus_vsearch	2236	C	*/+T	559	7	1.22%	2	2	93	93	0.007668082173792139	1	1	361	198	1	6	+T
B10_BC22_191109_LF_LIB_consensus_vsearch	2237	C	C	595	3	0.5%	2	2	93	93	0.12468619246852639	1	1	386	209	1	2	+T
B10_BC22_191109_LF_LIB_consensus_vsearch	2238	C	*/-G	581	8	1.33%	2	2	93	93	0.0038139152066312184	1	1	377	204	6	2	-G
B10_BC22_191109_LF_LIB_consensus_vsearch	2239	G	G	589	2	0.34%	2	1	93	93	0.2497883149871952	1	1	377	212	2	0	A
B10_BC22_191109_LF_LIB_consensus_vsearch	2240	C	C	586	4	0.66%	2	2	93	93	0.062182068959449006	1	1	375	211	2	2	A
B10_BC22_191109_LF_LIB_consensus_vsearch	2241	T	Y	590	8	1.33%	2	2	93	93	0.003815297238788008	1	1	381	209	4	4	C
B10_BC22_191109_LF_LIB_consensus_vsearch	2242	G	G	599	1	0.17%	2	1	93	93	0.4999999999990043	1	1	386	213	0	1	+A
B10_BC22_191109_LF_LIB_consensus_vsearch	2243	A	A	596	4	0.67%	2	1	93	93	0.062187370009836374	1	1	381	215	4	0	G
B10_BC22_191109_LF_LIB_consensus_vsearch	2244	A	A	589	6	1%	2	1	93	93	0.015428378627452975	1	1	376	213	6	0	G
B10_BC22_191109_LF_LIB_consensus_vsearch	2245	C	*/-T	582	8	1.33%	2	2	93	93	0.00381407083625578	1	1	374	208	4	4	-T
B10_BC22_191109_LF_LIB_consensus_vsearch	2246	T	T	580	6	1.02%	2	2	93	93	0.01542536405110175	1	1	371	209	5	1	C
B10_BC22_191109_LF_LIB_consensus_vsearch	2247	T	*/-A	569	10	1.68%	2	2	93	93	9.390387757385067E-4	1	1	366	203	1	9	-A
B10_BC22_191109_LF_LIB_consensus_vsearch	2248	A	A	586	2	0.34%	2	1	93	93	0.24978723404299805	1	1	381	205	2	0	C
B10_BC22_191109_LF_LIB_consensus_vsearch	2249	A	*/-G	589	7	1.16%	2	2	93	93	0.007675326899053761	1	1	379	210	3	4	-G
B10_BC22_191109_LF_LIB_consensus_vsearch	2250	G	R	575	14	2.36%	2	1	93	93	5.6447057855957204E-5	1	1	367	208	14	0	A
B10_BC22_191109_LF_LIB_consensus_vsearch	2251	C	C	597	2	0.33%	2	2	93	93	0.24979114452852993	1	1	385	212	1	1	+GC
B10_BC22_191109_LF_LIB_consensus_vsearch	2252	A	A	598	2	0.33%	2	1	93	93	0.24979149291046765	1	1	384	214	2	0	G
B10_BC22_191109_LF_LIB_consensus_vsearch	2253	T	T	599	2	0.33%	2	1	93	93	0.24979184013288794	1	1	387	212	0	2	-A
B10_BC22_191109_LF_LIB_consensus_vsearch	2254	A	A	597	1	0.17%	2	1	93	93	0.4999999999999138	1	1	385	212	1	0	+GA
B10_BC22_191109_LF_LIB_consensus_vsearch	2255	T	*/+C	578	14	2.33%	2	1	93	93	5.646967505352899E-5	1	1	369	209	14	0	+C
B10_BC22_191109_LF_LIB_consensus_vsearch	2256	C	*/-A	588	13	2.16%	2	2	93	93	1.1432236795092524E-4	1	1	387	201	1	12	-A
B10_BC22_191109_LF_LIB_consensus_vsearch	2257	A	A	584	2	0.34%	2	1	93	93	0.2497865072588101	1	1	383	201	2	0	G
B10_BC22_191109_LF_LIB_consensus_vsearch	2258	A	R	591	7	1.16%	2	2	93	93	0.007675784123381086	1	1	382	209	5	2	G
B10_BC22_191109_LF_LIB_consensus_vsearch	2259	T	*/+C	573	11	1.84%	2	1	93	93	4.656222726659411E-4	1	1	378	195	0	11	+C
B10_BC22_191109_LF_LIB_consensus_vsearch	2260	A	A	588	3	0.51%	2	2	93	93	0.12468247248078299	1	1	382	206	2	1	C
B10_BC22_191109_LF_LIB_consensus_vsearch	2261	A	R	585	7	1.17%	2	2	93	93	0.007674403214110395	1	1	381	204	4	3	G
B10_BC22_191109_LF_LIB_consensus_vsearch	2262	G	G	591	2	0.33%	2	2	93	93	0.24978902953563295	1	1	382	209	1	1	+C
B10_BC22_191109_LF_LIB_consensus_vsearch	2263	C	*/-G	577	7	1.17%	2	2	93	93	0.007672518016675552	1	1	378	199	1	6	-G
B10_BC22_191109_LF_LIB_consensus_vsearch	2264	G	G	592	2	0.34%	2	1	93	93	0.24978938500452047	1	1	385	207	2	0	A
B10_BC22_191109_LF_LIB_consensus_vsearch	2265	G	G	599	3	0.5%	2	2	93	93	0.12468827930162561	1	1	385	214	2	1	-A
B10_BC22_191109_LF_LIB_consensus_vsearch	2266	A	*/-G	543	29	4.83%	2	2	93	93	1.2943332925958352E-9	1	1	335	208	27	2	-G
B10_BC22_191109_LF_LIB_consensus_vsearch	2267	G	G	550	6	1.07%	2	1	93	93	0.01541461190481993	1	1	345	205	0	6	+T
B10_BC22_191109_LF_LIB_consensus_vsearch	2268	G	*/+A	472	65	11.02%	2	2	93	93	3.4483321372238E-21	1	1	270	202	59	6	+A
B10_BC22_191109_LF_LIB_consensus_vsearch	2269	A	A	544	5	0.9%	2	2	93	93	0.030965522408583822	1	1	340	204	1	4	G
B10_BC22_191109_LF_LIB_consensus_vsearch	2270	A	A	586	2	0.34%	2	1	93	93	0.24978723404299805	1	1	374	212	2	0	G
B10_BC22_191109_LF_LIB_consensus_vsearch	2271	A	A	599	1	0.17%	2	1	93	93	0.4999999999990043	1	1	387	212	0	1	+G
B10_BC22_191109_LF_LIB_consensus_vsearch	2272	A	*/-GAA	560	14	2.33%	2	1	93	93	5.6330526991142806E-5	1	1	350	210	14	0	-GAA
B10_BC22_191109_LF_LIB_consensus_vsearch	2273	G	*/+A	524	21	3.69%	2	2	93	93	3.9182277530784886E-7	1	1	340	184	1	20	+A
B10_BC22_191109_LF_LIB_consensus_vsearch	2274	A	R	552	7	1.25%	2	2	93	93	0.007666280255386365	1	1	349	203	3	4	G
B10_BC22_191109_LF_LIB_consensus_vsearch	2275	A	A	574	2	0.35%	2	1	93	93	0.24978279756726465	1	1	360	214	2	0	+G
B10_BC22_191109_LF_LIB_consensus_vsearch	2276	A	R	561	24	4.06%	2	1	93	93	4.6851547206789726E-8	1	1	348	213	24	0	G
B10_BC22_191109_LF_LIB_consensus_vsearch	2277	C	C	599	1	0.17%	2	1	93	93	0.4999999999990043	1	1	386	213	1	0	G
B10_BC22_191109_LF_LIB_consensus_vsearch	2278	C	Y	585	8	1.33%	2	2	93	93	0.0038145345933480535	1	1	378	207	2	6	T
B10_BC22_191109_LF_LIB_consensus_vsearch	2279	A	A	596	0	0%	2	0	93	0	1.0	1	0	381	215	0	0	
B10_BC22_191109_LF_LIB_consensus_vsearch	2280	A	R	483	111	18.53%	2	2	93	93	1.3203028398696218E-36	1	1	273	210	108	3	G
B10_BC22_191109_LF_LIB_consensus_vsearch	2281	C	*/-A	566	11	1.85%	2	1	93	93	4.653514663553586E-4	1	1	354	212	11	0	-A
B10_BC22_191109_LF_LIB_consensus_vsearch	2282	A	*/-G	494	58	9.85%	2	2	93	93	7.143723254704718E-19	1	1	331	163	20	38	-G
B10_BC22_191109_LF_LIB_consensus_vsearch	2283	G	G	538	1	0.18%	2	1	93	93	0.5000000000008233	1	1	362	176	1	0	+A
B10_BC22_191109_LF_LIB_consensus_vsearch	2284	G	R	586	14	2.33%	2	1	93	93	5.652891210314472E-5	1	1	373	213	14	0	A
B10_BC22_191109_LF_LIB_consensus_vsearch	2285	G	*/-A	584	14	2.33%	2	2	93	93	5.651424735111487E-5	1	1	372	212	13	1	-A
B10_BC22_191109_LF_LIB_consensus_vsearch	2286	A	A	584	2	0.34%	2	2	93	93	0.2497865072588101	1	1	372	212	1	1	+T
B10_BC22_191109_LF_LIB_consensus_vsearch	2287	T	T	595	5	0.83%	2	2	93	93	0.03098969274732699	1	1	383	212	3	2	C
B10_BC22_191109_LF_LIB_consensus_vsearch	2288	T	T	591	5	0.83%	2	2	93	93	0.030987946464272845	1	1	380	211	4	1	-G
B10_BC22_191109_LF_LIB_consensus_vsearch	2289	G	*/-C	497	83	13.93%	2	2	93	93	4.3808931201014445E-27	1	1	290	207	82	1	-C
B10_BC22_191109_LF_LIB_consensus_vsearch	2290	C	C	498	5	0.98%	2	2	93	93	0.030939519749212746	1	1	291	207	1	4	+T
B10_BC22_191109_LF_LIB_consensus_vsearch	2291	C	C	582	5	0.84%	2	2	93	93	0.030983930348565846	1	1	375	207	1	4	T
B10_BC22_191109_LF_LIB_consensus_vsearch	2292	C	*/-T	586	7	1.17%	2	2	93	93	0.007674635299574334	1	1	381	205	1	6	-T
B10_BC22_191109_LF_LIB_consensus_vsearch	2293	T	*/+A	577	9	1.51%	2	1	93	93	0.0018936179518815892	1	1	370	207	9	0	+A
B10_BC22_191109_LF_LIB_consensus_vsearch	2294	A	*/-G	579	7	1.17%	2	1	93	93	0.007672994124905477	1	1	376	203	0	7	-G
B10_BC22_191109_LF_LIB_consensus_vsearch	2295	G	G	576	3	0.51%	2	1	93	93	0.12467588591190074	1	1	373	203	3	0	+C
B10_BC22_191109_LF_LIB_consensus_vsearch	2296	T	T	579	5	0.85%	2	2	93	93	0.03098256414789269	1	1	375	204	3	2	C
B10_BC22_191109_LF_LIB_consensus_vsearch	2297	A	A	587	2	0.34%	2	2	93	93	0.249787595581865	1	1	379	208	1	1	C
B10_BC22_191109_LF_LIB_consensus_vsearch	2298	A	R	587	9	1.49%	2	2	93	93	0.001894608361560784	1	1	380	207	8	1	G
B10_BC22_191109_LF_LIB_consensus_vsearch	2299	C	*/-G	582	8	1.33%	2	2	93	93	0.00381407083625578	1	1	379	203	3	5	-G
B10_BC22_191109_LF_LIB_consensus_vsearch	2300	G	G	579	6	1.01%	2	2	93	93	0.015425023382419913	1	1	376	203	5	1	A
B10_BC22_191109_LF_LIB_consensus_vsearch	2301	G	G	590	5	0.83%	2	2	93	93	0.030987506226370864	1	1	382	208	3	2	A
B10_BC22_191109_LF_LIB_consensus_vsearch	2302	C	*/-G	553	17	2.82%	2	1	93	93	6.759533476367155E-6	1	1	347	206	17	0	-G
B10_BC22_191109_LF_LIB_consensus_vsearch	2303	G	*/-A	561	10	1.71%	2	2	93	93	9.385190892979372E-4	1	1	349	212	9	1	-A
B10_BC22_191109_LF_LIB_consensus_vsearch	2304	A	R	576	8	1.35%	2	1	93	93	0.0038131291090651434	1	1	362	214	8	0	G
B10_BC22_191109_LF_LIB_consensus_vsearch	2305	G	G	578	5	0.84%	2	2	93	93	0.030982105624386143	1	1	375	203	2	3	+AG
B10_BC22_191109_LF_LIB_consensus_vsearch	2306	T	T	583	3	0.5%	2	2	93	93	0.12467976088783492	1	1	383	200	2	1	+G
B10_BC22_191109_LF_LIB_consensus_vsearch	2307	G	*/-A	579	7	1.18%	2	2	93	93	0.007672994124905477	1	1	376	203	6	1	-A
B10_BC22_191109_LF_LIB_consensus_vsearch	2308	A	A	583	3	0.51%	2	2	93	93	0.12467976088783492	1	1	376	207	2	1	G
B10_BC22_191109_LF_LIB_consensus_vsearch	2309	A	A	590	5	0.84%	2	1	93	93	0.030987506226370864	1	1	379	211	5	0	-G
B10_BC22_191109_LF_LIB_consensus_vsearch	2310	G	*/-C	573	15	2.53%	2	1	93	93	2.7879737666977125E-5	1	1	379	194	0	15	-C
B10_BC22_191109_LF_LIB_consensus_vsearch	2311	C	Y	560	12	2.07%	2	1	93	93	2.3031898910607474E-4	1	1	384	176	0	12	T
B10_BC22_191109_LF_LIB_consensus_vsearch	2312	G	R	574	10	1.69%	2	2	93	93	9.393564316164558E-4	1	1	372	202	9	1	A
B10_BC22_191109_LF_LIB_consensus_vsearch	2313	G	G	596	1	0.17%	2	1	93	93	0.4999999999999138	1	1	383	213	1	0	+C
B10_BC22_191109_LF_LIB_consensus_vsearch	2314	C	C	586	4	0.67%	2	1	93	93	0.062182068959449006	1	1	377	209	4	0	-AAC
B10_BC22_191109_LF_LIB_consensus_vsearch	2315	A	A	590	3	0.5%	2	2	93	93	0.12468354430400949	1	1	378	212	1	2	G
B10_BC22_191109_LF_LIB_consensus_vsearch	2316	A	R	548	42	7.01%	2	2	93	93	1.0671579546793504E-13	1	1	337	211	41	1	G
B10_BC22_191109_LF_LIB_consensus_vsearch	2317	C	C	582	6	1%	2	2	93	93	0.015426041918236095	1	1	370	212	5	1	-A
B10_BC22_191109_LF_LIB_consensus_vsearch	2318	A	R	586	8	1.34%	2	2	93	93	0.00381468814385855	1	1	373	213	7	1	G
B10_BC22_191109_LF_LIB_consensus_vsearch	2319	G	G	591	5	0.83%	2	2	93	93	0.030987946464272845	1	1	380	211	3	2	A
B10_BC22_191109_LF_LIB_consensus_vsearch	2320	C	C	589	4	0.67%	2	1	93	93	0.06218367805512527	1	1	379	210	4	0	-TC
B10_BC22_191109_LF_LIB_consensus_vsearch	2321	T	*/+C	586	8	1.34%	2	1	93	93	0.00381468814385855	1	1	372	214	8	0	+C
B10_BC22_191109_LF_LIB_consensus_vsearch	2322	C	*/-A	569	14	2.35%	2	2	93	93	5.640114481653746E-5	1	1	363	206	7	7	-A
B10_BC22_191109_LF_LIB_consensus_vsearch	2323	A	A	574	4	0.69%	2	1	93	93	0.06217546547116354	1	1	369	205	4	0	+G
B10_BC22_191109_LF_LIB_consensus_vsearch	2324	A	A	593	2	0.33%	2	1	93	93	0.24978973927711676	1	1	381	212	0	2	C
B10_BC22_191109_LF_LIB_consensus_vsearch	2325	A	*/-T	574	16	2.66%	2	2	93	93	1.3764655753705977E-5	1	1	369	205	12	4	-T
B10_BC22_191109_LF_LIB_consensus_vsearch	2326	T	K	574	8	1.37%	2	1	93	93	0.0038128109095927364	1	1	366	208	8	0	G
B10_BC22_191109_LF_LIB_consensus_vsearch	2327	T	K	584	9	1.5%	2	1	93	93	0.0018943147174077597	1	1	377	207	9	0	G
B10_BC22_191109_LF_LIB_consensus_vsearch	2328	T	*/+G	574	11	1.82%	2	2	93	93	4.6566043808442384E-4	1	1	372	202	2	9	+G
B10_BC22_191109_LF_LIB_consensus_vsearch	2329	G	*/-A	574	9	1.52%	2	2	93	93	0.0018933142585401675	1	1	370	204	1	8	-A
B10_BC22_191109_LF_LIB_consensus_vsearch	2330	A	A	579	3	0.51%	2	2	93	93	0.12467755803936205	1	1	374	205	2	1	G
B10_BC22_191109_LF_LIB_consensus_vsearch	2331	A	A	593	2	0.33%	2	1	93	93	0.24978973927711676	1	1	379	214	2	0	+GA
B10_BC22_191109_LF_LIB_consensus_vsearch	2332	A	R	583	8	1.33%	2	2	93	93	0.0038142259421648926	1	1	378	205	7	1	G
B10_BC22_191109_LF_LIB_consensus_vsearch	2333	T	T	586	5	0.84%	2	1	93	93	0.030985730383315414	1	1	381	205	0	5	-C
B10_BC22_191109_LF_LIB_consensus_vsearch	2334	C	*/-T	582	7	1.18%	2	2	93	93	0.007673702245629301	1	1	377	205	5	2	-T
B10_BC22_191109_LF_LIB_consensus_vsearch	2335	T	T	570	6	1.02%	2	2	93	93	0.015421904228749098	1	1	375	195	1	5	A
B10_BC22_191109_LF_LIB_consensus_vsearch	2336	G	R	584	7	1.17%	2	2	93	93	0.007674170345963	1	1	379	205	4	3	A
B10_BC22_191109_LF_LIB_consensus_vsearch	2337	G	R	592	8	1.33%	2	2	93	93	0.003815598757548882	1	1	382	210	5	3	A
B10_BC22_191109_LF_LIB_consensus_vsearch	2338	C	*/+A	578	7	1.16%	2	1	93	93	0.007672756476313913	1	1	374	204	7	0	+A
B10_BC22_191109_LF_LIB_consensus_vsearch	2339	G	R	572	10	1.68%	2	2	93	93	9.39230016764963E-4	1	1	368	204	8	2	A
B10_BC22_191109_LF_LIB_consensus_vsearch	2340	C	*/-A	575	8	1.35%	2	2	93	93	0.0038129702806793094	1	1	375	200	5	3	-A
B10_BC22_191109_LF_LIB_consensus_vsearch	2341	A	A	586	1	0.17%	2	1	93	93	0.4999999999999138	1	1	380	206	1	0	+GA
B10_BC22_191109_LF_LIB_consensus_vsearch	2342	A	A	588	4	0.67%	2	2	93	93	0.06218314350277022	1	1	380	208	3	1	G
B10_BC22_191109_LF_LIB_consensus_vsearch	2343	G	*/-CC	540	33	5.55%	2	2	93	93	7.245143018541985E-11	1	1	334	206	32	1	-CC
B10_BC22_191109_LF_LIB_consensus_vsearch	2344	C	C	547	6	1.08%	2	1	93	93	0.015413472645223152	1	1	344	203	0	6	T
B10_BC22_191109_LF_LIB_consensus_vsearch	2345	C	C	559	6	1.05%	2	1	93	93	0.015417957224098422	1	1	351	208	0	6	T
B10_BC22_191109_LF_LIB_consensus_vsearch	2346	C	*/-G	555	19	3.16%	2	1	93	93	1.6393715543553221E-6	1	1	351	204	19	0	-G
B10_BC22_191109_LF_LIB_consensus_vsearch	2347	G	*/-A	541	34	5.82%	2	2	93	93	3.5215228653898495E-11	1	1	330	211	33	1	-A
B10_BC22_191109_LF_LIB_consensus_vsearch	2348	A	*/+G	527	25	4.41%	2	1	93	93	2.2570778692388136E-8	1	1	320	207	25	0	+G
B10_BC22_191109_LF_LIB_consensus_vsearch	2349	G	G	589	2	0.33%	2	1	93	93	0.2497883149871952	1	1	378	211	2	0	-TT
B10_BC22_191109_LF_LIB_consensus_vsearch	2350	T	T	592	3	0.5%	2	1	93	93	0.1246846089151382	1	1	381	211	3	0	C
B10_BC22_191109_LF_LIB_consensus_vsearch	2351	T	*/-G	574	8	1.34%	2	2	93	93	0.0038128109095927364	1	1	363	211	7	1	-G
B10_BC22_191109_LF_LIB_consensus_vsearch	2352	G	R	574	8	1.36%	2	2	93	93	0.0038128109095927364	1	1	364	210	7	1	A
B10_BC22_191109_LF_LIB_consensus_vsearch	2353	T	*/-A	566	19	3.2%	2	2	93	93	1.6441208717700983E-6	1	1	362	204	16	3	-A
B10_BC22_191109_LF_LIB_consensus_vsearch	2354	A	A	564	3	0.52%	2	1	93	93	0.1246690203000711	1	1	356	208	3	0	+T
B10_BC22_191109_LF_LIB_consensus_vsearch	2355	A	*/-T	563	25	4.17%	2	2	93	93	2.296650789566818E-8	1	1	354	209	22	3	-T
B10_BC22_191109_LF_LIB_consensus_vsearch	2356	T	*/+G	557	11	1.91%	2	1	93	93	4.6499362882328774E-4	1	1	350	207	11	0	+G
B10_BC22_191109_LF_LIB_consensus_vsearch	2357	T	T	595	1	0.17%	2	1	93	93	0.4999999999999138	1	1	383	212	1	0	+C
B10_BC22_191109_LF_LIB_consensus_vsearch	2358	T	T	585	6	1%	2	1	93	93	0.015427050131369397	1	1	373	212	6	0	+A
B10_BC22_191109_LF_LIB_consensus_vsearch	2359	G	G	582	5	0.84%	2	1	93	93	0.030983930348565846	1	1	371	211	5	0	+C
B10_BC22_191109_LF_LIB_consensus_vsearch	2360	T	*/-A	535	27	4.55%	2	2	93	93	5.411050155429821E-9	1	1	327	208	26	1	-A
B10_BC22_191109_LF_LIB_consensus_vsearch	2361	A	*/-G	557	7	1.22%	2	1	93	93	0.007667571887622288	1	1	346	211	7	0	-G
B10_BC22_191109_LF_LIB_consensus_vsearch	2362	G	*/-AG	571	10	1.69%	2	1	93	93	9.391664866947025E-4	1	1	359	212	10	0	-AG
B10_BC22_191109_LF_LIB_consensus_vsearch	2363	A	R	542	22	3.75%	2	2	93	93	1.9349436591079555E-7	1	1	337	205	21	1	G
B10_BC22_191109_LF_LIB_consensus_vsearch	2364	G	G	575	4	0.68%	2	1	93	93	0.062176026221018546	1	1	370	205	4	0	+AG
B10_BC22_191109_LF_LIB_consensus_vsearch	2365	G	G	596	1	0.17%	2	1	93	93	0.4999999999999138	1	1	383	213	1	0	+T
B10_BC22_191109_LF_LIB_consensus_vsearch	2366	A	A	592	2	0.33%	2	1	93	93	0.24978938500452047	1	1	380	212	2	0	-T
B10_BC22_191109_LF_LIB_consensus_vsearch	2367	T	T	590	3	0.5%	2	1	93	93	0.12468354430400949	1	1	377	213	3	0	-G
B10_BC22_191109_LF_LIB_consensus_vsearch	2368	G	G	582	6	1%	2	1	93	93	0.015426041918236095	1	1	375	207	0	6	-C
B10_BC22_191109_LF_LIB_consensus_vsearch	2369	C	*/-T	548	22	3.7%	2	2	93	93	1.9392831771612027E-7	1	1	360	188	15	7	-T
B10_BC22_191109_LF_LIB_consensus_vsearch	2370	T	T	564	4	0.7%	2	2	93	93	0.06216974933029789	1	1	360	204	2	2	C
B10_BC22_191109_LF_LIB_consensus_vsearch	2371	T	T	577	6	1.01%	2	1	93	93	0.01542433854516302	1	1	374	203	0	6	-C
B10_BC22_191109_LF_LIB_consensus_vsearch	2372	C	*/-T	557	19	3.24%	2	2	93	93	1.6402477468452338E-6	1	1	372	185	4	15	-T
B10_BC22_191109_LF_LIB_consensus_vsearch	2373	T	*/-A	555	13	2.24%	2	1	93	93	1.1388280498018359E-4	1	1	366	189	13	0	-A
B10_BC22_191109_LF_LIB_consensus_vsearch	2374	A	*/-G	562	11	1.87%	2	2	93	93	4.6519379419598136E-4	1	1	364	198	5	6	-G
B10_BC22_191109_LF_LIB_consensus_vsearch	2375	G	G	587	2	0.34%	2	1	93	93	0.249787595581865	1	1	380	207	2	0	+A
B10_BC22_191109_LF_LIB_consensus_vsearch	2376	G	G	592	4	0.66%	2	1	93	93	0.06218527094514562	1	1	378	214	4	0	-TAG
B10_BC22_191109_LF_LIB_consensus_vsearch	2377	T	T	580	5	0.84%	2	2	93	93	0.030983021104337604	1	1	372	208	4	1	C
B10_BC22_191109_LF_LIB_consensus_vsearch	2378	A	*/-G	574	14	2.34%	2	2	93	93	5.643946893550629E-5	1	1	375	199	2	12	-G
B10_BC22_191109_LF_LIB_consensus_vsearch	2379	G	G	575	6	1.03%	2	1	93	93	0.015423649001259471	1	1	374	201	6	0	A
B10_BC22_191109_LF_LIB_consensus_vsearch	2380	C	Y	581	14	2.33%	2	1	93	93	5.6492070470485533E-5	1	1	381	200	0	14	T
B10_BC22_191109_LF_LIB_consensus_vsearch	2381	G	G	592	2	0.33%	2	2	93	93	0.24978938500452047	1	1	381	211	1	1	+A
B10_BC22_191109_LF_LIB_consensus_vsearch	2382	A	*/-C	580	14	2.34%	2	2	93	93	5.648462977218392E-5	1	1	367	213	13	1	-C
B10_BC22_191109_LF_LIB_consensus_vsearch	2383	C	Y	576	7	1.19%	2	2	93	93	0.007672278741851824	1	1	366	210	3	4	T
B10_BC22_191109_LF_LIB_consensus_vsearch	2384	C	Y	577	16	2.66%	2	2	93	93	1.3771929190263783E-5	1	1	379	198	5	11	T
B10_BC22_191109_LF_LIB_consensus_vsearch	2385	G	R	584	11	1.85%	2	1	93	93	4.660351394123344E-4	1	1	374	210	11	0	A
B10_BC22_191109_LF_LIB_consensus_vsearch	2386	G	G	597	3	0.5%	2	2	93	93	0.12468723936635923	1	1	386	211	1	2	A
B10_BC22_191109_LF_LIB_consensus_vsearch	2387	T	T	596	3	0.5%	2	1	93	93	0.1246867167922604	1	1	383	213	3	0	+C
B10_BC22_191109_LF_LIB_consensus_vsearch	2388	C	C	586	5	0.83%	2	1	93	93	0.030985730383315414	1	1	376	210	5	0	+A
B10_BC22_191109_LF_LIB_consensus_vsearch	2389	T	*/-A	567	10	1.68%	2	2	93	93	9.389101896133754E-4	1	1	365	202	5	5	-A
B10_BC22_191109_LF_LIB_consensus_vsearch	2390	A	R	564	10	1.71%	2	1	93	93	9.387156496901478E-4	1	1	370	194	0	10	G
B10_BC22_191109_LF_LIB_consensus_vsearch	2391	A	R	581	15	2.5%	2	2	93	93	2.7914007952918256E-5	1	1	383	198	3	12	G
B10_BC22_191109_LF_LIB_consensus_vsearch	2392	G	*/-T	573	19	3.17%	2	1	93	93	1.647056656618272E-6	1	1	381	192	0	19	-T
B10_BC22_191109_LF_LIB_consensus_vsearch	2393	T	T	575	3	0.52%	2	1	93	93	0.12467532467531917	1	1	388	187	0	3	+C
B10_BC22_191109_LF_LIB_consensus_vsearch	2394	T	*/-C	553	37	6.16%	2	2	93	93	4.0635388693111066E-12	1	1	372	181	12	25	-C
B10_BC22_191109_LF_LIB_consensus_vsearch	2395	C	*/+G	545	11	1.95%	2	1	93	93	4.6449877293201324E-4	1	1	358	187	11	0	+G
B10_BC22_191109_LF_LIB_consensus_vsearch	2396	C	*/-T	549	24	3.99%	2	2	93	93	4.6610967308022154E-8	1	1	367	182	6	18	-T
B10_BC22_191109_LF_LIB_consensus_vsearch	2397	T	W	546	13	2.28%	2	1	93	93	1.1375413566253189E-4	1	1	354	192	13	0	A
B10_BC22_191109_LF_LIB_consensus_vsearch	2398	T	*/-G	483	80	13.45%	2	2	93	93	4.0266653522788955E-26	1	1	357	126	5	75	-G
B10_BC22_191109_LF_LIB_consensus_vsearch	2399	G	K	498	14	2.7%	2	1	93	93	5.577874865171707E-5	1	1	377	121	0	14	T
B10_BC22_191109_LF_LIB_consensus_vsearch	2400	G	*/-A	588	7	1.16%	2	1	93	93	0.007675097138165556	1	1	380	208	7	0	-A
B10_BC22_191109_LF_LIB_consensus_vsearch	2401	A	A	588	3	0.5%	2	1	93	93	0.12468247248078299	1	1	375	213	3	0	G
B10_BC22_191109_LF_LIB_consensus_vsearch	2402	A	R	590	9	1.5%	2	2	93	93	0.0018948990881047542	1	1	379	211	8	1	G
B10_BC22_191109_LF_LIB_consensus_vsearch	2403	C	*/+A	573	22	3.67%	2	1	93	93	1.9565001112381234E-7	1	1	363	210	22	0	+A
B10_BC22_191109_LF_LIB_consensus_vsearch	2404	A	R	569	15	2.5%	2	1	93	93	2.7862262199428654E-5	1	1	371	198	15	0	G
B10_BC22_191109_LF_LIB_consensus_vsearch	2405	G	G	583	1	0.17%	2	1	93	93	0.4999999999999138	1	1	387	196	0	1	+A
B10_BC22_191109_LF_LIB_consensus_vsearch	2406	G	G	600	1	0.17%	2	1	93	93	0.4999999999999138	1	1	388	212	0	1	+TG
B10_BC22_191109_LF_LIB_consensus_vsearch	2407	A	A	596	3	0.5%	2	1	93	93	0.1246867167922604	1	1	384	212	3	0	G
B10_BC22_191109_LF_LIB_consensus_vsearch	2408	C	C	598	1	0.17%	2	1	93	93	0.5000000000008233	1	1	387	211	0	1	+G
B10_BC22_191109_LF_LIB_consensus_vsearch	2409	G	G	585	5	0.83%	2	1	93	93	0.030985282661769052	1	1	379	206	5	0	A
B10_BC22_191109_LF_LIB_consensus_vsearch	2410	T	Y	579	8	1.34%	2	2	93	93	0.003813602365568841	1	1	377	202	3	5	C
B10_BC22_191109_LF_LIB_consensus_vsearch	2411	C	C	588	3	0.5%	2	1	93	93	0.12468247248078299	1	1	377	211	3	0	-A
B10_BC22_191109_LF_LIB_consensus_vsearch	2412	A	R	578	7	1.17%	2	2	93	93	0.007672756476313913	1	1	375	203	6	1	G
B10_BC22_191109_LF_LIB_consensus_vsearch	2413	T	*/+A	568	12	2.01%	2	1	93	93	2.3050606703904357E-4	1	1	364	204	12	0	+A
B10_BC22_191109_LF_LIB_consensus_vsearch	2414	A	*/-G	574	16	2.7%	2	1	93	93	1.3764655753705977E-5	1	1	365	209	16	0	-G
B10_BC22_191109_LF_LIB_consensus_vsearch	2415	G	*/-AG	556	12	2.05%	2	1	93	93	2.3022351222638007E-4	1	1	344	212	12	0	-AG
B10_BC22_191109_LF_LIB_consensus_vsearch	2416	A	*/-G	451	112	19.41%	2	2	93	93	4.152100495611412E-37	1	1	264	187	90	22	-G
B10_BC22_191109_LF_LIB_consensus_vsearch	2417	G	*/+A	431	11	2.36%	2	1	93	93	4.584838174083158E-4	1	1	245	186	11	0	+A
B10_BC22_191109_LF_LIB_consensus_vsearch	2418	G	R	525	34	5.75%	2	1	93	93	3.4696740057395264E-11	1	1	315	210	34	0	A
B10_BC22_191109_LF_LIB_consensus_vsearch	2419	G	K	560	28	4.66%	2	1	93	93	2.6804600811283658E-9	1	1	351	209	28	0	T
B10_BC22_191109_LF_LIB_consensus_vsearch	2420	T	Y	572	10	1.68%	2	2	93	93	9.39230016764963E-4	1	1	370	202	6	4	C
B10_BC22_191109_LF_LIB_consensus_vsearch	2421	G	G	585	5	0.84%	2	2	93	93	0.030985282661769052	1	1	376	209	4	1	-A
B10_BC22_191109_LF_LIB_consensus_vsearch	2422	A	*/-G	543	25	4.19%	2	1	93	93	2.2752135138481967E-8	1	1	334	209	25	0	-G
B10_BC22_191109_LF_LIB_consensus_vsearch	2423	G	R	538	8	1.42%	2	1	93	93	0.0038066871088034355	1	1	327	211	8	0	A
B10_BC22_191109_LF_LIB_consensus_vsearch	2424	A	A	572	3	0.52%	2	2	93	93	0.12467362924259917	1	1	361	211	2	1	G
B10_BC22_191109_LF_LIB_consensus_vsearch	2425	A	*/-T	563	16	2.67%	2	1	93	93	1.3737367128226719E-5	1	1	374	189	0	16	-T
B10_BC22_191109_LF_LIB_consensus_vsearch	2426	T	*/-C	467	104	17.84%	2	2	93	93	2.8139162253311866E-34	1	1	280	187	97	7	-C
B10_BC22_191109_LF_LIB_consensus_vsearch	2427	C	C	485	1	0.21%	2	1	93	93	0.4999999999999138	1	1	282	203	1	0	G
B10_BC22_191109_LF_LIB_consensus_vsearch	2428	C	Y	574	12	2.02%	2	1	93	93	2.3064308632724596E-4	1	1	376	198	0	12	T
B10_BC22_191109_LF_LIB_consensus_vsearch	2429	C	Y	560	27	4.48%	2	1	93	93	5.487004521479837E-9	1	1	383	177	0	27	T
B10_BC22_191109_LF_LIB_consensus_vsearch	2430	G	G	585	4	0.67%	2	2	93	93	0.06218152895025356	1	1	379	206	2	2	A
B10_BC22_191109_LF_LIB_consensus_vsearch	2431	T	Y	560	15	2.53%	2	1	93	93	2.782208360962169E-5	1	1	370	190	0	15	C
B10_BC22_191109_LF_LIB_consensus_vsearch	2432	A	*/-T	566	9	1.52%	2	2	93	93	0.0018924890471757854	1	1	362	204	7	2	-T
B10_BC22_191109_LF_LIB_consensus_vsearch	2433	T	Y	567	14	2.39%	2	2	93	93	5.638563569251906E-5	1	1	365	202	4	10	C
B10_BC22_191109_LF_LIB_consensus_vsearch	2434	G	G	581	5	0.83%	2	2	93	93	0.030983476501936075	1	1	375	206	1	4	-TG
B10_BC22_191109_LF_LIB_consensus_vsearch	2435	T	Y	575	12	2.02%	2	2	93	93	2.306656556500044E-4	1	1	372	203	10	2	C
B10_BC22_191109_LF_LIB_consensus_vsearch	2436	G	G	591	2	0.34%	2	1	93	93	0.24978902953563295	1	1	383	208	2	0	+C
B10_BC22_191109_LF_LIB_consensus_vsearch	2437	A	A	584	5	0.83%	2	1	93	93	0.030984833420659205	1	1	372	212	5	0	-C
B10_BC22_191109_LF_LIB_consensus_vsearch	2438	C	C	588	4	0.67%	2	2	93	93	0.06218314350277022	1	1	376	212	2	2	T
B10_BC22_191109_LF_LIB_consensus_vsearch	2439	C	*/-G	567	9	1.5%	2	2	93	93	0.0018925934416486783	1	1	361	206	6	3	-G
B10_BC22_191109_LF_LIB_consensus_vsearch	2440	G	R	548	32	5.41%	2	2	93	93	1.500146351706038E-10	1	1	338	210	31	1	A
B10_BC22_191109_LF_LIB_consensus_vsearch	2441	G	*/-C	507	41	6.82%	2	1	93	93	2.0906986042745236E-13	1	1	298	209	41	0	-C
B10_BC22_191109_LF_LIB_consensus_vsearch	2442	C	Y	532	10	1.81%	2	2	93	93	9.365081955943183E-4	1	1	325	207	6	4	T
B10_BC22_191109_LF_LIB_consensus_vsearch	2443	C	M	581	8	1.34%	2	1	93	93	0.0038139152066312184	1	1	369	212	8	0	A
B10_BC22_191109_LF_LIB_consensus_vsearch	2444	C	Y	564	17	2.82%	2	2	93	93	6.775268260038078E-6	1	1	368	196	8	9	T
B10_BC22_191109_LF_LIB_consensus_vsearch	2445	G	R	567	16	2.71%	2	2	93	93	1.3747404729208327E-5	1	1	362	205	14	2	A
B10_BC22_191109_LF_LIB_consensus_vsearch	2446	C	C	580	3	0.51%	2	1	93	93	0.12467811158812642	1	1	373	207	0	3	A
B10_BC22_191109_LF_LIB_consensus_vsearch	2447	A	A	589	6	1%	2	2	93	93	0.015428378627452975	1	1	379	210	4	2	-C
B10_BC22_191109_LF_LIB_consensus_vsearch	2448	C	*/+AC	583	9	1.51%	2	1	93	93	0.0018942161800671361	1	1	371	212	9	0	+AC
B10_BC22_191109_LF_LIB_consensus_vsearch	2449	C	*/+T	579	13	2.16%	2	1	93	93	1.1420723572987618E-4	1	1	384	195	0	13	+T
B10_BC22_191109_LF_LIB_consensus_vsearch	2450	T	T	591	2	0.34%	2	2	93	93	0.24978902953563295	1	1	383	208	1	1	C
B10_BC22_191109_LF_LIB_consensus_vsearch	2451	T	T	589	3	0.5%	2	2	93	93	0.1246830092985462	1	1	378	211	2	1	+C
B10_BC22_191109_LF_LIB_consensus_vsearch	2452	C	*/-T	560	14	2.33%	2	2	93	93	5.6330526991142806E-5	1	1	372	188	6	8	-T
B10_BC22_191109_LF_LIB_consensus_vsearch	2453	T	T	569	4	0.69%	2	1	93	93	0.06217263235112447	1	1	372	197	4	0	C
B10_BC22_191109_LF_LIB_consensus_vsearch	2454	A	R	575	11	1.85%	2	1	93	93	4.65698475176409E-4	1	1	368	207	11	0	G
B10_BC22_191109_LF_LIB_consensus_vsearch	2455	C	*/+A	562	10	1.68%	2	1	93	93	9.385848358637225E-4	1	1	360	202	10	0	+A
B10_BC22_191109_LF_LIB_consensus_vsearch	2456	G	*/+C	576	10	1.67%	2	1	93	93	9.394819933234852E-4	1	1	362	214	10	0	+C
B10_BC22_191109_LF_LIB_consensus_vsearch	2457	T	Y	557	24	4.01%	2	2	93	93	4.677234447440285E-8	1	1	354	203	16	8	C
B10_BC22_191109_LF_LIB_consensus_vsearch	2458	A	R	585	8	1.34%	2	2	93	93	0.0038145345933480535	1	1	374	211	6	2	G
B10_BC22_191109_LF_LIB_consensus_vsearch	2459	G	R	580	9	1.51%	2	1	93	93	0.001893918576967777	1	1	372	208	9	0	A
B10_BC22_191109_LF_LIB_consensus_vsearch	2460	C	*/-T	580	13	2.17%	2	2	93	93	1.1422019683041178E-4	1	1	381	199	2	11	-T
B10_BC22_191109_LF_LIB_consensus_vsearch	2461	T	T	576	3	0.51%	2	2	93	93	0.12467588591190074	1	1	376	200	2	1	-C
B10_BC22_191109_LF_LIB_consensus_vsearch	2462	C	C	588	2	0.34%	2	1	93	93	0.2497879558944788	1	1	378	210	0	2	T
B10_BC22_191109_LF_LIB_consensus_vsearch	2463	C	*/-T	581	7	1.17%	2	2	93	93	0.007673467005464533	1	1	380	201	2	5	-T
B10_BC22_191109_LF_LIB_consensus_vsearch	2464	T	T	581	5	0.85%	2	1	93	93	0.030983476501936075	1	1	380	201	0	5	+C
B10_BC22_191109_LF_LIB_consensus_vsearch	2465	T	*/-C	582	8	1.34%	2	2	93	93	0.00381407083625578	1	1	381	201	4	4	-C
B10_BC22_191109_LF_LIB_consensus_vsearch	2466	C	*/+T	571	9	1.51%	2	2	93	93	0.0018930074497425708	1	1	375	196	1	8	+T
B10_BC22_191109_LF_LIB_consensus_vsearch	2467	G	G	597	1	0.17%	2	1	93	93	0.4999999999999138	1	1	383	214	1	0	+T
B10_BC22_191109_LF_LIB_consensus_vsearch	2468	A	A	590	6	1%	2	2	93	93	0.01542870796997642	1	1	377	213	5	1	G
B10_BC22_191109_LF_LIB_consensus_vsearch	2469	C	*/+G	576	10	1.66%	2	1	93	93	9.394819933234852E-4	1	1	363	213	10	0	+G
B10_BC22_191109_LF_LIB_consensus_vsearch	2470	G	G	587	5	0.84%	2	1	93	93	0.030986176592841308	1	1	373	214	5	0	-A
B10_BC22_191109_LF_LIB_consensus_vsearch	2471	A	A	592	2	0.34%	2	1	93	93	0.24978938500452047	1	1	380	212	2	0	+G
B10_BC22_191109_LF_LIB_consensus_vsearch	2472	G	G	596	3	0.5%	2	1	93	93	0.1246867167922604	1	1	384	212	3	0	A
B10_BC22_191109_LF_LIB_consensus_vsearch	2473	T	*/+C	593	8	1.33%	2	1	93	93	0.0038157487685222483	1	1	379	214	8	0	+C
B10_BC22_191109_LF_LIB_consensus_vsearch	2474	C	*/-G	582	10	1.66%	2	1	93	93	9.398536450879837E-4	1	1	370	212	10	0	-G
B10_BC22_191109_LF_LIB_consensus_vsearch	2475	G	G	587	4	0.67%	2	1	93	93	0.062182607140620794	1	1	372	215	4	0	-A
B10_BC22_191109_LF_LIB_consensus_vsearch	2476	A	A	588	5	0.83%	2	2	93	93	0.0309866212982286	1	1	375	213	3	2	-G
B10_BC22_191109_LF_LIB_consensus_vsearch	2477	G	G	594	2	0.33%	2	1	93	93	0.24979009235977778	1	1	382	212	2	0	+A
B10_BC22_191109_LF_LIB_consensus_vsearch	2478	T	T	596	4	0.67%	2	2	93	93	0.062187370009836374	1	1	385	211	1	3	C
B10_BC22_191109_LF_LIB_consensus_vsearch	2479	T	T	600	3	0.5%	2	2	93	93	0.12468879668066746	1	1	387	213	1	2	C
B10_BC22_191109_LF_LIB_consensus_vsearch	2480	G	*/-T	571	14	2.32%	2	2	93	93	5.6416550871607475E-5	1	1	365	206	9	5	-T
B10_BC22_191109_LF_LIB_consensus_vsearch	2481	T	T	585	2	0.34%	2	1	93	93	0.2497868712706135	1	1	378	207	0	2	+C
B10_BC22_191109_LF_LIB_consensus_vsearch	2482	T	T	597	4	0.66%	2	2	93	93	0.062187890408182296	1	1	385	212	2	2	C
B10_BC22_191109_LF_LIB_consensus_vsearch	2483	T	*/-G	543	34	5.64%	2	2	93	93	3.527847960661656E-11	1	1	347	196	28	6	-G
B10_BC22_191109_LF_LIB_consensus_vsearch	2484	G	G	560	3	0.53%	2	1	93	93	0.12466666666660314	1	1	353	207	3	0	A
B10_BC22_191109_LF_LIB_consensus_vsearch	2485	G	R	579	20	3.34%	2	1	93	93	8.116693151646295E-7	1	1	366	213	20	0	A
B10_BC22_191109_LF_LIB_consensus_vsearch	2486	G	*/+A	588	8	1.33%	2	2	93	93	0.00381499370763636	1	1	375	213	6	2	+A
B10_BC22_191109_LF_LIB_consensus_vsearch	2487	A	A	594	3	0.5%	2	1	93	93	0.12468566638724124	1	1	379	215	3	0	G
B10_BC22_191109_LF_LIB_consensus_vsearch	2488	A	A	599	2	0.33%	2	1	93	93	0.24979184013288794	1	1	387	212	0	2	+T
B10_BC22_191109_LF_LIB_consensus_vsearch	2489	T	T	599	1	0.17%	2	1	93	93	0.4999999999990043	1	1	386	213	1	0	+A
B10_BC22_191109_LF_LIB_consensus_vsearch	2490	G	R	582	13	2.16%	2	1	93	93	1.1424599131191439E-4	1	1	371	211	13	0	A
B10_BC22_191109_LF_LIB_consensus_vsearch	2491	C	C	591	3	0.5%	2	2	93	93	0.12468407750622149	1	1	381	210	2	1	T
B10_BC22_191109_LF_LIB_consensus_vsearch	2492	A	R	583	11	1.84%	2	2	93	93	4.65998228714525E-4	1	1	374	209	9	2	G
B10_BC22_191109_LF_LIB_consensus_vsearch	2493	G	*/+C	582	8	1.33%	2	1	93	93	0.00381407083625578	1	1	381	201	0	8	+C
B10_BC22_191109_LF_LIB_consensus_vsearch	2494	C	*/-T	574	15	2.52%	2	2	93	93	2.7884070676335E-5	1	1	381	193	1	14	-T
B10_BC22_191109_LF_LIB_consensus_vsearch	2495	T	T	573	4	0.68%	2	2	93	93	0.062174902776938816	1	1	378	195	2	2	C
B10_BC22_191109_LF_LIB_consensus_vsearch	2496	C	*/-T	577	10	1.68%	2	1	93	93	9.395444569434851E-4	1	1	378	199	0	10	-T
B10_BC22_191109_LF_LIB_consensus_vsearch	2497	T	*/+A	563	9	1.52%	2	2	93	93	0.0018921736921997058	1	1	377	186	2	7	+A
B10_BC22_191109_LF_LIB_consensus_vsearch	2498	A	A	593	2	0.34%	2	1	93	93	0.24978973927711676	1	1	383	210	2	0	G
B10_BC22_191109_LF_LIB_consensus_vsearch	2499	A	A	601	1	0.17%	2	1	93	93	0.4999999999990043	1	1	387	214	1	0	+G
B10_BC22_191109_LF_LIB_consensus_vsearch	2500	A	A	601	1	0.17%	2	1	93	93	0.4999999999990043	1	1	387	214	1	0	-TGG
B10_BC22_191109_LF_LIB_consensus_vsearch	2501	T	*/-G	538	52	8.64%	2	2	93	93	6.854286296037712E-17	1	1	364	174	14	38	-G
B10_BC22_191109_LF_LIB_consensus_vsearch	2502	G	G	545	1	0.18%	2	1	93	93	0.5000000000008233	1	1	369	176	1	0	+A
B10_BC22_191109_LF_LIB_consensus_vsearch	2503	G	G	597	2	0.33%	2	1	93	93	0.24979114452852993	1	1	382	215	2	0	A
B10_BC22_191109_LF_LIB_consensus_vsearch	2504	G	*/-AG	590	7	1.17%	2	1	93	93	0.007675555892850146	1	1	377	213	7	0	-AG
B10_BC22_191109_LF_LIB_consensus_vsearch	2505	A	*/-G	568	19	3.2%	2	1	93	93	1.644966390386684E-6	1	1	356	212	19	0	-G
B10_BC22_191109_LF_LIB_consensus_vsearch	2506	G	*/+A	561	9	1.56%	2	1	93	93	0.0018919616270182597	1	1	347	214	9	0	+A
B10_BC22_191109_LF_LIB_consensus_vsearch	2507	G	G	594	4	0.66%	2	2	93	93	0.062186323989038686	1	1	382	212	2	2	-T
B10_BC22_191109_LF_LIB_consensus_vsearch	2508	T	*/-A	568	17	2.84%	2	2	93	93	6.780849953574307E-6	1	1	368	200	11	6	-A
B10_BC22_191109_LF_LIB_consensus_vsearch	2509	A	*/+G	559	12	2.07%	2	1	93	93	2.3029524287792016E-4	1	1	357	202	12	0	+G
B10_BC22_191109_LF_LIB_consensus_vsearch	2510	A	A	591	3	0.5%	2	2	93	93	0.12468407750622149	1	1	381	210	2	1	G
B10_BC22_191109_LF_LIB_consensus_vsearch	2511	A	*/-T	579	18	2.99%	2	2	93	93	3.3494956774692988E-6	1	1	384	195	3	15	-T
B10_BC22_191109_LF_LIB_consensus_vsearch	2512	T	T	579	3	0.51%	2	2	93	93	0.12467755803936205	1	1	382	197	2	1	C
B10_BC22_191109_LF_LIB_consensus_vsearch	2513	T	T	595	4	0.67%	2	1	93	93	0.062186847872822006	1	1	388	207	0	4	C
B10_BC22_191109_LF_LIB_consensus_vsearch	2514	T	*/-CT	582	8	1.33%	2	1	93	93	0.00381407083625578	1	1	386	196	0	8	-CT
B10_BC22_191109_LF_LIB_consensus_vsearch	2515	C	*/+T	560	11	1.87%	2	2	93	93	4.6511414231246333E-4	1	1	381	179	2	9	+T
B10_BC22_191109_LF_LIB_consensus_vsearch	2516	T	T	571	3	0.52%	2	2	93	93	0.12467306015692373	1	1	381	190	2	1	C
B10_BC22_191109_LF_LIB_consensus_vsearch	2517	T	*/+C	566	19	3.21%	2	1	93	93	1.6441208717700983E-6	1	1	364	202	19	0	+C
B10_BC22_191109_LF_LIB_consensus_vsearch	2518	C	*/-T	553	16	2.72%	2	2	93	93	1.3711680551357027E-5	1	1	376	177	6	10	-T
B10_BC22_191109_LF_LIB_consensus_vsearch	2519	T	*/-A	504	31	5.34%	2	2	93	93	2.976933666625634E-10	1	1	334	170	25	6	-A
B10_BC22_191109_LF_LIB_consensus_vsearch	2520	A	A	550	4	0.71%	2	1	93	93	0.06216139989452796	1	1	352	198	4	0	+C
B10_BC22_191109_LF_LIB_consensus_vsearch	2521	A	*/+GA	577	9	1.52%	2	1	93	93	0.0018936179518815892	1	1	375	202	9	0	+GA
B10_BC22_191109_LF_LIB_consensus_vsearch	2522	A	A	591	5	0.83%	2	2	93	93	0.030987946464272845	1	1	382	209	4	1	-G
B10_BC22_191109_LF_LIB_consensus_vsearch	2523	G	G	574	6	1%	2	2	93	93	0.01542330244911806	1	1	362	212	5	1	-C
B10_BC22_191109_LF_LIB_consensus_vsearch	2524	C	Y	570	12	2.01%	2	2	93	93	2.3055204810949474E-4	1	1	376	194	1	11	T
B10_BC22_191109_LF_LIB_consensus_vsearch	2525	T	Y	559	14	2.36%	2	2	93	93	5.632254755438094E-5	1	1	378	181	1	13	C
B10_BC22_191109_LF_LIB_consensus_vsearch	2526	A	A	576	4	0.68%	2	2	93	93	0.0621765850361776	1	1	375	201	3	1	G
B10_BC22_191109_LF_LIB_consensus_vsearch	2527	A	R	591	7	1.17%	2	2	93	93	0.007675784123381086	1	1	382	209	4	3	G
B10_BC22_191109_LF_LIB_consensus_vsearch	2528	A	A	587	6	1%	2	2	93	93	0.015427716615850288	1	1	380	207	3	3	G
B10_BC22_191109_LF_LIB_consensus_vsearch	2529	T	T	581	6	1.01%	2	1	93	93	0.015425703561055139	1	1	383	198	0	6	C
B10_BC22_191109_LF_LIB_consensus_vsearch	2530	A	R	577	9	1.51%	2	2	93	93	0.0018936179518815892	1	1	371	206	8	1	G
B10_BC22_191109_LF_LIB_consensus_vsearch	2531	C	Y	578	7	1.19%	2	2	93	93	0.007672756476313913	1	1	378	200	2	5	T
B10_BC22_191109_LF_LIB_consensus_vsearch	2532	C	*/-G	547	20	3.35%	2	2	93	93	8.041883682433435E-7	1	1	352	195	15	5	-G
B10_BC22_191109_LF_LIB_consensus_vsearch	2533	G	*/+A	545	22	3.79%	2	1	93	93	1.937123907246917E-7	1	1	340	205	22	0	+A
B10_BC22_191109_LF_LIB_consensus_vsearch	2534	G	R	522	38	6.33%	2	2	93	93	1.900041692154342E-12	1	1	312	210	35	3	A
B10_BC22_191109_LF_LIB_consensus_vsearch	2535	C	M	572	14	2.37%	2	1	93	93	5.642421556871879E-5	1	1	360	212	14	0	A
B10_BC22_191109_LF_LIB_consensus_vsearch	2536	C	*/-A	564	23	3.83%	2	1	93	93	9.569378289882198E-8	1	1	352	212	23	0	-A
B10_BC22_191109_LF_LIB_consensus_vsearch	2537	A	M	540	17	2.94%	2	1	93	93	6.740174767448187E-6	1	1	329	211	17	0	C
B10_BC22_191109_LF_LIB_consensus_vsearch	2538	G	G	594	2	0.33%	2	1	93	93	0.24979009235977778	1	1	381	213	2	0	+A
B10_BC22_191109_LF_LIB_consensus_vsearch	2539	A	*/-G	576	12	2%	2	2	93	93	2.306881496410543E-4	1	1	371	205	9	3	-G
B10_BC22_191109_LF_LIB_consensus_vsearch	2540	G	G	576	6	1.03%	2	1	93	93	0.015423994364567683	1	1	370	206	6	0	-A
B10_BC22_191109_LF_LIB_consensus_vsearch	2541	A	A	580	5	0.85%	2	2	93	93	0.030983021104337604	1	1	373	207	4	1	G
B10_BC22_191109_LF_LIB_consensus_vsearch	2542	C	C	595	3	0.5%	2	1	93	93	0.12468619246852639	1	1	385	210	0	3	T
B10_BC22_191109_LF_LIB_consensus_vsearch	2543	C	C	591	5	0.83%	2	1	93	93	0.030987946464272845	1	1	379	212	5	0	T
B10_BC22_191109_LF_LIB_consensus_vsearch	2544	G	G	594	3	0.5%	2	2	93	93	0.12468566638724124	1	1	381	213	2	1	A
B10_BC22_191109_LF_LIB_consensus_vsearch	2545	A	A	595	4	0.67%	2	2	93	93	0.062186847872822006	1	1	381	214	3	1	G
B10_BC22_191109_LF_LIB_consensus_vsearch	2546	T	T	596	2	0.33%	2	1	93	93	0.24979079497935539	1	1	383	213	0	2	+AA
B10_BC22_191109_LF_LIB_consensus_vsearch	2547	A	R	564	33	5.49%	2	1	93	93	7.388577574207544E-11	1	1	351	213	33	0	G
B10_BC22_191109_LF_LIB_consensus_vsearch	2548	G	G	598	2	0.33%	2	2	93	93	0.24979149291046765	1	1	387	211	1	1	-C
B10_BC22_191109_LF_LIB_consensus_vsearch	2549	C	C	582	6	1%	2	1	93	93	0.015426041918236095	1	1	382	200	0	6	-GC
B10_BC22_191109_LF_LIB_consensus_vsearch	2550	G	G	587	5	0.84%	2	2	93	93	0.030986176592841308	1	1	383	204	4	1	A
B10_BC22_191109_LF_LIB_consensus_vsearch	2551	C	*/+A	576	10	1.68%	2	1	93	93	9.394819933234852E-4	1	1	386	190	0	10	+A
B10_BC22_191109_LF_LIB_consensus_vsearch	2552	A	A	595	4	0.66%	2	2	93	93	0.062186847872822006	1	1	384	211	2	2	G
B10_BC22_191109_LF_LIB_consensus_vsearch	2553	C	Y	576	11	1.83%	2	1	93	93	4.657363845851338E-4	1	1	377	199	0	11	T
B10_BC22_191109_LF_LIB_consensus_vsearch	2554	A	A	579	4	0.67%	2	1	93	93	0.0621782499750882	1	1	370	209	4	0	+G
B10_BC22_191109_LF_LIB_consensus_vsearch	2555	A	A	594	3	0.5%	2	1	93	93	0.12468566638724124	1	1	381	213	3	0	G
B10_BC22_191109_LF_LIB_consensus_vsearch	2556	G	R	579	11	1.83%	2	1	93	93	4.658493531133954E-4	1	1	367	212	11	0	A
B10_BC22_191109_LF_LIB_consensus_vsearch	2557	T	Y	540	28	4.67%	2	2	93	93	2.648804807338248E-9	1	1	351	189	5	23	C
B10_BC22_191109_LF_LIB_consensus_vsearch	2558	A	*/-G	560	31	5.19%	2	1	93	93	3.1093698562724354E-10	1	1	348	212	31	0	-G
B10_BC22_191109_LF_LIB_consensus_vsearch	2559	G	*/-A	543	10	1.75%	2	1	93	93	9.372954779492018E-4	1	1	328	215	10	0	-A
B10_BC22_191109_LF_LIB_consensus_vsearch	2560	A	A	581	3	0.51%	2	1	93	93	0.1246786632393088	1	1	368	213	3	0	+G
B10_BC22_191109_LF_LIB_consensus_vsearch	2561	G	*/-T	580	12	2.01%	2	1	93	93	2.3077737978553087E-4	1	1	380	200	0	12	-T
B10_BC22_191109_LF_LIB_consensus_vsearch	2562	T	T	574	5	0.85%	2	1	93	93	0.030980255699410347	1	1	382	192	0	5	+G
B10_BC22_191109_LF_LIB_consensus_vsearch	2563	G	G	592	2	0.33%	2	1	93	93	0.24978938500452047	1	1	382	210	2	0	-A
B10_BC22_191109_LF_LIB_consensus_vsearch	2564	A	A	594	4	0.67%	2	1	93	93	0.062186323989038686	1	1	381	213	4	0	G
B10_BC22_191109_LF_LIB_consensus_vsearch	2565	T	T	587	6	1%	2	2	93	93	0.015427716615850288	1	1	376	211	4	2	C
B10_BC22_191109_LF_LIB_consensus_vsearch	2566	C	C	585	3	0.5%	2	1	93	93	0.1246808510636648	1	1	375	210	3	0	+A
B10_BC22_191109_LF_LIB_consensus_vsearch	2567	G	*/-A	520	59	9.88%	2	1	93	93	3.6566102184635446E-19	1	1	316	204	59	0	-A
B10_BC22_191109_LF_LIB_consensus_vsearch	2568	A	A	525	3	0.56%	2	2	93	93	0.12464454976311873	1	1	321	204	1	2	G
B10_BC22_191109_LF_LIB_consensus_vsearch	2569	A	A	589	2	0.34%	2	1	93	93	0.2497883149871952	1	1	381	208	2	0	+GAA
B10_BC22_191109_LF_LIB_consensus_vsearch	2570	A	A	593	4	0.66%	2	1	93	93	0.06218579834936829	1	1	380	213	4	0	G
B10_BC22_191109_LF_LIB_consensus_vsearch	2571	G	G	599	2	0.33%	2	2	93	93	0.24979184013288794	1	1	385	214	1	1	-A
B10_BC22_191109_LF_LIB_consensus_vsearch	2572	A	A	590	5	0.83%	2	1	93	93	0.030987506226370864	1	1	380	210	5	0	G
B10_BC22_191109_LF_LIB_consensus_vsearch	2573	T	T	588	5	0.83%	2	1	93	93	0.0309866212982286	1	1	380	208	0	5	C
B10_BC22_191109_LF_LIB_consensus_vsearch	2574	G	*/-A	524	45	7.55%	2	2	93	93	1.1490879591942121E-14	1	1	344	180	25	20	-A
B10_BC22_191109_LF_LIB_consensus_vsearch	2575	A	A	547	1	0.18%	2	1	93	93	0.4999999999999138	1	1	355	192	0	1	C
B10_BC22_191109_LF_LIB_consensus_vsearch	2576	A	A	591	4	0.67%	2	2	93	93	0.06218474176725347	1	1	379	212	2	2	G
B10_BC22_191109_LF_LIB_consensus_vsearch	2577	A	A	600	2	0.33%	2	1	93	93	0.249792186200784	1	1	388	212	0	2	G
B10_BC22_191109_LF_LIB_consensus_vsearch	2578	A	A	597	4	0.66%	2	2	93	93	0.062187890408182296	1	1	384	213	3	1	G
B10_BC22_191109_LF_LIB_consensus_vsearch	2579	G	G	601	1	0.17%	2	1	93	93	0.4999999999990043	1	1	387	214	0	1	-C
B10_BC22_191109_LF_LIB_consensus_vsearch	2580	C	C	598	2	0.33%	2	1	93	93	0.24979149291046765	1	1	386	212	0	2	+T
B10_BC22_191109_LF_LIB_consensus_vsearch	2581	A	A	596	6	1%	2	2	93	93	0.015430661086331218	1	1	382	214	5	1	G
B10_BC22_191109_LF_LIB_consensus_vsearch	2582	C	*/-T	550	22	3.65%	2	2	93	93	1.9407111842786683E-7	1	1	370	180	2	20	-T
B10_BC22_191109_LF_LIB_consensus_vsearch	2583	T	T	564	2	0.35%	2	2	93	93	0.24977895667588107	1	1	371	193	1	1	C
B10_BC22_191109_LF_LIB_consensus_vsearch	2584	T	T	579	3	0.51%	2	1	93	93	0.12467755803936205	1	1	371	208	0	3	+C
B10_BC22_191109_LF_LIB_consensus_vsearch	2585	T	*/-G	577	24	3.98%	2	2	93	93	4.715886544916048E-8	1	1	380	197	7	17	-G
B10_BC22_191109_LF_LIB_consensus_vsearch	2586	G	G	572	5	0.86%	2	1	93	93	0.030979321122758578	1	1	381	191	0	5	T
B10_BC22_191109_LF_LIB_consensus_vsearch	2587	G	*/+A	559	23	3.81%	2	1	93	93	9.550973546202137E-8	1	1	347	212	23	0	+A
B10_BC22_191109_LF_LIB_consensus_vsearch	2588	A	A	583	1	0.17%	2	1	93	93	0.4999999999999138	1	1	369	214	1	0	G
B10_BC22_191109_LF_LIB_consensus_vsearch	2589	A	*/+G	555	43	7.15%	2	2	93	93	5.1958002002313704E-14	1	1	343	212	42	1	+G
B10_BC22_191109_LF_LIB_consensus_vsearch	2590	A	A	591	6	1%	2	1	93	93	0.015429036211008771	1	1	377	214	6	0	-G
B10_BC22_191109_LF_LIB_consensus_vsearch	2591	G	*/+A	583	8	1.34%	2	2	93	93	0.0038142259421648926	1	1	370	213	7	1	+A
B10_BC22_191109_LF_LIB_consensus_vsearch	2592	A	*/+G	579	14	2.33%	2	2	93	93	5.647716467319973E-5	1	1	369	210	11	3	+G
B10_BC22_191109_LF_LIB_consensus_vsearch	2593	G	*/-A	557	42	6.98%	2	2	93	93	1.0798015253491715E-13	1	1	346	211	38	4	-A
B10_BC22_191109_LF_LIB_consensus_vsearch	2594	A	*/+GT	4	319	56.86%	2	2	93	93	5.104457019633275E-185	1	1	3	1	176	143	+GT
B10_BC22_191109_LF_LIB_consensus_vsearch	2595	T	*/-A	512	51	8.49%	2	2	93	93	1.356522518152232E-16	1	1	314	198	42	9	-A
B10_BC22_191109_LF_LIB_consensus_vsearch	2596	A	W	424	118	21.49%	2	2	93	93	2.3384519507739873E-39	1	1	262	162	79	39	T
B10_BC22_191109_LF_LIB_consensus_vsearch	2597	A	W	543	51	8.5%	2	2	93	93	1.4471670951722103E-16	1	1	342	201	42	9	T
B10_BC22_191109_LF_LIB_consensus_vsearch	2598	A	A	593	5	0.83%	2	2	93	93	0.03098882252468081	1	1	385	208	1	4	G
B10_BC22_191109_LF_LIB_consensus_vsearch	2599	A	A	597	4	0.66%	2	2	93	93	0.062187890408182296	1	1	386	211	1	3	G
B10_BC22_191109_LF_LIB_consensus_vsearch	2600	A	A	592	2	0.33%	2	2	93	93	0.24978938500452047	1	1	384	208	1	1	-G
B10_BC22_191109_LF_LIB_consensus_vsearch	2601	G	G	592	3	0.5%	2	1	93	93	0.1246846089151382	1	1	386	206	0	3	-C
B10_BC22_191109_LF_LIB_consensus_vsearch	2602	C	*/-AC	571	15	2.51%	2	1	93	93	2.7871028761098336E-5	1	1	369	202	15	0	-AC
B10_BC22_191109_LF_LIB_consensus_vsearch	2603	A	A	574	3	0.51%	2	2	93	93	0.12467476149184535	1	1	366	208	1	2	-C
B10_BC22_191109_LF_LIB_consensus_vsearch	2604	C	C	572	6	1.03%	2	2	93	93	0.015422605753746292	1	1	365	207	1	5	T
B10_BC22_191109_LF_LIB_consensus_vsearch	2605	G	*/-TG	564	25	4.17%	2	2	93	93	2.297688701857108E-8	1	1	377	187	2	23	-TG
B10_BC22_191109_LF_LIB_consensus_vsearch	2606	T	T	557	6	1.05%	2	1	93	93	0.0154172230461365	1	1	369	188	6	0	+A
B10_BC22_191109_LF_LIB_consensus_vsearch	2607	G	G	560	6	1.05%	2	1	93	93	0.01541832237086722	1	1	373	187	6	0	-AA
B10_BC22_191109_LF_LIB_consensus_vsearch	2608	A	A	576	4	0.68%	2	1	93	93	0.0621765850361776	1	1	365	211	4	0	+GA
B10_BC22_191109_LF_LIB_consensus_vsearch	2609	A	A	585	5	0.84%	2	1	93	93	0.030985282661769052	1	1	373	212	5	0	G
B10_BC22_191109_LF_LIB_consensus_vsearch	2610	A	R	580	10	1.67%	2	2	93	93	9.39730591623294E-4	1	1	373	207	9	1	G
B10_BC22_191109_LF_LIB_consensus_vsearch	2611	T	K	582	8	1.34%	2	2	93	93	0.00381407083625578	1	1	373	209	7	1	G
B10_BC22_191109_LF_LIB_consensus_vsearch	2612	T	-G/-G	28	564	93.84%	2	2	93	93	4.460213502285595E-307	1	1	15	13	366	198	-G
B10_BC22_191109_LF_LIB_consensus_vsearch	2613	G	R	15	7	22.58%	2	2	93	93	0.004450455953575614	1	1	9	6	6	1	A
B10_BC22_191109_LF_LIB_consensus_vsearch	2614	G	K	576	13	2.18%	2	1	93	93	1.141680944483324E-4	1	1	369	207	13	0	T
B10_BC22_191109_LF_LIB_consensus_vsearch	2615	T	Y	582	14	2.33%	2	2	93	93	5.6499486887489286E-5	1	1	385	197	1	13	C
B10_BC22_191109_LF_LIB_consensus_vsearch	2616	T	*/+G	577	12	2%	2	2	93	93	2.3071056867786312E-4	1	1	380	197	1	11	+G
B10_BC22_191109_LF_LIB_consensus_vsearch	2617	G	*/-A	503	74	12.33%	2	2	93	93	4.3381649809725734E-24	1	1	307	196	69	5	-A
B10_BC22_191109_LF_LIB_consensus_vsearch	2618	A	A	506	2	0.39%	2	2	93	93	0.24975369458145744	1	1	307	199	1	1	+G
B10_BC22_191109_LF_LIB_consensus_vsearch	2619	A	R	576	8	1.36%	2	2	93	93	0.0038131291090651434	1	1	377	199	2	6	G
B10_BC22_191109_LF_LIB_consensus_vsearch	2620	A	*/-G	396	168	27.95%	2	2	93	93	1.1261383627298524E-57	1	1	238	158	122	46	-G
B10_BC22_191109_LF_LIB_consensus_vsearch	2621	G	G	408	5	1.19%	2	1	93	93	0.030871902500081518	1	1	246	162	0	5	+C
B10_BC22_191109_LF_LIB_consensus_vsearch	2622	G	R	555	26	4.43%	2	2	93	93	1.1194801558231206E-8	1	1	347	208	25	1	A
B10_BC22_191109_LF_LIB_consensus_vsearch	2623	G	*/-A	527	22	3.68%	2	2	93	93	1.9237168299587703E-7	1	1	318	209	20	2	-A
B10_BC22_191109_LF_LIB_consensus_vsearch	2624	A	A	534	4	0.74%	2	2	93	93	0.06215132534293568	1	1	330	204	2	2	T
B10_BC22_191109_LF_LIB_consensus_vsearch	2625	A	R	537	18	3.18%	2	2	93	93	3.3161669603931005E-6	1	1	332	205	17	1	G
B10_BC22_191109_LF_LIB_consensus_vsearch	2626	G	G	579	2	0.34%	2	1	93	93	0.24978466838924643	1	1	373	206	0	2	A
B10_BC22_191109_LF_LIB_consensus_vsearch	2627	C	*/-GC	581	7	1.17%	2	2	93	93	0.007673467005464533	1	1	378	203	6	1	-GC
B10_BC22_191109_LF_LIB_consensus_vsearch	2628	G	*/-C	567	12	2.04%	2	1	93	93	2.3048295964434314E-4	1	1	378	189	0	12	-C
B10_BC22_191109_LF_LIB_consensus_vsearch	2629	C	*/-T	565	7	1.2%	2	2	93	93	0.007669591697725923	1	1	375	190	2	5	-T
B10_BC22_191109_LF_LIB_consensus_vsearch	2630	T	*/-C	582	8	1.35%	2	2	93	93	0.00381407083625578	1	1	379	203	3	5	-C
B10_BC22_191109_LF_LIB_consensus_vsearch	2631	C	C	578	3	0.51%	2	2	93	93	0.12467700258396955	1	1	375	203	2	1	+TC
B10_BC22_191109_LF_LIB_consensus_vsearch	2632	A	R	574	11	1.84%	2	2	93	93	4.6566043808442384E-4	1	1	371	203	8	3	G
B10_BC22_191109_LF_LIB_consensus_vsearch	2633	C	*/-A	546	22	3.69%	2	2	93	93	1.9378459798667462E-7	1	1	353	193	19	3	-A
B10_BC22_191109_LF_LIB_consensus_vsearch	2634	A	R	557	10	1.75%	2	2	93	93	9.382538110477103E-4	1	1	352	205	9	1	G
B10_BC22_191109_LF_LIB_consensus_vsearch	2635	A	R	563	18	3.01%	2	2	93	93	3.337337378734891E-6	1	1	351	212	17	1	G
B10_BC22_191109_LF_LIB_consensus_vsearch	2636	C	S	561	22	3.72%	2	1	93	93	1.9484048038021322E-7	1	1	354	207	22	0	G
B10_BC22_191109_LF_LIB_consensus_vsearch	2637	C	C	584	3	0.5%	2	1	93	93	0.12468030690531334	1	1	375	209	3	0	+G
B10_BC22_191109_LF_LIB_consensus_vsearch	2638	A	A	586	4	0.67%	2	2	93	93	0.062182068959449006	1	1	378	208	3	1	G
B10_BC22_191109_LF_LIB_consensus_vsearch	2639	G	*/-A	586	10	1.67%	2	2	93	93	9.400973019723426E-4	1	1	377	209	6	4	-A
B10_BC22_191109_LF_LIB_consensus_vsearch	2640	A	*/-C	555	19	3.21%	2	1	93	93	1.6393715543553221E-6	1	1	376	179	0	19	-C
B10_BC22_191109_LF_LIB_consensus_vsearch	2641	C	Y	508	55	9.43%	2	1	93	93	6.93742936065825E-18	1	1	380	128	0	55	T
B10_BC22_191109_LF_LIB_consensus_vsearch	2642	T	T	576	5	0.85%	2	2	93	93	0.030981183844570895	1	1	379	197	3	2	C
B10_BC22_191109_LF_LIB_consensus_vsearch	2643	T	*/-CTG	564	8	1.34%	2	1	93	93	0.0038111867275475823	1	1	382	182	0	8	-CTG
B10_BC22_191109_LF_LIB_consensus_vsearch	2644	C	*/-T	558	8	1.39%	2	2	93	93	0.0038101848312436046	1	1	377	181	3	5	-T
B10_BC22_191109_LF_LIB_consensus_vsearch	2645	T	*/-G	520	36	6.27%	2	2	93	93	8.104234740656339E-12	1	1	377	143	1	35	-G
B10_BC22_191109_LF_LIB_consensus_vsearch	2646	G	R	536	8	1.46%	2	2	93	93	0.003806323277364471	1	1	381	155	4	4	A
B10_BC22_191109_LF_LIB_consensus_vsearch	2647	G	G	586	6	1.01%	2	2	93	93	0.015427383935577244	1	1	383	203	2	4	A
B10_BC22_191109_LF_LIB_consensus_vsearch	2648	G	G	592	2	0.34%	2	1	93	93	0.24978938500452047	1	1	385	207	2	0	A
B10_BC22_191109_LF_LIB_consensus_vsearch	2649	C	C	574	6	1.01%	2	2	93	93	0.01542330244911806	1	1	376	198	5	1	-G
B10_BC22_191109_LF_LIB_consensus_vsearch	2650	G	R	577	10	1.68%	2	1	93	93	9.395444569434851E-4	1	1	368	209	10	0	A
B10_BC22_191109_LF_LIB_consensus_vsearch	2651	G	K	586	8	1.33%	2	1	93	93	0.00381468814385855	1	1	375	211	8	0	T
B10_BC22_191109_LF_LIB_consensus_vsearch	2652	T	T	589	5	0.83%	2	2	93	93	0.030987064506852544	1	1	382	207	2	3	C
B10_BC22_191109_LF_LIB_consensus_vsearch	2653	G	*/-T	580	9	1.51%	2	2	93	93	0.001893918576967777	1	1	377	203	2	7	-T
B10_BC22_191109_LF_LIB_consensus_vsearch	2654	T	T	584	2	0.34%	2	2	93	93	0.2497865072588101	1	1	382	202	1	1	A
B10_BC22_191109_LF_LIB_consensus_vsearch	2655	T	*/-C	562	24	3.99%	2	2	93	93	4.6871196177712065E-8	1	1	357	205	18	6	-C
B10_BC22_191109_LF_LIB_consensus_vsearch	2656	C	C	573	4	0.69%	2	1	93	93	0.062174902776938816	1	1	365	208	4	0	T
B10_BC22_191109_LF_LIB_consensus_vsearch	2657	C	C	584	6	1%	2	2	93	93	0.015426715197547503	1	1	382	202	1	5	T
B10_BC22_191109_LF_LIB_consensus_vsearch	2658	G	*/-C	578	10	1.68%	2	2	93	93	9.396067104969792E-4	1	1	367	211	9	1	-C
B10_BC22_191109_LF_LIB_consensus_vsearch	2659	C	Y	582	7	1.18%	2	2	93	93	0.007673702245629301	1	1	374	208	4	3	T
B10_BC22_191109_LF_LIB_consensus_vsearch	2660	C	Y	579	14	2.33%	2	2	93	93	5.647716467319973E-5	1	1	380	199	2	12	T
B10_BC22_191109_LF_LIB_consensus_vsearch	2661	G	R	549	42	7.04%	2	1	93	93	1.0685750844301655E-13	1	1	344	205	42	0	A
B10_BC22_191109_LF_LIB_consensus_vsearch	2662	G	R	581	8	1.33%	2	2	93	93	0.0038139152066312184	1	1	378	203	7	1	A
B10_BC22_191109_LF_LIB_consensus_vsearch	2663	T	T	581	5	0.84%	2	2	93	93	0.030983476501936075	1	1	381	200	1	4	-CT
B10_BC22_191109_LF_LIB_consensus_vsearch	2664	C	*/-T	557	25	4.21%	2	2	93	93	2.2903568510906506E-8	1	1	379	178	2	23	-T
B10_BC22_191109_LF_LIB_consensus_vsearch	2665	T	T	563	4	0.7%	2	2	93	93	0.062169166621763194	1	1	381	182	1	3	C
B10_BC22_191109_LF_LIB_consensus_vsearch	2666	T	*/+C	546	33	5.5%	2	2	93	93	7.281880378587062E-11	1	1	345	201	28	5	+C
B10_BC22_191109_LF_LIB_consensus_vsearch	2667	C	*/-T	562	22	3.7%	2	2	93	93	1.9490910563964625E-7	1	1	364	198	13	9	-T
B10_BC22_191109_LF_LIB_consensus_vsearch	2668	T	Y	553	15	2.61%	2	2	93	93	2.7789983577292E-5	1	1	360	193	9	6	C
B10_BC22_191109_LF_LIB_consensus_vsearch	2669	G	G	594	2	0.33%	2	2	93	93	0.24979009235977778	1	1	382	212	1	1	+A
B10_BC22_191109_LF_LIB_consensus_vsearch	2670	A	*/-C	560	27	4.5%	2	1	93	93	5.487004521479837E-9	1	1	346	214	27	0	-C
B10_BC22_191109_LF_LIB_consensus_vsearch	2671	C	C	565	4	0.7%	2	2	93	93	0.06217032998972652	1	1	353	212	2	2	T
B10_BC22_191109_LF_LIB_consensus_vsearch	2672	C	C	586	6	1%	2	2	93	93	0.015427383935577244	1	1	374	212	4	2	T
B10_BC22_191109_LF_LIB_consensus_vsearch	2673	G	R	575	21	3.51%	2	2	93	93	3.985801356911812E-7	1	1	365	210	19	2	A
B10_BC22_191109_LF_LIB_consensus_vsearch	2674	G	*/+T	584	7	1.16%	2	1	93	93	0.007674170345963	1	1	383	201	0	7	+T
B10_BC22_191109_LF_LIB_consensus_vsearch	2675	T	T	590	4	0.66%	2	2	93	93	0.062184210806914414	1	1	380	210	3	1	C
B10_BC22_191109_LF_LIB_consensus_vsearch	2676	C	*/-T	577	15	2.51%	2	2	93	93	2.7896984770005455E-5	1	1	376	201	6	9	-T
B10_BC22_191109_LF_LIB_consensus_vsearch	2677	T	*/-ACT	565	10	1.71%	2	1	93	93	9.387807192830865E-4	1	1	365	200	10	0	-ACT
B10_BC22_191109_LF_LIB_consensus_vsearch	2678	A	R	555	17	2.89%	2	2	93	93	6.762437269239861E-6	1	1	353	202	16	1	G
B10_BC22_191109_LF_LIB_consensus_vsearch	2679	C	*/-T	568	9	1.53%	2	2	93	93	0.0018926974773018042	1	1	372	196	1	8	-T
B10_BC22_191109_LF_LIB_consensus_vsearch	2680	T	*/+C	546	11	1.89%	2	2	93	93	4.6454081261780003E-4	1	1	355	191	8	3	+C
B10_BC22_191109_LF_LIB_consensus_vsearch	2681	C	*/-A	551	23	3.89%	2	1	93	93	9.520921926797758E-8	1	1	347	204	23	0	-A
B10_BC22_191109_LF_LIB_consensus_vsearch	2682	A	R	539	12	2.09%	2	2	93	93	2.2980257902033605E-4	1	1	331	208	10	2	G
B10_BC22_191109_LF_LIB_consensus_vsearch	2683	C	*/+TG	554	19	3.23%	2	2	93	93	1.6389313032449787E-6	1	1	348	206	18	1	+TG
B10_BC22_191109_LF_LIB_consensus_vsearch	2684	C	Y	560	12	2.01%	2	2	93	93	2.3031898910607474E-4	1	1	359	201	5	7	T
B10_BC22_191109_LF_LIB_consensus_vsearch	2685	G	R	571	20	3.34%	2	2	93	93	8.09869995415386E-7	1	1	357	214	19	1	A
B10_BC22_191109_LF_LIB_consensus_vsearch	2686	T	*/-CC	408	142	23.71%	2	1	93	93	5.025234753095724E-48	1	1	196	212	142	0	-CC
B10_BC22_191109_LF_LIB_consensus_vsearch	2687	C	C	411	2	0.48%	2	1	93	93	0.24969696969696092	1	1	197	214	2	0	+G
B10_BC22_191109_LF_LIB_consensus_vsearch	2688	C	M	444	7	1.53%	2	1	93	93	0.007631422258539495	1	1	230	214	7	0	A
B10_BC22_191109_LF_LIB_consensus_vsearch	2689	C	*/-G	484	51	8.47%	2	2	93	93	1.2709067985861632E-16	1	1	306	178	50	1	-G
B10_BC22_191109_LF_LIB_consensus_vsearch	2690	G	*/-A	501	26	4.71%	2	1	93	93	1.086354491975161E-8	1	1	291	210	26	0	-A
B10_BC22_191109_LF_LIB_consensus_vsearch	2691	A	*/-G	540	14	2.45%	2	1	93	93	5.616562721441904E-5	1	1	331	209	14	0	-G
B10_BC22_191109_LF_LIB_consensus_vsearch	2692	G	G	566	4	0.69%	2	2	93	93	0.062170908610734946	1	1	360	206	3	1	A
B10_BC22_191109_LF_LIB_consensus_vsearch	2693	G	G	578	4	0.67%	2	1	93	93	0.06217769690336766	1	1	366	212	4	0	-C
B10_BC22_191109_LF_LIB_consensus_vsearch	2694	C	C	590	3	0.51%	2	2	93	93	0.12468354430400949	1	1	376	214	2	1	A
B10_BC22_191109_LF_LIB_consensus_vsearch	2695	C	Y	580	11	1.84%	2	2	93	93	4.658867581677564E-4	1	1	370	210	9	2	T
B10_BC22_191109_LF_LIB_consensus_vsearch	2696	A	A	588	4	0.67%	2	2	93	93	0.06218314350277022	1	1	377	211	1	3	G
B10_BC22_191109_LF_LIB_consensus_vsearch	2697	A	R	502	87	14.48%	2	1	93	93	2.090887581777677E-28	1	1	288	214	87	0	G
B10_BC22_191109_LF_LIB_consensus_vsearch	2698	C	Y	584	8	1.33%	2	1	93	93	0.0038143805269862142	1	1	371	213	8	0	T
B10_BC22_191109_LF_LIB_consensus_vsearch	2699	A	A	598	3	0.5%	2	1	93	93	0.12468776019987309	1	1	383	215	3	0	G
B10_BC22_191109_LF_LIB_consensus_vsearch	2700	T	T	597	2	0.33%	2	1	93	93	0.24979114452852993	1	1	383	214	2	0	C
B10_BC22_191109_LF_LIB_consensus_vsearch	2701	C	C	597	6	1%	2	1	93	93	0.015430982833263808	1	1	382	215	6	0	-ATC
B10_BC22_191109_LF_LIB_consensus_vsearch	2702	A	A	596	1	0.17%	2	1	93	93	0.4999999999999138	1	1	381	215	1	0	G
B10_BC22_191109_LF_LIB_consensus_vsearch	2703	T	T	590	4	0.67%	2	2	93	93	0.062184210806914414	1	1	378	212	2	2	C
B10_BC22_191109_LF_LIB_consensus_vsearch	2704	C	C	589	4	0.67%	2	2	93	93	0.06218367805512527	1	1	376	213	3	1	-T
B10_BC22_191109_LF_LIB_consensus_vsearch	2705	T	*/-G	571	11	1.84%	2	2	93	93	4.655455542392171E-4	1	1	374	197	4	7	-G
B10_BC22_191109_LF_LIB_consensus_vsearch	2706	G	R	580	7	1.18%	2	1	93	93	0.0076732309665896	1	1	374	206	7	0	A
B10_BC22_191109_LF_LIB_consensus_vsearch	2707	G	G	597	4	0.66%	2	2	93	93	0.062187890408182296	1	1	386	211	1	3	A
B10_BC22_191109_LF_LIB_consensus_vsearch	2708	G	G	601	2	0.33%	2	1	93	93	0.2497925311200579	1	1	388	213	0	2	A
B10_BC22_191109_LF_LIB_consensus_vsearch	2709	A	A	591	6	1%	2	2	93	93	0.015429036211008771	1	1	379	212	5	1	-C
B10_BC22_191109_LF_LIB_consensus_vsearch	2710	C	C	592	4	0.67%	2	1	93	93	0.06218527094514562	1	1	383	209	0	4	T
B10_BC22_191109_LF_LIB_consensus_vsearch	2711	C	C	592	2	0.33%	2	1	93	93	0.24978938500452047	1	1	384	208	2	0	-G
B10_BC22_191109_LF_LIB_consensus_vsearch	2712	G	*/-C	575	12	2.01%	2	2	93	93	2.306656556500044E-4	1	1	368	207	10	2	-C
B10_BC22_191109_LF_LIB_consensus_vsearch	2713	C	C	580	2	0.34%	2	2	93	93	0.24978503869256835	1	1	374	206	1	1	A
B10_BC22_191109_LF_LIB_consensus_vsearch	2714	C	*/-G	581	8	1.34%	2	1	93	93	0.0038139152066312184	1	1	383	198	0	8	-G
B10_BC22_191109_LF_LIB_consensus_vsearch	2715	G	G	586	3	0.51%	2	1	93	93	0.12468139337307069	1	1	387	199	0	3	T
B10_BC22_191109_LF_LIB_consensus_vsearch	2716	G	G	600	1	0.17%	2	1	93	93	0.4999999999999138	1	1	387	213	1	0	A
B10_BC22_191109_LF_LIB_consensus_vsearch	2717	A	A	595	3	0.5%	2	2	93	93	0.12468619246852639	1	1	384	211	1	2	G
B10_BC22_191109_LF_LIB_consensus_vsearch	2718	T	*/-A	588	8	1.33%	2	2	93	93	0.00381499370763636	1	1	380	208	5	3	-A
B10_BC22_191109_LF_LIB_consensus_vsearch	2719	A	A	589	3	0.51%	2	1	93	93	0.1246830092985462	1	1	379	210	3	0	G
B10_BC22_191109_LF_LIB_consensus_vsearch	2720	A	R	587	9	1.5%	2	2	93	93	0.001894608361560784	1	1	380	207	7	2	G
B10_BC22_191109_LF_LIB_consensus_vsearch	2721	G	G	588	2	0.34%	2	1	93	93	0.2497879558944788	1	1	384	204	0	2	-ACCTTAG
B10_BC22_191109_LF_LIB_consensus_vsearch	2722	A	R	577	7	1.17%	2	2	93	93	0.007672518016675552	1	1	377	200	4	3	G
B10_BC22_191109_LF_LIB_consensus_vsearch	2723	C	*/+G	581	10	1.68%	2	1	93	93	9.397922212937875E-4	1	1	373	208	10	0	+G
B10_BC22_191109_LF_LIB_consensus_vsearch	2724	C	*/-T	540	37	6.16%	2	2	93	93	4.008817896923828E-12	1	1	372	168	8	29	-T
B10_BC22_191109_LF_LIB_consensus_vsearch	2725	T	Y	545	9	1.61%	2	1	93	93	0.001890210465296116	1	1	363	182	9	0	C
B10_BC22_191109_LF_LIB_consensus_vsearch	2726	T	Y	546	17	2.86%	2	2	93	93	6.749215399993968E-6	1	1	345	201	11	6	C
B10_BC22_191109_LF_LIB_consensus_vsearch	2727	A	*/-G	479	62	10.82%	2	2	93	93	3.395464905559842E-20	1	1	319	160	31	31	-G
B10_BC22_191109_LF_LIB_consensus_vsearch	2728	G	G	516	4	0.76%	2	1	93	93	0.06213925005774881	1	1	339	177	4	0	+A
B10_BC22_191109_LF_LIB_consensus_vsearch	2729	G	G	593	3	0.5%	2	1	93	93	0.12468513853935516	1	1	380	213	3	0	-A
B10_BC22_191109_LF_LIB_consensus_vsearch	2730	A	A	589	5	0.84%	2	1	93	93	0.030987064506852544	1	1	377	212	5	0	+G
B10_BC22_191109_LF_LIB_consensus_vsearch	2731	A	R	587	7	1.17%	2	2	93	93	0.007674866606290045	1	1	376	211	6	1	G
B10_BC22_191109_LF_LIB_consensus_vsearch	2732	T	T	585	6	1%	2	1	93	93	0.015427050131369397	1	1	377	208	6	0	+C
B10_BC22_191109_LF_LIB_consensus_vsearch	2733	G	*/-TA	550	19	3.17%	2	2	93	93	1.6371557674519644E-6	1	1	350	200	10	9	-TA
B10_BC22_191109_LF_LIB_consensus_vsearch	2734	T	Y	523	29	5.02%	2	2	93	93	1.27692477156723E-9	1	1	357	166	9	20	C
B10_BC22_191109_LF_LIB_consensus_vsearch	2735	A	R	517	51	8.92%	2	2	93	93	1.3714349227520852E-16	1	1	322	195	48	3	G
B10_BC22_191109_LF_LIB_consensus_vsearch	2736	G	*/+C	565	12	2%	2	1	93	93	2.3043650914873222E-4	1	1	380	185	0	12	+C
B10_BC22_191109_LF_LIB_consensus_vsearch	2737	C	*/+T	527	20	3.35%	2	1	93	93	7.991000300516907E-7	1	1	378	149	0	20	+T
B10_BC22_191109_LF_LIB_consensus_vsearch	2738	T	*/+C	167	293	51.68%	2	2	93	93	1.0316674247363847E-119	1	1	85	82	268	25	+C
B10_BC22_191109_LF_LIB_consensus_vsearch	2739	C	Y	480	16	3.2%	2	2	93	93	1.3494236669722314E-5	1	1	366	114	1	15	T
B10_BC22_191109_LF_LIB_consensus_vsearch	2740	C	Y	566	10	1.72%	2	1	93	93	9.388455655418633E-4	1	1	387	179	0	10	T
B10_BC22_191109_LF_LIB_consensus_vsearch	2741	C	*/-T	572	11	1.85%	2	2	93	93	4.655839782704286E-4	1	1	382	190	1	10	-T
B10_BC22_191109_LF_LIB_consensus_vsearch	2742	T	*/+C	555	16	2.75%	2	1	93	93	1.3716886954288146E-5	1	1	367	188	16	0	+C
B10_BC22_191109_LF_LIB_consensus_vsearch	2743	C	*/-G	470	80	13.42%	2	2	93	93	3.727649364252979E-26	1	1	298	172	51	29	-G
B10_BC22_191109_LF_LIB_consensus_vsearch	2744	G	*/+A	435	27	5.47%	2	1	93	93	5.038704004941931E-9	1	1	256	179	27	0	+A
B10_BC22_191109_LF_LIB_consensus_vsearch	2745	G	R	523	45	7.84%	2	2	93	93	1.1471817275992872E-14	1	1	312	211	44	1	A
B10_BC22_191109_LF_LIB_consensus_vsearch	2746	G	R	553	33	5.59%	2	1	93	93	7.323989576814462E-11	1	1	342	211	33	0	A
B10_BC22_191109_LF_LIB_consensus_vsearch	2747	G	R	534	32	5.31%	2	1	93	93	1.4834574404749108E-10	1	1	323	211	32	0	A
B10_BC22_191109_LF_LIB_consensus_vsearch	2748	A	A	555	4	0.7%	2	2	93	93	0.062164429867041036	1	1	346	209	3	1	-G
B10_BC22_191109_LF_LIB_consensus_vsearch	2749	G	G	579	3	0.51%	2	1	93	93	0.12467755803936205	1	1	368	211	3	0	-T
B10_BC22_191109_LF_LIB_consensus_vsearch	2750	T	*/+A	533	39	6.52%	2	1	93	93	9.304013172538626E-13	1	1	336	197	39	0	+A
B10_BC22_191109_LF_LIB_consensus_vsearch	2751	G	K	503	39	6.59%	2	1	93	93	8.952692214760027E-13	1	1	298	205	39	0	T
B10_BC22_191109_LF_LIB_consensus_vsearch	2752	T	K	550	11	1.87%	2	1	93	93	4.647074958288269E-4	1	1	351	199	11	0	G
B10_BC22_191109_LF_LIB_consensus_vsearch	2753	T	*/+G	530	23	3.84%	2	2	93	93	9.438304217032579E-8	1	1	327	203	22	1	+G
B10_BC22_191109_LF_LIB_consensus_vsearch	2754	A	M	533	25	4.22%	2	1	93	93	2.2639862580938872E-8	1	1	330	203	25	0	C
B10_BC22_191109_LF_LIB_consensus_vsearch	2755	T	Y	540	38	6.45%	2	2	93	93	1.9401984453484113E-12	1	1	336	204	34	4	C
B10_BC22_191109_LF_LIB_consensus_vsearch	2756	A	A	576	5	0.84%	2	2	93	93	0.030981183844570895	1	1	372	204	3	2	-G
B10_BC22_191109_LF_LIB_consensus_vsearch	2757	G	R	524	40	6.73%	2	2	93	93	4.441443139511569E-13	1	1	338	186	38	2	A
B10_BC22_191109_LF_LIB_consensus_vsearch	2758	C	*/+T	542	26	4.5%	2	1	93	93	1.1120080450256333E-8	1	1	378	164	0	26	+T
B10_BC22_191109_LF_LIB_consensus_vsearch	2759	C	*/-T	579	14	2.33%	2	2	93	93	5.647716467319973E-5	1	1	383	196	1	13	-T
B10_BC22_191109_LF_LIB_consensus_vsearch	2760	T	W	532	21	3.58%	2	2	93	93	3.9295863677024223E-7	1	1	359	173	6	15	A
B10_BC22_191109_LF_LIB_consensus_vsearch	2761	G	*/-TG	516	22	3.7%	2	2	93	93	1.915122117926581E-7	1	1	340	176	20	2	-TG
B10_BC22_191109_LF_LIB_consensus_vsearch	2762	T	*/-G	497	14	2.5%	2	2	93	93	5.5768787085626295E-5	1	1	349	148	9	5	-G
B10_BC22_191109_LF_LIB_consensus_vsearch	2763	G	*/+TG	527	16	2.87%	2	2	93	93	1.3640654423489123E-5	1	1	332	195	13	3	+TG
B10_BC22_191109_LF_LIB_consensus_vsearch	2764	G	G	583	3	0.5%	2	1	93	93	0.12467976088783492	1	1	376	207	0	3	-TG
B10_BC22_191109_LF_LIB_consensus_vsearch	2765	T	W	562	17	2.88%	2	2	93	93	6.772449818907221E-6	1	1	376	186	1	16	A
B10_BC22_191109_LF_LIB_consensus_vsearch	2766	G	G	595	1	0.17%	2	1	93	93	0.4999999999999138	1	1	384	211	1	0	-A
B10_BC22_191109_LF_LIB_consensus_vsearch	2767	A	A	595	3	0.5%	2	1	93	93	0.12468619246852639	1	1	382	213	3	0	+T
B10_BC22_191109_LF_LIB_consensus_vsearch	2768	T	T	598	2	0.33%	2	1	93	93	0.24979149291046765	1	1	383	215	2	0	C
B10_BC22_191109_LF_LIB_consensus_vsearch	2769	G	*/-CG	583	9	1.5%	2	2	93	93	0.0018942161800671361	1	1	374	209	7	2	-CG
B10_BC22_191109_LF_LIB_consensus_vsearch	2770	C	*/+G	570	10	1.69%	2	2	93	93	9.39102740052465E-4	1	1	369	201	5	5	+G
B10_BC22_191109_LF_LIB_consensus_vsearch	2771	G	G	584	5	0.84%	2	2	93	93	0.030984833420659205	1	1	377	207	4	1	A
B10_BC22_191109_LF_LIB_consensus_vsearch	2772	G	G	602	1	0.17%	2	1	93	93	0.4999999999990043	1	1	388	214	0	1	+TGG
B10_BC22_191109_LF_LIB_consensus_vsearch	2773	C	C	599	2	0.33%	2	2	93	93	0.24979184013288794	1	1	385	214	1	1	T
B10_BC22_191109_LF_LIB_consensus_vsearch	2774	G	*/-CG	567	34	5.64%	2	2	93	93	3.601186955865482E-11	1	1	370	197	17	17	-CG
B10_BC22_191109_LF_LIB_consensus_vsearch	2775	C	C	564	2	0.35%	2	2	93	93	0.24977895667588107	1	1	369	195	1	1	-G
B10_BC22_191109_LF_LIB_consensus_vsearch	2776	G	G	556	3	0.53%	2	1	93	93	0.12466427931981025	1	1	367	189	0	3	+C
B10_BC22_191109_LF_LIB_consensus_vsearch	2777	T	T	590	4	0.67%	2	2	93	93	0.062184210806914414	1	1	383	207	1	3	-C
B10_BC22_191109_LF_LIB_consensus_vsearch	2778	C	*/-T	587	8	1.34%	2	2	93	93	0.003814841181091788	1	1	383	204	1	7	-T
B10_BC22_191109_LF_LIB_consensus_vsearch	2779	T	*/+C	553	26	4.38%	2	1	93	93	1.11834972973567E-8	1	1	352	201	26	0	+C
B10_BC22_191109_LF_LIB_consensus_vsearch	2780	C	*/-G	526	44	7.42%	2	2	93	93	2.3982613136553384E-14	1	1	345	181	25	19	-G
B10_BC22_191109_LF_LIB_consensus_vsearch	2781	G	R	487	31	5.68%	2	1	93	93	2.9322235702919227E-10	1	1	301	186	31	0	A
B10_BC22_191109_LF_LIB_consensus_vsearch	2782	G	R	525	32	5.37%	2	1	93	93	1.4723767990427373E-10	1	1	317	208	32	0	A
B10_BC22_191109_LF_LIB_consensus_vsearch	2783	G	R	566	13	2.16%	2	1	93	93	1.1403476275553268E-4	1	1	354	212	13	0	A
B10_BC22_191109_LF_LIB_consensus_vsearch	2784	T	*/-G	493	81	13.64%	2	1	93	93	1.9823432198407867E-26	1	1	285	208	81	0	-G
B10_BC22_191109_LF_LIB_consensus_vsearch	2785	G	*/+A	458	27	5.23%	2	1	93	93	5.135740696905451E-9	1	1	245	213	27	0	+A
B10_BC22_191109_LF_LIB_consensus_vsearch	2786	A	*/-G	343	229	39.08%	2	2	93	93	3.5325519009369455E-82	1	1	135	208	226	3	-G
B10_BC22_191109_LF_LIB_consensus_vsearch	2787	G	G	342	6	1.69%	2	1	93	93	0.015289228950998206	1	1	131	211	6	0	A
B10_BC22_191109_LF_LIB_consensus_vsearch	2788	G	R	525	65	10.94%	2	2	93	93	4.195638581768666E-21	1	1	311	214	64	1	A
B10_BC22_191109_LF_LIB_consensus_vsearch	2789	T	*/-C	526	42	7.02%	2	1	93	93	1.0351803241089785E-13	1	1	312	214	42	0	-C
B10_BC22_191109_LF_LIB_consensus_vsearch	2790	C	C	547	6	1.08%	2	1	93	93	0.015413472645223152	1	1	332	215	6	0	+A
B10_BC22_191109_LF_LIB_consensus_vsearch	2791	C	*/-G	585	9	1.5%	2	2	93	93	0.0018944129256754595	1	1	376	209	8	1	-G
B10_BC22_191109_LF_LIB_consensus_vsearch	2792	G	R	575	17	2.86%	2	2	93	93	6.790444562646919E-6	1	1	362	213	16	1	A
B10_BC22_191109_LF_LIB_consensus_vsearch	2793	C	*/-G	575	11	1.82%	2	1	93	93	4.65698475176409E-4	1	1	365	210	11	0	-G
B10_BC22_191109_LF_LIB_consensus_vsearch	2794	G	G	571	5	0.86%	2	1	93	93	0.030978851401829387	1	1	363	208	5	0	C
B10_BC22_191109_LF_LIB_consensus_vsearch	2795	C	*/-T	557	18	3.05%	2	2	93	93	3.332612809559604E-6	1	1	363	194	7	11	-T
B10_BC22_191109_LF_LIB_consensus_vsearch	2796	T	T	569	5	0.87%	2	2	93	93	0.030977907051971357	1	1	374	195	3	2	C
B10_BC22_191109_LF_LIB_consensus_vsearch	2797	T	*/-C	576	9	1.51%	2	2	93	93	0.001893517063995506	1	1	372	204	5	4	-C
B10_BC22_191109_LF_LIB_consensus_vsearch	2798	C	*/+G	573	10	1.69%	2	1	93	93	9.392933313754103E-4	1	1	380	193	0	10	+G
B10_BC22_191109_LF_LIB_consensus_vsearch	2799	G	R	580	11	1.84%	2	2	93	93	4.658867581677564E-4	1	1	377	203	8	3	A
B10_BC22_191109_LF_LIB_consensus_vsearch	2800	G	G	596	2	0.33%	2	1	93	93	0.24979079497935539	1	1	384	212	2	0	A
B10_BC22_191109_LF_LIB_consensus_vsearch	2801	C	*/-A	535	43	7.14%	2	2	93	93	5.051621451982351E-14	1	1	338	197	41	2	-A
B10_BC22_191109_LF_LIB_consensus_vsearch	2802	A	A	543	6	1.09%	2	2	93	93	0.015411934300312994	1	1	342	201	3	3	G
B10_BC22_191109_LF_LIB_consensus_vsearch	2803	A	A	575	6	1.01%	2	2	93	93	0.015423649001259471	1	1	377	198	5	1	G
B10_BC22_191109_LF_LIB_consensus_vsearch	2804	G	G	580	6	1.01%	2	1	93	93	0.01542536405110175	1	1	383	197	0	6	+C
B10_BC22_191109_LF_LIB_consensus_vsearch	2805	G	G	599	1	0.17%	2	1	93	93	0.4999999999990043	1	1	384	215	1	0	+A
B10_BC22_191109_LF_LIB_consensus_vsearch	2806	A	A	597	4	0.66%	2	2	93	93	0.062187890408182296	1	1	383	214	3	1	G
B10_BC22_191109_LF_LIB_consensus_vsearch	2807	T	*/+A	568	30	4.98%	2	1	93	93	6.414014859746018E-10	1	1	354	214	30	0	+A
B10_BC22_191109_LF_LIB_consensus_vsearch	2808	G	K	559	30	4.98%	2	1	93	93	6.37662551159861E-10	1	1	347	212	30	0	T
B10_BC22_191109_LF_LIB_consensus_vsearch	2809	T	Y	591	7	1.17%	2	2	93	93	0.007675784123381086	1	1	385	206	2	5	C
B10_BC22_191109_LF_LIB_consensus_vsearch	2810	T	*/-GGC	580	9	1.5%	2	2	93	93	0.001893918576967777	1	1	374	206	7	2	-GGC
B10_BC22_191109_LF_LIB_consensus_vsearch	2811	G	R	575	12	2.04%	2	1	93	93	2.306656556500044E-4	1	1	367	208	12	0	A
B10_BC22_191109_LF_LIB_consensus_vsearch	2812	G	G	587	2	0.34%	2	1	93	93	0.249787595581865	1	1	377	210	0	2	-CG
B10_BC22_191109_LF_LIB_consensus_vsearch	2813	C	C	579	3	0.51%	2	2	93	93	0.12467755803936205	1	1	372	207	1	2	-GT
B10_BC22_191109_LF_LIB_consensus_vsearch	2814	G	G	585	4	0.67%	2	2	93	93	0.06218152895025356	1	1	381	204	2	2	A
B10_BC22_191109_LF_LIB_consensus_vsearch	2815	T	*/-A	559	22	3.71%	2	2	93	93	1.9470258079362864E-7	1	1	375	184	6	16	-A
B10_BC22_191109_LF_LIB_consensus_vsearch	2816	A	A	572	2	0.35%	2	1	93	93	0.24978204010503535	1	1	378	194	0	2	C
B10_BC22_191109_LF_LIB_consensus_vsearch	2817	A	A	589	4	0.67%	2	2	93	93	0.06218367805512527	1	1	380	209	2	2	-TG
B10_BC22_191109_LF_LIB_consensus_vsearch	2818	T	Y	567	13	2.17%	2	2	93	93	1.1404829797726498E-4	1	1	380	187	3	10	C
B10_BC22_191109_LF_LIB_consensus_vsearch	2819	G	*/+A	551	24	4.06%	2	2	93	93	4.665168881452447E-8	1	1	380	171	2	22	+A
B10_BC22_191109_LF_LIB_consensus_vsearch	2820	G	R	578	11	1.83%	2	2	93	93	4.658118229180549E-4	1	1	378	200	1	10	A
B10_BC22_191109_LF_LIB_consensus_vsearch	2821	T	Y	576	15	2.5%	2	2	93	93	2.789269415844126E-5	1	1	386	190	1	14	C
B10_BC22_191109_LF_LIB_consensus_vsearch	2822	T	K	581	8	1.33%	2	1	93	93	0.0038139152066312184	1	1	381	200	0	8	G
B10_BC22_191109_LF_LIB_consensus_vsearch	2823	G	G	592	4	0.67%	2	1	93	93	0.06218527094514562	1	1	380	212	4	0	A
B10_BC22_191109_LF_LIB_consensus_vsearch	2824	T	*/+C	578	15	2.5%	2	1	93	93	2.7901261387207864E-5	1	1	366	212	15	0	+C
B10_BC22_191109_LF_LIB_consensus_vsearch	2825	C	C	591	5	0.84%	2	2	93	93	0.030987946464272845	1	1	379	212	2	3	-A
B10_BC22_191109_LF_LIB_consensus_vsearch	2826	A	R	572	12	2.02%	2	2	93	93	2.3059772017075368E-4	1	1	371	201	10	2	G
B10_BC22_191109_LF_LIB_consensus_vsearch	2827	G	R	551	40	6.75%	2	2	93	93	4.594544938667246E-13	1	1	348	203	37	3	A
B10_BC22_191109_LF_LIB_consensus_vsearch	2828	C	Y	572	13	2.16%	2	2	93	93	1.141152960809769E-4	1	1	378	194	5	8	T
B10_BC22_191109_LF_LIB_consensus_vsearch	2829	G	R	559	31	5.21%	2	1	93	93	3.107185204765343E-10	1	1	353	206	31	0	A
B10_BC22_191109_LF_LIB_consensus_vsearch	2830	G	*/-C	558	28	4.66%	2	1	93	93	2.677377679802448E-9	1	1	347	211	28	0	-C
B10_BC22_191109_LF_LIB_consensus_vsearch	2831	C	Y	561	7	1.23%	2	1	93	93	0.007668588879253857	1	1	356	205	0	7	T
B10_BC22_191109_LF_LIB_consensus_vsearch	2832	C	C	594	2	0.33%	2	1	93	93	0.24979009235977778	1	1	379	215	2	0	T
B10_BC22_191109_LF_LIB_consensus_vsearch	2833	C	Y	590	13	2.16%	2	2	93	93	1.1434749666655842E-4	1	1	386	204	2	11	T
B10_BC22_191109_LF_LIB_consensus_vsearch	2834	G	R	592	8	1.33%	2	2	93	93	0.003815598757548882	1	1	378	214	7	1	A
B10_BC22_191109_LF_LIB_consensus_vsearch	2835	T	T	592	6	1%	2	2	93	93	0.01542936335614873	1	1	382	210	1	5	C
B10_BC22_191109_LF_LIB_consensus_vsearch	2836	C	*/-T	583	10	1.66%	2	2	93	93	9.399148640318375E-4	1	1	376	207	4	6	-T
B10_BC22_191109_LF_LIB_consensus_vsearch	2837	T	T	584	1	0.17%	2	1	93	93	0.4999999999999138	1	1	376	208	1	0	A
B10_BC22_191109_LF_LIB_consensus_vsearch	2838	T	T	585	5	0.84%	2	2	93	93	0.030985282661769052	1	1	374	211	2	3	+G
B10_BC22_191109_LF_LIB_consensus_vsearch	2839	G	*/-A	562	15	2.49%	2	2	93	93	2.783111683740202E-5	1	1	358	204	6	9	-A
B10_BC22_191109_LF_LIB_consensus_vsearch	2840	A	R	565	9	1.56%	2	2	93	93	0.0018923842920326984	1	1	366	199	3	6	G
B10_BC22_191109_LF_LIB_consensus_vsearch	2841	A	A	583	2	0.34%	2	2	93	93	0.24978614200168656	1	1	370	213	1	1	+C
B10_BC22_191109_LF_LIB_consensus_vsearch	2842	A	R	575	24	3.98%	2	1	93	93	4.712125894421053E-8	1	1	360	215	24	0	G
B10_BC22_191109_LF_LIB_consensus_vsearch	2843	C	C	585	6	1%	2	1	93	93	0.015427050131369397	1	1	372	213	6	0	-A
B10_BC22_191109_LF_LIB_consensus_vsearch	2844	A	R	574	10	1.69%	2	2	93	93	9.393564316164558E-4	1	1	364	210	7	3	G
B10_BC22_191109_LF_LIB_consensus_vsearch	2845	C	*/-G	574	9	1.5%	2	1	93	93	0.0018933142585401675	1	1	371	203	0	9	-G
B10_BC22_191109_LF_LIB_consensus_vsearch	2846	G	R	584	7	1.18%	2	1	93	93	0.007674170345963	1	1	380	204	7	0	A
B10_BC22_191109_LF_LIB_consensus_vsearch	2847	G	G	596	2	0.33%	2	2	93	93	0.24979079497935539	1	1	384	212	1	1	A
B10_BC22_191109_LF_LIB_consensus_vsearch	2848	A	*/-C	570	28	4.66%	2	1	93	93	2.6956067704680517E-9	1	1	355	215	28	0	-C
B10_BC22_191109_LF_LIB_consensus_vsearch	2849	C	C	572	2	0.35%	2	2	93	93	0.24978204010503535	1	1	358	214	1	1	T
B10_BC22_191109_LF_LIB_consensus_vsearch	2850	C	*/-A	546	46	7.63%	2	2	93	93	5.7240307378803985E-15	1	1	340	206	42	4	-A
B10_BC22_191109_LF_LIB_consensus_vsearch	2851	A	A	541	5	0.9%	2	1	93	93	0.030963960074036706	1	1	334	207	5	0	+G
B10_BC22_191109_LF_LIB_consensus_vsearch	2852	A	*/-G	510	71	11.81%	2	2	93	93	4.339411604009398E-23	1	1	301	209	70	1	-G
B10_BC22_191109_LF_LIB_consensus_vsearch	2853	G	G	506	6	1.15%	2	1	93	93	0.015396567387895594	1	1	297	209	6	0	+A
B10_BC22_191109_LF_LIB_consensus_vsearch	2854	G	*/-A	574	8	1.34%	2	1	93	93	0.0038128109095927364	1	1	359	215	8	0	-A
B10_BC22_191109_LF_LIB_consensus_vsearch	2855	A	A	583	2	0.34%	2	1	93	93	0.24978614200168656	1	1	370	213	2	0	+G
B10_BC22_191109_LF_LIB_consensus_vsearch	2856	G	*/+T	582	7	1.17%	2	1	93	93	0.007673702245629301	1	1	380	202	0	7	+T
B10_BC22_191109_LF_LIB_consensus_vsearch	2857	T	*/+C	589	7	1.16%	2	1	93	93	0.007675326899053761	1	1	378	211	7	0	+C
B10_BC22_191109_LF_LIB_consensus_vsearch	2858	C	*/-T	577	14	2.33%	2	2	93	93	5.6462160792036027E-5	1	1	372	205	5	9	-T
B10_BC22_191109_LF_LIB_consensus_vsearch	2859	T	Y	566	12	2.06%	2	2	93	93	2.3045977381397776E-4	1	1	369	197	6	6	C
B10_BC22_191109_LF_LIB_consensus_vsearch	2860	A	A	590	1	0.17%	2	1	93	93	0.5000000000008233	1	1	378	212	1	0	+CA
B10_BC22_191109_LF_LIB_consensus_vsearch	2861	A	R	576	18	2.99%	2	1	93	93	3.347263328889398E-6	1	1	367	209	18	0	G
B10_BC22_191109_LF_LIB_consensus_vsearch	2862	C	C	596	2	0.33%	2	1	93	93	0.24979079497935539	1	1	386	210	0	2	G
B10_BC22_191109_LF_LIB_consensus_vsearch	2863	A	A	592	5	0.83%	2	2	93	93	0.03098838522787931	1	1	381	211	4	1	+CA
B10_BC22_191109_LF_LIB_consensus_vsearch	2864	T	T	599	1	0.17%	2	1	93	93	0.4999999999990043	1	1	386	213	1	0	+C
B10_BC22_191109_LF_LIB_consensus_vsearch	2865	C	C	595	3	0.5%	2	2	93	93	0.12468619246852639	1	1	385	210	1	2	-T
B10_BC22_191109_LF_LIB_consensus_vsearch	2866	T	T	589	4	0.67%	2	2	93	93	0.06218367805512527	1	1	382	207	2	2	-AT
B10_BC22_191109_LF_LIB_consensus_vsearch	2867	A	R	587	7	1.17%	2	2	93	93	0.007674866606290045	1	1	379	208	5	2	G
B10_BC22_191109_LF_LIB_consensus_vsearch	2868	T	T	589	3	0.5%	2	2	93	93	0.1246830092985462	1	1	380	209	1	2	C
B10_BC22_191109_LF_LIB_consensus_vsearch	2869	G	*/-CG	568	13	2.17%	2	1	93	93	1.1406178769493562E-4	1	1	370	198	0	13	-CG
B10_BC22_191109_LF_LIB_consensus_vsearch	2870	C	*/-G	536	36	6.13%	2	1	93	93	8.242386890782678E-12	1	1	341	195	36	0	-G
B10_BC22_191109_LF_LIB_consensus_vsearch	2871	G	*/-A	527	8	1.45%	2	2	93	93	0.003804652581188002	1	1	329	198	7	1	-A
B10_BC22_191109_LF_LIB_consensus_vsearch	2872	A	*/+G	573	7	1.18%	2	1	93	93	0.0076715559842246905	1	1	364	209	7	0	+G
B10_BC22_191109_LF_LIB_consensus_vsearch	2873	G	G	583	5	0.84%	2	1	93	93	0.030984382652161722	1	1	376	207	0	5	-T
B10_BC22_191109_LF_LIB_consensus_vsearch	2874	T	T	583	5	0.84%	2	2	93	93	0.030984382652161722	1	1	381	202	2	3	C
B10_BC22_191109_LF_LIB_consensus_vsearch	2875	G	G	593	2	0.33%	2	1	93	93	0.24978973927711676	1	1	383	210	2	0	A
B10_BC22_191109_LF_LIB_consensus_vsearch	2876	T	T	597	1	0.17%	2	1	93	93	0.4999999999999138	1	1	385	212	0	1	A
B10_BC22_191109_LF_LIB_consensus_vsearch	2877	T	*/+C	585	13	2.16%	2	1	93	93	1.1428436686558987E-4	1	1	373	212	13	0	+C
B10_BC22_191109_LF_LIB_consensus_vsearch	2878	C	*/-G	566	19	3.16%	2	2	93	93	1.6441208717700983E-6	1	1	368	198	17	2	-G
B10_BC22_191109_LF_LIB_consensus_vsearch	2879	G	R	542	16	2.79%	2	2	93	93	1.3682405604174076E-5	1	1	342	200	15	1	A
B10_BC22_191109_LF_LIB_consensus_vsearch	2880	G	S	519	51	8.6%	2	1	93	93	1.3773681971328116E-16	1	1	366	153	0	51	C
B10_BC22_191109_LF_LIB_consensus_vsearch	2881	G	K	588	14	2.32%	2	1	93	93	5.654348207050046E-5	1	1	374	214	14	0	T
B10_BC22_191109_LF_LIB_consensus_vsearch	2882	T	*/-GT	532	48	7.96%	2	2	93	93	1.288490130550505E-15	1	1	380	152	1	47	-GT
B10_BC22_191109_LF_LIB_consensus_vsearch	2883	G	G	549	2	0.36%	2	1	93	93	0.24977293369627507	1	1	383	166	2	0	A
B10_BC22_191109_LF_LIB_consensus_vsearch	2884	T	T	534	6	1.08%	2	2	93	93	0.015408389854212225	1	1	371	163	3	3	C
B10_BC22_191109_LF_LIB_consensus_vsearch	2885	C	*/+A	565	11	1.84%	2	1	93	93	4.6531225052335137E-4	1	1	368	197	0	11	+A
B10_BC22_191109_LF_LIB_consensus_vsearch	2886	A	A	588	4	0.67%	2	2	93	93	0.06218314350277022	1	1	375	213	3	1	G
B10_BC22_191109_LF_LIB_consensus_vsearch	2887	A	*/+G	561	35	5.83%	2	1	93	93	1.7404954281890085E-11	1	1	347	214	35	0	+G
B10_BC22_191109_LF_LIB_consensus_vsearch	2888	A	*/+C	220	262	43.59%	2	2	93	93	2.988419025502019E-101	1	1	119	101	161	101	+C
B10_BC22_191109_LF_LIB_consensus_vsearch	2889	C	C	583	6	1.02%	2	1	93	93	0.015426379128433065	1	1	371	212	6	0	G
B10_BC22_191109_LF_LIB_consensus_vsearch	2890	C	C	592	4	0.67%	2	1	93	93	0.06218527094514562	1	1	382	210	0	4	+T
B10_BC22_191109_LF_LIB_consensus_vsearch	2891	C	C	595	2	0.33%	2	1	93	93	0.24979044425840527	1	1	384	211	0	2	-T
B10_BC22_191109_LF_LIB_consensus_vsearch	2892	T	Y	585	9	1.51%	2	2	93	93	0.0018944129256754595	1	1	378	207	6	3	C
B10_BC22_191109_LF_LIB_consensus_vsearch	2893	A	A	593	3	0.5%	2	1	93	93	0.12468513853935516	1	1	380	213	3	0	G
B10_BC22_191109_LF_LIB_consensus_vsearch	2894	C	C	594	4	0.67%	2	1	93	93	0.062186323989038686	1	1	384	210	0	4	T
B10_BC22_191109_LF_LIB_consensus_vsearch	2895	G	*/-CG	591	8	1.33%	2	2	93	93	0.0038154482484643428	1	1	381	210	3	5	-CG
B10_BC22_191109_LF_LIB_consensus_vsearch	2896	C	C	591	3	0.5%	2	1	93	93	0.12468407750622149	1	1	381	210	3	0	T
B10_BC22_191109_LF_LIB_consensus_vsearch	2897	G	G	585	3	0.5%	2	2	93	93	0.1246808510636648	1	1	376	209	2	1	+CG
B10_BC22_191109_LF_LIB_consensus_vsearch	2898	T	*/-A	584	9	1.5%	2	2	93	93	0.0018943147174077597	1	1	376	208	2	7	-A
B10_BC22_191109_LF_LIB_consensus_vsearch	2899	A	A	585	2	0.34%	2	1	93	93	0.2497868712706135	1	1	377	208	2	0	G
B10_BC22_191109_LF_LIB_consensus_vsearch	2900	A	A	594	3	0.5%	2	1	93	93	0.12468566638724124	1	1	379	215	3	0	G
B10_BC22_191109_LF_LIB_consensus_vsearch	2901	T	Y	580	11	1.84%	2	2	93	93	4.658867581677564E-4	1	1	377	203	2	9	C
B10_BC22_191109_LF_LIB_consensus_vsearch	2902	G	*/-A	586	8	1.33%	2	1	93	93	0.00381468814385855	1	1	371	215	8	0	-A
B10_BC22_191109_LF_LIB_consensus_vsearch	2903	A	A	575	4	0.68%	2	1	93	93	0.062176026221018546	1	1	362	213	4	0	+G
B10_BC22_191109_LF_LIB_consensus_vsearch	2904	A	R	576	7	1.17%	2	2	93	93	0.007672278741851824	1	1	362	214	6	1	G
B10_BC22_191109_LF_LIB_consensus_vsearch	2905	A	A	593	3	0.5%	2	2	93	93	0.12468513853935516	1	1	380	213	1	2	G
B10_BC22_191109_LF_LIB_consensus_vsearch	2906	G	*/-T	584	10	1.66%	2	2	93	93	9.39975879151716E-4	1	1	381	203	2	8	-T
B10_BC22_191109_LF_LIB_consensus_vsearch	2907	T	T	582	4	0.68%	2	2	93	93	0.0621798978595429	1	1	384	198	1	3	C
B10_BC22_191109_LF_LIB_consensus_vsearch	2908	G	G	596	2	0.33%	2	1	93	93	0.24979079497935539	1	1	385	211	2	0	-A
B10_BC22_191109_LF_LIB_consensus_vsearch	2909	A	A	595	5	0.83%	2	1	93	93	0.03098969274732699	1	1	380	215	5	0	G
B10_BC22_191109_LF_LIB_consensus_vsearch	2910	A	A	591	6	1%	2	2	93	93	0.015429036211008771	1	1	380	211	5	1	G
B10_BC22_191109_LF_LIB_consensus_vsearch	2911	C	*/-G	578	13	2.17%	2	2	93	93	1.1419423177491619E-4	1	1	374	204	4	9	-G
B10_BC22_191109_LF_LIB_consensus_vsearch	2912	G	G	581	2	0.34%	2	1	93	93	0.24978540772560268	1	1	376	205	2	0	A
B10_BC22_191109_LF_LIB_consensus_vsearch	2913	G	G	592	3	0.5%	2	1	93	93	0.1246846089151382	1	1	377	215	3	0	+A
B10_BC22_191109_LF_LIB_consensus_vsearch	2914	A	*/-G	588	10	1.67%	2	1	93	93	9.402179215996255E-4	1	1	375	213	10	0	-G
B10_BC22_191109_LF_LIB_consensus_vsearch	2915	G	R	574	10	1.69%	2	1	93	93	9.393564316164558E-4	1	1	363	211	10	0	A
B10_BC22_191109_LF_LIB_consensus_vsearch	2916	G	G	597	3	0.5%	2	1	93	93	0.12468723936635923	1	1	383	214	3	0	+AG
B10_BC22_191109_LF_LIB_consensus_vsearch	2917	T	*/-G	495	90	14.95%	2	2	93	93	1.9755657068383115E-29	1	1	371	124	9	81	-G
B10_BC22_191109_LF_LIB_consensus_vsearch	2918	G	G	502	3	0.59%	2	2	93	93	0.12462834489588868	1	1	373	129	2	1	A
B10_BC22_191109_LF_LIB_consensus_vsearch	2919	G	G	600	0	0%	2	0	93	0	1.0	1	0	386	214	0	0	
B10_BC22_191109_LF_LIB_consensus_vsearch	2920	G	*/+A	587	8	1.33%	2	1	93	93	0.003814841181091788	1	1	378	209	8	0	+A
B10_BC22_191109_LF_LIB_consensus_vsearch	2921	A	A	584	5	0.84%	2	2	93	93	0.030984833420659205	1	1	379	205	4	1	G
B10_BC22_191109_LF_LIB_consensus_vsearch	2922	A	*/-G	540	38	6.33%	2	2	93	93	1.9401984453484113E-12	1	1	354	186	20	18	-G
B10_BC22_191109_LF_LIB_consensus_vsearch	2923	G	*/+A	543	7	1.25%	2	1	93	93	0.007663896355890601	1	1	356	187	7	0	+A
B10_BC22_191109_LF_LIB_consensus_vsearch	2924	G	*/+A	588	8	1.34%	2	1	93	93	0.00381499370763636	1	1	377	211	8	0	+A
B10_BC22_191109_LF_LIB_consensus_vsearch	2925	G	G	591	2	0.33%	2	2	93	93	0.24978902953563295	1	1	383	208	1	1	+A
B10_BC22_191109_LF_LIB_consensus_vsearch	2926	T	Y	564	15	2.51%	2	2	93	93	2.784008976528302E-5	1	1	377	187	4	11	C
B10_BC22_191109_LF_LIB_consensus_vsearch	2927	A	A	588	2	0.34%	2	2	93	93	0.2497879558944788	1	1	381	207	1	1	C
B10_BC22_191109_LF_LIB_consensus_vsearch	2928	A	R	546	29	4.83%	2	2	93	93	1.2968568797478625E-9	1	1	343	203	28	1	G
B10_BC22_191109_LF_LIB_consensus_vsearch	2929	C	Y	571	9	1.52%	2	1	93	93	0.0018930074497425708	1	1	381	190	0	9	T
B10_BC22_191109_LF_LIB_consensus_vsearch	2930	C	*/+T	573	11	1.83%	2	1	93	93	4.656222726659411E-4	1	1	382	191	0	11	+T
B10_BC22_191109_LF_LIB_consensus_vsearch	2931	T	T	585	3	0.51%	2	1	93	93	0.1246808510636648	1	1	381	204	0	3	+G
B10_BC22_191109_LF_LIB_consensus_vsearch	2932	G	G	594	2	0.33%	2	2	93	93	0.24979009235977778	1	1	383	211	1	1	A
B10_BC22_191109_LF_LIB_consensus_vsearch	2933	C	*/-AC	527	65	10.83%	2	1	93	93	4.223731817843842E-21	1	1	318	209	65	0	-AC
B10_BC22_191109_LF_LIB_consensus_vsearch	2934	A	A	519	5	0.93%	2	2	93	93	0.030951956604203933	1	1	310	209	2	3	+C
B10_BC22_191109_LF_LIB_consensus_vsearch	2935	C	C	524	5	0.94%	2	2	93	93	0.030954772292166692	1	1	313	211	2	3	T
B10_BC22_191109_LF_LIB_consensus_vsearch	2936	C	C	598	1	0.17%	2	1	93	93	0.5000000000008233	1	1	383	215	1	0	-ATCGACC
B10_BC22_191109_LF_LIB_consensus_vsearch	2937	A	A	594	3	0.5%	2	2	93	93	0.12468566638724124	1	1	382	212	1	2	G
B10_BC22_191109_LF_LIB_consensus_vsearch	2938	T	T	594	5	0.83%	2	2	93	93	0.03098925836211217	1	1	383	211	2	3	C
B10_BC22_191109_LF_LIB_consensus_vsearch	2939	C	C	591	5	0.83%	2	1	93	93	0.030987946464272845	1	1	378	213	5	0	+T
B10_BC22_191109_LF_LIB_consensus_vsearch	2940	G	G	598	2	0.33%	2	1	93	93	0.24979149291046765	1	1	386	212	0	2	A
B10_BC22_191109_LF_LIB_consensus_vsearch	2941	A	R	588	7	1.16%	2	2	93	93	0.007675097138165556	1	1	375	213	5	2	G
B10_BC22_191109_LF_LIB_consensus_vsearch	2942	C	C	592	2	0.34%	2	1	93	93	0.24978938500452047	1	1	379	213	0	2	T
B10_BC22_191109_LF_LIB_consensus_vsearch	2943	C	*/+G	582	7	1.16%	2	1	93	93	0.007673702245629301	1	1	376	206	0	7	+G
B10_BC22_191109_LF_LIB_consensus_vsearch	2944	G	G	593	4	0.67%	2	1	93	93	0.06218579834936829	1	1	379	214	4	0	-A
B10_BC22_191109_LF_LIB_consensus_vsearch	2945	A	A	586	6	1%	2	2	93	93	0.015427383935577244	1	1	375	211	3	3	G
B10_BC22_191109_LF_LIB_consensus_vsearch	2946	T	*/-C	503	81	13.46%	2	1	93	93	2.0964687861683553E-26	1	1	293	210	81	0	-C
B10_BC22_191109_LF_LIB_consensus_vsearch	2947	C	*/+A	508	10	1.92%	2	1	93	93	9.346759140832711E-4	1	1	293	215	10	0	+A
B10_BC22_191109_LF_LIB_consensus_vsearch	2948	C	*/-T	580	16	2.65%	2	2	93	93	1.3779132218050288E-5	1	1	371	209	12	4	-T
B10_BC22_191109_LF_LIB_consensus_vsearch	2949	T	Y	555	11	1.88%	2	2	93	93	4.649125876501121E-4	1	1	364	191	2	9	C
B10_BC22_191109_LF_LIB_consensus_vsearch	2950	G	*/-ATG	562	13	2.16%	2	1	93	93	1.1398016219406192E-4	1	1	351	211	13	0	-ATG
B10_BC22_191109_LF_LIB_consensus_vsearch	2951	A	A	571	2	0.34%	2	1	93	93	0.24978165938881738	1	1	356	215	2	0	+C
B10_BC22_191109_LF_LIB_consensus_vsearch	2952	T	T	572	6	1.02%	2	1	93	93	0.015422605753746292	1	1	358	214	6	0	+A
B10_BC22_191109_LF_LIB_consensus_vsearch	2953	G	R	573	10	1.71%	2	1	93	93	9.392933313754103E-4	1	1	358	215	10	0	A
B10_BC22_191109_LF_LIB_consensus_vsearch	2954	T	*/-C	588	7	1.17%	2	2	93	93	0.007675097138165556	1	1	376	212	5	2	-C
B10_BC22_191109_LF_LIB_consensus_vsearch	2955	C	C	592	2	0.34%	2	1	93	93	0.24978938500452047	1	1	380	212	2	0	T
B10_BC22_191109_LF_LIB_consensus_vsearch	2956	C	C	597	3	0.5%	2	2	93	93	0.12468723936635923	1	1	386	211	1	2	-T
B10_BC22_191109_LF_LIB_consensus_vsearch	2957	T	*/+C	579	13	2.17%	2	1	93	93	1.1420723572987618E-4	1	1	372	207	13	0	+C
B10_BC22_191109_LF_LIB_consensus_vsearch	2958	C	*/-G	591	7	1.16%	2	1	93	93	0.007675784123381086	1	1	388	203	0	7	-G
B10_BC22_191109_LF_LIB_consensus_vsearch	2959	G	G	586	6	1.01%	2	2	93	93	0.015427383935577244	1	1	382	204	5	1	A
B10_BC22_191109_LF_LIB_consensus_vsearch	2960	G	G	601	1	0.17%	2	1	93	93	0.4999999999990043	1	1	386	215	1	0	-A
B10_BC22_191109_LF_LIB_consensus_vsearch	2961	A	A	598	2	0.33%	2	1	93	93	0.24979149291046765	1	1	384	214	2	0	+T
B10_BC22_191109_LF_LIB_consensus_vsearch	2962	T	T	592	5	0.83%	2	1	93	93	0.03098838522787931	1	1	385	207	0	5	-G
B10_BC22_191109_LF_LIB_consensus_vsearch	2963	G	G	589	2	0.34%	2	1	93	93	0.2497883149871952	1	1	382	207	2	0	A
B10_BC22_191109_LF_LIB_consensus_vsearch	2964	G	*/-AT	576	19	3.16%	2	1	93	93	1.6482949361380827E-6	1	1	362	214	19	0	-AT
B10_BC22_191109_LF_LIB_consensus_vsearch	2965	A	*/-T	559	10	1.74%	2	2	93	93	9.383869109591451E-4	1	1	354	205	6	4	-T
B10_BC22_191109_LF_LIB_consensus_vsearch	2966	T	T	571	1	0.17%	2	1	93	93	0.4999999999990043	1	1	362	209	0	1	+AC
B10_BC22_191109_LF_LIB_consensus_vsearch	2967	T	T	598	3	0.5%	2	1	93	93	0.12468776019987309	1	1	388	210	0	3	C
B10_BC22_191109_LF_LIB_consensus_vsearch	2968	T	*/-G	579	9	1.49%	2	2	93	93	0.0018938187066465067	1	1	382	197	4	5	-G
B10_BC22_191109_LF_LIB_consensus_vsearch	2969	G	*/-A	499	89	14.98%	2	2	93	93	4.3927912483622864E-29	1	1	291	208	87	2	-A
B10_BC22_191109_LF_LIB_consensus_vsearch	2970	A	*/-G	494	13	2.53%	2	2	93	93	1.1292366233165766E-4	1	1	287	207	8	5	-G
B10_BC22_191109_LF_LIB_consensus_vsearch	2971	G	G	584	2	0.34%	2	1	93	93	0.2497865072588101	1	1	378	206	2	0	+AG
B10_BC22_191109_LF_LIB_consensus_vsearch	2972	T	*/-A	558	14	2.34%	2	2	93	93	5.6314541018637804E-5	1	1	360	198	13	1	-A
B10_BC22_191109_LF_LIB_consensus_vsearch	2973	A	A	581	2	0.34%	2	2	93	93	0.24978540772560268	1	1	371	210	1	1	C
B10_BC22_191109_LF_LIB_consensus_vsearch	2974	A	*/-G	582	12	2%	2	1	93	93	2.3082155254131308E-4	1	1	371	211	12	0	-G
B10_BC22_191109_LF_LIB_consensus_vsearch	2975	G	*/-A	578	8	1.36%	2	1	93	93	0.003813445148774959	1	1	365	213	8	0	-A
B10_BC22_191109_LF_LIB_consensus_vsearch	2976	A	A	583	4	0.67%	2	2	93	93	0.06218044340963991	1	1	375	208	3	1	G
B10_BC22_191109_LF_LIB_consensus_vsearch	2977	G	R	576	14	2.34%	2	2	93	93	5.645462176707094E-5	1	1	372	204	12	2	A
B10_BC22_191109_LF_LIB_consensus_vsearch	2978	C	C	587	4	0.67%	2	2	93	93	0.062182607140620794	1	1	383	204	1	3	T
B10_BC22_191109_LF_LIB_consensus_vsearch	2979	A	A	573	6	1%	2	2	93	93	0.015422954702023957	1	1	369	204	3	3	G
B10_BC22_191109_LF_LIB_consensus_vsearch	2980	T	Y	577	16	2.68%	2	2	93	93	1.3771929190263783E-5	1	1	380	197	3	13	C
B10_BC22_191109_LF_LIB_consensus_vsearch	2981	A	R	554	32	5.36%	2	2	93	93	1.5071025482941867E-10	1	1	349	205	31	1	G
B10_BC22_191109_LF_LIB_consensus_vsearch	2982	G	G	591	1	0.17%	2	1	93	93	0.5000000000008233	1	1	384	207	0	1	+C
B10_BC22_191109_LF_LIB_consensus_vsearch	2983	C	Y	587	8	1.33%	2	2	93	93	0.003814841181091788	1	1	382	205	1	7	T
B10_BC22_191109_LF_LIB_consensus_vsearch	2984	T	*/+A	577	12	2.01%	2	1	93	93	2.3071056867786312E-4	1	1	369	208	12	0	+A
B10_BC22_191109_LF_LIB_consensus_vsearch	2985	G	K	576	13	2.17%	2	1	93	93	1.141680944483324E-4	1	1	366	210	13	0	T
B10_BC22_191109_LF_LIB_consensus_vsearch	2986	T	Y	586	8	1.34%	2	2	93	93	0.00381468814385855	1	1	381	205	1	7	C
B10_BC22_191109_LF_LIB_consensus_vsearch	2987	T	T	588	4	0.67%	2	2	93	93	0.06218314350277022	1	1	384	204	1	3	-G
B10_BC22_191109_LF_LIB_consensus_vsearch	2988	G	G	588	5	0.84%	2	2	93	93	0.0309866212982286	1	1	381	207	3	2	A
B10_BC22_191109_LF_LIB_consensus_vsearch	2989	G	G	597	2	0.33%	2	1	93	93	0.24979114452852993	1	1	387	210	0	2	C
B10_BC22_191109_LF_LIB_consensus_vsearch	2990	G	G	597	4	0.66%	2	2	93	93	0.062187890408182296	1	1	386	211	1	3	A
B10_BC22_191109_LF_LIB_consensus_vsearch	2991	A	*/-CC	563	16	2.66%	2	1	93	93	1.3737367128226719E-5	1	1	355	208	16	0	-CC
B10_BC22_191109_LF_LIB_consensus_vsearch	2992	C	C	572	4	0.69%	2	2	93	93	0.06217433812810566	1	1	365	207	2	2	T
B10_BC22_191109_LF_LIB_consensus_vsearch	2993	C	C	582	3	0.51%	2	1	93	93	0.12467921300240917	1	1	371	211	0	3	+T
B10_BC22_191109_LF_LIB_consensus_vsearch	2994	C	*/+G	559	16	2.65%	2	2	93	93	1.37271954373405E-5	1	1	375	184	2	14	+G
B10_BC22_191109_LF_LIB_consensus_vsearch	2995	G	*/-A	533	45	7.56%	2	2	93	93	1.1660733940727416E-14	1	1	321	212	44	1	-A
B10_BC22_191109_LF_LIB_consensus_vsearch	2996	A	A	541	2	0.37%	2	1	93	93	0.24976958525388432	1	1	328	213	2	0	G
B10_BC22_191109_LF_LIB_consensus_vsearch	2997	A	A	581	5	0.85%	2	2	93	93	0.030983476501936075	1	1	367	214	4	1	G
B10_BC22_191109_LF_LIB_consensus_vsearch	2998	A	A	597	3	0.5%	2	2	93	93	0.12468723936635923	1	1	384	213	2	1	G
B10_BC22_191109_LF_LIB_consensus_vsearch	2999	G	G	597	4	0.66%	2	1	93	93	0.062187890408182296	1	1	383	214	4	0	-A
B10_BC22_191109_LF_LIB_consensus_vsearch	3000	A	A	588	5	0.84%	2	2	93	93	0.0309866212982286	1	1	379	209	3	2	G
B10_BC22_191109_LF_LIB_consensus_vsearch	3001	T	T	589	4	0.66%	2	2	93	93	0.06218367805512527	1	1	384	205	3	1	-GGT
B10_BC22_191109_LF_LIB_consensus_vsearch	3002	G	R	577	11	1.85%	2	2	93	93	4.6577416695331333E-4	1	1	367	210	10	1	A
B10_BC22_191109_LF_LIB_consensus_vsearch	3003	G	G	578	5	0.84%	2	2	93	93	0.030982105624386143	1	1	374	204	4	1	A
B10_BC22_191109_LF_LIB_consensus_vsearch	3004	T	*/+A	575	7	1.18%	2	1	93	93	0.007672038647635164	1	1	374	201	7	0	+A
B10_BC22_191109_LF_LIB_consensus_vsearch	3005	G	*/-A	592	8	1.33%	2	1	93	93	0.003815598757548882	1	1	379	213	8	0	-A
B10_BC22_191109_LF_LIB_consensus_vsearch	3006	A	A	592	2	0.34%	2	1	93	93	0.24978938500452047	1	1	377	215	2	0	G
B10_BC22_191109_LF_LIB_consensus_vsearch	3007	A	A	593	4	0.66%	2	1	93	93	0.06218579834936829	1	1	379	214	4	0	-C
B10_BC22_191109_LF_LIB_consensus_vsearch	3008	C	C	588	3	0.5%	2	1	93	93	0.12468247248078299	1	1	378	210	0	3	-T
B10_BC22_191109_LF_LIB_consensus_vsearch	3009	T	T	589	4	0.67%	2	2	93	93	0.06218367805512527	1	1	383	206	1	3	C
B10_BC22_191109_LF_LIB_consensus_vsearch	3010	A	R	586	7	1.17%	2	2	93	93	0.007674635299574334	1	1	377	209	4	3	G
B10_BC22_191109_LF_LIB_consensus_vsearch	3011	T	T	589	5	0.84%	2	1	93	93	0.030987064506852544	1	1	382	207	0	5	C
B10_BC22_191109_LF_LIB_consensus_vsearch	3012	G	*/-C	581	11	1.83%	2	2	93	93	4.659240387073297E-4	1	1	371	210	10	1	-C
B10_BC22_191109_LF_LIB_consensus_vsearch	3013	C	C	588	1	0.17%	2	1	93	93	0.4999999999990043	1	1	374	214	1	0	+A
B10_BC22_191109_LF_LIB_consensus_vsearch	3014	C	C	598	1	0.17%	2	1	93	93	0.5000000000008233	1	1	385	213	1	0	+AC
B10_BC22_191109_LF_LIB_consensus_vsearch	3015	T	Y	582	13	2.16%	2	2	93	93	1.1424599131191439E-4	1	1	377	205	5	8	C
B10_BC22_191109_LF_LIB_consensus_vsearch	3016	G	G	597	2	0.33%	2	1	93	93	0.24979114452852993	1	1	383	214	2	0	-AAT
B10_BC22_191109_LF_LIB_consensus_vsearch	3017	A	A	594	4	0.67%	2	2	93	93	0.062186323989038686	1	1	381	213	3	1	G
B10_BC22_191109_LF_LIB_consensus_vsearch	3018	A	A	594	2	0.33%	2	2	93	93	0.24979009235977778	1	1	382	212	1	1	C
B10_BC22_191109_LF_LIB_consensus_vsearch	3019	T	T	577	6	1%	2	1	93	93	0.01542433854516302	1	1	365	212	6	0	+A
B10_BC22_191109_LF_LIB_consensus_vsearch	3020	A	*/-G	500	59	9.88%	2	2	93	93	3.4476722151179236E-19	1	1	355	145	13	46	-G
B10_BC22_191109_LF_LIB_consensus_vsearch	3021	G	*/+A	504	19	3.59%	2	2	93	93	1.6149141910215713E-6	1	1	347	157	18	1	+A
B10_BC22_191109_LF_LIB_consensus_vsearch	3022	G	*/+A	555	20	3.38%	2	1	93	93	8.061313561430355E-7	1	1	351	204	20	0	+A
B10_BC22_191109_LF_LIB_consensus_vsearch	3023	G	K	578	16	2.66%	2	1	93	93	1.377433797210423E-5	1	1	369	209	16	0	T
B10_BC22_191109_LF_LIB_consensus_vsearch	3024	T	T	587	5	0.83%	2	2	93	93	0.030986176592841308	1	1	383	204	2	3	C
B10_BC22_191109_LF_LIB_consensus_vsearch	3025	G	G	586	6	1%	2	1	93	93	0.015427383935577244	1	1	376	210	6	0	-A
B10_BC22_191109_LF_LIB_consensus_vsearch	3026	A	A	579	3	0.51%	2	2	93	93	0.12467755803936205	1	1	371	208	2	1	G
B10_BC22_191109_LF_LIB_consensus_vsearch	3027	A	A	588	2	0.33%	2	1	93	93	0.2497879558944788	1	1	378	210	2	0	-G
B10_BC22_191109_LF_LIB_consensus_vsearch	3028	G	*/-C	574	15	2.51%	2	2	93	93	2.7884070676335E-5	1	1	367	207	10	5	-C
B10_BC22_191109_LF_LIB_consensus_vsearch	3029	C	C	576	3	0.51%	2	1	93	93	0.12467588591190074	1	1	370	206	3	0	G
B10_BC22_191109_LF_LIB_consensus_vsearch	3030	C	*/-A	580	7	1.16%	2	2	93	93	0.0076732309665896	1	1	372	208	2	5	-A
B10_BC22_191109_LF_LIB_consensus_vsearch	3031	A	A	575	6	1.02%	2	1	93	93	0.015423649001259471	1	1	368	207	6	0	G
B10_BC22_191109_LF_LIB_consensus_vsearch	3032	G	*/-AG	570	21	3.52%	2	2	93	93	3.97965376405317E-7	1	1	358	212	18	3	-AG
B10_BC22_191109_LF_LIB_consensus_vsearch	3033	A	*/-G	496	53	9.23%	2	2	93	93	2.970000843543031E-17	1	1	296	200	45	8	-G
B10_BC22_191109_LF_LIB_consensus_vsearch	3034	G	G	496	5	0.99%	2	1	93	93	0.030938280938185188	1	1	294	202	5	0	+AG
B10_BC22_191109_LF_LIB_consensus_vsearch	3035	G	*/-A	560	16	2.75%	2	2	93	93	1.3729751077540724E-5	1	1	354	206	10	6	-A
B10_BC22_191109_LF_LIB_consensus_vsearch	3036	A	A	564	1	0.18%	2	1	93	93	0.5000000000008233	1	1	357	207	1	0	+G
B10_BC22_191109_LF_LIB_consensus_vsearch	3037	A	A	592	5	0.84%	2	2	93	93	0.03098838522787931	1	1	378	214	4	1	G
B10_BC22_191109_LF_LIB_consensus_vsearch	3038	A	R	581	11	1.83%	2	2	93	93	4.659240387073297E-4	1	1	374	207	10	1	G
B10_BC22_191109_LF_LIB_consensus_vsearch	3039	C	*/-T	579	19	3.17%	2	2	93	93	1.6495215114626903E-6	1	1	384	195	1	18	-T
B10_BC22_191109_LF_LIB_consensus_vsearch	3040	T	T	568	5	0.86%	2	2	93	93	0.03097743240611924	1	1	379	189	1	4	C
B10_BC22_191109_LF_LIB_consensus_vsearch	3041	C	C	585	6	1%	2	2	93	93	0.015427050131369397	1	1	381	204	3	3	-T
B10_BC22_191109_LF_LIB_consensus_vsearch	3042	T	*/-G	553	33	5.56%	2	2	93	93	7.323989576814462E-11	1	1	378	175	3	30	-G
B10_BC22_191109_LF_LIB_consensus_vsearch	3043	G	G	555	5	0.88%	2	1	93	93	0.03097110782021969	1	1	374	181	5	0	+A
B10_BC22_191109_LF_LIB_consensus_vsearch	3044	G	G	595	3	0.5%	2	2	93	93	0.12468619246852639	1	1	384	211	1	2	-T
B10_BC22_191109_LF_LIB_consensus_vsearch	3045	T	Y	553	25	4.18%	2	2	93	93	2.2860965323358137E-8	1	1	375	178	1	24	C
B10_BC22_191109_LF_LIB_consensus_vsearch	3046	G	G	583	1	0.17%	2	1	93	93	0.4999999999999138	1	1	378	205	1	0	+A
B10_BC22_191109_LF_LIB_consensus_vsearch	3047	G	*/-AG	585	12	2%	2	1	93	93	2.3088726695666827E-4	1	1	373	212	12	0	-AG
B10_BC22_191109_LF_LIB_consensus_vsearch	3048	A	*/-G	558	17	2.89%	2	2	93	93	6.766756833757936E-6	1	1	348	210	15	2	-G
B10_BC22_191109_LF_LIB_consensus_vsearch	3049	G	*/+A	551	7	1.22%	2	1	93	93	0.007666019161359943	1	1	342	209	7	0	+A
B10_BC22_191109_LF_LIB_consensus_vsearch	3050	G	*/-C	585	10	1.66%	2	2	93	93	9.400366914624269E-4	1	1	382	203	1	9	-C
B10_BC22_191109_LF_LIB_consensus_vsearch	3051	C	C	587	2	0.34%	2	1	93	93	0.249787595581865	1	1	383	204	2	0	A
B10_BC22_191109_LF_LIB_consensus_vsearch	3052	T	*/-C	586	8	1.33%	2	2	93	93	0.00381468814385855	1	1	379	207	5	3	-C
B10_BC22_191109_LF_LIB_consensus_vsearch	3053	C	*/+AC	558	11	1.85%	2	1	93	93	4.6503393903056577E-4	1	1	353	205	11	0	+AC
B10_BC22_191109_LF_LIB_consensus_vsearch	3054	G	R	548	30	5.03%	2	2	93	93	6.329616543699974E-10	1	1	336	212	29	1	A
B10_BC22_191109_LF_LIB_consensus_vsearch	3055	C	Y	570	11	1.84%	2	2	93	93	4.6550699991566706E-4	1	1	361	209	10	1	T
B10_BC22_191109_LF_LIB_consensus_vsearch	3056	A	A	569	6	1%	2	1	93	93	0.015421551639459893	1	1	361	208	6	0	G
B10_BC22_191109_LF_LIB_consensus_vsearch	3057	G	R	553	26	4.36%	2	2	93	93	1.11834972973567E-8	1	1	346	207	25	1	A
B10_BC22_191109_LF_LIB_consensus_vsearch	3058	C	*/+A	547	27	4.53%	2	1	93	93	5.448221407061866E-9	1	1	345	202	27	0	+A
B10_BC22_191109_LF_LIB_consensus_vsearch	3059	G	R	411	168	28.28%	2	2	93	93	1.7643791844858256E-57	1	1	207	204	166	2	A
B10_BC22_191109_LF_LIB_consensus_vsearch	3060	G	K	534	32	5.32%	2	1	93	93	1.4834574404749108E-10	1	1	325	209	32	0	T
B10_BC22_191109_LF_LIB_consensus_vsearch	3061	T	T	595	4	0.67%	2	2	93	93	0.062186847872822006	1	1	384	211	2	2	C
B10_BC22_191109_LF_LIB_consensus_vsearch	3062	T	*/+C	569	26	4.31%	2	1	93	93	1.1272060653769355E-8	1	1	358	211	26	0	+C
B10_BC22_191109_LF_LIB_consensus_vsearch	3063	C	C	587	5	0.83%	2	1	93	93	0.030986176592841308	1	1	382	205	0	5	+T
B10_BC22_191109_LF_LIB_consensus_vsearch	3064	T	*/+G	576	9	1.51%	2	1	93	93	0.001893517063995506	1	1	378	198	0	9	+G
B10_BC22_191109_LF_LIB_consensus_vsearch	3065	G	G	598	2	0.33%	2	1	93	93	0.24979149291046765	1	1	385	213	2	0	C
B10_BC22_191109_LF_LIB_consensus_vsearch	3066	A	A	597	3	0.5%	2	1	93	93	0.12468723936635923	1	1	384	213	3	0	G
B10_BC22_191109_LF_LIB_consensus_vsearch	3067	C	*/+A	583	12	1.99%	2	1	93	93	2.308435296158339E-4	1	1	372	211	12	0	+A
B10_BC22_191109_LF_LIB_consensus_vsearch	3068	G	*/-TG	550	24	3.99%	2	1	93	93	4.6631359837056654E-8	1	1	362	188	0	24	-TG
B10_BC22_191109_LF_LIB_consensus_vsearch	3069	T	*/+A	563	7	1.21%	2	1	93	93	0.007669092041544023	1	1	377	186	7	0	+A
B10_BC22_191109_LF_LIB_consensus_vsearch	3070	G	*/+C	557	7	1.22%	2	1	93	93	0.007667571887622288	1	1	369	188	7	0	+C
B10_BC22_191109_LF_LIB_consensus_vsearch	3071	C	*/-A	562	21	3.5%	2	2	93	93	3.9696147693062243E-7	1	1	371	191	3	18	-A
B10_BC22_191109_LF_LIB_consensus_vsearch	3072	A	A	576	2	0.35%	2	2	93	93	0.24978354978355208	1	1	383	193	1	1	G
B10_BC22_191109_LF_LIB_consensus_vsearch	3073	A	A	596	2	0.33%	2	1	93	93	0.24979079497935539	1	1	384	212	2	0	C
B10_BC22_191109_LF_LIB_consensus_vsearch	3074	A	A	594	4	0.66%	2	2	93	93	0.062186323989038686	1	1	385	209	1	3	-T
B10_BC22_191109_LF_LIB_consensus_vsearch	3075	T	Y	585	9	1.5%	2	1	93	93	0.0018944129256754595	1	1	384	201	0	9	C
B10_BC22_191109_LF_LIB_consensus_vsearch	3076	C	C	592	3	0.5%	2	2	93	93	0.1246846089151382	1	1	384	208	1	2	-G
B10_BC22_191109_LF_LIB_consensus_vsearch	3077	G	G	598	1	0.17%	2	1	93	93	0.5000000000008233	1	1	385	213	1	0	-A
B10_BC22_191109_LF_LIB_consensus_vsearch	3078	A	A	592	4	0.66%	2	1	93	93	0.06218527094514562	1	1	385	207	0	4	-T
B10_BC22_191109_LF_LIB_consensus_vsearch	3079	T	T	591	4	0.67%	2	2	93	93	0.06218474176725347	1	1	385	206	2	2	-C
B10_BC22_191109_LF_LIB_consensus_vsearch	3080	C	C	592	2	0.33%	2	2	93	93	0.24978938500452047	1	1	382	210	1	1	-GTC
B10_BC22_191109_LF_LIB_consensus_vsearch	3081	G	G	593	5	0.84%	2	2	93	93	0.03098882252468081	1	1	381	212	4	1	A
B10_BC22_191109_LF_LIB_consensus_vsearch	3082	T	T	593	2	0.33%	2	1	93	93	0.24978973927711676	1	1	380	213	2	0	+C
B10_BC22_191109_LF_LIB_consensus_vsearch	3083	C	*/-A	582	10	1.67%	2	2	93	93	9.398536450879837E-4	1	1	377	205	3	7	-A
B10_BC22_191109_LF_LIB_consensus_vsearch	3084	A	*/+G	562	23	3.89%	2	1	93	93	9.562050648761614E-8	1	1	356	206	23	0	+G
B10_BC22_191109_LF_LIB_consensus_vsearch	3085	A	A	596	4	0.66%	2	1	93	93	0.062187370009836374	1	1	382	214	4	0	G
B10_BC22_191109_LF_LIB_consensus_vsearch	3086	A	A	586	5	0.83%	2	2	93	93	0.030985730383315414	1	1	380	206	1	4	+T
B10_BC22_191109_LF_LIB_consensus_vsearch	3087	T	Y	585	8	1.34%	2	2	93	93	0.0038145345933480535	1	1	380	205	4	4	C
B10_BC22_191109_LF_LIB_consensus_vsearch	3088	T	T	591	4	0.67%	2	2	93	93	0.06218474176725347	1	1	383	208	2	2	C
B10_BC22_191109_LF_LIB_consensus_vsearch	3089	T	*/-G	576	15	2.5%	2	2	93	93	2.789269415844126E-5	1	1	373	203	11	4	-G
B10_BC22_191109_LF_LIB_consensus_vsearch	3090	G	G	575	5	0.85%	2	1	93	93	0.030980720571722742	1	1	369	206	5	0	A
B10_BC22_191109_LF_LIB_consensus_vsearch	3091	G	G	591	5	0.83%	2	1	93	93	0.030987946464272845	1	1	381	210	5	0	+A
B10_BC22_191109_LF_LIB_consensus_vsearch	3092	G	G	595	2	0.33%	2	1	93	93	0.24979044425840527	1	1	384	211	0	2	C
B10_BC22_191109_LF_LIB_consensus_vsearch	3093	T	Y	566	33	5.48%	2	2	93	93	7.400118254742092E-11	1	1	386	180	1	32	C
B10_BC22_191109_LF_LIB_consensus_vsearch	3094	A	A	593	2	0.33%	2	1	93	93	0.24978973927711676	1	1	384	209	0	2	-TA
B10_BC22_191109_LF_LIB_consensus_vsearch	3095	T	T	585	5	0.83%	2	1	93	93	0.030985282661769052	1	1	377	208	5	0	+G
B10_BC22_191109_LF_LIB_consensus_vsearch	3096	A	*/-G	448	120	20.2%	2	2	93	93	6.588807065971809E-40	1	1	321	127	50	70	-G
B10_BC22_191109_LF_LIB_consensus_vsearch	3097	G	G	467	4	0.85%	2	1	93	93	0.06210169997917713	1	1	331	136	4	0	+A
B10_BC22_191109_LF_LIB_consensus_vsearch	3098	G	G	592	3	0.5%	2	2	93	93	0.1246846089151382	1	1	386	206	1	2	A
B10_BC22_191109_LF_LIB_consensus_vsearch	3099	G	*/+C	581	7	1.17%	2	2	93	93	0.007673467005464533	1	1	382	199	3	4	+C
B10_BC22_191109_LF_LIB_consensus_vsearch	3100	G	*/-C	580	8	1.33%	2	2	93	93	0.0038137590506295174	1	1	382	198	1	7	-C
B10_BC22_191109_LF_LIB_consensus_vsearch	3101	C	*/+A	559	8	1.36%	2	1	93	93	0.0038103532778841847	1	1	368	191	8	0	+A
B10_BC22_191109_LF_LIB_consensus_vsearch	3102	G	*/-A	518	37	6.26%	2	2	93	93	3.912026167317691E-12	1	1	339	179	30	7	-A
B10_BC22_191109_LF_LIB_consensus_vsearch	3103	A	A	537	3	0.55%	2	2	93	93	0.12465245597770591	1	1	342	195	2	1	+GA
B10_BC22_191109_LF_LIB_consensus_vsearch	3104	A	A	572	6	1.03%	2	2	93	93	0.015422605753746292	1	1	370	202	2	4	G
B10_BC22_191109_LF_LIB_consensus_vsearch	3105	A	A	586	4	0.67%	2	1	93	93	0.062182068959449006	1	1	375	211	4	0	-G
B10_BC22_191109_LF_LIB_consensus_vsearch	3106	G	G	587	5	0.84%	2	1	93	93	0.030986176592841308	1	1	374	213	5	0	-A
B10_BC22_191109_LF_LIB_consensus_vsearch	3107	A	R	573	11	1.85%	2	2	93	93	4.656222726659411E-4	1	1	366	207	8	3	G
B10_BC22_191109_LF_LIB_consensus_vsearch	3108	C	C	588	5	0.83%	2	2	93	93	0.0309866212982286	1	1	380	208	1	4	-T
B10_BC22_191109_LF_LIB_consensus_vsearch	3109	T	Y	570	18	3.02%	2	2	93	93	3.3427338331157792E-6	1	1	376	194	4	14	C
B10_BC22_191109_LF_LIB_consensus_vsearch	3110	A	A	594	3	0.5%	2	2	93	93	0.12468566638724124	1	1	384	210	1	2	G
B10_BC22_191109_LF_LIB_consensus_vsearch	3111	A	A	591	6	1%	2	2	93	93	0.015429036211008771	1	1	384	207	3	3	G
B10_BC22_191109_LF_LIB_consensus_vsearch	3112	T	*/+C	576	18	3%	2	1	93	93	3.347263328889398E-6	1	1	367	209	18	0	+C
B10_BC22_191109_LF_LIB_consensus_vsearch	3113	C	*/+A	562	23	3.85%	2	1	93	93	9.562050648761614E-8	1	1	358	204	23	0	+A
B10_BC22_191109_LF_LIB_consensus_vsearch	3114	G	*/-A	570	20	3.33%	2	1	93	93	8.096418768897144E-7	1	1	359	211	20	0	-A
B10_BC22_191109_LF_LIB_consensus_vsearch	3115	A	A	576	3	0.52%	2	1	93	93	0.12467588591190074	1	1	363	213	3	0	+G
B10_BC22_191109_LF_LIB_consensus_vsearch	3116	A	R	589	7	1.16%	2	2	93	93	0.007675326899053761	1	1	376	213	6	1	G
B10_BC22_191109_LF_LIB_consensus_vsearch	3117	C	C	597	1	0.17%	2	1	93	93	0.4999999999999138	1	1	383	214	1	0	+AC
B10_BC22_191109_LF_LIB_consensus_vsearch	3118	C	Y	591	12	1.99%	2	2	93	93	2.3101676991554602E-4	1	1	385	206	3	9	T
B10_BC22_191109_LF_LIB_consensus_vsearch	3119	A	A	591	5	0.83%	2	1	93	93	0.030987946464272845	1	1	383	208	0	5	+T
B10_BC22_191109_LF_LIB_consensus_vsearch	3120	T	*/+C	582	12	1.99%	2	2	93	93	2.3082155254131308E-4	1	1	373	209	11	1	+C
B10_BC22_191109_LF_LIB_consensus_vsearch	3121	C	*/-T	582	10	1.68%	2	2	93	93	9.398536450879837E-4	1	1	377	205	7	3	-T
B10_BC22_191109_LF_LIB_consensus_vsearch	3122	T	T	575	3	0.51%	2	1	93	93	0.12467532467531917	1	1	368	207	3	0	+G
B10_BC22_191109_LF_LIB_consensus_vsearch	3123	A	R	580	9	1.5%	2	1	93	93	0.001893918576967777	1	1	370	210	9	0	G
B10_BC22_191109_LF_LIB_consensus_vsearch	3124	G	G	588	5	0.84%	2	1	93	93	0.0309866212982286	1	1	377	211	5	0	T
B10_BC22_191109_LF_LIB_consensus_vsearch	3125	T	Y	582	12	2%	2	2	93	93	2.3082155254131308E-4	1	1	381	201	1	11	C
B10_BC22_191109_LF_LIB_consensus_vsearch	3126	A	R	583	8	1.34%	2	2	93	93	0.0038142259421648926	1	1	374	209	7	1	G
B10_BC22_191109_LF_LIB_consensus_vsearch	3127	G	G	593	3	0.5%	2	1	93	93	0.12468513853935516	1	1	381	212	3	0	-C
B10_BC22_191109_LF_LIB_consensus_vsearch	3128	C	C	591	1	0.17%	2	1	93	93	0.5000000000008233	1	1	380	211	1	0	+GAGC
B10_BC22_191109_LF_LIB_consensus_vsearch	3129	T	T	591	2	0.33%	2	1	93	93	0.24978902953563295	1	1	383	208	0	2	+G
B10_BC22_191109_LF_LIB_consensus_vsearch	3130	G	G	590	3	0.5%	2	1	93	93	0.12468354430400949	1	1	380	210	3	0	A
B10_BC22_191109_LF_LIB_consensus_vsearch	3131	G	*/+T	577	8	1.33%	2	1	93	93	0.0038132873975118887	1	1	367	210	8	0	+T
B10_BC22_191109_LF_LIB_consensus_vsearch	3132	T	T	596	1	0.17%	2	1	93	93	0.4999999999999138	1	1	385	211	0	1	+AT
B10_BC22_191109_LF_LIB_consensus_vsearch	3133	T	*/-C	575	19	3.15%	2	2	93	93	1.647883484990673E-6	1	1	368	207	15	4	-C
B10_BC22_191109_LF_LIB_consensus_vsearch	3134	C	*/+A	570	7	1.2%	2	1	93	93	0.007670825737374831	1	1	360	210	7	0	+A
B10_BC22_191109_LF_LIB_consensus_vsearch	3135	C	*/-T	586	13	2.16%	2	2	93	93	1.1429707523026712E-4	1	1	381	205	5	8	-T
B10_BC22_191109_LF_LIB_consensus_vsearch	3136	T	Y	550	32	5.42%	2	1	93	93	1.5024778824394835E-10	1	1	380	170	0	32	C
B10_BC22_191109_LF_LIB_consensus_vsearch	3137	G	*/-C	569	19	3.18%	2	1	93	93	1.6453871199250226E-6	1	1	359	210	19	0	-C
B10_BC22_191109_LF_LIB_consensus_vsearch	3138	C	C	574	5	0.86%	2	1	93	93	0.030980255699410347	1	1	366	208	0	5	A
B10_BC22_191109_LF_LIB_consensus_vsearch	3139	C	*/-GA	541	31	5.15%	2	2	93	93	3.0667980614545534E-10	1	1	341	200	24	7	-GA
B10_BC22_191109_LF_LIB_consensus_vsearch	3140	G	*/-AA	527	13	2.3%	2	2	93	93	1.1346876988055956E-4	1	1	336	191	4	9	-AA
B10_BC22_191109_LF_LIB_consensus_vsearch	3141	A	A	535	5	0.92%	2	1	93	93	0.030960783351964165	1	1	341	194	5	0	G
B10_BC22_191109_LF_LIB_consensus_vsearch	3142	A	*/-G	571	8	1.36%	2	1	93	93	0.0038123295121620672	1	1	366	205	8	0	-G
B10_BC22_191109_LF_LIB_consensus_vsearch	3143	G	*/+T	554	13	2.19%	2	1	93	93	1.138687052715257E-4	1	1	345	209	13	0	+T
B10_BC22_191109_LF_LIB_consensus_vsearch	3144	T	T	582	6	1.02%	2	2	93	93	0.015426041918236095	1	1	375	207	3	3	C
B10_BC22_191109_LF_LIB_consensus_vsearch	3145	T	T	595	4	0.67%	2	1	93	93	0.062186847872822006	1	1	387	208	0	4	C
B10_BC22_191109_LF_LIB_consensus_vsearch	3146	T	*/-C	403	150	25%	2	2	93	93	5.632235498563995E-51	1	1	314	89	66	84	-C
B10_BC22_191109_LF_LIB_consensus_vsearch	3147	C	C	410	2	0.48%	2	1	93	93	0.24969623329349078	1	1	319	91	2	0	T
B10_BC22_191109_LF_LIB_consensus_vsearch	3148	C	C	555	5	0.88%	2	1	93	93	0.03097110782021969	1	1	379	176	5	0	+A
B10_BC22_191109_LF_LIB_consensus_vsearch	3149	C	*/-T	551	9	1.58%	2	2	93	93	0.0018908787761269387	1	1	385	166	1	8	-T
B10_BC22_191109_LF_LIB_consensus_vsearch	3150	T	T	542	3	0.54%	2	1	93	93	0.12465564738290234	1	1	380	162	3	0	+C
B10_BC22_191109_LF_LIB_consensus_vsearch	3151	C	C	580	4	0.68%	2	1	93	93	0.06217880115194425	1	1	377	203	4	0	+A
B10_BC22_191109_LF_LIB_consensus_vsearch	3152	A	*/-G	538	42	7.06%	2	2	93	93	1.0528145808332416E-13	1	1	376	162	1	41	-G
B10_BC22_191109_LF_LIB_consensus_vsearch	3153	G	G	554	1	0.18%	2	1	93	93	0.4999999999990043	1	1	384	170	1	0	+A
B10_BC22_191109_LF_LIB_consensus_vsearch	3154	G	G	602	1	0.17%	2	1	93	93	0.4999999999990043	1	1	387	215	1	0	-A
B10_BC22_191109_LF_LIB_consensus_vsearch	3155	A	A	598	3	0.5%	2	1	93	93	0.12468776019987309	1	1	384	214	3	0	G
B10_BC22_191109_LF_LIB_consensus_vsearch	3156	T	T	596	2	0.33%	2	1	93	93	0.24979079497935539	1	1	385	211	0	2	+A
B10_BC22_191109_LF_LIB_consensus_vsearch	3157	A	R	588	7	1.16%	2	1	93	93	0.007675097138165556	1	1	377	211	7	0	G
B10_BC22_191109_LF_LIB_consensus_vsearch	3158	G	G	592	4	0.67%	2	2	93	93	0.06218527094514562	1	1	381	211	3	1	A
B10_BC22_191109_LF_LIB_consensus_vsearch	3159	C	C	590	4	0.67%	2	2	93	93	0.062184210806914414	1	1	379	211	3	1	T
B10_BC22_191109_LF_LIB_consensus_vsearch	3160	A	R	585	7	1.17%	2	2	93	93	0.007674403214110395	1	1	377	208	6	1	G
B10_BC22_191109_LF_LIB_consensus_vsearch	3161	G	G	587	6	1%	2	1	93	93	0.015427716615850288	1	1	376	211	6	0	T
B10_BC22_191109_LF_LIB_consensus_vsearch	3162	T	T	588	4	0.67%	2	2	93	93	0.06218314350277022	1	1	384	204	1	3	-A
B10_BC22_191109_LF_LIB_consensus_vsearch	3163	A	A	590	3	0.5%	2	1	93	93	0.12468354430400949	1	1	385	205	0	3	G
B10_BC22_191109_LF_LIB_consensus_vsearch	3164	A	A	591	6	1%	2	2	93	93	0.015429036211008771	1	1	381	210	5	1	G
B10_BC22_191109_LF_LIB_consensus_vsearch	3165	C	C	593	4	0.67%	2	1	93	93	0.06218579834936829	1	1	385	208	0	4	T
B10_BC22_191109_LF_LIB_consensus_vsearch	3166	G	*/-T	559	22	3.66%	2	2	93	93	1.9470258079362864E-7	1	1	352	207	18	4	-T
B10_BC22_191109_LF_LIB_consensus_vsearch	3167	T	T	574	5	0.86%	2	2	93	93	0.030980255699410347	1	1	368	206	1	4	C
B10_BC22_191109_LF_LIB_consensus_vsearch	3168	T	T	600	1	0.17%	2	1	93	93	0.4999999999999138	1	1	387	213	0	1	G
B10_BC22_191109_LF_LIB_consensus_vsearch	3169	T	T	598	2	0.33%	2	2	93	93	0.24979149291046765	1	1	386	212	1	1	C
B10_BC22_191109_LF_LIB_consensus_vsearch	3170	T	*/+C	547	40	6.63%	2	1	93	93	4.57246580562262E-13	1	1	335	212	40	0	+C
B10_BC22_191109_LF_LIB_consensus_vsearch	3171	C	C	591	4	0.67%	2	2	93	93	0.06218474176725347	1	1	382	209	2	2	-A
B10_BC22_191109_LF_LIB_consensus_vsearch	3172	A	A	588	6	1%	2	2	93	93	0.015428048177952706	1	1	377	211	5	1	G
B10_BC22_191109_LF_LIB_consensus_vsearch	3173	G	*/+T	556	21	3.49%	2	2	93	93	3.9619167172305123E-7	1	1	349	207	20	1	+T
B10_BC22_191109_LF_LIB_consensus_vsearch	3174	T	T	577	3	0.52%	2	1	93	93	0.12467644521108873	1	1	368	209	3	0	G
B10_BC22_191109_LF_LIB_consensus_vsearch	3175	T	T	597	2	0.33%	2	1	93	93	0.24979114452852993	1	1	386	211	0	2	+C
B10_BC22_191109_LF_LIB_consensus_vsearch	3176	T	T	598	3	0.5%	2	2	93	93	0.12468776019987309	1	1	385	213	1	2	C
B10_BC22_191109_LF_LIB_consensus_vsearch	3177	T	T	583	6	1%	2	1	93	93	0.015426379128433065	1	1	381	202	0	6	+A
B10_BC22_191109_LF_LIB_consensus_vsearch	3178	A	R	578	11	1.85%	2	2	93	93	4.658118229180549E-4	1	1	369	209	9	2	G
B10_BC22_191109_LF_LIB_consensus_vsearch	3179	T	K	573	10	1.68%	2	1	93	93	9.392933313754103E-4	1	1	375	198	0	10	G
B10_BC22_191109_LF_LIB_consensus_vsearch	3180	G	*/+A	580	7	1.16%	2	1	93	93	0.0076732309665896	1	1	367	213	7	0	+A
B10_BC22_191109_LF_LIB_consensus_vsearch	3181	A	*/-G	559	23	3.87%	2	2	93	93	9.550973546202137E-8	1	1	346	213	22	1	-G
B10_BC22_191109_LF_LIB_consensus_vsearch	3182	G	R	543	12	2.1%	2	1	93	93	2.2990389605394288E-4	1	1	329	214	12	0	A
B10_BC22_191109_LF_LIB_consensus_vsearch	3183	G	K	583	8	1.33%	2	1	93	93	0.0038142259421648926	1	1	369	214	8	0	T
B10_BC22_191109_LF_LIB_consensus_vsearch	3184	T	*/-A	545	14	2.33%	2	2	93	93	5.620792585693959E-5	1	1	357	188	12	2	-A
B10_BC22_191109_LF_LIB_consensus_vsearch	3185	A	A	568	6	1.04%	2	2	93	93	0.015421197823763643	1	1	368	200	3	3	G
B10_BC22_191109_LF_LIB_consensus_vsearch	3186	A	A	584	3	0.51%	2	2	93	93	0.12468030690531334	1	1	380	204	2	1	G
B10_BC22_191109_LF_LIB_consensus_vsearch	3187	A	*/-G	581	8	1.34%	2	2	93	93	0.0038139152066312184	1	1	374	207	6	2	-G
B10_BC22_191109_LF_LIB_consensus_vsearch	3188	G	G	570	6	1.01%	2	2	93	93	0.015421904228749098	1	1	369	201	5	1	+C
B10_BC22_191109_LF_LIB_consensus_vsearch	3189	C	*/+A	569	8	1.35%	2	1	93	93	0.003812005815438782	1	1	371	198	8	0	+A
B10_BC22_191109_LF_LIB_consensus_vsearch	3190	G	*/-A	580	9	1.51%	2	2	93	93	0.001893918576967777	1	1	373	207	7	2	-A
B10_BC22_191109_LF_LIB_consensus_vsearch	3191	A	A	584	5	0.84%	2	2	93	93	0.030984833420659205	1	1	372	212	4	1	G
B10_BC22_191109_LF_LIB_consensus_vsearch	3192	A	A	596	2	0.33%	2	1	93	93	0.24979079497935539	1	1	383	213	2	0	C
B10_BC22_191109_LF_LIB_consensus_vsearch	3193	T	T	593	2	0.33%	2	2	93	93	0.24978973927711676	1	1	383	210	1	1	+G
B10_BC22_191109_LF_LIB_consensus_vsearch	3194	G	G	598	2	0.33%	2	1	93	93	0.24979149291046765	1	1	384	214	2	0	-A
B10_BC22_191109_LF_LIB_consensus_vsearch	3195	A	A	595	3	0.5%	2	1	93	93	0.12468619246852639	1	1	380	215	3	0	+T
B10_BC22_191109_LF_LIB_consensus_vsearch	3196	T	T	598	2	0.33%	2	1	93	93	0.24979149291046765	1	1	386	212	0	2	C
B10_BC22_191109_LF_LIB_consensus_vsearch	3197	T	*/-A	585	8	1.33%	2	2	93	93	0.0038145345933480535	1	1	374	211	6	2	-A
B10_BC22_191109_LF_LIB_consensus_vsearch	3198	A	*/+G	544	40	6.73%	2	2	93	93	4.555771793784991E-13	1	1	358	186	21	19	+G
B10_BC22_191109_LF_LIB_consensus_vsearch	3199	G	*/-A	583	10	1.67%	2	1	93	93	9.399148640318375E-4	1	1	371	212	10	0	-A
B10_BC22_191109_LF_LIB_consensus_vsearch	3200	A	*/-G	536	41	6.95%	2	2	93	93	2.1770980511348615E-13	1	1	334	202	37	4	-G
B10_BC22_191109_LF_LIB_consensus_vsearch	3201	G	G	550	2	0.36%	2	1	93	93	0.24977334542118992	1	1	343	207	2	0	+AG
B10_BC22_191109_LF_LIB_consensus_vsearch	3202	G	*/-C	576	8	1.33%	2	1	93	93	0.0038131291090651434	1	1	364	212	8	0	-C
B10_BC22_191109_LF_LIB_consensus_vsearch	3203	C	Y	575	7	1.18%	2	2	93	93	0.007672038647635164	1	1	371	204	1	6	T
B10_BC22_191109_LF_LIB_consensus_vsearch	3204	C	*/-T	571	14	2.33%	2	2	93	93	5.6416550871607475E-5	1	1	369	202	4	10	-T
B10_BC22_191109_LF_LIB_consensus_vsearch	3205	T	T	566	5	0.86%	2	2	93	93	0.030976478129055057	1	1	366	200	2	3	C
B10_BC22_191109_LF_LIB_consensus_vsearch	3206	T	*/-G	508	36	6.06%	2	2	93	93	7.996743563575994E-12	1	1	327	181	22	14	-G
B10_BC22_191109_LF_LIB_consensus_vsearch	3207	G	R	525	20	3.63%	2	1	93	93	7.985721325300169E-7	1	1	334	191	20	0	A
B10_BC22_191109_LF_LIB_consensus_vsearch	3208	G	R	545	37	6.29%	2	2	93	93	4.030075034876132E-12	1	1	349	196	29	8	A
B10_BC22_191109_LF_LIB_consensus_vsearch	3209	G	R	557	27	4.49%	2	2	93	93	5.478187293804813E-9	1	1	355	202	15	12	A
B10_BC22_191109_LF_LIB_consensus_vsearch	3210	G	G	588	3	0.5%	2	1	93	93	0.12468247248078299	1	1	380	208	0	3	-T
B10_BC22_191109_LF_LIB_consensus_vsearch	3211	T	Y	589	9	1.51%	2	2	93	93	0.001894802500745058	1	1	385	204	3	6	C
B10_BC22_191109_LF_LIB_consensus_vsearch	3212	T	*/+G	580	10	1.66%	2	2	93	93	9.39730591623294E-4	1	1	376	204	6	4	+G
B10_BC22_191109_LF_LIB_consensus_vsearch	3213	G	G	584	5	0.84%	2	1	93	93	0.030984833420659205	1	1	384	200	0	5	+A
B10_BC22_191109_LF_LIB_consensus_vsearch	3214	A	A	595	4	0.67%	2	2	93	93	0.062186847872822006	1	1	384	211	3	1	G
B10_BC22_191109_LF_LIB_consensus_vsearch	3215	A	A	596	5	0.83%	2	2	93	93	0.030990125687592227	1	1	385	211	2	3	G
B10_BC22_191109_LF_LIB_consensus_vsearch	3216	A	A	594	4	0.66%	2	2	93	93	0.062186323989038686	1	1	380	214	3	1	G
B10_BC22_191109_LF_LIB_consensus_vsearch	3217	C	*/+A	584	7	1.17%	2	2	93	93	0.007674170345963	1	1	377	207	2	5	+A
B10_BC22_191109_LF_LIB_consensus_vsearch	3218	A	A	591	2	0.34%	2	1	93	93	0.24978902953563295	1	1	380	211	0	2	G
B10_BC22_191109_LF_LIB_consensus_vsearch	3219	A	R	554	28	4.64%	2	2	93	93	2.6711585833238053E-9	1	1	348	206	27	1	G
B10_BC22_191109_LF_LIB_consensus_vsearch	3220	C	C	575	5	0.85%	2	2	93	93	0.030980720571722742	1	1	369	206	2	3	T
B10_BC22_191109_LF_LIB_consensus_vsearch	3221	C	*/-T	556	19	3.16%	2	2	93	93	1.6398103665470737E-6	1	1	378	178	2	17	-T
B10_BC22_191109_LF_LIB_consensus_vsearch	3222	T	T	570	5	0.87%	2	1	93	93	0.030978380047692815	1	1	373	197	5	0	A
B10_BC22_191109_LF_LIB_consensus_vsearch	3223	T	T	586	3	0.5%	2	2	93	93	0.12468139337307069	1	1	376	210	1	2	C
B10_BC22_191109_LF_LIB_consensus_vsearch	3224	A	A	591	2	0.34%	2	2	93	93	0.24978902953563295	1	1	379	212	1	1	C
B10_BC22_191109_LF_LIB_consensus_vsearch	3225	A	*/-C	577	12	2.01%	2	2	93	93	2.3071056867786312E-4	1	1	363	214	11	1	-C
B10_BC22_191109_LF_LIB_consensus_vsearch	3226	C	*/+T	572	9	1.54%	2	1	93	93	0.0018931100684577166	1	1	368	204	0	9	+T
B10_BC22_191109_LF_LIB_consensus_vsearch	3227	C	*/-T	586	9	1.5%	2	2	93	93	0.0018945108065208946	1	1	378	208	3	6	-T
B10_BC22_191109_LF_LIB_consensus_vsearch	3228	T	T	584	4	0.68%	2	2	93	93	0.062180987103355005	1	1	377	207	3	1	C
B10_BC22_191109_LF_LIB_consensus_vsearch	3229	A	R	592	7	1.16%	2	1	93	93	0.007676011594473652	1	1	379	213	7	0	G
B10_BC22_191109_LF_LIB_consensus_vsearch	3230	T	T	599	2	0.33%	2	2	93	93	0.24979184013288794	1	1	385	214	1	1	G
B10_BC22_191109_LF_LIB_consensus_vsearch	3231	T	T	591	4	0.66%	2	1	93	93	0.06218474176725347	1	1	383	208	0	4	+C
B10_BC22_191109_LF_LIB_consensus_vsearch	3232	C	C	595	5	0.83%	2	2	93	93	0.03098969274732699	1	1	385	210	2	3	-TC
B10_BC22_191109_LF_LIB_consensus_vsearch	3233	T	T	589	4	0.67%	2	2	93	93	0.06218367805512527	1	1	381	208	3	1	C
B10_BC22_191109_LF_LIB_consensus_vsearch	3234	C	C	590	3	0.5%	2	2	93	93	0.12468354430400949	1	1	382	208	2	1	+A
B10_BC22_191109_LF_LIB_consensus_vsearch	3235	A	A	591	4	0.67%	2	2	93	93	0.06218474176725347	1	1	382	209	2	2	G
B10_BC22_191109_LF_LIB_consensus_vsearch	3236	A	A	599	2	0.33%	2	1	93	93	0.24979184013288794	1	1	386	213	2	0	G
B10_BC22_191109_LF_LIB_consensus_vsearch	3237	A	R	591	10	1.66%	2	2	93	93	9.403973623913355E-4	1	1	379	212	9	1	G
B10_BC22_191109_LF_LIB_consensus_vsearch	3238	C	*/+T	575	16	2.65%	2	2	93	93	1.3767088119335913E-5	1	1	369	206	12	4	+T
B10_BC22_191109_LF_LIB_consensus_vsearch	3239	T	T	592	2	0.34%	2	1	93	93	0.24978938500452047	1	1	383	209	0	2	+C
B10_BC22_191109_LF_LIB_consensus_vsearch	3240	T	T	594	2	0.33%	2	1	93	93	0.24979009235977778	1	1	382	212	0	2	+CTT
B10_BC22_191109_LF_LIB_consensus_vsearch	3241	T	T	591	5	0.83%	2	2	93	93	0.030987946464272845	1	1	381	210	4	1	C
B10_BC22_191109_LF_LIB_consensus_vsearch	3242	A	A	596	3	0.5%	2	2	93	93	0.1246867167922604	1	1	384	212	1	2	G
B10_BC22_191109_LF_LIB_consensus_vsearch	3243	A	A	600	1	0.17%	2	1	93	93	0.4999999999999138	1	1	386	214	0	1	G
B10_BC22_191109_LF_LIB_consensus_vsearch	3244	A	A	595	5	0.83%	2	2	93	93	0.03098969274732699	1	1	383	212	3	2	G
B10_BC22_191109_LF_LIB_consensus_vsearch	3245	T	T	594	6	1%	2	1	93	93	0.015430014380448172	1	1	381	213	6	0	-AT
B10_BC22_191109_LF_LIB_consensus_vsearch	3246	A	A	590	4	0.67%	2	1	93	93	0.062184210806914414	1	1	376	214	4	0	-T
B10_BC22_191109_LF_LIB_consensus_vsearch	3247	T	T	590	1	0.17%	2	1	93	93	0.5000000000008233	1	1	378	212	0	1	+AT
B10_BC22_191109_LF_LIB_consensus_vsearch	3248	G	G	594	5	0.83%	2	2	93	93	0.03098925836211217	1	1	381	213	4	1	A
B10_BC22_191109_LF_LIB_consensus_vsearch	3249	T	*/-A	538	38	6.33%	2	2	93	93	1.9358242300194315E-12	1	1	329	209	36	2	-A
B10_BC22_191109_LF_LIB_consensus_vsearch	3250	A	A	555	2	0.36%	2	1	93	93	0.2497753818510447	1	1	344	211	0	2	G
B10_BC22_191109_LF_LIB_consensus_vsearch	3251	A	*/-G	563	12	2.01%	2	2	93	93	2.303897416995595E-4	1	1	352	211	11	1	-G
B10_BC22_191109_LF_LIB_consensus_vsearch	3252	G	*/-AAG	539	23	3.99%	2	2	93	93	9.474394843009294E-8	1	1	329	210	22	1	-AAG
B10_BC22_191109_LF_LIB_consensus_vsearch	3253	A	A	552	3	0.54%	2	1	93	93	0.12466185752942743	1	1	342	210	3	0	G
B10_BC22_191109_LF_LIB_consensus_vsearch	3254	A	A	577	1	0.17%	2	1	93	93	0.4999999999999138	1	1	364	213	1	0	-G
B10_BC22_191109_LF_LIB_consensus_vsearch	3255	G	G	574	2	0.35%	2	1	93	93	0.24978279756726465	1	1	361	213	2	0	A
B10_BC22_191109_LF_LIB_consensus_vsearch	3256	T	*/-C	580	14	2.33%	2	2	93	93	5.648462977218392E-5	1	1	368	212	12	2	-C
B10_BC22_191109_LF_LIB_consensus_vsearch	3257	C	C	580	4	0.68%	2	1	93	93	0.06217880115194425	1	1	368	212	4	0	+A
B10_BC22_191109_LF_LIB_consensus_vsearch	3258	C	*/-T	584	8	1.33%	2	2	93	93	0.0038143805269862142	1	1	374	210	4	4	-T
B10_BC22_191109_LF_LIB_consensus_vsearch	3259	T	T	584	5	0.84%	2	1	93	93	0.030984833420659205	1	1	376	208	5	0	A
B10_BC22_191109_LF_LIB_consensus_vsearch	3260	T	Y	582	12	1.99%	2	2	93	93	2.3082155254131308E-4	1	1	375	207	6	6	C
B10_BC22_191109_LF_LIB_consensus_vsearch	3261	G	G	583	6	1%	2	2	93	93	0.015426379128433065	1	1	376	207	5	1	A
B10_BC22_191109_LF_LIB_consensus_vsearch	3262	T	T	587	5	0.84%	2	2	93	93	0.030986176592841308	1	1	381	206	1	4	C
B10_BC22_191109_LF_LIB_consensus_vsearch	3263	T	T	592	4	0.67%	2	2	93	93	0.06218527094514562	1	1	382	210	1	3	C
B10_BC22_191109_LF_LIB_consensus_vsearch	3264	A	A	587	6	1%	2	1	93	93	0.015427716615850288	1	1	378	209	6	0	G
B10_BC22_191109_LF_LIB_consensus_vsearch	3265	C	*/-T	581	9	1.51%	2	2	93	93	0.0018940181115188759	1	1	379	202	3	6	-T
B10_BC22_191109_LF_LIB_consensus_vsearch	3266	T	T	579	6	1.01%	2	2	93	93	0.015425023382419913	1	1	377	202	4	2	C
B10_BC22_191109_LF_LIB_consensus_vsearch	3267	T	Y	584	9	1.5%	2	2	93	93	0.0018943147174077597	1	1	378	206	6	3	C
B10_BC22_191109_LF_LIB_consensus_vsearch	3268	A	R	590	8	1.33%	2	1	93	93	0.003815297238788008	1	1	377	213	8	0	G
B10_BC22_191109_LF_LIB_consensus_vsearch	3269	G	G	590	3	0.5%	2	1	93	93	0.12468354430400949	1	1	383	207	0	3	+C
B10_BC22_191109_LF_LIB_consensus_vsearch	3270	T	Y	582	16	2.67%	2	2	93	93	1.3783895623260012E-5	1	1	382	200	4	12	C
B10_BC22_191109_LF_LIB_consensus_vsearch	3271	T	Y	586	8	1.33%	2	2	93	93	0.00381468814385855	1	1	380	206	6	2	C
B10_BC22_191109_LF_LIB_consensus_vsearch	3272	G	G	600	1	0.17%	2	1	93	93	0.4999999999999138	1	1	385	215	1	0	+TG
B10_BC22_191109_LF_LIB_consensus_vsearch	3273	A	A	596	3	0.5%	2	2	93	93	0.1246867167922604	1	1	382	214	2	1	G
B10_BC22_191109_LF_LIB_consensus_vsearch	3274	A	A	597	2	0.33%	2	1	93	93	0.24979114452852993	1	1	384	213	0	2	-CG
B10_BC22_191109_LF_LIB_consensus_vsearch	3275	C	C	592	4	0.67%	2	2	93	93	0.06218527094514562	1	1	383	209	1	3	T
B10_BC22_191109_LF_LIB_consensus_vsearch	3276	G	G	580	5	0.83%	2	2	93	93	0.030983021104337604	1	1	380	200	1	4	-TG
B10_BC22_191109_LF_LIB_consensus_vsearch	3277	T	*/-G	576	7	1.18%	2	2	93	93	0.007672278741851824	1	1	385	191	1	6	-G
B10_BC22_191109_LF_LIB_consensus_vsearch	3278	G	G	584	1	0.17%	2	1	93	93	0.4999999999999138	1	1	385	199	1	0	+A
B10_BC22_191109_LF_LIB_consensus_vsearch	3279	G	G	592	3	0.5%	2	2	93	93	0.1246846089151382	1	1	384	208	2	1	A
B10_BC22_191109_LF_LIB_consensus_vsearch	3280	A	A	592	5	0.83%	2	2	93	93	0.03098838522787931	1	1	383	209	3	2	G
B10_BC22_191109_LF_LIB_consensus_vsearch	3281	C	C	594	5	0.83%	2	2	93	93	0.03098925836211217	1	1	384	210	2	3	T
B10_BC22_191109_LF_LIB_consensus_vsearch	3282	A	*/+T	583	9	1.5%	2	2	93	93	0.0018942161800671361	1	1	372	211	7	2	+T
B10_BC22_191109_LF_LIB_consensus_vsearch	3283	T	T	593	3	0.5%	2	1	93	93	0.12468513853935516	1	1	382	211	0	3	C
B10_BC22_191109_LF_LIB_consensus_vsearch	3284	T	T	600	1	0.17%	2	1	93	93	0.4999999999999138	1	1	387	213	0	1	+ATT
B10_BC22_191109_LF_LIB_consensus_vsearch	3285	T	T	591	6	1%	2	2	93	93	0.015429036211008771	1	1	380	211	5	1	+A
B10_BC22_191109_LF_LIB_consensus_vsearch	3286	G	G	592	5	0.83%	2	2	93	93	0.03098838522787931	1	1	382	210	4	1	-A
B10_BC22_191109_LF_LIB_consensus_vsearch	3287	A	A	595	2	0.33%	2	1	93	93	0.24979044425840527	1	1	381	214	2	0	G
B10_BC22_191109_LF_LIB_consensus_vsearch	3288	A	A	597	5	0.83%	2	2	93	93	0.030990557190175443	1	1	384	213	4	1	G
B10_BC22_191109_LF_LIB_consensus_vsearch	3289	T	T	593	4	0.66%	2	1	93	93	0.06218579834936829	1	1	382	211	4	0	-GT
B10_BC22_191109_LF_LIB_consensus_vsearch	3290	G	G	591	3	0.5%	2	1	93	93	0.12468407750622149	1	1	378	213	3	0	A
B10_BC22_191109_LF_LIB_consensus_vsearch	3291	T	Y	575	9	1.51%	2	2	93	93	0.0018934158334647266	1	1	379	196	1	8	C
B10_BC22_191109_LF_LIB_consensus_vsearch	3292	A	A	587	5	0.83%	2	1	93	93	0.030986176592841308	1	1	380	207	0	5	-T
B10_BC22_191109_LF_LIB_consensus_vsearch	3293	T	*/-C	581	8	1.35%	2	2	93	93	0.0038139152066312184	1	1	378	203	2	6	-C
B10_BC22_191109_LF_LIB_consensus_vsearch	3294	C	C	578	5	0.84%	2	1	93	93	0.030982105624386143	1	1	374	204	5	0	+TC
B10_BC22_191109_LF_LIB_consensus_vsearch	3295	G	G	593	6	1%	2	2	93	93	0.015429689410799249	1	1	382	211	3	3	A
B10_BC22_191109_LF_LIB_consensus_vsearch	3296	T	T	599	1	0.17%	2	1	93	93	0.4999999999990043	1	1	387	212	0	1	A
B10_BC22_191109_LF_LIB_consensus_vsearch	3297	T	T	601	2	0.33%	2	2	93	93	0.2497925311200579	1	1	387	214	1	1	C
B10_BC22_191109_LF_LIB_consensus_vsearch	3298	A	R	594	7	1.16%	2	1	93	93	0.0076764642733761	1	1	379	215	7	0	G
B10_BC22_191109_LF_LIB_consensus_vsearch	3299	C	C	595	5	0.83%	2	2	93	93	0.03098969274732699	1	1	384	211	1	4	+T
B10_BC22_191109_LF_LIB_consensus_vsearch	3300	T	Y	585	7	1.16%	2	1	93	93	0.007674403214110395	1	1	378	207	0	7	C
B10_BC22_191109_LF_LIB_consensus_vsearch	3301	A	*/-G	587	7	1.16%	2	1	93	93	0.007674866606290045	1	1	382	205	0	7	-G
B10_BC22_191109_LF_LIB_consensus_vsearch	3302	G	K	577	8	1.34%	2	1	93	93	0.0038132873975118887	1	1	376	201	8	0	T
B10_BC22_191109_LF_LIB_consensus_vsearch	3303	T	*/-G	574	13	2.18%	2	2	93	93	1.1414178313129473E-4	1	1	380	194	2	11	-G
B10_BC22_191109_LF_LIB_consensus_vsearch	3304	G	G	577	5	0.86%	2	1	93	93	0.030981645525998008	1	1	380	197	5	0	A
B10_BC22_191109_LF_LIB_consensus_vsearch	3305	G	G	593	3	0.5%	2	1	93	93	0.12468513853935516	1	1	382	211	3	0	+A
B10_BC22_191109_LF_LIB_consensus_vsearch	3306	G	G	592	3	0.5%	2	1	93	93	0.1246846089151382	1	1	379	213	3	0	+C
B10_BC22_191109_LF_LIB_consensus_vsearch	3307	C	C	593	4	0.67%	2	1	93	93	0.06218579834936829	1	1	384	209	0	4	T
B10_BC22_191109_LF_LIB_consensus_vsearch	3308	C	C	597	2	0.33%	2	1	93	93	0.24979114452852993	1	1	386	211	2	0	-A
B10_BC22_191109_LF_LIB_consensus_vsearch	3309	A	*/-T	399	151	25.21%	2	2	93	93	2.200836374569357E-51	1	1	250	149	120	31	-T
B10_BC22_191109_LF_LIB_consensus_vsearch	3310	T	T	433	2	0.46%	2	2	93	93	0.2497123130030455	1	1	261	172	1	1	C
B10_BC22_191109_LF_LIB_consensus_vsearch	3311	T	T	588	0	0%	2	0	93	0	1.0	1	0	384	204	0	0	
B10_BC22_191109_LF_LIB_consensus_vsearch	3312	T	T	594	1	0.17%	2	1	93	93	0.5000000000008233	1	1	384	210	0	1	+CTT
B10_BC22_191109_LF_LIB_consensus_vsearch	3313	T	T	594	2	0.33%	2	2	93	93	0.24979009235977778	1	1	383	211	1	1	+G
B10_BC22_191109_LF_LIB_consensus_vsearch	3314	T	*/-G	577	21	3.48%	2	2	93	93	3.988233720488958E-7	1	1	383	194	2	19	-G
B10_BC22_191109_LF_LIB_consensus_vsearch	3315	G	G	574	2	0.34%	2	1	93	93	0.24978279756726465	1	1	382	192	2	0	+A
B10_BC22_191109_LF_LIB_consensus_vsearch	3316	G	G	590	3	0.5%	2	1	93	93	0.12468354430400949	1	1	381	209	0	3	-T
B10_BC22_191109_LF_LIB_consensus_vsearch	3317	T	*/-A	556	18	3.01%	2	2	93	93	3.331816288518551E-6	1	1	364	192	15	3	-A
B10_BC22_191109_LF_LIB_consensus_vsearch	3318	A	A	572	3	0.52%	2	1	93	93	0.12467362924259917	1	1	368	204	0	3	G
B10_BC22_191109_LF_LIB_consensus_vsearch	3319	A	R	588	7	1.17%	2	2	93	93	0.007675097138165556	1	1	381	207	3	4	G
B10_BC22_191109_LF_LIB_consensus_vsearch	3320	G	R	577	11	1.84%	2	1	93	93	4.6577416695331333E-4	1	1	368	209	11	0	A
B10_BC22_191109_LF_LIB_consensus_vsearch	3321	C	C	582	5	0.83%	2	1	93	93	0.030983930348565846	1	1	371	211	5	0	+A
B10_BC22_191109_LF_LIB_consensus_vsearch	3322	A	A	589	4	0.67%	2	1	93	93	0.06218367805512527	1	1	377	212	4	0	+G
B10_BC22_191109_LF_LIB_consensus_vsearch	3323	G	G	596	1	0.17%	2	1	93	93	0.4999999999999138	1	1	384	212	1	0	+AA
B10_BC22_191109_LF_LIB_consensus_vsearch	3324	A	R	587	8	1.33%	2	1	93	93	0.003814841181091788	1	1	373	214	8	0	G
B10_BC22_191109_LF_LIB_consensus_vsearch	3325	A	R	579	13	2.16%	2	1	93	93	1.1420723572987618E-4	1	1	369	210	13	0	G
B10_BC22_191109_LF_LIB_consensus_vsearch	3326	C	*/-T	579	12	2.01%	2	1	93	93	2.3075518337962257E-4	1	1	372	207	12	0	-T
B10_BC22_191109_LF_LIB_consensus_vsearch	3327	T	T	574	5	0.85%	2	2	93	93	0.030980255699410347	1	1	367	207	4	1	C
B10_BC22_191109_LF_LIB_consensus_vsearch	3328	G	R	580	15	2.51%	2	2	93	93	2.790977291101727E-5	1	1	372	208	14	1	A
B10_BC22_191109_LF_LIB_consensus_vsearch	3329	G	R	593	8	1.33%	2	2	93	93	0.0038157487685222483	1	1	386	207	1	7	A
B10_BC22_191109_LF_LIB_consensus_vsearch	3330	C	C	583	6	1%	2	2	93	93	0.015426379128433065	1	1	379	204	5	1	-G
B10_BC22_191109_LF_LIB_consensus_vsearch	3331	G	*/-A	556	37	6.2%	2	2	93	93	4.075917291348865E-12	1	1	345	211	36	1	-A
B10_BC22_191109_LF_LIB_consensus_vsearch	3332	A	R	554	7	1.24%	2	2	93	93	0.007666799661120067	1	1	346	208	4	3	G
B10_BC22_191109_LF_LIB_consensus_vsearch	3333	T	T	596	2	0.33%	2	2	93	93	0.24979079497935539	1	1	385	211	1	1	C
B10_BC22_191109_LF_LIB_consensus_vsearch	3334	G	*/-CG	569	15	2.5%	2	2	93	93	2.7862262199428654E-5	1	1	373	196	5	10	-CG
B10_BC22_191109_LF_LIB_consensus_vsearch	3335	C	*/-G	511	22	3.81%	2	2	93	93	1.9111089364878963E-7	1	1	365	146	5	17	-G
B10_BC22_191109_LF_LIB_consensus_vsearch	3336	G	R	456	85	15.54%	2	1	93	93	7.182396766070361E-28	1	1	291	165	85	0	A
B10_BC22_191109_LF_LIB_consensus_vsearch	3337	G	K	571	7	1.2%	2	1	93	93	0.007671069992311274	1	1	383	188	0	7	T
B10_BC22_191109_LF_LIB_consensus_vsearch	3338	G	G	593	3	0.5%	2	1	93	93	0.12468513853935516	1	1	381	212	3	0	A
B10_BC22_191109_LF_LIB_consensus_vsearch	3339	A	A	594	3	0.5%	2	2	93	93	0.12468566638724124	1	1	382	212	1	2	G
B10_BC22_191109_LF_LIB_consensus_vsearch	3340	T	*/+A	586	9	1.5%	2	2	93	93	0.0018945108065208946	1	1	374	212	8	1	+A
B10_BC22_191109_LF_LIB_consensus_vsearch	3341	G	*/-A	589	8	1.33%	2	2	93	93	0.003815145726019033	1	1	380	209	7	1	-A
B10_BC22_191109_LF_LIB_consensus_vsearch	3342	A	A	588	4	0.67%	2	2	93	93	0.06218314350277022	1	1	377	211	2	2	G
B10_BC22_191109_LF_LIB_consensus_vsearch	3343	A	*/-C	583	8	1.33%	2	2	93	93	0.0038142259421648926	1	1	372	211	7	1	-C
B10_BC22_191109_LF_LIB_consensus_vsearch	3344	C	C	589	3	0.51%	2	1	93	93	0.1246830092985462	1	1	379	210	0	3	T
B10_BC22_191109_LF_LIB_consensus_vsearch	3345	C	Y	558	29	4.82%	2	2	93	93	1.306733778080878E-9	1	1	376	182	4	25	T
B10_BC22_191109_LF_LIB_consensus_vsearch	3346	G	*/-A	591	7	1.16%	2	2	93	93	0.007675784123381086	1	1	378	213	6	1	-A
B10_BC22_191109_LF_LIB_consensus_vsearch	3347	A	A	592	2	0.34%	2	2	93	93	0.24978938500452047	1	1	379	213	1	1	G
B10_BC22_191109_LF_LIB_consensus_vsearch	3348	A	A	593	4	0.66%	2	2	93	93	0.06218579834936829	1	1	381	212	3	1	G
B10_BC22_191109_LF_LIB_consensus_vsearch	3349	C	C	596	2	0.33%	2	1	93	93	0.24979079497935539	1	1	384	212	0	2	+G
B10_BC22_191109_LF_LIB_consensus_vsearch	3350	G	*/-CG	584	7	1.16%	2	2	93	93	0.007674170345963	1	1	374	210	5	2	-CG
B10_BC22_191109_LF_LIB_consensus_vsearch	3351	C	C	585	3	0.5%	2	2	93	93	0.1246808510636648	1	1	376	209	2	1	T
B10_BC22_191109_LF_LIB_consensus_vsearch	3352	G	*/-A	567	11	1.85%	2	1	93	93	4.653905485314612E-4	1	1	357	210	11	0	-A
B10_BC22_191109_LF_LIB_consensus_vsearch	3353	A	*/-G	533	42	7.19%	2	2	93	93	1.0455237546290371E-13	1	1	323	210	40	2	-G
B10_BC22_191109_LF_LIB_consensus_vsearch	3354	G	G	548	3	0.54%	2	2	93	93	0.12465940054486688	1	1	339	209	1	2	A
B10_BC22_191109_LF_LIB_consensus_vsearch	3355	G	G	590	3	0.5%	2	1	93	93	0.12468354430400949	1	1	379	211	3	0	+A
B10_BC22_191109_LF_LIB_consensus_vsearch	3356	T	T	591	5	0.83%	2	2	93	93	0.030987946464272845	1	1	382	209	3	2	C
B10_BC22_191109_LF_LIB_consensus_vsearch	3357	T	*/-A	531	51	8.47%	2	2	93	93	1.412589478598874E-16	1	1	325	206	46	5	-A
B10_BC22_191109_LF_LIB_consensus_vsearch	3358	A	A	545	3	0.54%	2	2	93	93	0.12465753424651009	1	1	339	206	1	2	G
B10_BC22_191109_LF_LIB_consensus_vsearch	3359	A	R	582	11	1.83%	2	2	93	93	4.659611953509893E-4	1	1	375	207	9	2	G
B10_BC22_191109_LF_LIB_consensus_vsearch	3360	G	G	583	4	0.67%	2	2	93	93	0.06218044340963991	1	1	380	203	3	1	+A
B10_BC22_191109_LF_LIB_consensus_vsearch	3361	G	G	595	3	0.5%	2	1	93	93	0.12468619246852639	1	1	384	211	3	0	T
B10_BC22_191109_LF_LIB_consensus_vsearch	3362	T	T	597	2	0.33%	2	1	93	93	0.24979114452852993	1	1	386	211	0	2	G
B10_BC22_191109_LF_LIB_consensus_vsearch	3363	G	*/-C	575	15	2.49%	2	2	93	93	2.7888389483588588E-5	1	1	363	212	12	3	-C
B10_BC22_191109_LF_LIB_consensus_vsearch	3364	C	C	581	1	0.17%	2	1	93	93	0.4999999999999138	1	1	369	212	1	0	A
B10_BC22_191109_LF_LIB_consensus_vsearch	3365	C	*/-G	580	10	1.67%	2	2	93	93	9.39730591623294E-4	1	1	371	209	6	4	-G
B10_BC22_191109_LF_LIB_consensus_vsearch	3366	G	G	578	4	0.68%	2	2	93	93	0.06217769690336766	1	1	370	208	2	2	T
B10_BC22_191109_LF_LIB_consensus_vsearch	3367	G	G	596	3	0.5%	2	1	93	93	0.1246867167922604	1	1	382	214	3	0	-A
B10_BC22_191109_LF_LIB_consensus_vsearch	3368	A	A	596	3	0.5%	2	1	93	93	0.1246867167922604	1	1	381	215	3	0	+G
B10_BC22_191109_LF_LIB_consensus_vsearch	3369	A	A	600	3	0.5%	2	1	93	93	0.12468879668066746	1	1	385	215	3	0	G
B10_BC22_191109_LF_LIB_consensus_vsearch	3370	T	*/+A	587	8	1.33%	2	1	93	93	0.003814841181091788	1	1	378	209	8	0	+A
B10_BC22_191109_LF_LIB_consensus_vsearch	3371	G	G	585	6	1%	2	1	93	93	0.015427050131369397	1	1	374	211	6	0	T
B10_BC22_191109_LF_LIB_consensus_vsearch	3372	T	T	588	4	0.67%	2	1	93	93	0.06218314350277022	1	1	383	205	4	0	C
B10_BC22_191109_LF_LIB_consensus_vsearch	3373	A	R	580	13	2.16%	2	1	93	93	1.1422019683041178E-4	1	1	372	208	13	0	G
B10_BC22_191109_LF_LIB_consensus_vsearch	3374	C	C	590	2	0.33%	2	1	93	93	0.2497886728654613	1	1	381	209	2	0	+A
B10_BC22_191109_LF_LIB_consensus_vsearch	3375	G	G	586	5	0.83%	2	1	93	93	0.030985730383315414	1	1	380	206	0	5	-C
B10_BC22_191109_LF_LIB_consensus_vsearch	3376	C	C	591	2	0.34%	2	1	93	93	0.24978902953563295	1	1	385	206	0	2	+T
B10_BC22_191109_LF_LIB_consensus_vsearch	3377	T	T	598	1	0.17%	2	1	93	93	0.5000000000008233	1	1	385	213	1	0	+C
B10_BC22_191109_LF_LIB_consensus_vsearch	3378	C	C	597	4	0.66%	2	1	93	93	0.062187890408182296	1	1	384	213	4	0	-A
B10_BC22_191109_LF_LIB_consensus_vsearch	3379	A	A	592	5	0.83%	2	2	93	93	0.03098838522787931	1	1	380	212	4	1	G
B10_BC22_191109_LF_LIB_consensus_vsearch	3380	T	*/+C	569	25	4.15%	2	1	93	93	2.3028316352755332E-8	1	1	358	211	25	0	+C
B10_BC22_191109_LF_LIB_consensus_vsearch	3381	C	*/+G	582	9	1.5%	2	1	93	93	0.0018941173119931185	1	1	372	210	9	0	+G
B10_BC22_191109_LF_LIB_consensus_vsearch	3382	A	R	578	13	2.17%	2	2	93	93	1.1419423177491619E-4	1	1	371	207	11	2	G
B10_BC22_191109_LF_LIB_consensus_vsearch	3383	G	G	594	2	0.34%	2	1	93	93	0.24979009235977778	1	1	381	213	2	0	+A
B10_BC22_191109_LF_LIB_consensus_vsearch	3384	A	*/+G	588	7	1.16%	2	1	93	93	0.007675097138165556	1	1	379	209	7	0	+G
B10_BC22_191109_LF_LIB_consensus_vsearch	3385	C	C	588	4	0.67%	2	2	93	93	0.06218314350277022	1	1	383	205	1	3	-AC
B10_BC22_191109_LF_LIB_consensus_vsearch	3386	A	R	582	7	1.17%	2	2	93	93	0.007673702245629301	1	1	378	204	3	4	G
B10_BC22_191109_LF_LIB_consensus_vsearch	3387	C	C	588	3	0.51%	2	1	93	93	0.12468247248078299	1	1	382	206	0	3	T
B10_BC22_191109_LF_LIB_consensus_vsearch	3388	C	Y	591	7	1.16%	2	2	93	93	0.007675784123381086	1	1	383	208	1	6	T
B10_BC22_191109_LF_LIB_consensus_vsearch	3389	A	A	582	6	1%	2	1	93	93	0.015426041918236095	1	1	379	203	0	6	-CA
B10_BC22_191109_LF_LIB_consensus_vsearch	3390	C	*/-A	378	126	21.25%	2	2	93	93	1.5192188415498786E-42	1	1	229	149	93	33	-A
B10_BC22_191109_LF_LIB_consensus_vsearch	3391	A	A	423	3	0.7%	2	2	93	93	0.12455934195065375	1	1	254	169	1	2	T
B10_BC22_191109_LF_LIB_consensus_vsearch	3392	A	A	557	2	0.36%	2	1	93	93	0.24977618621279463	1	1	348	209	0	2	G
B10_BC22_191109_LF_LIB_consensus_vsearch	3393	A	A	593	3	0.5%	2	2	93	93	0.12468513853935516	1	1	385	208	1	2	G
B10_BC22_191109_LF_LIB_consensus_vsearch	3394	A	*/-G	585	7	1.16%	2	2	93	93	0.007674403214110395	1	1	378	207	4	3	-G
B10_BC22_191109_LF_LIB_consensus_vsearch	3395	G	G	591	2	0.34%	2	1	93	93	0.24978902953563295	1	1	382	209	0	2	+C
B10_BC22_191109_LF_LIB_consensus_vsearch	3396	G	G	596	4	0.67%	2	2	93	93	0.062187370009836374	1	1	383	213	3	1	A
B10_BC22_191109_LF_LIB_consensus_vsearch	3397	T	Y	587	9	1.5%	2	2	93	93	0.001894608361560784	1	1	380	207	3	6	C
B10_BC22_191109_LF_LIB_consensus_vsearch	3398	G	G	591	4	0.67%	2	2	93	93	0.06218474176725347	1	1	380	211	1	3	-T
B10_BC22_191109_LF_LIB_consensus_vsearch	3399	T	T	588	5	0.84%	2	2	93	93	0.0309866212982286	1	1	382	206	1	4	C
B10_BC22_191109_LF_LIB_consensus_vsearch	3400	T	T	590	3	0.5%	2	2	93	93	0.12468354430400949	1	1	380	210	2	1	+A
B10_BC22_191109_LF_LIB_consensus_vsearch	3401	A	R	587	7	1.16%	2	2	93	93	0.007674866606290045	1	1	380	207	6	1	G
B10_BC22_191109_LF_LIB_consensus_vsearch	3402	G	G	591	5	0.84%	2	1	93	93	0.030987946464272845	1	1	379	212	5	0	+A
B10_BC22_191109_LF_LIB_consensus_vsearch	3403	T	T	600	2	0.33%	2	2	93	93	0.249792186200784	1	1	387	213	1	1	C
B10_BC22_191109_LF_LIB_consensus_vsearch	3404	T	T	601	2	0.33%	2	2	93	93	0.2497925311200579	1	1	387	214	1	1	C
B10_BC22_191109_LF_LIB_consensus_vsearch	3405	C	C	598	1	0.17%	2	1	93	93	0.5000000000008233	1	1	386	212	1	0	+A
B10_BC22_191109_LF_LIB_consensus_vsearch	3406	A	A	592	4	0.67%	2	1	93	93	0.06218527094514562	1	1	385	207	0	4	+T
B10_BC22_191109_LF_LIB_consensus_vsearch	3407	T	*/+C	586	9	1.5%	2	1	93	93	0.0018945108065208946	1	1	376	210	9	0	+C
B10_BC22_191109_LF_LIB_consensus_vsearch	3408	C	*/-T	589	7	1.16%	2	1	93	93	0.007675326899053761	1	1	384	205	0	7	-T
B10_BC22_191109_LF_LIB_consensus_vsearch	3409	T	*/+G	568	18	3.03%	2	2	93	93	3.341204460471138E-6	1	1	364	204	17	1	+G
B10_BC22_191109_LF_LIB_consensus_vsearch	3410	A	*/-G	574	17	2.83%	2	1	93	93	6.7890871943561975E-6	1	1	360	214	17	0	-G
B10_BC22_191109_LF_LIB_consensus_vsearch	3411	G	G	578	3	0.51%	2	1	93	93	0.12467700258396955	1	1	365	213	3	0	+A
B10_BC22_191109_LF_LIB_consensus_vsearch	3412	A	A	592	3	0.5%	2	1	93	93	0.1246846089151382	1	1	379	213	3	0	+G
B10_BC22_191109_LF_LIB_consensus_vsearch	3413	C	C	585	6	1%	2	2	93	93	0.015427050131369397	1	1	373	212	5	1	+A
B10_BC22_191109_LF_LIB_consensus_vsearch	3414	A	A	593	3	0.5%	2	1	93	93	0.12468513853935516	1	1	380	213	3	0	+C
B10_BC22_191109_LF_LIB_consensus_vsearch	3415	G	R	516	73	12.17%	2	1	93	93	9.809848020704973E-24	1	1	302	214	73	0	A
B10_BC22_191109_LF_LIB_consensus_vsearch	3416	C	C	590	5	0.83%	2	2	93	93	0.030987506226370864	1	1	376	214	4	1	+A
B10_BC22_191109_LF_LIB_consensus_vsearch	3417	A	R	568	14	2.34%	2	1	93	93	5.639340320250585E-5	1	1	367	201	14	0	G
B10_BC22_191109_LF_LIB_consensus_vsearch	3418	G	G	591	1	0.17%	2	1	93	93	0.5000000000008233	1	1	385	206	1	0	+CAG
B10_BC22_191109_LF_LIB_consensus_vsearch	3419	G	G	601	1	0.17%	2	1	93	93	0.4999999999990043	1	1	387	214	0	1	+TG
B10_BC22_191109_LF_LIB_consensus_vsearch	3420	A	A	593	6	1%	2	2	93	93	0.015429689410799249	1	1	381	212	4	2	G
B10_BC22_191109_LF_LIB_consensus_vsearch	3421	C	C	593	4	0.66%	2	1	93	93	0.06218579834936829	1	1	384	209	0	4	T
B10_BC22_191109_LF_LIB_consensus_vsearch	3422	G	R	583	14	2.32%	2	2	93	93	5.650687914175413E-5	1	1	374	209	11	3	A
B10_BC22_191109_LF_LIB_consensus_vsearch	3423	G	G	593	3	0.5%	2	2	93	93	0.12468513853935516	1	1	382	211	1	2	-TG
B10_BC22_191109_LF_LIB_consensus_vsearch	3424	T	T	584	5	0.84%	2	2	93	93	0.030984833420659205	1	1	381	203	2	3	-G
B10_BC22_191109_LF_LIB_consensus_vsearch	3425	G	G	583	6	1.01%	2	2	93	93	0.015426379128433065	1	1	376	207	5	1	A
B10_BC22_191109_LF_LIB_consensus_vsearch	3426	G	*/-C	586	7	1.17%	2	2	93	93	0.007674635299574334	1	1	379	207	5	2	-C
B10_BC22_191109_LF_LIB_consensus_vsearch	3427	C	C	585	5	0.84%	2	2	93	93	0.030985282661769052	1	1	379	206	1	4	T
B10_BC22_191109_LF_LIB_consensus_vsearch	3428	C	Y	584	12	2%	2	2	93	93	2.3086543430195892E-4	1	1	382	202	2	10	T
B10_BC22_191109_LF_LIB_consensus_vsearch	3429	A	A	587	6	1%	2	2	93	93	0.015427716615850288	1	1	380	207	5	1	G
B10_BC22_191109_LF_LIB_consensus_vsearch	3430	T	*/-G	548	36	6.03%	2	2	93	93	8.3423104729881E-12	1	1	354	194	26	10	-G
B10_BC22_191109_LF_LIB_consensus_vsearch	3431	G	G	554	3	0.53%	2	1	93	93	0.12466307277640029	1	1	358	196	3	0	A
B10_BC22_191109_LF_LIB_consensus_vsearch	3432	G	*/-A	575	13	2.16%	2	2	93	93	1.14154960647074E-4	1	1	373	202	9	4	-A
B10_BC22_191109_LF_LIB_consensus_vsearch	3433	A	A	567	4	0.69%	2	1	93	93	0.062171485204235814	1	1	369	198	4	0	+G
B10_BC22_191109_LF_LIB_consensus_vsearch	3434	A	*/-G	573	8	1.35%	2	1	93	93	0.0038126509930167373	1	1	369	204	8	0	-G
B10_BC22_191109_LF_LIB_consensus_vsearch	3435	G	G	583	2	0.34%	2	1	93	93	0.24978614200168656	1	1	374	209	2	0	+A
B10_BC22_191109_LF_LIB_consensus_vsearch	3436	T	*/+C	572	8	1.33%	2	1	93	93	0.0038124905281564036	1	1	365	207	8	0	+C
B10_BC22_191109_LF_LIB_consensus_vsearch	3437	C	*/-G	567	16	2.69%	2	2	93	93	1.3747404729208327E-5	1	1	363	204	10	6	-G
B10_BC22_191109_LF_LIB_consensus_vsearch	3438	G	G	577	3	0.51%	2	1	93	93	0.12467644521108873	1	1	371	206	0	3	T
B10_BC22_191109_LF_LIB_consensus_vsearch	3439	G	G	593	6	1%	2	1	93	93	0.015429689410799249	1	1	379	214	6	0	-A
B10_BC22_191109_LF_LIB_consensus_vsearch	3440	A	A	588	5	0.84%	2	2	93	93	0.0309866212982286	1	1	374	214	4	1	G
B10_BC22_191109_LF_LIB_consensus_vsearch	3441	A	*/-T	576	13	2.16%	2	1	93	93	1.141680944483324E-4	1	1	380	196	0	13	-T
B10_BC22_191109_LF_LIB_consensus_vsearch	3442	T	*/-C	554	20	3.4%	2	2	93	93	8.058912423980617E-7	1	1	360	194	15	5	-C
B10_BC22_191109_LF_LIB_consensus_vsearch	3443	C	C	576	3	0.52%	2	1	93	93	0.12467588591190074	1	1	373	203	0	3	G
B10_BC22_191109_LF_LIB_consensus_vsearch	3444	C	Y	569	15	2.5%	2	2	93	93	2.7862262199428654E-5	1	1	382	187	1	14	T
B10_BC22_191109_LF_LIB_consensus_vsearch	3445	G	G	583	5	0.84%	2	2	93	93	0.030984382652161722	1	1	377	206	2	3	A
B10_BC22_191109_LF_LIB_consensus_vsearch	3446	C	C	581	5	0.83%	2	1	93	93	0.030983476501936075	1	1	374	207	5	0	+T
B10_BC22_191109_LF_LIB_consensus_vsearch	3447	T	*/-A	555	24	4.03%	2	2	93	93	4.6732375075825604E-8	1	1	369	186	11	13	-A
B10_BC22_191109_LF_LIB_consensus_vsearch	3448	A	R	566	9	1.56%	2	2	93	93	0.0018924890471757854	1	1	368	198	6	3	G
B10_BC22_191109_LF_LIB_consensus_vsearch	3449	A	*/-GGA	543	13	2.16%	2	1	93	93	1.1371034282771197E-4	1	1	340	203	13	0	-GGA
B10_BC22_191109_LF_LIB_consensus_vsearch	3450	G	K	547	12	2.11%	2	1	93	93	2.3000379166900636E-4	1	1	351	196	0	12	T
B10_BC22_191109_LF_LIB_consensus_vsearch	3451	G	R	557	9	1.55%	2	1	93	93	0.001891533038997417	1	1	344	213	9	0	A
B10_BC22_191109_LF_LIB_consensus_vsearch	3452	A	A	568	3	0.52%	2	1	93	93	0.12467134092879167	1	1	358	210	3	0	+G
B10_BC22_191109_LF_LIB_consensus_vsearch	3453	G	G	582	6	1%	2	1	93	93	0.015426041918236095	1	1	377	205	0	6	-TGT
B10_BC22_191109_LF_LIB_consensus_vsearch	3454	T	T	577	4	0.67%	2	1	93	93	0.06217714192710672	1	1	382	195	4	0	+A
B10_BC22_191109_LF_LIB_consensus_vsearch	3455	G	G	581	3	0.51%	2	2	93	93	0.1246786632393088	1	1	380	201	2	1	-T
B10_BC22_191109_LF_LIB_consensus_vsearch	3456	T	*/-GT	526	50	8.5%	2	2	93	93	2.9227297147728894E-16	1	1	378	148	5	45	-GT
B10_BC22_191109_LF_LIB_consensus_vsearch	3457	G	*/+C	524	8	1.47%	2	1	93	93	0.0038040831989871004	1	1	368	156	8	0	+C
B10_BC22_191109_LF_LIB_consensus_vsearch	3458	T	Y	510	13	2.38%	2	2	93	93	1.1319632414400743E-4	1	1	366	144	10	3	C
B10_BC22_191109_LF_LIB_consensus_vsearch	3459	A	A	595	3	0.5%	2	2	93	93	0.12468619246852639	1	1	382	213	2	1	G
B10_BC22_191109_LF_LIB_consensus_vsearch	3460	A	R	586	10	1.66%	2	2	93	93	9.400973019723426E-4	1	1	373	213	9	1	G
B10_BC22_191109_LF_LIB_consensus_vsearch	3461	C	Y	577	13	2.16%	2	2	93	93	1.1418118475245747E-4	1	1	379	198	2	11	T
B10_BC22_191109_LF_LIB_consensus_vsearch	3462	A	A	589	2	0.34%	2	2	93	93	0.2497883149871952	1	1	379	210	1	1	G
B10_BC22_191109_LF_LIB_consensus_vsearch	3463	A	R	576	8	1.34%	2	1	93	93	0.0038131291090651434	1	1	375	201	8	0	G
B10_BC22_191109_LF_LIB_consensus_vsearch	3464	C	*/-T	576	12	2.02%	2	1	93	93	2.306881496410543E-4	1	1	384	192	0	12	-T
B10_BC22_191109_LF_LIB_consensus_vsearch	3465	T	T	582	4	0.68%	2	2	93	93	0.0621798978595429	1	1	381	201	2	2	-C
B10_BC22_191109_LF_LIB_consensus_vsearch	3466	C	C	590	3	0.5%	2	1	93	93	0.12468354430400949	1	1	378	212	3	0	-ACC
B10_BC22_191109_LF_LIB_consensus_vsearch	3467	A	A	582	5	0.84%	2	1	93	93	0.030983930348565846	1	1	373	209	5	0	-C
B10_BC22_191109_LF_LIB_consensus_vsearch	3468	C	C	588	2	0.34%	2	1	93	93	0.2497879558944788	1	1	378	210	0	2	+T
B10_BC22_191109_LF_LIB_consensus_vsearch	3469	C	C	583	6	1%	2	2	93	93	0.015426379128433065	1	1	377	206	3	3	-T
B10_BC22_191109_LF_LIB_consensus_vsearch	3470	T	Y	571	18	3.04%	2	2	93	93	3.343494826100154E-6	1	1	378	193	2	16	C
B10_BC22_191109_LF_LIB_consensus_vsearch	3471	G	G	585	5	0.84%	2	2	93	93	0.030985282661769052	1	1	376	209	4	1	-C
B10_BC22_191109_LF_LIB_consensus_vsearch	3472	C	C	586	4	0.68%	2	1	93	93	0.062182068959449006	1	1	379	207	0	4	T
B10_BC22_191109_LF_LIB_consensus_vsearch	3473	C	*/+A	567	15	2.5%	2	1	93	93	2.7853437407917936E-5	1	1	363	204	15	0	+A
B10_BC22_191109_LF_LIB_consensus_vsearch	3474	G	*/-A	574	13	2.17%	2	2	93	93	1.1414178313129473E-4	1	1	365	209	12	1	-A
B10_BC22_191109_LF_LIB_consensus_vsearch	3475	A	A	583	4	0.68%	2	2	93	93	0.06218044340963991	1	1	371	212	3	1	G
B10_BC22_191109_LF_LIB_consensus_vsearch	3476	A	A	591	4	0.66%	2	1	93	93	0.06218474176725347	1	1	380	211	4	0	G
B10_BC22_191109_LF_LIB_consensus_vsearch	3477	T	*/+A	574	11	1.83%	2	1	93	93	4.6566043808442384E-4	1	1	369	205	11	0	+A
B10_BC22_191109_LF_LIB_consensus_vsearch	3478	G	*/-A	581	13	2.17%	2	2	93	93	1.1423311528767137E-4	1	1	369	212	11	2	-A
B10_BC22_191109_LF_LIB_consensus_vsearch	3479	A	A	586	2	0.34%	2	1	93	93	0.24978723404299805	1	1	374	212	2	0	+G
B10_BC22_191109_LF_LIB_consensus_vsearch	3480	A	A	594	2	0.33%	2	1	93	93	0.24979009235977778	1	1	382	212	2	0	+C
B10_BC22_191109_LF_LIB_consensus_vsearch	3481	C	C	585	6	1%	2	1	93	93	0.015427050131369397	1	1	374	211	6	0	-T
B10_BC22_191109_LF_LIB_consensus_vsearch	3482	T	Y	572	12	2.03%	2	2	93	93	2.3059772017075368E-4	1	1	368	204	6	6	C
B10_BC22_191109_LF_LIB_consensus_vsearch	3483	A	A	588	5	0.84%	2	2	93	93	0.0309866212982286	1	1	377	211	4	1	G
B10_BC22_191109_LF_LIB_consensus_vsearch	3484	G	*/-C	551	26	4.35%	2	1	93	93	1.1172124416054001E-8	1	1	345	206	26	0	-C
B10_BC22_191109_LF_LIB_consensus_vsearch	3485	C	C	565	2	0.35%	2	1	93	93	0.24977934686699968	1	1	356	209	2	0	G
B10_BC22_191109_LF_LIB_consensus_vsearch	3486	C	C	597	2	0.33%	2	1	93	93	0.24979114452852993	1	1	384	213	2	0	+A
B10_BC22_191109_LF_LIB_consensus_vsearch	3487	C	*/-T	591	7	1.16%	2	2	93	93	0.007675784123381086	1	1	379	212	4	3	-T
B10_BC22_191109_LF_LIB_consensus_vsearch	3488	T	T	578	6	1.01%	2	2	93	93	0.015424681549082461	1	1	375	203	1	5	C
B10_BC22_191109_LF_LIB_consensus_vsearch	3489	G	*/-A	510	73	12.21%	2	2	93	93	9.556701361431345E-24	1	1	367	143	7	66	-A
B10_BC22_191109_LF_LIB_consensus_vsearch	3490	A	A	522	2	0.38%	2	1	93	93	0.24976122254010238	1	1	374	148	2	0	+G
B10_BC22_191109_LF_LIB_consensus_vsearch	3491	A	A	592	3	0.5%	2	1	93	93	0.1246846089151382	1	1	380	212	0	3	G
B10_BC22_191109_LF_LIB_consensus_vsearch	3492	A	A	600	2	0.33%	2	2	93	93	0.249792186200784	1	1	386	214	1	1	T
B10_BC22_191109_LF_LIB_consensus_vsearch	3493	A	A	599	2	0.33%	2	2	93	93	0.24979184013288794	1	1	385	214	1	1	G
B10_BC22_191109_LF_LIB_consensus_vsearch	3494	T	T	587	6	1%	2	2	93	93	0.015427716615850288	1	1	382	205	3	3	C
B10_BC22_191109_LF_LIB_consensus_vsearch	3495	G	G	592	1	0.17%	2	1	93	93	0.4999999999999138	1	1	385	207	1	0	+A
B10_BC22_191109_LF_LIB_consensus_vsearch	3496	G	G	601	1	0.17%	2	1	93	93	0.4999999999990043	1	1	388	213	0	1	C
B10_BC22_191109_LF_LIB_consensus_vsearch	3497	A	A	600	3	0.5%	2	2	93	93	0.12468879668066746	1	1	387	213	1	2	G
B10_BC22_191109_LF_LIB_consensus_vsearch	3498	T	T	594	4	0.66%	2	2	93	93	0.062186323989038686	1	1	386	208	1	3	C
B10_BC22_191109_LF_LIB_consensus_vsearch	3499	G	R	580	13	2.17%	2	2	93	93	1.1422019683041178E-4	1	1	371	209	12	1	A
B10_BC22_191109_LF_LIB_consensus_vsearch	3500	G	G	597	2	0.33%	2	1	93	93	0.24979114452852993	1	1	385	212	2	0	A
B10_BC22_191109_LF_LIB_consensus_vsearch	3501	C	*/+A	577	12	2%	2	1	93	93	2.3071056867786312E-4	1	1	369	208	12	0	+A
B10_BC22_191109_LF_LIB_consensus_vsearch	3502	G	R	585	9	1.51%	2	1	93	93	0.0018944129256754595	1	1	373	212	9	0	A
B10_BC22_191109_LF_LIB_consensus_vsearch	3503	C	*/-T	561	18	3.02%	2	2	93	93	3.3357728293002333E-6	1	1	369	192	2	16	-T
B10_BC22_191109_LF_LIB_consensus_vsearch	3504	T	T	566	2	0.35%	2	1	93	93	0.2497797356825117	1	1	369	197	2	0	A
B10_BC22_191109_LF_LIB_consensus_vsearch	3505	T	*/-A	545	21	3.57%	2	2	93	93	3.947412566388036E-7	1	1	353	192	13	8	-A
B10_BC22_191109_LF_LIB_consensus_vsearch	3506	A	A	562	4	0.7%	2	2	93	93	0.062168581853437176	1	1	370	192	2	2	C
B10_BC22_191109_LF_LIB_consensus_vsearch	3507	A	R	570	11	1.86%	2	2	93	93	4.6550699991566706E-4	1	1	378	192	9	2	G
B10_BC22_191109_LF_LIB_consensus_vsearch	3508	G	*/-C	577	8	1.33%	2	1	93	93	0.0038132873975118887	1	1	382	195	0	8	-C
B10_BC22_191109_LF_LIB_consensus_vsearch	3509	C	*/+T	572	7	1.18%	2	2	93	93	0.00767131340646626	1	1	383	189	1	6	+T
B10_BC22_191109_LF_LIB_consensus_vsearch	3510	G	*/-TG	574	7	1.18%	2	2	93	93	0.007671797729860669	1	1	375	199	2	5	-TG
B10_BC22_191109_LF_LIB_consensus_vsearch	3511	T	Y	574	11	1.85%	2	1	93	93	4.6566043808442384E-4	1	1	382	192	0	11	C
B10_BC22_191109_LF_LIB_consensus_vsearch	3512	G	R	560	27	4.55%	2	2	93	93	5.487004521479837E-9	1	1	358	202	26	1	A
B10_BC22_191109_LF_LIB_consensus_vsearch	3513	C	C	581	6	1%	2	2	93	93	0.015425703561055139	1	1	380	201	1	5	-T
B10_BC22_191109_LF_LIB_consensus_vsearch	3514	T	T	577	6	1.01%	2	2	93	93	0.01542433854516302	1	1	377	200	2	4	C
B10_BC22_191109_LF_LIB_consensus_vsearch	3515	A	*/-C	546	22	3.7%	2	2	93	93	1.9378459798667462E-7	1	1	342	204	16	6	-C
B10_BC22_191109_LF_LIB_consensus_vsearch	3516	C	*/+T	550	8	1.4%	2	1	93	93	0.003808815651854499	1	1	358	192	0	8	+T
B10_BC22_191109_LF_LIB_consensus_vsearch	3517	C	Y	570	8	1.35%	2	2	93	93	0.003812167942212529	1	1	368	202	4	4	T
B10_BC22_191109_LF_LIB_consensus_vsearch	3518	C	Y	558	18	3.01%	2	2	93	93	3.333406711322731E-6	1	1	362	196	7	11	T
B10_BC22_191109_LF_LIB_consensus_vsearch	3519	A	A	571	5	0.85%	2	1	93	93	0.030978851401829387	1	1	359	212	5	0	T
B10_BC22_191109_LF_LIB_consensus_vsearch	3520	T	Y	583	8	1.34%	2	2	93	93	0.0038142259421648926	1	1	377	206	5	3	C
B10_BC22_191109_LF_LIB_consensus_vsearch	3521	A	R	573	9	1.51%	2	2	93	93	0.0018932123374629899	1	1	368	205	8	1	G
B10_BC22_191109_LF_LIB_consensus_vsearch	3522	C	C	588	2	0.34%	2	1	93	93	0.2497879558944788	1	1	380	208	0	2	+T
B10_BC22_191109_LF_LIB_consensus_vsearch	3523	C	*/-T	558	25	4.15%	2	1	93	93	2.2914138250396737E-8	1	1	384	174	0	25	-T
B10_BC22_191109_LF_LIB_consensus_vsearch	3524	T	T	552	4	0.71%	2	2	93	93	0.06216261842595227	1	1	379	173	1	3	C
B10_BC22_191109_LF_LIB_consensus_vsearch	3525	C	C	582	1	0.17%	2	1	93	93	0.4999999999999138	1	1	383	199	0	1	+AA
B10_BC22_191109_LF_LIB_consensus_vsearch	3526	G	G	595	4	0.66%	2	2	93	93	0.062186847872822006	1	1	384	211	2	2	A
B10_BC22_191109_LF_LIB_consensus_vsearch	3527	C	C	597	1	0.17%	2	1	93	93	0.4999999999999138	1	1	385	212	0	1	+AT
B10_BC22_191109_LF_LIB_consensus_vsearch	3528	C	C	594	5	0.83%	2	2	93	93	0.03098925836211217	1	1	384	210	3	2	-GCC
B10_BC22_191109_LF_LIB_consensus_vsearch	3529	G	G	594	2	0.34%	2	2	93	93	0.24979009235977778	1	1	383	211	1	1	-C
B10_BC22_191109_LF_LIB_consensus_vsearch	3530	C	C	595	1	0.17%	2	1	93	93	0.4999999999999138	1	1	384	211	0	1	T
B10_BC22_191109_LF_LIB_consensus_vsearch	3531	C	C	591	4	0.67%	2	2	93	93	0.06218474176725347	1	1	381	210	2	2	-A
B10_BC22_191109_LF_LIB_consensus_vsearch	3532	A	*/-G	562	17	2.84%	2	2	93	93	6.772449818907221E-6	1	1	367	195	6	11	-G
B10_BC22_191109_LF_LIB_consensus_vsearch	3533	G	*/+A	572	7	1.2%	2	1	93	93	0.00767131340646626	1	1	372	200	7	0	+A
B10_BC22_191109_LF_LIB_consensus_vsearch	3534	G	*/+A	521	60	10%	2	1	93	93	1.740311126792606E-19	1	1	310	211	60	0	+A
B10_BC22_191109_LF_LIB_consensus_vsearch	3535	G	G	594	5	0.83%	2	2	93	93	0.03098925836211217	1	1	380	214	4	1	A
B10_BC22_191109_LF_LIB_consensus_vsearch	3536	T	*/-A	555	19	3.16%	2	2	93	93	1.6393715543553221E-6	1	1	345	210	15	4	-A
B10_BC22_191109_LF_LIB_consensus_vsearch	3537	A	*/+G	561	9	1.54%	2	2	93	93	0.0018919616270182597	1	1	355	206	7	2	+G
B10_BC22_191109_LF_LIB_consensus_vsearch	3538	G	*/-A	565	23	3.86%	2	2	93	93	9.573025140118971E-8	1	1	362	203	16	7	-A
B10_BC22_191109_LF_LIB_consensus_vsearch	3539	A	R	569	7	1.21%	2	2	93	93	0.007670580637356587	1	1	363	206	6	1	G
B10_BC22_191109_LF_LIB_consensus_vsearch	3540	A	A	603	0	0%	2	0	93	0	1.0	1	0	388	215	0	0	
B10_BC22_191109_LF_LIB_consensus_vsearch	3541	A	R	568	30	4.98%	2	2	93	93	6.414014859746018E-10	1	1	358	210	29	1	G
B10_BC22_191109_LF_LIB_consensus_vsearch	3542	C	C	594	3	0.5%	2	2	93	93	0.12468566638724124	1	1	382	212	2	1	T
B10_BC22_191109_LF_LIB_consensus_vsearch	3543	G	*/-A	568	30	4.99%	2	2	93	93	6.414014859746018E-10	1	1	354	214	29	1	-A
B10_BC22_191109_LF_LIB_consensus_vsearch	3544	A	A	562	3	0.53%	2	1	93	93	0.12466784765272246	1	1	350	212	3	0	G
B10_BC22_191109_LF_LIB_consensus_vsearch	3545	T	T	591	4	0.67%	2	2	93	93	0.06218474176725347	1	1	381	210	2	2	C
B10_BC22_191109_LF_LIB_consensus_vsearch	3546	G	*/-C	564	19	3.18%	2	2	93	93	1.643269896857881E-6	1	1	364	200	11	8	-C
B10_BC22_191109_LF_LIB_consensus_vsearch	3547	C	C	568	5	0.86%	2	1	93	93	0.03097743240611924	1	1	371	197	0	5	T
B10_BC22_191109_LF_LIB_consensus_vsearch	3548	C	C	591	5	0.83%	2	2	93	93	0.030987946464272845	1	1	383	208	1	4	T
B10_BC22_191109_LF_LIB_consensus_vsearch	3549	C	C	597	3	0.5%	2	2	93	93	0.12468723936635923	1	1	385	212	1	2	-T
B10_BC22_191109_LF_LIB_consensus_vsearch	3550	T	Y	578	14	2.33%	2	2	93	93	5.646967505352899E-5	1	1	384	194	2	12	C
B10_BC22_191109_LF_LIB_consensus_vsearch	3551	G	G	592	6	1%	2	2	93	93	0.01542936335614873	1	1	380	212	3	3	A
B10_BC22_191109_LF_LIB_consensus_vsearch	3552	G	G	598	2	0.33%	2	1	93	93	0.24979149291046765	1	1	386	212	0	2	-C
B10_BC22_191109_LF_LIB_consensus_vsearch	3553	C	*/-G	549	36	6.01%	2	1	93	93	8.350499645901173E-12	1	1	339	210	36	0	-G
B10_BC22_191109_LF_LIB_consensus_vsearch	3554	G	*/-A	544	12	2.12%	2	1	93	93	2.2992900204191565E-4	1	1	330	214	12	0	-A
B10_BC22_191109_LF_LIB_consensus_vsearch	3555	A	*/+G	571	9	1.53%	2	2	93	93	0.0018930074497425708	1	1	365	206	5	4	+G
B10_BC22_191109_LF_LIB_consensus_vsearch	3556	G	G	585	6	1%	2	2	93	93	0.015427050131369397	1	1	375	210	5	1	+AG
B10_BC22_191109_LF_LIB_consensus_vsearch	3557	T	Y	562	15	2.51%	2	2	93	93	2.783111683740202E-5	1	1	370	192	1	14	C
B10_BC22_191109_LF_LIB_consensus_vsearch	3558	A	*/+G	561	15	2.52%	2	2	93	93	2.782660779890985E-5	1	1	374	187	1	14	+G
B10_BC22_191109_LF_LIB_consensus_vsearch	3559	G	*/+A	582	7	1.18%	2	2	93	93	0.007673702245629301	1	1	374	208	5	2	+A
B10_BC22_191109_LF_LIB_consensus_vsearch	3560	G	G	586	6	1%	2	1	93	93	0.015427383935577244	1	1	376	210	6	0	+C
B10_BC22_191109_LF_LIB_consensus_vsearch	3561	C	*/+G	493	73	12.25%	2	1	93	93	8.845811169798923E-24	1	1	287	206	73	0	+G
B10_BC22_191109_LF_LIB_consensus_vsearch	3562	A	*/-G	467	64	10.88%	2	2	93	93	7.188455165787375E-21	1	1	265	202	61	3	-G
B10_BC22_191109_LF_LIB_consensus_vsearch	3563	G	*/+A	491	17	3.19%	2	1	93	93	6.658766873142193E-6	1	1	281	210	17	0	+A
B10_BC22_191109_LF_LIB_consensus_vsearch	3564	G	R	564	28	4.66%	2	1	93	93	2.686571365413896E-9	1	1	353	211	28	0	A
B10_BC22_191109_LF_LIB_consensus_vsearch	3565	C	C	585	4	0.67%	2	2	93	93	0.06218152895025356	1	1	377	208	3	1	T
B10_BC22_191109_LF_LIB_consensus_vsearch	3566	G	*/-TG	559	17	2.84%	2	2	93	93	6.768187150907897E-6	1	1	375	184	1	16	-TG
B10_BC22_191109_LF_LIB_consensus_vsearch	3567	T	*/-G	551	10	1.74%	2	2	93	93	9.378488845021741E-4	1	1	376	175	4	6	-G
B10_BC22_191109_LF_LIB_consensus_vsearch	3568	G	G	567	1	0.18%	2	1	93	93	0.4999999999999138	1	1	382	185	1	0	+TG
B10_BC22_191109_LF_LIB_consensus_vsearch	3569	G	G	587	6	1.01%	2	1	93	93	0.015427716615850288	1	1	379	208	6	0	-A
B10_BC22_191109_LF_LIB_consensus_vsearch	3570	A	*/-G	557	21	3.54%	2	2	93	93	3.963209982025283E-7	1	1	346	211	19	2	-G
B10_BC22_191109_LF_LIB_consensus_vsearch	3571	G	G	578	1	0.17%	2	1	93	93	0.4999999999990043	1	1	365	213	1	0	+AG
B10_BC22_191109_LF_LIB_consensus_vsearch	3572	G	G	596	3	0.5%	2	1	93	93	0.1246867167922604	1	1	383	213	3	0	+AG
B10_BC22_191109_LF_LIB_consensus_vsearch	3573	T	*/-C	557	27	4.49%	2	2	93	93	5.478187293804813E-9	1	1	346	211	26	1	-C
B10_BC22_191109_LF_LIB_consensus_vsearch	3574	C	C	573	2	0.35%	2	1	93	93	0.249782419495127	1	1	359	214	2	0	+A
B10_BC22_191109_LF_LIB_consensus_vsearch	3575	C	C	590	4	0.66%	2	1	93	93	0.062184210806914414	1	1	384	206	0	4	-G
B10_BC22_191109_LF_LIB_consensus_vsearch	3576	G	G	589	4	0.67%	2	2	93	93	0.06218367805512527	1	1	382	207	1	3	-T
B10_BC22_191109_LF_LIB_consensus_vsearch	3577	T	T	585	4	0.67%	2	1	93	93	0.06218152895025356	1	1	383	202	0	4	A
B10_BC22_191109_LF_LIB_consensus_vsearch	3578	G	G	591	3	0.5%	2	1	93	93	0.12468407750622149	1	1	383	208	0	3	C
B10_BC22_191109_LF_LIB_consensus_vsearch	3579	A	A	590	3	0.5%	2	1	93	93	0.12468354430400949	1	1	376	214	3	0	+C
B10_BC22_191109_LF_LIB_consensus_vsearch	3580	C	*/-G	573	13	2.17%	2	1	93	93	1.1412856168272655E-4	1	1	361	212	13	0	-G
B10_BC22_191109_LF_LIB_consensus_vsearch	3581	G	G	570	5	0.85%	2	2	93	93	0.030978380047692815	1	1	365	205	1	4	-AA
B10_BC22_191109_LF_LIB_consensus_vsearch	3582	A	A	579	6	1.01%	2	2	93	93	0.015425023382419913	1	1	376	203	5	1	G
B10_BC22_191109_LF_LIB_consensus_vsearch	3583	A	A	587	6	1.01%	2	2	93	93	0.015427716615850288	1	1	379	208	5	1	G
B10_BC22_191109_LF_LIB_consensus_vsearch	3584	G	R	588	7	1.17%	2	1	93	93	0.007675097138165556	1	1	377	211	7	0	A
B10_BC22_191109_LF_LIB_consensus_vsearch	3585	C	*/-TT	465	99	16.5%	2	2	93	93	1.4076783114196525E-32	1	1	361	104	11	88	-TT
B10_BC22_191109_LF_LIB_consensus_vsearch	3586	T	T	476	4	0.83%	2	2	93	93	0.06210917197567908	1	1	369	107	1	3	C
B10_BC22_191109_LF_LIB_consensus_vsearch	3587	T	T	494	2	0.4%	2	1	93	93	0.24974772956627841	1	1	372	122	2	0	A
B10_BC22_191109_LF_LIB_consensus_vsearch	3588	T	*/-C	453	59	9.9%	2	1	93	93	2.9452949840190594E-19	1	1	336	117	0	59	-C
B10_BC22_191109_LF_LIB_consensus_vsearch	3589	C	*/-G	397	37	7.23%	2	2	93	93	3.2653149759027558E-12	1	1	311	86	18	19	-G
B10_BC22_191109_LF_LIB_consensus_vsearch	3590	G	R	451	60	11.58%	2	2	93	93	1.3773376828605652E-19	1	1	306	145	59	1	A
B10_BC22_191109_LF_LIB_consensus_vsearch	3591	G	R	569	11	1.89%	2	2	93	93	4.654683146367026E-4	1	1	375	194	9	2	A
B10_BC22_191109_LF_LIB_consensus_vsearch	3592	G	*/+A	564	15	2.57%	2	1	93	93	2.784008976528302E-5	1	1	368	196	15	0	+A
B10_BC22_191109_LF_LIB_consensus_vsearch	3593	G	G	583	4	0.67%	2	1	93	93	0.06218044340963991	1	1	383	200	0	4	-T
B10_BC22_191109_LF_LIB_consensus_vsearch	3594	T	T	579	3	0.51%	2	1	93	93	0.12467755803936205	1	1	382	197	0	3	A
B10_BC22_191109_LF_LIB_consensus_vsearch	3595	G	G	589	3	0.5%	2	2	93	93	0.1246830092985462	1	1	384	205	1	2	A
B10_BC22_191109_LF_LIB_consensus_vsearch	3596	A	*/-C	561	20	3.33%	2	2	93	93	8.075558512578247E-7	1	1	359	202	11	9	-C
B10_BC22_191109_LF_LIB_consensus_vsearch	3597	C	C	563	4	0.7%	2	1	93	93	0.062169166621763194	1	1	363	200	0	4	+T
B10_BC22_191109_LF_LIB_consensus_vsearch	3598	C	C	584	2	0.34%	2	1	93	93	0.2497865072588101	1	1	373	211	0	2	+T
B10_BC22_191109_LF_LIB_consensus_vsearch	3599	C	*/-G	524	49	8.13%	2	2	93	93	6.081641678446412E-16	1	1	367	157	9	40	-G
B10_BC22_191109_LF_LIB_consensus_vsearch	3600	G	R	518	22	3.99%	2	1	93	93	1.9167084730168957E-7	1	1	352	166	22	0	A
B10_BC22_191109_LF_LIB_consensus_vsearch	3601	G	*/-A	533	52	8.67%	2	2	93	93	6.7825823557839E-17	1	1	323	210	51	1	-A
B10_BC22_191109_LF_LIB_consensus_vsearch	3602	A	A	530	5	0.92%	2	2	93	93	0.030958081679908694	1	1	321	209	4	1	+G
B10_BC22_191109_LF_LIB_consensus_vsearch	3603	G	*/-TAG	557	25	4.23%	2	1	93	93	2.2903568510906506E-8	1	1	375	182	0	25	-TAG
B10_BC22_191109_LF_LIB_consensus_vsearch	3604	T	*/+A	532	13	2.29%	2	1	93	93	1.1354574710143783E-4	1	1	360	172	13	0	+A
B10_BC22_191109_LF_LIB_consensus_vsearch	3605	A	R	542	11	1.94%	2	2	93	93	4.643717559554366E-4	1	1	362	180	10	1	G
B10_BC22_191109_LF_LIB_consensus_vsearch	3606	G	G	558	5	0.88%	2	1	93	93	0.03097259325215208	1	1	376	182	0	5	+A
B10_BC22_191109_LF_LIB_consensus_vsearch	3607	A	R	575	8	1.35%	2	2	93	93	0.0038129702806793094	1	1	362	213	6	2	G
B10_BC22_191109_LF_LIB_consensus_vsearch	3608	A	R	586	9	1.5%	2	2	93	93	0.0018945108065208946	1	1	372	214	8	1	G
B10_BC22_191109_LF_LIB_consensus_vsearch	3609	C	C	586	5	0.84%	2	2	93	93	0.030985730383315414	1	1	378	208	2	3	-G
B10_BC22_191109_LF_LIB_consensus_vsearch	3610	G	G	587	6	1.01%	2	1	93	93	0.015427716615850288	1	1	376	211	6	0	A
B10_BC22_191109_LF_LIB_consensus_vsearch	3611	G	*/-C	566	21	3.49%	2	2	93	93	3.974665915070485E-7	1	1	378	188	2	19	-C
B10_BC22_191109_LF_LIB_consensus_vsearch	3612	C	C	571	6	1.04%	2	2	93	93	0.015422255598111148	1	1	382	189	1	5	+T
B10_BC22_191109_LF_LIB_consensus_vsearch	3613	C	*/-T	580	15	2.5%	2	1	93	93	2.790977291101727E-5	1	1	385	195	0	15	-T
B10_BC22_191109_LF_LIB_consensus_vsearch	3614	T	*/+C	562	11	1.87%	2	1	93	93	4.6519379419598136E-4	1	1	374	188	11	0	+C
B10_BC22_191109_LF_LIB_consensus_vsearch	3615	C	*/-T	570	22	3.69%	2	2	93	93	1.954504511336083E-7	1	1	381	189	3	19	-T
B10_BC22_191109_LF_LIB_consensus_vsearch	3616	T	*/+G	551	13	2.26%	2	1	93	93	1.1382611337590673E-4	1	1	363	188	13	0	+G
B10_BC22_191109_LF_LIB_consensus_vsearch	3617	A	R	579	13	2.16%	2	1	93	93	1.1420723572987618E-4	1	1	369	210	13	0	G
B10_BC22_191109_LF_LIB_consensus_vsearch	3618	G	*/-TG	580	10	1.68%	2	1	93	93	9.39730591623294E-4	1	1	381	199	0	10	-TG
B10_BC22_191109_LF_LIB_consensus_vsearch	3619	T	T	586	3	0.51%	2	2	93	93	0.12468139337307069	1	1	387	199	1	2	-G
B10_BC22_191109_LF_LIB_consensus_vsearch	3620	G	G	576	4	0.68%	2	2	93	93	0.0621765850361776	1	1	377	199	1	3	-CAG
B10_BC22_191109_LF_LIB_consensus_vsearch	3621	C	*/+G	575	14	2.35%	2	1	93	93	5.6447057855957204E-5	1	1	366	209	14	0	+G
B10_BC22_191109_LF_LIB_consensus_vsearch	3622	A	*/-G	574	12	2.01%	2	1	93	93	2.3064308632724596E-4	1	1	367	207	12	0	-G
B10_BC22_191109_LF_LIB_consensus_vsearch	3623	G	G	583	1	0.17%	2	1	93	93	0.4999999999999138	1	1	373	210	1	0	-A
B10_BC22_191109_LF_LIB_consensus_vsearch	3624	A	A	593	3	0.5%	2	1	93	93	0.12468513853935516	1	1	381	212	3	0	G
B10_BC22_191109_LF_LIB_consensus_vsearch	3625	T	T	595	2	0.33%	2	1	93	93	0.24979044425840527	1	1	381	214	2	0	C
B10_BC22_191109_LF_LIB_consensus_vsearch	3626	C	*/-T	583	14	2.33%	2	1	93	93	5.650687914175413E-5	1	1	383	200	0	14	-T
B10_BC22_191109_LF_LIB_consensus_vsearch	3627	T	T	578	5	0.85%	2	1	93	93	0.030982105624386143	1	1	378	200	5	0	C
B10_BC22_191109_LF_LIB_consensus_vsearch	3628	T	*/+A	567	13	2.17%	2	1	93	93	1.1404829797726498E-4	1	1	367	200	13	0	+A
B10_BC22_191109_LF_LIB_consensus_vsearch	3629	G	R	525	51	8.6%	2	1	93	93	1.3950597368151002E-16	1	1	321	204	51	0	A
B10_BC22_191109_LF_LIB_consensus_vsearch	3630	G	K	575	19	3.17%	2	1	93	93	1.647883484990673E-6	1	1	364	211	19	0	T
B10_BC22_191109_LF_LIB_consensus_vsearch	3631	T	*/-GGT	574	13	2.17%	2	2	93	93	1.1414178313129473E-4	1	1	378	196	1	12	-GGT
B10_BC22_191109_LF_LIB_consensus_vsearch	3632	G	R	563	11	1.9%	2	1	93	93	4.652334151374629E-4	1	1	365	198	11	0	A
B10_BC22_191109_LF_LIB_consensus_vsearch	3633	G	G	580	4	0.68%	2	1	93	93	0.06217880115194425	1	1	379	201	4	0	T
B10_BC22_191109_LF_LIB_consensus_vsearch	3634	T	T	570	5	0.85%	2	2	93	93	0.030978380047692815	1	1	375	195	2	3	C
B10_BC22_191109_LF_LIB_consensus_vsearch	3635	A	A	591	2	0.33%	2	1	93	93	0.24978902953563295	1	1	381	210	0	2	+G
B10_BC22_191109_LF_LIB_consensus_vsearch	3636	G	R	577	10	1.66%	2	2	93	93	9.395444569434851E-4	1	1	369	208	9	1	A
B10_BC22_191109_LF_LIB_consensus_vsearch	3637	T	*/+A	571	10	1.69%	2	1	93	93	9.391664866947025E-4	1	1	365	206	10	0	+A
B10_BC22_191109_LF_LIB_consensus_vsearch	3638	A	A	574	6	1.02%	2	1	93	93	0.01542330244911806	1	1	370	204	6	0	G
B10_BC22_191109_LF_LIB_consensus_vsearch	3639	G	R	572	8	1.36%	2	1	93	93	0.0038124905281564036	1	1	367	205	8	0	A
B10_BC22_191109_LF_LIB_consensus_vsearch	3640	C	*/-A	549	27	4.52%	2	2	93	93	5.454286524831224E-9	1	1	372	177	4	23	-A
B10_BC22_191109_LF_LIB_consensus_vsearch	3641	A	A	569	4	0.7%	2	2	93	93	0.06217263235112447	1	1	380	189	3	1	G
B10_BC22_191109_LF_LIB_consensus_vsearch	3642	A	A	596	3	0.5%	2	1	93	93	0.1246867167922604	1	1	384	212	0	3	C
B10_BC22_191109_LF_LIB_consensus_vsearch	3643	A	A	591	6	1%	2	2	93	93	0.015429036211008771	1	1	381	210	5	1	G
B10_BC22_191109_LF_LIB_consensus_vsearch	3644	T	Y	569	21	3.51%	2	2	93	93	3.978412670926488E-7	1	1	381	188	1	20	C
B10_BC22_191109_LF_LIB_consensus_vsearch	3645	A	R	569	14	2.35%	2	1	93	93	5.640114481653746E-5	1	1	366	203	14	0	G
B10_BC22_191109_LF_LIB_consensus_vsearch	3646	C	*/-T	548	38	6.4%	2	2	93	93	1.957482624084725E-12	1	1	381	167	3	35	-T
B10_BC22_191109_LF_LIB_consensus_vsearch	3647	T	*/-C	539	10	1.77%	2	2	93	93	9.370127995938237E-4	1	1	373	166	2	8	-C
B10_BC22_191109_LF_LIB_consensus_vsearch	3648	C	*/-A	570	11	1.86%	2	2	93	93	4.6550699991566706E-4	1	1	376	194	8	3	-A
B10_BC22_191109_LF_LIB_consensus_vsearch	3649	A	A	583	4	0.68%	2	1	93	93	0.06218044340963991	1	1	373	210	4	0	G
B10_BC22_191109_LF_LIB_consensus_vsearch	3650	A	A	595	4	0.66%	2	1	93	93	0.062186847872822006	1	1	382	213	4	0	G
B10_BC22_191109_LF_LIB_consensus_vsearch	3651	A	R	587	11	1.83%	2	1	93	93	4.661451415700126E-4	1	1	376	211	11	0	G
B10_BC22_191109_LF_LIB_consensus_vsearch	3652	T	*/+A	583	9	1.5%	2	1	93	93	0.0018942161800671361	1	1	374	209	9	0	+A
B10_BC22_191109_LF_LIB_consensus_vsearch	3653	G	G	594	3	0.5%	2	2	93	93	0.12468566638724124	1	1	381	213	1	2	C
B10_BC22_191109_LF_LIB_consensus_vsearch	3654	A	*/+G	578	11	1.83%	2	1	93	93	4.658118229180549E-4	1	1	364	214	11	0	+G
B10_BC22_191109_LF_LIB_consensus_vsearch	3655	G	G	596	1	0.17%	2	1	93	93	0.4999999999999138	1	1	382	214	1	0	+A
B10_BC22_191109_LF_LIB_consensus_vsearch	3656	A	A	593	3	0.5%	2	2	93	93	0.12468513853935516	1	1	380	213	2	1	G
B10_BC22_191109_LF_LIB_consensus_vsearch	3657	A	R	593	8	1.33%	2	2	93	93	0.0038157487685222483	1	1	381	212	6	2	G
B10_BC22_191109_LF_LIB_consensus_vsearch	3658	C	C	582	6	1%	2	1	93	93	0.015426041918236095	1	1	379	203	0	6	-T
B10_BC22_191109_LF_LIB_consensus_vsearch	3659	T	T	582	4	0.68%	2	2	93	93	0.0621798978595429	1	1	379	203	2	2	C
B10_BC22_191109_LF_LIB_consensus_vsearch	3660	T	T	594	2	0.34%	2	2	93	93	0.24979009235977778	1	1	382	212	1	1	C
B10_BC22_191109_LF_LIB_consensus_vsearch	3661	T	*/+G	587	11	1.83%	2	2	93	93	4.661451415700126E-4	1	1	383	204	1	10	+G
B10_BC22_191109_LF_LIB_consensus_vsearch	3662	G	G	597	2	0.33%	2	1	93	93	0.24979114452852993	1	1	382	215	2	0	+TG
B10_BC22_191109_LF_LIB_consensus_vsearch	3663	A	*/+G	575	13	2.16%	2	2	93	93	1.14154960647074E-4	1	1	370	205	9	4	+G
B10_BC22_191109_LF_LIB_consensus_vsearch	3664	G	G	588	2	0.34%	2	1	93	93	0.2497879558944788	1	1	378	210	2	0	+A
B10_BC22_191109_LF_LIB_consensus_vsearch	3665	G	G	599	4	0.66%	2	1	93	93	0.062188926025119017	1	1	384	215	4	0	-A
B10_BC22_191109_LF_LIB_consensus_vsearch	3666	A	A	596	1	0.17%	2	1	93	93	0.4999999999999138	1	1	384	212	0	1	+C
B10_BC22_191109_LF_LIB_consensus_vsearch	3667	C	C	594	5	0.83%	2	2	93	93	0.03098925836211217	1	1	383	211	4	1	T
B10_BC22_191109_LF_LIB_consensus_vsearch	3668	T	*/+G	574	12	2%	2	2	93	93	2.3064308632724596E-4	1	1	377	197	5	7	+G
B10_BC22_191109_LF_LIB_consensus_vsearch	3669	G	G	590	2	0.33%	2	1	93	93	0.2497886728654613	1	1	380	210	2	0	+A
B10_BC22_191109_LF_LIB_consensus_vsearch	3670	A	A	590	5	0.84%	2	2	93	93	0.030987506226370864	1	1	381	209	4	1	G
B10_BC22_191109_LF_LIB_consensus_vsearch	3671	A	A	593	3	0.5%	2	2	93	93	0.12468513853935516	1	1	385	208	2	1	G
B10_BC22_191109_LF_LIB_consensus_vsearch	3672	G	*/-T	581	11	1.83%	2	1	93	93	4.659240387073297E-4	1	1	384	197	0	11	-T
B10_BC22_191109_LF_LIB_consensus_vsearch	3673	T	*/-G	449	77	13.1%	2	2	93	93	3.2861803103369315E-25	1	1	297	152	51	26	-G
B10_BC22_191109_LF_LIB_consensus_vsearch	3674	G	*/+A	494	8	1.57%	2	1	93	93	0.003798017550142225	1	1	312	182	8	0	+A
B10_BC22_191109_LF_LIB_consensus_vsearch	3675	G	R	567	12	2.04%	2	1	93	93	2.3048295964434314E-4	1	1	362	205	12	0	A
B10_BC22_191109_LF_LIB_consensus_vsearch	3676	G	G	591	5	0.83%	2	2	93	93	0.030987946464272845	1	1	382	209	4	1	A
B10_BC22_191109_LF_LIB_consensus_vsearch	3677	G	*/-A	552	36	5.97%	2	2	93	93	8.374942426240958E-12	1	1	346	206	32	4	-A
B10_BC22_191109_LF_LIB_consensus_vsearch	3678	A	A	561	1	0.18%	2	1	93	93	0.4999999999999138	1	1	354	207	1	0	+GA
B10_BC22_191109_LF_LIB_consensus_vsearch	3679	A	A	597	2	0.33%	2	2	93	93	0.24979114452852993	1	1	386	211	1	1	G
B10_BC22_191109_LF_LIB_consensus_vsearch	3680	A	A	592	4	0.66%	2	2	93	93	0.06218527094514562	1	1	382	210	3	1	-G
B10_BC22_191109_LF_LIB_consensus_vsearch	3681	G	G	594	2	0.33%	2	1	93	93	0.24979009235977778	1	1	384	210	0	2	T
B10_BC22_191109_LF_LIB_consensus_vsearch	3682	G	G	589	5	0.83%	2	2	93	93	0.030987064506852544	1	1	380	209	2	3	-T
B10_BC22_191109_LF_LIB_consensus_vsearch	3683	T	T	589	4	0.67%	2	1	93	93	0.06218367805512527	1	1	385	204	0	4	+C
B10_BC22_191109_LF_LIB_consensus_vsearch	3684	T	*/-C	580	11	1.83%	2	2	93	93	4.658867581677564E-4	1	1	375	205	7	4	-C
B10_BC22_191109_LF_LIB_consensus_vsearch	3685	C	C	588	3	0.51%	2	1	93	93	0.12468247248078299	1	1	377	211	3	0	T
B10_BC22_191109_LF_LIB_consensus_vsearch	3686	C	C	584	6	1%	2	2	93	93	0.015426715197547503	1	1	383	201	1	5	-G
B10_BC22_191109_LF_LIB_consensus_vsearch	3687	G	G	583	4	0.67%	2	1	93	93	0.06218044340963991	1	1	379	204	4	0	+A
B10_BC22_191109_LF_LIB_consensus_vsearch	3688	T	Y	582	7	1.17%	2	2	93	93	0.007673702245629301	1	1	382	200	3	4	C
B10_BC22_191109_LF_LIB_consensus_vsearch	3689	G	*/-TG	557	32	5.36%	2	2	93	93	1.5105378542671882E-10	1	1	371	186	14	18	-TG
B10_BC22_191109_LF_LIB_consensus_vsearch	3690	T	*/+A	540	7	1.24%	2	2	93	93	0.007663084355008458	1	1	360	180	6	1	+A
B10_BC22_191109_LF_LIB_consensus_vsearch	3691	G	*/-A	545	7	1.23%	2	2	93	93	0.007664432804486939	1	1	362	183	6	1	-A
B10_BC22_191109_LF_LIB_consensus_vsearch	3692	A	A	588	2	0.34%	2	1	93	93	0.2497879558944788	1	1	376	212	2	0	+G
B10_BC22_191109_LF_LIB_consensus_vsearch	3693	A	A	592	3	0.5%	2	1	93	93	0.1246846089151382	1	1	380	212	3	0	G
B10_BC22_191109_LF_LIB_consensus_vsearch	3694	C	C	590	2	0.33%	2	2	93	93	0.2497886728654613	1	1	379	211	1	1	+G
B10_BC22_191109_LF_LIB_consensus_vsearch	3695	A	W	588	7	1.17%	2	2	93	93	0.007675097138165556	1	1	377	211	5	2	T
B10_BC22_191109_LF_LIB_consensus_vsearch	3696	G	R	583	10	1.67%	2	2	93	93	9.399148640318375E-4	1	1	374	209	9	1	A
B10_BC22_191109_LF_LIB_consensus_vsearch	3697	C	C	580	3	0.5%	2	1	93	93	0.12467811158812642	1	1	371	209	3	0	+AAC
B10_BC22_191109_LF_LIB_consensus_vsearch	3698	A	A	584	5	0.84%	2	2	93	93	0.030984833420659205	1	1	372	212	3	2	T
B10_BC22_191109_LF_LIB_consensus_vsearch	3699	G	G	589	4	0.67%	2	1	93	93	0.06218367805512527	1	1	377	212	4	0	+A
B10_BC22_191109_LF_LIB_consensus_vsearch	3700	T	Y	585	16	2.66%	2	2	93	93	1.3790983552186495E-5	1	1	384	201	2	14	C
B10_BC22_191109_LF_LIB_consensus_vsearch	3701	T	*/-G	581	17	2.83%	2	2	93	93	6.7984976718225545E-6	1	1	383	198	1	16	-G
B10_BC22_191109_LF_LIB_consensus_vsearch	3702	G	G	585	1	0.17%	2	1	93	93	0.5000000000008233	1	1	386	199	1	0	+A
B10_BC22_191109_LF_LIB_consensus_vsearch	3703	G	G	599	2	0.33%	2	2	93	93	0.24979184013288794	1	1	385	214	1	1	A
B10_BC22_191109_LF_LIB_consensus_vsearch	3704	A	A	595	5	0.83%	2	1	93	93	0.03098969274732699	1	1	381	214	5	0	G
B10_BC22_191109_LF_LIB_consensus_vsearch	3705	C	C	589	4	0.66%	2	1	93	93	0.06218367805512527	1	1	377	212	4	0	-AC
B10_BC22_191109_LF_LIB_consensus_vsearch	3706	A	R	579	9	1.51%	2	2	93	93	0.0018938187066465067	1	1	367	212	7	2	G
B10_BC22_191109_LF_LIB_consensus_vsearch	3707	C	*/-G	556	18	3.02%	2	2	93	93	3.331816288518551E-6	1	1	369	187	7	11	-G
B10_BC22_191109_LF_LIB_consensus_vsearch	3708	G	R	527	45	7.77%	2	2	93	93	1.1547837945614171E-14	1	1	333	194	43	2	A
B10_BC22_191109_LF_LIB_consensus_vsearch	3709	G	*/+A	569	23	3.84%	2	1	93	93	9.587500614964659E-8	1	1	361	208	23	0	+A
B10_BC22_191109_LF_LIB_consensus_vsearch	3710	G	G	591	4	0.66%	2	1	93	93	0.06218474176725347	1	1	384	207	0	4	-TTAG
B10_BC22_191109_LF_LIB_consensus_vsearch	3711	T	Y	587	8	1.34%	2	2	93	93	0.003814841181091788	1	1	386	201	2	6	C
B10_BC22_191109_LF_LIB_consensus_vsearch	3712	T	*/+G	570	12	2.01%	2	2	93	93	2.3055204810949474E-4	1	1	373	197	11	1	+G
B10_BC22_191109_LF_LIB_consensus_vsearch	3713	A	R	562	18	3.04%	2	2	93	93	3.3365563818796594E-6	1	1	372	190	10	8	G
B10_BC22_191109_LF_LIB_consensus_vsearch	3714	G	R	574	10	1.7%	2	2	93	93	9.393564316164558E-4	1	1	379	195	3	7	A
B10_BC22_191109_LF_LIB_consensus_vsearch	3715	T	*/-C	584	11	1.83%	2	2	93	93	4.660351394123344E-4	1	1	383	201	3	8	-C
B10_BC22_191109_LF_LIB_consensus_vsearch	3716	C	C	584	4	0.68%	2	2	93	93	0.062180987103355005	1	1	380	204	1	3	+A
B10_BC22_191109_LF_LIB_consensus_vsearch	3717	G	G	592	5	0.83%	2	1	93	93	0.03098838522787931	1	1	380	212	5	0	-A
B10_BC22_191109_LF_LIB_consensus_vsearch	3718	A	A	591	3	0.5%	2	1	93	93	0.12468407750622149	1	1	378	213	3	0	G
B10_BC22_191109_LF_LIB_consensus_vsearch	3719	T	*/-C	398	192	32%	2	1	93	93	1.2451312180592046E-66	1	1	184	214	192	0	-C
B10_BC22_191109_LF_LIB_consensus_vsearch	3720	C	C	404	2	0.49%	2	1	93	93	0.24969173859492816	1	1	190	214	2	0	T
B10_BC22_191109_LF_LIB_consensus_vsearch	3721	C	C	589	5	0.83%	2	2	93	93	0.030987064506852544	1	1	382	207	2	3	-TAA
B10_BC22_191109_LF_LIB_consensus_vsearch	3722	T	*/-A	564	11	1.86%	2	2	93	93	4.6527290034786725E-4	1	1	370	194	8	3	-A
B10_BC22_191109_LF_LIB_consensus_vsearch	3723	A	A	570	6	1.03%	2	2	93	93	0.015421904228749098	1	1	371	199	2	4	G
B10_BC22_191109_LF_LIB_consensus_vsearch	3724	A	R	570	11	1.85%	2	2	93	93	4.6550699991566706E-4	1	1	373	197	3	8	G
B10_BC22_191109_LF_LIB_consensus_vsearch	3725	G	G	581	6	1.01%	2	2	93	93	0.015425703561055139	1	1	370	211	5	1	A
B10_BC22_191109_LF_LIB_consensus_vsearch	3726	C	C	584	6	1.01%	2	2	93	93	0.015426715197547503	1	1	376	208	1	5	T
B10_BC22_191109_LF_LIB_consensus_vsearch	3727	C	C	582	6	1%	2	1	93	93	0.015426041918236095	1	1	368	214	6	0	-ATA
B10_BC22_191109_LF_LIB_consensus_vsearch	3728	A	A	574	5	0.84%	2	1	93	93	0.030980255699410347	1	1	365	209	5	0	C
B10_BC22_191109_LF_LIB_consensus_vsearch	3729	T	*/-A	546	15	2.55%	2	1	93	93	2.7757110370314073E-5	1	1	338	208	15	0	-A
B10_BC22_191109_LF_LIB_consensus_vsearch	3730	A	*/-G	381	137	24.29%	2	2	93	93	1.7520183108396815E-46	1	1	241	140	78	59	-G
B10_BC22_191109_LF_LIB_consensus_vsearch	3731	G	G	420	6	1.4%	2	1	93	93	0.01535056152092204	1	1	269	151	6	0	A
B10_BC22_191109_LF_LIB_consensus_vsearch	3732	G	G	569	3	0.52%	2	1	93	93	0.12467191601031084	1	1	357	212	3	0	A
B10_BC22_191109_LF_LIB_consensus_vsearch	3733	G	*/-A	592	7	1.16%	2	2	93	93	0.007676011594473652	1	1	382	210	3	4	-A
B10_BC22_191109_LF_LIB_consensus_vsearch	3734	A	A	594	0	0%	2	0	93	0	1.0	1	0	383	211	0	0	
B10_BC22_191109_LF_LIB_consensus_vsearch	3735	A	A	595	4	0.67%	2	2	93	93	0.062186847872822006	1	1	383	212	3	1	G
B10_BC22_191109_LF_LIB_consensus_vsearch	3736	A	*/-T	584	7	1.16%	2	2	93	93	0.007674170345963	1	1	384	200	1	6	-T
B10_BC22_191109_LF_LIB_consensus_vsearch	3737	T	T	584	4	0.68%	2	1	93	93	0.062180987103355005	1	1	386	198	0	4	+C
B10_BC22_191109_LF_LIB_consensus_vsearch	3738	T	*/+C	567	20	3.34%	2	2	93	93	8.089531686060739E-7	1	1	362	205	19	1	+C
B10_BC22_191109_LF_LIB_consensus_vsearch	3739	C	C	587	3	0.51%	2	2	93	93	0.12468193384235185	1	1	379	208	1	2	G
B10_BC22_191109_LF_LIB_consensus_vsearch	3740	C	Y	578	9	1.49%	2	2	93	93	0.001893718498855406	1	1	383	195	1	8	T
B10_BC22_191109_LF_LIB_consensus_vsearch	3741	G	*/-T	510	55	9.18%	2	2	93	93	6.973326810175675E-18	1	1	324	186	35	20	-T
B10_BC22_191109_LF_LIB_consensus_vsearch	3742	T	T	533	5	0.92%	2	2	93	93	0.03095970870624187	1	1	348	185	1	4	C
B10_BC22_191109_LF_LIB_consensus_vsearch	3743	T	T	593	3	0.5%	2	2	93	93	0.12468513853935516	1	1	385	208	2	1	C
B10_BC22_191109_LF_LIB_consensus_vsearch	3744	T	T	597	1	0.17%	2	1	93	93	0.4999999999999138	1	1	386	211	1	0	+G
B10_BC22_191109_LF_LIB_consensus_vsearch	3745	T	*/+A	524	26	4.33%	2	2	93	93	1.1011548186548613E-8	1	1	333	191	25	1	+A
B10_BC22_191109_LF_LIB_consensus_vsearch	3746	A	A	559	4	0.7%	2	2	93	93	0.062166815078796796	1	1	365	194	1	3	G
B10_BC22_191109_LF_LIB_consensus_vsearch	3747	A	A	577	6	1.01%	2	1	93	93	0.01542433854516302	1	1	381	196	0	6	C
B10_BC22_191109_LF_LIB_consensus_vsearch	3748	A	A	585	4	0.67%	2	1	93	93	0.06218152895025356	1	1	381	204	4	0	-G
B10_BC22_191109_LF_LIB_consensus_vsearch	3749	G	K	575	10	1.68%	2	1	93	93	9.394193185721279E-4	1	1	367	208	10	0	T
B10_BC22_191109_LF_LIB_consensus_vsearch	3750	T	Y	566	12	2.02%	2	2	93	93	2.3045977381397776E-4	1	1	374	192	2	10	C
B10_BC22_191109_LF_LIB_consensus_vsearch	3751	G	G	574	5	0.85%	2	2	93	93	0.030980255699410347	1	1	368	206	4	1	A
B10_BC22_191109_LF_LIB_consensus_vsearch	3752	C	Y	570	10	1.68%	2	2	93	93	9.39102740052465E-4	1	1	370	200	8	2	T
B10_BC22_191109_LF_LIB_consensus_vsearch	3753	A	A	565	6	1.01%	2	1	93	93	0.015420128954288594	1	1	375	190	0	6	+T
B10_BC22_191109_LF_LIB_consensus_vsearch	3754	C	*/-A	531	29	4.87%	2	2	93	93	1.2840128699899644E-9	1	1	338	193	28	1	-A
B10_BC22_191109_LF_LIB_consensus_vsearch	3755	A	A	538	6	1.08%	2	1	93	93	0.015409979615446455	1	1	332	206	6	0	T
B10_BC22_191109_LF_LIB_consensus_vsearch	3756	C	*/-T	518	50	8.59%	2	2	93	93	2.875247733802356E-16	1	1	366	152	5	45	-T
B10_BC22_191109_LF_LIB_consensus_vsearch	3757	T	*/+C	487	40	7.27%	2	1	93	93	4.215099413012498E-13	1	1	330	157	40	0	+C
B10_BC22_191109_LF_LIB_consensus_vsearch	3758	C	Y	575	7	1.2%	2	2	93	93	0.007672038647635164	1	1	379	196	1	6	T
B10_BC22_191109_LF_LIB_consensus_vsearch	3759	C	*/+A	530	26	4.34%	2	2	93	93	1.1048405468771383E-8	1	1	358	172	23	3	+A
B10_BC22_191109_LF_LIB_consensus_vsearch	3760	G	K	555	24	4.01%	2	1	93	93	4.6732375075825604E-8	1	1	353	202	24	0	T
B10_BC22_191109_LF_LIB_consensus_vsearch	3761	T	W	579	8	1.34%	2	1	93	93	0.003813602365568841	1	1	378	201	0	8	A
B10_BC22_191109_LF_LIB_consensus_vsearch	3762	G	R	579	8	1.35%	2	2	93	93	0.003813602365568841	1	1	369	210	7	1	A
B10_BC22_191109_LF_LIB_consensus_vsearch	3763	C	C	591	4	0.67%	2	2	93	93	0.06218474176725347	1	1	378	213	2	2	A
B10_BC22_191109_LF_LIB_consensus_vsearch	3764	C	C	587	6	1%	2	2	93	93	0.015427716615850288	1	1	375	212	3	3	T
B10_BC22_191109_LF_LIB_consensus_vsearch	3765	G	*/+C	573	13	2.17%	2	1	93	93	1.1412856168272655E-4	1	1	361	212	13	0	+C
B10_BC22_191109_LF_LIB_consensus_vsearch	3766	C	C	590	2	0.34%	2	1	93	93	0.2497886728654613	1	1	376	214	2	0	T
B10_BC22_191109_LF_LIB_consensus_vsearch	3767	C	C	596	1	0.17%	2	1	93	93	0.4999999999999138	1	1	383	213	0	1	+GCC
B10_BC22_191109_LF_LIB_consensus_vsearch	3768	C	Y	587	8	1.33%	2	2	93	93	0.003814841181091788	1	1	382	205	1	7	T
B10_BC22_191109_LF_LIB_consensus_vsearch	3769	G	G	596	4	0.67%	2	1	93	93	0.062187370009836374	1	1	381	215	4	0	A
B10_BC22_191109_LF_LIB_consensus_vsearch	3770	G	G	597	4	0.66%	2	2	93	93	0.062187890408182296	1	1	384	213	2	2	A
B10_BC22_191109_LF_LIB_consensus_vsearch	3771	C	*/+A	581	9	1.5%	2	2	93	93	0.0018940181115188759	1	1	368	213	8	1	+A
B10_BC22_191109_LF_LIB_consensus_vsearch	3772	G	*/-A	501	43	7.2%	2	2	93	93	4.7918816435215765E-14	1	1	296	205	40	3	-A
B10_BC22_191109_LF_LIB_consensus_vsearch	3773	A	A	532	3	0.56%	2	1	93	93	0.12464920486402759	1	1	323	209	3	0	T
B10_BC22_191109_LF_LIB_consensus_vsearch	3774	A	A	574	6	1.03%	2	2	93	93	0.01542330244911806	1	1	364	210	3	3	G
B10_BC22_191109_LF_LIB_consensus_vsearch	3775	A	*/-G	356	180	30%	2	2	93	93	8.349938971402993E-63	1	1	166	190	159	21	-G
B10_BC22_191109_LF_LIB_consensus_vsearch	3776	G	R	324	28	7.73%	2	2	93	93	2.130236132985742E-9	1	1	142	182	27	1	A
B10_BC22_191109_LF_LIB_consensus_vsearch	3777	G	G	534	4	0.74%	2	1	93	93	0.06215132534293568	1	1	322	212	4	0	A
B10_BC22_191109_LF_LIB_consensus_vsearch	3778	G	*/-A	559	13	2.2%	2	2	93	93	1.1393872252603484E-4	1	1	364	195	6	7	-A
B10_BC22_191109_LF_LIB_consensus_vsearch	3779	A	A	568	5	0.87%	2	2	93	93	0.03097743240611924	1	1	365	203	1	4	G
B10_BC22_191109_LF_LIB_consensus_vsearch	3780	A	A	585	3	0.51%	2	1	93	93	0.1246808510636648	1	1	371	214	3	0	G
B10_BC22_191109_LF_LIB_consensus_vsearch	3781	A	*/-C	564	16	2.69%	2	2	93	93	1.3739888995429954E-5	1	1	354	210	13	3	-C
B10_BC22_191109_LF_LIB_consensus_vsearch	3782	C	C	583	1	0.17%	2	1	93	93	0.4999999999999138	1	1	371	212	1	0	+T
B10_BC22_191109_LF_LIB_consensus_vsearch	3783	C	*/-G	582	7	1.16%	2	2	93	93	0.007673702245629301	1	1	378	204	1	6	-G
B10_BC22_191109_LF_LIB_consensus_vsearch	3784	G	R	582	7	1.18%	2	1	93	93	0.007673702245629301	1	1	374	208	7	0	A
B10_BC22_191109_LF_LIB_consensus_vsearch	3785	G	G	586	6	1%	2	1	93	93	0.015427383935577244	1	1	374	212	6	0	T
B10_BC22_191109_LF_LIB_consensus_vsearch	3786	T	T	592	4	0.67%	2	2	93	93	0.06218527094514562	1	1	382	210	2	2	C
B10_BC22_191109_LF_LIB_consensus_vsearch	3787	T	T	590	4	0.67%	2	1	93	93	0.062184210806914414	1	1	379	211	4	0	-A
B10_BC22_191109_LF_LIB_consensus_vsearch	3788	A	A	593	2	0.34%	2	1	93	93	0.24978973927711676	1	1	381	212	0	2	C
B10_BC22_191109_LF_LIB_consensus_vsearch	3789	A	R	589	8	1.33%	2	2	93	93	0.003815145726019033	1	1	378	211	7	1	G
B10_BC22_191109_LF_LIB_consensus_vsearch	3790	C	C	594	3	0.5%	2	1	93	93	0.12468566638724124	1	1	380	214	3	0	-A
B10_BC22_191109_LF_LIB_consensus_vsearch	3791	A	A	592	4	0.67%	2	1	93	93	0.06218527094514562	1	1	378	214	4	0	G
B10_BC22_191109_LF_LIB_consensus_vsearch	3792	T	T	596	2	0.33%	2	1	93	93	0.24979079497935539	1	1	382	214	2	0	+G
B10_BC22_191109_LF_LIB_consensus_vsearch	3793	T	*/-C	578	15	2.49%	2	1	93	93	2.7901261387207864E-5	1	1	364	214	15	0	-C
B10_BC22_191109_LF_LIB_consensus_vsearch	3794	C	C	583	3	0.51%	2	1	93	93	0.12467976088783492	1	1	368	215	3	0	T
B10_BC22_191109_LF_LIB_consensus_vsearch	3795	C	C	596	4	0.66%	2	2	93	93	0.062187370009836374	1	1	385	211	1	3	-G
B10_BC22_191109_LF_LIB_consensus_vsearch	3796	G	R	588	8	1.34%	2	1	93	93	0.00381499370763636	1	1	377	211	8	0	A
B10_BC22_191109_LF_LIB_consensus_vsearch	3797	G	G	597	1	0.17%	2	1	93	93	0.4999999999999138	1	1	383	214	0	1	+AA
B10_BC22_191109_LF_LIB_consensus_vsearch	3798	T	T	590	5	0.83%	2	1	93	93	0.030987506226370864	1	1	384	206	0	5	C
B10_BC22_191109_LF_LIB_consensus_vsearch	3799	A	A	591	6	1%	2	2	93	93	0.015429036211008771	1	1	383	208	1	5	-C
B10_BC22_191109_LF_LIB_consensus_vsearch	3800	C	C	590	1	0.17%	2	1	93	93	0.5000000000008233	1	1	385	205	1	0	+AC
B10_BC22_191109_LF_LIB_consensus_vsearch	3801	C	C	598	2	0.33%	2	1	93	93	0.24979149291046765	1	1	387	211	0	2	-T
B10_BC22_191109_LF_LIB_consensus_vsearch	3802	T	*/-G	577	18	3%	2	1	93	93	3.3480098182809704E-6	1	1	387	190	0	18	-G
B10_BC22_191109_LF_LIB_consensus_vsearch	3803	G	G	584	1	0.17%	2	1	93	93	0.4999999999999138	1	1	388	196	0	1	T
B10_BC22_191109_LF_LIB_consensus_vsearch	3804	G	G	600	1	0.17%	2	1	93	93	0.4999999999999138	1	1	386	214	1	0	-A
B10_BC22_191109_LF_LIB_consensus_vsearch	3805	A	A	596	2	0.33%	2	1	93	93	0.24979079497935539	1	1	385	211	0	2	C
B10_BC22_191109_LF_LIB_consensus_vsearch	3806	T	T	593	6	1%	2	2	93	93	0.015429689410799249	1	1	382	211	4	2	C
B10_BC22_191109_LF_LIB_consensus_vsearch	3807	G	*/-TG	566	10	1.66%	2	2	93	93	9.388455655418633E-4	1	1	370	196	6	4	-TG
B10_BC22_191109_LF_LIB_consensus_vsearch	3808	T	*/+G	539	12	2.06%	2	1	93	93	2.2980257902033605E-4	1	1	369	170	0	12	+G
B10_BC22_191109_LF_LIB_consensus_vsearch	3809	G	G	565	5	0.87%	2	1	93	93	0.030975998480304686	1	1	369	196	5	0	A
B10_BC22_191109_LF_LIB_consensus_vsearch	3810	G	*/-A	579	10	1.68%	2	2	93	93	9.396687550389984E-4	1	1	372	207	9	1	-A
B10_BC22_191109_LF_LIB_consensus_vsearch	3811	A	A	586	4	0.68%	2	2	93	93	0.062182068959449006	1	1	377	209	1	3	+T
B10_BC22_191109_LF_LIB_consensus_vsearch	3812	T	T	595	6	1%	2	1	93	93	0.01543033827052791	1	1	387	208	0	6	C
B10_BC22_191109_LF_LIB_consensus_vsearch	3813	T	T	594	6	1%	2	2	93	93	0.015430014380448172	1	1	386	208	2	4	C
B10_BC22_191109_LF_LIB_consensus_vsearch	3814	A	A	600	3	0.5%	2	1	93	93	0.12468879668066746	1	1	388	212	0	3	G
B10_BC22_191109_LF_LIB_consensus_vsearch	3815	T	*/-C	566	25	4.15%	2	1	93	93	2.299755159043207E-8	1	1	351	215	25	0	-C
B10_BC22_191109_LF_LIB_consensus_vsearch	3816	C	C	572	3	0.52%	2	1	93	93	0.12467362924259917	1	1	360	212	0	3	+T
B10_BC22_191109_LF_LIB_consensus_vsearch	3817	C	C	586	3	0.5%	2	2	93	93	0.12468139337307069	1	1	382	204	2	1	+AC
B10_BC22_191109_LF_LIB_consensus_vsearch	3818	G	R	587	11	1.83%	2	2	93	93	4.661451415700126E-4	1	1	376	211	10	1	A
B10_BC22_191109_LF_LIB_consensus_vsearch	3819	C	*/-G	580	7	1.17%	2	2	93	93	0.0076732309665896	1	1	377	203	2	5	-G
B10_BC22_191109_LF_LIB_consensus_vsearch	3820	G	R	573	16	2.7%	2	2	93	93	1.3762215449833868E-5	1	1	368	205	14	2	A
B10_BC22_191109_LF_LIB_consensus_vsearch	3821	G	G	600	2	0.33%	2	1	93	93	0.249792186200784	1	1	386	214	2	0	A
B10_BC22_191109_LF_LIB_consensus_vsearch	3822	C	C	590	5	0.83%	2	2	93	93	0.030987506226370864	1	1	382	208	3	2	-A
B10_BC22_191109_LF_LIB_consensus_vsearch	3823	A	A	592	2	0.34%	2	1	93	93	0.24978938500452047	1	1	381	211	2	0	T
B10_BC22_191109_LF_LIB_consensus_vsearch	3824	A	A	590	6	1%	2	1	93	93	0.01542870796997642	1	1	376	214	6	0	G
B10_BC22_191109_LF_LIB_consensus_vsearch	3825	C	C	590	2	0.33%	2	1	93	93	0.2497886728654613	1	1	379	211	2	0	+A
B10_BC22_191109_LF_LIB_consensus_vsearch	3826	G	G	591	3	0.5%	2	1	93	93	0.12468407750622149	1	1	381	210	3	0	A
B10_BC22_191109_LF_LIB_consensus_vsearch	3827	C	C	593	2	0.33%	2	1	93	93	0.24978973927711676	1	1	384	209	0	2	+A
B10_BC22_191109_LF_LIB_consensus_vsearch	3828	A	A	597	2	0.33%	2	1	93	93	0.24979114452852993	1	1	385	212	2	0	G
B10_BC22_191109_LF_LIB_consensus_vsearch	3829	A	R	576	19	3.16%	2	2	93	93	1.6482949361380827E-6	1	1	369	207	17	2	G
B10_BC22_191109_LF_LIB_consensus_vsearch	3830	C	C	595	3	0.5%	2	1	93	93	0.12468619246852639	1	1	384	211	3	0	+GC
B10_BC22_191109_LF_LIB_consensus_vsearch	3831	T	*/+G	575	12	1.99%	2	2	93	93	2.306656556500044E-4	1	1	379	196	5	7	+G
B10_BC22_191109_LF_LIB_consensus_vsearch	3832	G	*/+A	579	12	2%	2	1	93	93	2.3075518337962257E-4	1	1	368	211	12	0	+A
B10_BC22_191109_LF_LIB_consensus_vsearch	3833	A	A	590	2	0.34%	2	1	93	93	0.2497886728654613	1	1	379	211	2	0	+G
B10_BC22_191109_LF_LIB_consensus_vsearch	3834	A	*/-G	579	13	2.16%	2	2	93	93	1.1420723572987618E-4	1	1	370	209	12	1	-G
B10_BC22_191109_LF_LIB_consensus_vsearch	3835	G	*/+A	559	13	2.21%	2	1	93	93	1.1393872252603484E-4	1	1	348	211	13	0	+A
B10_BC22_191109_LF_LIB_consensus_vsearch	3836	G	G	589	2	0.33%	2	1	93	93	0.2497883149871952	1	1	377	212	2	0	+AG
B10_BC22_191109_LF_LIB_consensus_vsearch	3837	T	*/+G	562	13	2.17%	2	2	93	93	1.1398016219406192E-4	1	1	363	199	10	3	+G
B10_BC22_191109_LF_LIB_consensus_vsearch	3838	G	G	580	2	0.34%	2	1	93	93	0.24978503869256835	1	1	377	203	0	2	+TG
B10_BC22_191109_LF_LIB_consensus_vsearch	3839	G	*/-A	588	10	1.66%	2	2	93	93	9.402179215996255E-4	1	1	377	211	8	2	-A
B10_BC22_191109_LF_LIB_consensus_vsearch	3840	A	*/-G	542	37	6.25%	2	1	93	93	4.017352754361844E-12	1	1	334	208	37	0	-G
B10_BC22_191109_LF_LIB_consensus_vsearch	3841	G	*/+A	550	7	1.25%	2	1	93	93	0.007665757133253386	1	1	338	212	7	0	+A
B10_BC22_191109_LF_LIB_consensus_vsearch	3842	A	A	580	6	1.01%	2	2	93	93	0.01542536405110175	1	1	375	205	4	2	G
B10_BC22_191109_LF_LIB_consensus_vsearch	3843	C	C	588	2	0.34%	2	1	93	93	0.2497879558944788	1	1	377	211	2	0	+AC
B10_BC22_191109_LF_LIB_consensus_vsearch	3844	G	G	581	4	0.67%	2	1	93	93	0.062179350443499135	1	1	375	206	4	0	A
B10_BC22_191109_LF_LIB_consensus_vsearch	3845	T	*/-C	582	7	1.17%	2	2	93	93	0.007673702245629301	1	1	380	202	2	5	-C
B10_BC22_191109_LF_LIB_consensus_vsearch	3846	C	C	582	5	0.84%	2	2	93	93	0.030983930348565846	1	1	379	203	1	4	-G
B10_BC22_191109_LF_LIB_consensus_vsearch	3847	G	G	588	4	0.67%	2	1	93	93	0.06218314350277022	1	1	383	205	0	4	T
B10_BC22_191109_LF_LIB_consensus_vsearch	3848	G	G	589	6	1%	2	2	93	93	0.015428378627452975	1	1	382	207	1	5	T
B10_BC22_191109_LF_LIB_consensus_vsearch	3849	C	*/-G	373	158	26.47%	2	2	93	93	2.8282167022433974E-54	1	1	236	137	99	59	-G
B10_BC22_191109_LF_LIB_consensus_vsearch	3850	G	R	361	59	13.56%	2	1	93	93	1.9386764520594057E-19	1	1	218	143	59	0	A
B10_BC22_191109_LF_LIB_consensus_vsearch	3851	G	R	562	33	5.55%	2	2	93	93	7.376975284582562E-11	1	1	351	211	32	1	A
B10_BC22_191109_LF_LIB_consensus_vsearch	3852	G	R	589	9	1.5%	2	2	93	93	0.001894802500745058	1	1	378	211	8	1	A
B10_BC22_191109_LF_LIB_consensus_vsearch	3853	G	R	579	18	2.99%	2	2	93	93	3.3494956774692988E-6	1	1	365	214	17	1	A
B10_BC22_191109_LF_LIB_consensus_vsearch	3854	G	*/-C	539	41	6.8%	2	2	93	93	2.1857133876751528E-13	1	1	337	202	31	10	-C
B10_BC22_191109_LF_LIB_consensus_vsearch	3855	C	C	546	3	0.54%	2	1	93	93	0.12465815861460919	1	1	343	203	3	0	A
B10_BC22_191109_LF_LIB_consensus_vsearch	3856	C	C	584	5	0.84%	2	2	93	93	0.030984833420659205	1	1	370	214	4	1	T
B10_BC22_191109_LF_LIB_consensus_vsearch	3857	C	C	595	6	1%	2	2	93	93	0.01543033827052791	1	1	383	212	4	2	T
B10_BC22_191109_LF_LIB_consensus_vsearch	3858	C	Y	570	16	2.65%	2	2	93	93	1.3754846519059769E-5	1	1	360	210	12	4	T
B10_BC22_191109_LF_LIB_consensus_vsearch	3859	A	*/-G	561	17	2.88%	2	2	93	93	6.771033620181891E-6	1	1	362	199	5	12	-G
B10_BC22_191109_LF_LIB_consensus_vsearch	3860	G	G	582	1	0.17%	2	1	93	93	0.4999999999999138	1	1	381	201	0	1	A
B10_BC22_191109_LF_LIB_consensus_vsearch	3861	G	*/+A	569	16	2.66%	2	2	93	93	1.3752374071037443E-5	1	1	358	211	15	1	+A
B10_BC22_191109_LF_LIB_consensus_vsearch	3862	A	A	584	3	0.51%	2	1	93	93	0.12468030690531334	1	1	371	213	3	0	+G
B10_BC22_191109_LF_LIB_consensus_vsearch	3863	A	*/-G	552	32	5.37%	2	1	93	93	1.5047965803239209E-10	1	1	342	210	32	0	-G
B10_BC22_191109_LF_LIB_consensus_vsearch	3864	G	*/+A	532	17	3%	2	2	93	93	6.7278280810580445E-6	1	1	325	207	16	1	+A
B10_BC22_191109_LF_LIB_consensus_vsearch	3865	A	*/-G	577	7	1.18%	2	2	93	93	0.007672518016675552	1	1	366	211	6	1	-G
B10_BC22_191109_LF_LIB_consensus_vsearch	3866	G	*/-T	567	9	1.53%	2	2	93	93	0.0018925934416486783	1	1	365	202	2	7	-T
B10_BC22_191109_LF_LIB_consensus_vsearch	3867	T	Y	580	7	1.19%	2	2	93	93	0.0076732309665896	1	1	381	199	2	5	C
B10_BC22_191109_LF_LIB_consensus_vsearch	3868	T	T	588	5	0.83%	2	2	93	93	0.0309866212982286	1	1	385	203	2	3	C
B10_BC22_191109_LF_LIB_consensus_vsearch	3869	C	*/-T	588	8	1.34%	2	1	93	93	0.00381499370763636	1	1	388	200	0	8	-T
B10_BC22_191109_LF_LIB_consensus_vsearch	3870	T	*/-C	561	7	1.18%	2	1	93	93	0.007668588879253857	1	1	383	178	0	7	-C
B10_BC22_191109_LF_LIB_consensus_vsearch	3871	C	*/-T	450	85	14.71%	2	2	93	93	6.875022137936114E-28	1	1	327	123	36	49	-T
B10_BC22_191109_LF_LIB_consensus_vsearch	3872	T	T	482	4	0.82%	2	2	93	93	0.06211399948347886	1	1	348	134	2	2	+CT
B10_BC22_191109_LF_LIB_consensus_vsearch	3873	T	T	571	6	1.03%	2	1	93	93	0.015422255598111148	1	1	388	183	0	6	C
B10_BC22_191109_LF_LIB_consensus_vsearch	3874	T	*/+C	574	14	2.36%	2	1	93	93	5.643946893550629E-5	1	1	386	188	0	14	+C
B10_BC22_191109_LF_LIB_consensus_vsearch	3875	T	*/-C	574	17	2.84%	2	1	93	93	6.7890871943561975E-6	1	1	387	187	0	17	-C
B10_BC22_191109_LF_LIB_consensus_vsearch	3876	C	*/-T	550	9	1.56%	2	2	93	93	0.0018907683786527404	1	1	387	163	1	8	-T
B10_BC22_191109_LF_LIB_consensus_vsearch	3877	T	T	584	2	0.34%	2	1	93	93	0.2497865072588101	1	1	386	198	0	2	+C
B10_BC22_191109_LF_LIB_consensus_vsearch	3878	T	*/-CTT	566	20	3.32%	2	2	93	93	8.087221367515639E-7	1	1	376	190	3	17	-CTT
B10_BC22_191109_LF_LIB_consensus_vsearch	3879	C	*/-T	551	10	1.74%	2	1	93	93	9.378488845021741E-4	1	1	380	171	0	10	-T
B10_BC22_191109_LF_LIB_consensus_vsearch	3880	T	T	553	2	0.36%	2	1	93	93	0.249774571686363	1	1	381	172	0	2	+CT
B10_BC22_191109_LF_LIB_consensus_vsearch	3881	T	T	561	4	0.7%	2	1	93	93	0.062167995014182846	1	1	384	177	0	4	C
B10_BC22_191109_LF_LIB_consensus_vsearch	3882	A	A	594	5	0.83%	2	2	93	93	0.03098925836211217	1	1	385	209	1	4	G
B10_BC22_191109_LF_LIB_consensus_vsearch	3883	A	A	583	5	0.83%	2	2	93	93	0.030984382652161722	1	1	378	205	1	4	C
B10_BC22_191109_LF_LIB_consensus_vsearch	3884	C	C	590	4	0.67%	2	2	93	93	0.062184210806914414	1	1	380	210	3	1	+G
B10_BC22_191109_LF_LIB_consensus_vsearch	3885	A	R	580	10	1.67%	2	2	93	93	9.39730591623294E-4	1	1	373	207	8	2	G
B10_BC22_191109_LF_LIB_consensus_vsearch	3886	G	G	591	2	0.34%	2	2	93	93	0.24978902953563295	1	1	383	208	1	1	-T
B10_BC22_191109_LF_LIB_consensus_vsearch	3887	T	T	583	5	0.83%	2	1	93	93	0.030984382652161722	1	1	373	210	5	0	+C
B10_BC22_191109_LF_LIB_consensus_vsearch	3888	C	C	590	4	0.67%	2	1	93	93	0.062184210806914414	1	1	376	214	4	0	+A
B10_BC22_191109_LF_LIB_consensus_vsearch	3889	C	C	590	5	0.83%	2	1	93	93	0.030987506226370864	1	1	379	211	5	0	A
B10_BC22_191109_LF_LIB_consensus_vsearch	3890	G	R	590	10	1.66%	2	1	93	93	9.403377459733819E-4	1	1	378	212	10	0	A
B10_BC22_191109_LF_LIB_consensus_vsearch	3891	T	T	599	1	0.17%	2	1	93	93	0.4999999999990043	1	1	385	214	1	0	+C
B10_BC22_191109_LF_LIB_consensus_vsearch	3892	C	C	599	1	0.17%	2	1	93	93	0.4999999999990043	1	1	385	214	1	0	+GC
B10_BC22_191109_LF_LIB_consensus_vsearch	3893	A	*/+C	550	24	3.99%	2	2	93	93	4.6631359837056654E-8	1	1	350	200	15	9	+C
B10_BC22_191109_LF_LIB_consensus_vsearch	3894	C	C	572	6	1.03%	2	1	93	93	0.015422605753746292	1	1	370	202	0	6	+T
B10_BC22_191109_LF_LIB_consensus_vsearch	3895	C	C	597	4	0.66%	2	1	93	93	0.062187890408182296	1	1	388	209	0	4	+T
B10_BC22_191109_LF_LIB_consensus_vsearch	3896	C	C	596	3	0.5%	2	2	93	93	0.1246867167922604	1	1	385	211	1	2	-T
B10_BC22_191109_LF_LIB_consensus_vsearch	3897	T	*/+G	563	17	2.83%	2	2	93	93	6.773861357899011E-6	1	1	373	190	2	15	+G
B10_BC22_191109_LF_LIB_consensus_vsearch	3898	G	G	587	4	0.67%	2	2	93	93	0.062182607140620794	1	1	376	211	2	2	-A
B10_BC22_191109_LF_LIB_consensus_vsearch	3899	A	A	594	2	0.34%	2	1	93	93	0.24979009235977778	1	1	382	212	2	0	+GA
B10_BC22_191109_LF_LIB_consensus_vsearch	3900	A	A	601	1	0.17%	2	1	93	93	0.4999999999990043	1	1	387	214	0	1	G
B10_BC22_191109_LF_LIB_consensus_vsearch	3901	A	A	598	2	0.33%	2	1	93	93	0.24979149291046765	1	1	388	210	0	2	-T
B10_BC22_191109_LF_LIB_consensus_vsearch	3902	T	*/+C	579	11	1.83%	2	1	93	93	4.658493531133954E-4	1	1	367	212	11	0	+C
B10_BC22_191109_LF_LIB_consensus_vsearch	3903	C	*/+A	584	12	1.99%	2	1	93	93	2.3086543430195892E-4	1	1	375	209	12	0	+A
B10_BC22_191109_LF_LIB_consensus_vsearch	3904	G	R	564	33	5.52%	2	2	93	93	7.388577574207544E-11	1	1	356	208	31	2	A
B10_BC22_191109_LF_LIB_consensus_vsearch	3905	G	*/+T	536	31	5.16%	2	2	93	93	3.055209810120536E-10	1	1	333	203	30	1	+T
B10_BC22_191109_LF_LIB_consensus_vsearch	3906	T	Y	581	7	1.19%	2	2	93	93	0.007673467005464533	1	1	378	203	1	6	C
B10_BC22_191109_LF_LIB_consensus_vsearch	3907	T	T	598	3	0.5%	2	2	93	93	0.12468776019987309	1	1	386	212	2	1	C
B10_BC22_191109_LF_LIB_consensus_vsearch	3908	T	T	587	5	0.83%	2	1	93	93	0.030986176592841308	1	1	381	206	0	5	C
B10_BC22_191109_LF_LIB_consensus_vsearch	3909	G	G	586	5	0.84%	2	2	93	93	0.030985730383315414	1	1	375	211	3	2	A
B10_BC22_191109_LF_LIB_consensus_vsearch	3910	T	*/-C	555	26	4.35%	2	2	93	93	1.1194801558231206E-8	1	1	344	211	25	1	-C
B10_BC22_191109_LF_LIB_consensus_vsearch	3911	C	C	569	2	0.35%	2	1	93	93	0.24978089395303762	1	1	356	213	2	0	T
B10_BC22_191109_LF_LIB_consensus_vsearch	3912	C	*/-G	544	32	5.33%	2	2	93	93	1.4954443744982165E-10	1	1	367	177	2	30	-G
B10_BC22_191109_LF_LIB_consensus_vsearch	3913	G	G	563	3	0.53%	2	1	93	93	0.12466843501340043	1	1	382	181	3	0	A
B10_BC22_191109_LF_LIB_consensus_vsearch	3914	G	*/-A	560	27	4.49%	2	1	93	93	5.487004521479837E-9	1	1	351	209	27	0	-A
B10_BC22_191109_LF_LIB_consensus_vsearch	3915	A	A	554	4	0.71%	2	2	93	93	0.06216382821860171	1	1	350	204	2	2	G
B10_BC22_191109_LF_LIB_consensus_vsearch	3916	G	G	582	2	0.34%	2	1	93	93	0.24978577549334172	1	1	375	207	2	0	A
B10_BC22_191109_LF_LIB_consensus_vsearch	3917	C	Y	586	10	1.66%	2	2	93	93	9.400973019723426E-4	1	1	384	202	1	9	T
B10_BC22_191109_LF_LIB_consensus_vsearch	3918	T	*/-A	547	18	3%	2	2	93	93	3.324527564385411E-6	1	1	348	199	15	3	-A
B10_BC22_191109_LF_LIB_consensus_vsearch	3919	A	*/-G	478	85	14.6%	2	2	93	93	8.35912910603613E-28	1	1	337	141	25	60	-G
B10_BC22_191109_LF_LIB_consensus_vsearch	3920	G	*/+A	498	8	1.56%	2	1	93	93	0.00379886758778857	1	1	348	150	8	0	+A
B10_BC22_191109_LF_LIB_consensus_vsearch	3921	G	*/+A	569	25	4.17%	2	1	93	93	2.3028316352755332E-8	1	1	357	212	25	0	+A
B10_BC22_191109_LF_LIB_consensus_vsearch	3922	G	G	590	4	0.66%	2	2	93	93	0.062184210806914414	1	1	381	209	2	2	-T
B10_BC22_191109_LF_LIB_consensus_vsearch	3923	T	T	597	1	0.17%	2	1	93	93	0.4999999999999138	1	1	385	212	1	0	A
B10_BC22_191109_LF_LIB_consensus_vsearch	3924	T	T	597	4	0.66%	2	2	93	93	0.062187890408182296	1	1	386	211	1	3	C
B10_BC22_191109_LF_LIB_consensus_vsearch	3925	T	T	587	5	0.83%	2	2	93	93	0.030986176592841308	1	1	378	209	4	1	C
B10_BC22_191109_LF_LIB_consensus_vsearch	3926	A	A	595	4	0.67%	2	2	93	93	0.062186847872822006	1	1	382	213	2	2	G
B10_BC22_191109_LF_LIB_consensus_vsearch	3927	A	R	590	7	1.16%	2	2	93	93	0.007675555892850146	1	1	383	207	4	3	G
B10_BC22_191109_LF_LIB_consensus_vsearch	3928	C	C	589	6	1%	2	2	93	93	0.015428378627452975	1	1	383	206	1	5	T
B10_BC22_191109_LF_LIB_consensus_vsearch	3929	G	G	600	1	0.17%	2	1	93	93	0.4999999999999138	1	1	387	213	1	0	+CG
B10_BC22_191109_LF_LIB_consensus_vsearch	3930	A	R	571	14	2.33%	2	1	93	93	5.6416550871607475E-5	1	1	374	197	14	0	G
B10_BC22_191109_LF_LIB_consensus_vsearch	3931	C	Y	569	16	2.68%	2	1	93	93	1.3752374071037443E-5	1	1	385	184	0	16	T
B10_BC22_191109_LF_LIB_consensus_vsearch	3932	T	*/-G	557	16	2.7%	2	2	93	93	1.3722058466540388E-5	1	1	377	180	3	13	-G
B10_BC22_191109_LF_LIB_consensus_vsearch	3933	G	R	558	8	1.38%	2	2	93	93	0.0038101848312436046	1	1	368	190	7	1	A
B10_BC22_191109_LF_LIB_consensus_vsearch	3934	G	G	592	3	0.5%	2	1	93	93	0.1246846089151382	1	1	383	209	3	0	T
B10_BC22_191109_LF_LIB_consensus_vsearch	3935	T	Y	525	32	5.31%	2	2	93	93	1.4723767990427373E-10	1	1	345	180	4	28	C
B10_BC22_191109_LF_LIB_consensus_vsearch	3936	A	A	573	6	1.02%	2	2	93	93	0.015422954702023957	1	1	366	207	4	2	-G
B10_BC22_191109_LF_LIB_consensus_vsearch	3937	G	*/-A	566	24	4.03%	2	2	93	93	4.6949193480367304E-8	1	1	357	209	23	1	-A
B10_BC22_191109_LF_LIB_consensus_vsearch	3938	A	*/+G	500	60	10.4%	2	1	93	93	1.6329457319143234E-19	1	1	292	208	60	0	+G
B10_BC22_191109_LF_LIB_consensus_vsearch	3939	G	*/-CG	578	8	1.34%	2	2	93	93	0.003813445148774959	1	1	369	209	6	2	-CG
B10_BC22_191109_LF_LIB_consensus_vsearch	3940	C	*/+G	558	17	2.88%	2	2	93	93	6.766756833757936E-6	1	1	369	189	1	16	+G
B10_BC22_191109_LF_LIB_consensus_vsearch	3941	G	R	508	68	11.66%	2	2	93	93	4.141254852357069E-22	1	1	302	206	67	1	A
B10_BC22_191109_LF_LIB_consensus_vsearch	3942	G	G	593	5	0.83%	2	2	93	93	0.03098882252468081	1	1	381	212	4	1	A
B10_BC22_191109_LF_LIB_consensus_vsearch	3943	C	*/+T	569	13	2.16%	2	1	93	93	1.1407523213728538E-4	1	1	360	209	13	0	+T
B10_BC22_191109_LF_LIB_consensus_vsearch	3944	A	W	558	18	3.01%	2	1	93	93	3.333406711322731E-6	1	1	346	212	18	0	T
B10_BC22_191109_LF_LIB_consensus_vsearch	3945	C	Y	542	18	3.02%	2	2	93	93	3.3203825524341474E-6	1	1	333	209	17	1	T
B10_BC22_191109_LF_LIB_consensus_vsearch	3946	A	R	549	9	1.58%	2	2	93	93	0.001890657588920399	1	1	341	208	8	1	G
B10_BC22_191109_LF_LIB_consensus_vsearch	3947	C	*/-T	327	146	25.3%	2	2	93	93	1.883249867331084E-50	1	1	253	74	77	69	-T
B10_BC22_191109_LF_LIB_consensus_vsearch	3948	T	T	406	4	0.97%	2	2	93	93	0.06204240475964365	1	1	291	115	2	2	C
B10_BC22_191109_LF_LIB_consensus_vsearch	3949	T	T	555	6	1.06%	2	2	93	93	0.015416483642880736	1	1	372	183	3	3	C
B10_BC22_191109_LF_LIB_consensus_vsearch	3950	T	Y	573	8	1.35%	2	2	93	93	0.0038126509930167373	1	1	365	208	6	2	C
B10_BC22_191109_LF_LIB_consensus_vsearch	3951	T	*/+A	550	30	5%	2	1	93	93	6.338273592027254E-10	1	1	339	211	30	0	+A
B10_BC22_191109_LF_LIB_consensus_vsearch	3952	G	K	542	31	5.25%	2	2	93	93	3.06909597327545E-10	1	1	334	208	30	1	T
B10_BC22_191109_LF_LIB_consensus_vsearch	3953	T	T	576	6	1.02%	2	2	93	93	0.015423994364567683	1	1	372	204	3	3	C
B10_BC22_191109_LF_LIB_consensus_vsearch	3954	G	*/+C	562	12	2.04%	2	1	93	93	2.3036623810212666E-4	1	1	357	205	12	0	+C
B10_BC22_191109_LF_LIB_consensus_vsearch	3955	C	C	591	2	0.34%	2	1	93	93	0.24978902953563295	1	1	383	208	0	2	A
B10_BC22_191109_LF_LIB_consensus_vsearch	3956	C	Y	568	24	3.99%	2	2	93	93	4.698783677797095E-8	1	1	380	188	4	20	T
B10_BC22_191109_LF_LIB_consensus_vsearch	3957	G	G	590	6	1%	2	1	93	93	0.01542870796997642	1	1	386	204	0	6	+T
B10_BC22_191109_LF_LIB_consensus_vsearch	3958	T	T	591	4	0.67%	2	1	93	93	0.06218474176725347	1	1	385	206	0	4	-C
B10_BC22_191109_LF_LIB_consensus_vsearch	3959	C	*/-T	583	8	1.34%	2	2	93	93	0.0038142259421648926	1	1	378	205	3	5	-T
B10_BC22_191109_LF_LIB_consensus_vsearch	3960	T	T	568	6	1.01%	2	2	93	93	0.015421197823763643	1	1	372	196	1	5	-G
B10_BC22_191109_LF_LIB_consensus_vsearch	3961	G	R	561	12	2.03%	2	2	93	93	2.3034265404238912E-4	1	1	369	192	10	2	A
B10_BC22_191109_LF_LIB_consensus_vsearch	3962	G	G	582	5	0.84%	2	1	93	93	0.030983930348565846	1	1	376	206	5	0	T
B10_BC22_191109_LF_LIB_consensus_vsearch	3963	T	Y	583	8	1.35%	2	2	93	93	0.0038142259421648926	1	1	382	201	2	6	C
B10_BC22_191109_LF_LIB_consensus_vsearch	3964	G	*/+C	552	24	4%	2	1	93	93	4.667195453514113E-8	1	1	339	213	24	0	+C
B10_BC22_191109_LF_LIB_consensus_vsearch	3965	C	*/-G	471	83	13.81%	2	2	93	93	3.730761856613384E-27	1	1	273	198	77	6	-G
B10_BC22_191109_LF_LIB_consensus_vsearch	3966	G	R	462	21	4.23%	2	2	93	93	3.8185960170020475E-7	1	1	265	197	20	1	A
B10_BC22_191109_LF_LIB_consensus_vsearch	3967	C	*/+T	476	43	7.44%	2	2	93	93	4.5882798436173176E-14	1	1	289	187	35	8	+T
B10_BC22_191109_LF_LIB_consensus_vsearch	3968	T	*/-C	500	59	10.07%	2	2	93	93	3.4476722151179236E-19	1	1	319	181	44	15	-C
B10_BC22_191109_LF_LIB_consensus_vsearch	3969	C	Y	500	18	3.44%	2	2	93	93	3.2825909837906893E-6	1	1	318	182	12	6	T
B10_BC22_191109_LF_LIB_consensus_vsearch	3970	C	Y	578	8	1.36%	2	2	93	93	0.003813445148774959	1	1	373	205	4	4	T
B10_BC22_191109_LF_LIB_consensus_vsearch	3971	C	Y	515	64	10.67%	2	2	93	93	8.583967033878768E-21	1	1	372	143	7	57	T
B10_BC22_191109_LF_LIB_consensus_vsearch	3972	G	G	590	4	0.67%	2	1	93	93	0.062184210806914414	1	1	380	210	4	0	-A
B10_BC22_191109_LF_LIB_consensus_vsearch	3973	A	A	583	6	1.01%	2	1	93	93	0.015426379128433065	1	1	374	209	6	0	G
B10_BC22_191109_LF_LIB_consensus_vsearch	3974	C	Y	589	8	1.34%	2	2	93	93	0.003815145726019033	1	1	381	208	4	4	T
B10_BC22_191109_LF_LIB_consensus_vsearch	3975	G	G	599	1	0.17%	2	1	93	93	0.4999999999990043	1	1	387	212	0	1	C
B10_BC22_191109_LF_LIB_consensus_vsearch	3976	A	A	598	1	0.17%	2	1	93	93	0.5000000000008233	1	1	386	212	0	1	-T
B10_BC22_191109_LF_LIB_consensus_vsearch	3977	T	*/-C	555	37	6.15%	2	2	93	93	4.071801364272689E-12	1	1	347	208	36	1	-C
B10_BC22_191109_LF_LIB_consensus_vsearch	3978	C	*/+G	534	29	5.12%	2	1	93	93	1.286627481399863E-9	1	1	320	214	29	0	+G
B10_BC22_191109_LF_LIB_consensus_vsearch	3979	C	*/-T	544	36	5.97%	2	2	93	93	8.309343856787659E-12	1	1	360	184	8	28	-T
B10_BC22_191109_LF_LIB_consensus_vsearch	3980	T	W	512	26	4.72%	2	1	93	93	1.0935696504831296E-8	1	1	327	185	26	0	A
B10_BC22_191109_LF_LIB_consensus_vsearch	3981	T	Y	554	17	2.9%	2	2	93	93	6.76098779718637E-6	1	1	351	203	13	4	C
B10_BC22_191109_LF_LIB_consensus_vsearch	3982	G	*/+A	537	29	4.83%	2	2	93	93	1.289218888214443E-9	1	1	334	203	22	7	+A
B10_BC22_191109_LF_LIB_consensus_vsearch	3983	A	A	562	3	0.53%	2	2	93	93	0.12466784765272246	1	1	354	208	1	2	G
B10_BC22_191109_LF_LIB_consensus_vsearch	3984	A	A	584	4	0.67%	2	1	93	93	0.062180987103355005	1	1	370	214	4	0	G
B10_BC22_191109_LF_LIB_consensus_vsearch	3985	A	A	597	4	0.66%	2	1	93	93	0.062187890408182296	1	1	382	215	4	0	G
B10_BC22_191109_LF_LIB_consensus_vsearch	3986	A	A	590	6	1%	2	2	93	93	0.01542870796997642	1	1	383	207	1	5	-T
B10_BC22_191109_LF_LIB_consensus_vsearch	3987	T	*/-C	566	13	2.18%	2	2	93	93	1.1403476275553268E-4	1	1	362	204	12	1	-C
B10_BC22_191109_LF_LIB_consensus_vsearch	3988	C	C	586	1	0.17%	2	1	93	93	0.4999999999999138	1	1	374	212	1	0	+A
B10_BC22_191109_LF_LIB_consensus_vsearch	3989	C	C	597	3	0.5%	2	2	93	93	0.12468723936635923	1	1	386	211	1	2	T
B10_BC22_191109_LF_LIB_consensus_vsearch	3990	A	*/-C	584	10	1.66%	2	2	93	93	9.39975879151716E-4	1	1	375	209	8	2	-C
B10_BC22_191109_LF_LIB_consensus_vsearch	3991	C	C	586	3	0.51%	2	1	93	93	0.12468139337307069	1	1	380	206	0	3	A
B10_BC22_191109_LF_LIB_consensus_vsearch	3992	C	*/-G	570	29	4.83%	2	2	93	93	1.3162758206704341E-9	1	1	387	183	1	28	-G
B10_BC22_191109_LF_LIB_consensus_vsearch	3993	G	G	561	5	0.88%	2	2	93	93	0.03097406294471861	1	1	383	178	1	4	T
B10_BC22_191109_LF_LIB_consensus_vsearch	3994	G	G	596	2	0.33%	2	2	93	93	0.24979079497935539	1	1	385	211	1	1	+A
B10_BC22_191109_LF_LIB_consensus_vsearch	3995	A	A	595	1	0.17%	2	1	93	93	0.4999999999999138	1	1	384	211	1	0	+G
B10_BC22_191109_LF_LIB_consensus_vsearch	3996	A	*/-G	540	39	6.5%	2	2	93	93	9.382377097463086E-13	1	1	338	202	35	4	-G
B10_BC22_191109_LF_LIB_consensus_vsearch	3997	G	G	547	4	0.72%	2	1	93	93	0.06215955550371676	1	1	347	200	0	4	+C
B10_BC22_191109_LF_LIB_consensus_vsearch	3998	G	*/-A	579	7	1.17%	2	2	93	93	0.007672994124905477	1	1	371	208	6	1	-A
B10_BC22_191109_LF_LIB_consensus_vsearch	3999	A	R	570	7	1.2%	2	2	93	93	0.007670825737374831	1	1	359	211	6	1	G
B10_BC22_191109_LF_LIB_consensus_vsearch	4000	A	A	577	5	0.85%	2	1	93	93	0.030981645525998008	1	1	364	213	5	0	C
B10_BC22_191109_LF_LIB_consensus_vsearch	4001	T	Y	580	9	1.5%	2	2	93	93	0.001893918576967777	1	1	370	210	6	3	C
B10_BC22_191109_LF_LIB_consensus_vsearch	4002	G	G	583	5	0.83%	2	1	93	93	0.030984382652161722	1	1	371	212	5	0	-A
B10_BC22_191109_LF_LIB_consensus_vsearch	4003	A	*/-T	541	24	4.05%	2	2	93	93	4.6445503243433545E-8	1	1	342	199	14	10	-T
B10_BC22_191109_LF_LIB_consensus_vsearch	4004	T	T	561	5	0.88%	2	1	93	93	0.03097406294471861	1	1	364	197	5	0	G
B10_BC22_191109_LF_LIB_consensus_vsearch	4005	T	T	592	5	0.84%	2	1	93	93	0.03098838522787931	1	1	383	209	5	0	G
B10_BC22_191109_LF_LIB_consensus_vsearch	4006	T	T	597	2	0.33%	2	1	93	93	0.24979114452852993	1	1	386	211	0	2	+CT
B10_BC22_191109_LF_LIB_consensus_vsearch	4007	T	T	585	6	1%	2	2	93	93	0.015427050131369397	1	1	376	209	5	1	C
B10_BC22_191109_LF_LIB_consensus_vsearch	4008	C	*/-AC	569	12	2.01%	2	1	93	93	2.305290963962864E-4	1	1	366	203	12	0	-AC
B10_BC22_191109_LF_LIB_consensus_vsearch	4009	A	A	573	4	0.69%	2	1	93	93	0.062174902776938816	1	1	363	210	4	0	G
B10_BC22_191109_LF_LIB_consensus_vsearch	4010	C	*/+AC	570	8	1.36%	2	1	93	93	0.003812167942212529	1	1	357	213	8	0	+AC
B10_BC22_191109_LF_LIB_consensus_vsearch	4011	G	G	579	6	1.01%	2	2	93	93	0.015425023382419913	1	1	366	213	5	1	A
B10_BC22_191109_LF_LIB_consensus_vsearch	4012	C	C	581	4	0.68%	2	1	93	93	0.062179350443499135	1	1	367	214	4	0	A
B10_BC22_191109_LF_LIB_consensus_vsearch	4013	C	C	575	6	1%	2	1	93	93	0.015423649001259471	1	1	360	215	6	0	T
B10_BC22_191109_LF_LIB_consensus_vsearch	4014	A	R	563	19	3.16%	2	2	93	93	1.6428423468002437E-6	1	1	353	210	18	1	G
B10_BC22_191109_LF_LIB_consensus_vsearch	4015	G	*/+A	576	14	2.37%	2	1	93	93	5.645462176707094E-5	1	1	362	214	14	0	+A
B10_BC22_191109_LF_LIB_consensus_vsearch	4016	G	G	596	2	0.33%	2	1	93	93	0.24979079497935539	1	1	382	214	2	0	+A
B10_BC22_191109_LF_LIB_consensus_vsearch	4017	T	T	593	4	0.66%	2	2	93	93	0.06218579834936829	1	1	382	211	2	2	C
B10_BC22_191109_LF_LIB_consensus_vsearch	4018	C	*/+A	575	15	2.5%	2	1	93	93	2.7888389483588588E-5	1	1	363	212	15	0	+A
B10_BC22_191109_LF_LIB_consensus_vsearch	4019	G	R	561	16	2.68%	2	1	93	93	1.3732298211241208E-5	1	1	349	212	16	0	A
B10_BC22_191109_LF_LIB_consensus_vsearch	4020	T	T	589	4	0.67%	2	2	93	93	0.06218367805512527	1	1	382	207	1	3	+GT
B10_BC22_191109_LF_LIB_consensus_vsearch	4021	A	R	583	11	1.83%	2	2	93	93	4.65998228714525E-4	1	1	371	212	8	3	G
B10_BC22_191109_LF_LIB_consensus_vsearch	4022	C	*/-T	576	14	2.35%	2	1	93	93	5.645462176707094E-5	1	1	377	199	0	14	-T
B10_BC22_191109_LF_LIB_consensus_vsearch	4023	T	*/-C	560	12	2.06%	2	2	93	93	2.3031898910607474E-4	1	1	373	187	1	11	-C
B10_BC22_191109_LF_LIB_consensus_vsearch	4024	C	C	574	5	0.85%	2	1	93	93	0.030980255699410347	1	1	375	199	5	0	+GC
B10_BC22_191109_LF_LIB_consensus_vsearch	4025	A	*/+C	563	9	1.5%	2	1	93	93	0.0018921736921997058	1	1	352	211	9	0	+C
B10_BC22_191109_LF_LIB_consensus_vsearch	4026	T	Y	580	10	1.67%	2	2	93	93	9.39730591623294E-4	1	1	370	210	8	2	C
B10_BC22_191109_LF_LIB_consensus_vsearch	4027	A	A	588	4	0.67%	2	2	93	93	0.06218314350277022	1	1	376	212	3	1	G
B10_BC22_191109_LF_LIB_consensus_vsearch	4028	A	*/-C	572	11	1.83%	2	1	93	93	4.655839782704286E-4	1	1	359	213	11	0	-C
B10_BC22_191109_LF_LIB_consensus_vsearch	4029	C	C	574	3	0.51%	2	2	93	93	0.12467476149184535	1	1	364	210	1	2	A
B10_BC22_191109_LF_LIB_consensus_vsearch	4030	C	Y	567	9	1.5%	2	2	93	93	0.0018925934416486783	1	1	360	207	4	5	T
B10_BC22_191109_LF_LIB_consensus_vsearch	4031	G	R	563	12	2.02%	2	2	93	93	2.303897416995595E-4	1	1	353	210	11	1	A
B10_BC22_191109_LF_LIB_consensus_vsearch	4032	C	*/+A	578	9	1.51%	2	1	93	93	0.001893718498855406	1	1	368	210	9	0	+A
B10_BC22_191109_LF_LIB_consensus_vsearch	4033	A	*/+C	575	8	1.34%	2	2	93	93	0.0038129702806793094	1	1	367	208	7	1	+C
B10_BC22_191109_LF_LIB_consensus_vsearch	4034	G	R	551	14	2.34%	2	1	93	93	5.625772476863774E-5	1	1	346	205	14	0	A
B10_BC22_191109_LF_LIB_consensus_vsearch	4035	C	Y	566	10	1.71%	2	1	93	93	9.388455655418633E-4	1	1	361	205	10	0	T
B10_BC22_191109_LF_LIB_consensus_vsearch	4036	A	*/-G	570	9	1.53%	2	2	93	93	0.0018929044795225952	1	1	369	201	6	3	-G
B10_BC22_191109_LF_LIB_consensus_vsearch	4037	G	G	576	3	0.52%	2	2	93	93	0.12467588591190074	1	1	374	202	1	2	A
B10_BC22_191109_LF_LIB_consensus_vsearch	4038	G	G	594	3	0.5%	2	1	93	93	0.12468566638724124	1	1	383	211	3	0	A
B10_BC22_191109_LF_LIB_consensus_vsearch	4039	T	*/-C	586	7	1.17%	2	1	93	93	0.007674635299574334	1	1	382	204	0	7	-C
B10_BC22_191109_LF_LIB_consensus_vsearch	4040	C	C	589	3	0.5%	2	2	93	93	0.1246830092985462	1	1	385	204	2	1	-T
B10_BC22_191109_LF_LIB_consensus_vsearch	4041	T	*/-C	485	106	17.67%	2	2	93	93	6.952076698346711E-35	1	1	285	200	98	8	-C
B10_BC22_191109_LF_LIB_consensus_vsearch	4042	C	C	497	0	0%	2	0	93	0	1.0	1	0	290	207	0	0	
B10_BC22_191109_LF_LIB_consensus_vsearch	4043	C	*/-A	548	34	5.64%	2	2	93	93	3.543513484444305E-11	1	1	341	207	32	2	-A
B10_BC22_191109_LF_LIB_consensus_vsearch	4044	A	A	557	6	1.06%	2	2	93	93	0.0154172230461365	1	1	352	205	2	4	G
B10_BC22_191109_LF_LIB_consensus_vsearch	4045	A	A	589	4	0.67%	2	2	93	93	0.06218367805512527	1	1	381	208	3	1	-G
B10_BC22_191109_LF_LIB_consensus_vsearch	4046	G	G	586	5	0.84%	2	2	93	93	0.030985730383315414	1	1	379	207	2	3	T
B10_BC22_191109_LF_LIB_consensus_vsearch	4047	G	K	584	7	1.16%	2	1	93	93	0.007674170345963	1	1	376	208	7	0	T
B10_BC22_191109_LF_LIB_consensus_vsearch	4048	T	*/+A	566	18	3.01%	2	1	93	93	3.339665159154707E-6	1	1	361	205	18	0	+A
B10_BC22_191109_LF_LIB_consensus_vsearch	4049	G	*/-A	569	21	3.51%	2	2	93	93	3.978412670926488E-7	1	1	365	204	19	2	-A
B10_BC22_191109_LF_LIB_consensus_vsearch	4050	A	A	573	2	0.35%	2	1	93	93	0.249782419495127	1	1	363	210	2	0	+G
B10_BC22_191109_LF_LIB_consensus_vsearch	4051	A	R	583	11	1.83%	2	1	93	93	4.65998228714525E-4	1	1	375	208	11	0	G
B10_BC22_191109_LF_LIB_consensus_vsearch	4052	C	C	591	4	0.67%	2	2	93	93	0.06218474176725347	1	1	381	210	2	2	T
B10_BC22_191109_LF_LIB_consensus_vsearch	4053	A	R	586	7	1.17%	2	2	93	93	0.007674635299574334	1	1	376	210	6	1	G
B10_BC22_191109_LF_LIB_consensus_vsearch	4054	G	R	576	16	2.68%	2	2	93	93	1.3769512585367692E-5	1	1	367	209	14	2	A
B10_BC22_191109_LF_LIB_consensus_vsearch	4055	C	C	588	3	0.5%	2	2	93	93	0.12468247248078299	1	1	380	208	1	2	+T
B10_BC22_191109_LF_LIB_consensus_vsearch	4056	C	*/-T	583	10	1.66%	2	2	93	93	9.399148640318375E-4	1	1	383	200	3	7	-T
B10_BC22_191109_LF_LIB_consensus_vsearch	4057	T	T	584	4	0.68%	2	2	93	93	0.062180987103355005	1	1	381	203	3	1	+C
B10_BC22_191109_LF_LIB_consensus_vsearch	4058	C	*/-T	576	23	3.82%	2	2	93	93	9.612409593667203E-8	1	1	385	191	2	21	-T
B10_BC22_191109_LF_LIB_consensus_vsearch	4059	T	*/+G	563	8	1.38%	2	1	93	93	0.0038110211985538677	1	1	374	189	8	0	+G
B10_BC22_191109_LF_LIB_consensus_vsearch	4060	A	R	586	9	1.5%	2	2	93	93	0.0018945108065208946	1	1	375	211	7	2	G
B10_BC22_191109_LF_LIB_consensus_vsearch	4061	G	G	590	4	0.67%	2	1	93	93	0.062184210806914414	1	1	377	213	4	0	+A
B10_BC22_191109_LF_LIB_consensus_vsearch	4062	T	T	597	4	0.67%	2	2	93	93	0.062187890408182296	1	1	386	211	1	3	C
B10_BC22_191109_LF_LIB_consensus_vsearch	4063	T	T	590	5	0.83%	2	1	93	93	0.030987506226370864	1	1	381	209	5	0	+A
B10_BC22_191109_LF_LIB_consensus_vsearch	4064	G	G	594	4	0.67%	2	1	93	93	0.062186323989038686	1	1	380	214	4	0	-A
B10_BC22_191109_LF_LIB_consensus_vsearch	4065	A	A	589	4	0.67%	2	2	93	93	0.06218367805512527	1	1	377	212	3	1	G
B10_BC22_191109_LF_LIB_consensus_vsearch	4066	T	*/+A	576	13	2.16%	2	2	93	93	1.141680944483324E-4	1	1	366	210	11	2	+A
B10_BC22_191109_LF_LIB_consensus_vsearch	4067	A	R	584	7	1.17%	2	2	93	93	0.007674170345963	1	1	376	208	5	2	G
B10_BC22_191109_LF_LIB_consensus_vsearch	4068	G	G	599	1	0.17%	2	1	93	93	0.4999999999990043	1	1	384	215	1	0	+TT
B10_BC22_191109_LF_LIB_consensus_vsearch	4069	A	A	596	3	0.5%	2	1	93	93	0.1246867167922604	1	1	381	215	3	0	G
B10_BC22_191109_LF_LIB_consensus_vsearch	4070	A	R	591	9	1.49%	2	2	93	93	0.0018949953560998536	1	1	379	212	7	2	G
B10_BC22_191109_LF_LIB_consensus_vsearch	4071	C	C	587	6	1%	2	2	93	93	0.015427716615850288	1	1	381	206	1	5	+A
B10_BC22_191109_LF_LIB_consensus_vsearch	4072	A	A	594	3	0.5%	2	2	93	93	0.12468566638724124	1	1	384	210	2	1	G
B10_BC22_191109_LF_LIB_consensus_vsearch	4073	A	A	593	4	0.66%	2	2	93	93	0.06218579834936829	1	1	380	213	3	1	-T
B10_BC22_191109_LF_LIB_consensus_vsearch	4074	T	T	587	3	0.5%	2	2	93	93	0.12468193384235185	1	1	376	211	1	2	C
B10_BC22_191109_LF_LIB_consensus_vsearch	4075	G	G	586	5	0.83%	2	2	93	93	0.030985730383315414	1	1	378	208	4	1	-T
B10_BC22_191109_LF_LIB_consensus_vsearch	4076	T	Y	571	9	1.52%	2	2	93	93	0.0018930074497425708	1	1	370	201	3	6	C
B10_BC22_191109_LF_LIB_consensus_vsearch	4077	A	A	582	6	1.01%	2	1	93	93	0.015426041918236095	1	1	377	205	6	0	-G
B10_BC22_191109_LF_LIB_consensus_vsearch	4078	G	G	590	1	0.17%	2	1	93	93	0.5000000000008233	1	1	380	210	1	0	+A
B10_BC22_191109_LF_LIB_consensus_vsearch	4079	A	A	595	1	0.17%	2	1	93	93	0.4999999999999138	1	1	382	213	1	0	+C
B10_BC22_191109_LF_LIB_consensus_vsearch	4080	T	*/-A	540	41	6.83%	2	2	93	93	2.1885721699767573E-13	1	1	356	184	12	29	-A
B10_BC22_191109_LF_LIB_consensus_vsearch	4081	A	R	543	8	1.45%	2	2	93	93	0.003807585201342346	1	1	361	182	4	4	G
B10_BC22_191109_LF_LIB_consensus_vsearch	4082	A	*/-G	378	175	29.41%	2	2	93	93	1.5110179871294237E-60	1	1	210	168	140	35	-G
B10_BC22_191109_LF_LIB_consensus_vsearch	4083	G	K	354	21	5.28%	2	2	93	93	3.575477430686981E-7	1	1	212	142	1	20	T
B10_BC22_191109_LF_LIB_consensus_vsearch	4084	G	K	559	11	1.92%	2	1	93	93	4.6507410995373774E-4	1	1	358	201	0	11	T
B10_BC22_191109_LF_LIB_consensus_vsearch	4085	G	*/-A	580	10	1.68%	2	2	93	93	9.39730591623294E-4	1	1	373	207	7	3	-A
B10_BC22_191109_LF_LIB_consensus_vsearch	4086	A	A	580	2	0.34%	2	2	93	93	0.24978503869256835	1	1	374	206	1	1	G
B10_BC22_191109_LF_LIB_consensus_vsearch	4087	A	A	595	3	0.5%	2	2	93	93	0.12468619246852639	1	1	386	209	1	2	T
B10_BC22_191109_LF_LIB_consensus_vsearch	4088	G	G	591	3	0.5%	2	1	93	93	0.12468407750622149	1	1	386	205	0	3	+T
B10_BC22_191109_LF_LIB_consensus_vsearch	4089	T	T	595	4	0.66%	2	2	93	93	0.062186847872822006	1	1	387	208	1	3	-C
B10_BC22_191109_LF_LIB_consensus_vsearch	4090	C	C	577	6	1%	2	2	93	93	0.01542433854516302	1	1	380	197	1	5	T
B10_BC22_191109_LF_LIB_consensus_vsearch	4091	G	R	585	11	1.84%	2	1	93	93	4.6607192805233423E-4	1	1	374	211	11	0	A
B10_BC22_191109_LF_LIB_consensus_vsearch	4092	G	G	585	5	0.83%	2	1	93	93	0.030985282661769052	1	1	374	211	5	0	+C
B10_BC22_191109_LF_LIB_consensus_vsearch	4093	C	*/-A	524	35	5.84%	2	2	93	93	1.6804232961379E-11	1	1	344	180	11	24	-A
B10_BC22_191109_LF_LIB_consensus_vsearch	4094	A	A	559	4	0.71%	2	1	93	93	0.062166815078796796	1	1	369	190	4	0	G
B10_BC22_191109_LF_LIB_consensus_vsearch	4095	A	A	594	2	0.33%	2	1	93	93	0.24979009235977778	1	1	382	212	2	0	+G
B10_BC22_191109_LF_LIB_consensus_vsearch	4096	A	A	599	1	0.17%	2	1	93	93	0.4999999999990043	1	1	386	213	1	0	+GAA
B10_BC22_191109_LF_LIB_consensus_vsearch	4097	A	A	592	4	0.66%	2	2	93	93	0.06218527094514562	1	1	380	212	3	1	G
B10_BC22_191109_LF_LIB_consensus_vsearch	4098	T	T	585	6	1%	2	1	93	93	0.015427050131369397	1	1	374	211	6	0	-A
B10_BC22_191109_LF_LIB_consensus_vsearch	4099	A	A	581	5	0.84%	2	1	93	93	0.030983476501936075	1	1	371	210	5	0	G
B10_BC22_191109_LF_LIB_consensus_vsearch	4100	G	G	597	2	0.33%	2	1	93	93	0.24979114452852993	1	1	384	213	2	0	-A
B10_BC22_191109_LF_LIB_consensus_vsearch	4101	A	A	595	3	0.5%	2	1	93	93	0.12468619246852639	1	1	383	212	3	0	G
B10_BC22_191109_LF_LIB_consensus_vsearch	4102	T	*/-C	584	11	1.83%	2	1	93	93	4.660351394123344E-4	1	1	372	212	11	0	-C
B10_BC22_191109_LF_LIB_consensus_vsearch	4103	C	C	592	0	0%	2	0	93	0	1.0	1	0	377	215	0	0	
B10_BC22_191109_LF_LIB_consensus_vsearch	4104	C	C	585	6	1%	2	2	93	93	0.015427050131369397	1	1	378	207	5	1	A
B10_BC22_191109_LF_LIB_consensus_vsearch	4105	G	G	586	4	0.67%	2	1	93	93	0.062182068959449006	1	1	374	212	4	0	+C
B10_BC22_191109_LF_LIB_consensus_vsearch	4106	T	Y	576	14	2.35%	2	2	93	93	5.645462176707094E-5	1	1	367	209	12	2	C
B10_BC22_191109_LF_LIB_consensus_vsearch	4107	A	A	590	4	0.67%	2	2	93	93	0.062184210806914414	1	1	378	212	2	2	G
B10_BC22_191109_LF_LIB_consensus_vsearch	4108	A	R	576	17	2.84%	2	2	93	93	6.791797557940805E-6	1	1	365	211	15	2	G
B10_BC22_191109_LF_LIB_consensus_vsearch	4109	C	*/-T	569	17	2.82%	2	2	93	93	6.7822340102646855E-6	1	1	366	203	10	7	-T
B10_BC22_191109_LF_LIB_consensus_vsearch	4110	T	T	568	4	0.7%	2	1	93	93	0.062172059780916195	1	1	366	202	0	4	C
B10_BC22_191109_LF_LIB_consensus_vsearch	4111	T	*/+C	561	15	2.54%	2	1	93	93	2.782660779890985E-5	1	1	350	211	15	0	+C
B10_BC22_191109_LF_LIB_consensus_vsearch	4112	C	*/-G	510	40	6.76%	2	2	93	93	4.358146708588916E-13	1	1	313	197	33	7	-G
B10_BC22_191109_LF_LIB_consensus_vsearch	4113	G	R	547	12	2.14%	2	1	93	93	2.3000379166900636E-4	1	1	341	206	12	0	A
B10_BC22_191109_LF_LIB_consensus_vsearch	4114	G	G	597	2	0.33%	2	1	93	93	0.24979114452852993	1	1	387	210	0	2	+T
B10_BC22_191109_LF_LIB_consensus_vsearch	4115	G	*/-A	480	94	15.59%	2	2	93	93	7.954700227362698E-31	1	1	301	179	73	21	-A
B10_BC22_191109_LF_LIB_consensus_vsearch	4116	A	A	492	3	0.6%	2	2	93	93	0.12462082912008803	1	1	305	187	2	1	G
B10_BC22_191109_LF_LIB_consensus_vsearch	4117	A	A	584	5	0.85%	2	2	93	93	0.030984833420659205	1	1	376	208	4	1	G
B10_BC22_191109_LF_LIB_consensus_vsearch	4118	A	A	593	4	0.67%	2	2	93	93	0.06218579834936829	1	1	384	209	3	1	G
B10_BC22_191109_LF_LIB_consensus_vsearch	4119	A	*/-G	554	26	4.32%	2	2	93	93	1.1189157966830196E-8	1	1	360	194	24	2	-G
B10_BC22_191109_LF_LIB_consensus_vsearch	4120	G	R	546	17	2.95%	2	2	93	93	6.749215399993968E-6	1	1	344	202	16	1	A
B10_BC22_191109_LF_LIB_consensus_vsearch	4121	G	*/-A	558	41	6.8%	2	1	93	93	2.2389433061437806E-13	1	1	347	211	41	0	-A
B10_BC22_191109_LF_LIB_consensus_vsearch	4122	A	A	552	6	1.07%	2	2	93	93	0.015415364617984597	1	1	340	212	5	1	+T
B10_BC22_191109_LF_LIB_consensus_vsearch	4123	T	T	602	1	0.17%	2	1	93	93	0.4999999999990043	1	1	387	215	1	0	C
B10_BC22_191109_LF_LIB_consensus_vsearch	4124	T	*/-G	590	7	1.16%	2	2	93	93	0.007675555892850146	1	1	384	206	2	5	-G
B10_BC22_191109_LF_LIB_consensus_vsearch	4125	G	R	577	13	2.18%	2	1	93	93	1.1418118475245747E-4	1	1	367	210	13	0	A
B10_BC22_191109_LF_LIB_consensus_vsearch	4126	G	*/-C	572	9	1.49%	2	2	93	93	0.0018931100684577166	1	1	380	192	2	7	-C
B10_BC22_191109_LF_LIB_consensus_vsearch	4127	C	C	579	6	1.01%	2	2	93	93	0.015425023382419913	1	1	385	194	1	5	T
B10_BC22_191109_LF_LIB_consensus_vsearch	4128	T	T	586	4	0.67%	2	1	93	93	0.062182068959449006	1	1	383	203	4	0	+C
B10_BC22_191109_LF_LIB_consensus_vsearch	4129	C	*/-T	570	11	1.83%	2	2	93	93	4.6550699991566706E-4	1	1	384	186	2	9	-T
B10_BC22_191109_LF_LIB_consensus_vsearch	4130	T	*/-A	534	42	7.12%	2	2	93	93	1.0469883595014853E-13	1	1	345	189	33	9	-A
B10_BC22_191109_LF_LIB_consensus_vsearch	4131	A	A	546	5	0.9%	2	2	93	93	0.03096655451783916	1	1	351	195	1	4	G
B10_BC22_191109_LF_LIB_consensus_vsearch	4132	A	R	550	17	2.84%	2	2	93	93	6.755141177084072E-6	1	1	359	191	13	4	G
B10_BC22_191109_LF_LIB_consensus_vsearch	4133	G	K	570	8	1.37%	2	1	93	93	0.003812167942212529	1	1	379	191	0	8	T
B10_BC22_191109_LF_LIB_consensus_vsearch	4134	G	*/+A	584	13	2.17%	2	1	93	93	1.1427161689440221E-4	1	1	374	210	13	0	+A
B10_BC22_191109_LF_LIB_consensus_vsearch	4135	G	G	586	4	0.67%	2	1	93	93	0.062182068959449006	1	1	381	205	0	4	-TTGGG
B10_BC22_191109_LF_LIB_consensus_vsearch	4136	T	Y	580	15	2.52%	2	2	93	93	2.790977291101727E-5	1	1	386	194	1	14	C
B10_BC22_191109_LF_LIB_consensus_vsearch	4137	T	T	585	4	0.67%	2	2	93	93	0.06218152895025356	1	1	380	205	2	2	-G
B10_BC22_191109_LF_LIB_consensus_vsearch	4138	G	R	583	10	1.68%	2	2	93	93	9.399148640318375E-4	1	1	379	204	6	4	A
B10_BC22_191109_LF_LIB_consensus_vsearch	4139	G	G	584	6	1%	2	1	93	93	0.015426715197547503	1	1	376	208	6	0	+A
B10_BC22_191109_LF_LIB_consensus_vsearch	4140	G	G	592	2	0.33%	2	1	93	93	0.24978938500452047	1	1	382	210	2	0	+C
B10_BC22_191109_LF_LIB_consensus_vsearch	4141	C	C	593	3	0.5%	2	1	93	93	0.12468513853935516	1	1	383	210	0	3	+AA
B10_BC22_191109_LF_LIB_consensus_vsearch	4142	G	*/-CG	581	18	2.99%	2	2	93	93	3.3509721189416796E-6	1	1	385	196	1	17	-CG
B10_BC22_191109_LF_LIB_consensus_vsearch	4143	C	*/-GT	568	7	1.2%	2	2	93	93	0.007670334687803565	1	1	383	185	2	5	-GT
B10_BC22_191109_LF_LIB_consensus_vsearch	4144	G	*/+CG	555	13	2.25%	2	2	93	93	1.1388280498018359E-4	1	1	375	180	5	8	+CG
B10_BC22_191109_LF_LIB_consensus_vsearch	4145	T	Y	576	7	1.19%	2	1	93	93	0.007672278741851824	1	1	378	198	0	7	C
B10_BC22_191109_LF_LIB_consensus_vsearch	4146	T	*/-G	551	32	5.34%	2	2	93	93	1.5036388290288867E-10	1	1	384	167	2	30	-G
B10_BC22_191109_LF_LIB_consensus_vsearch	4147	G	R	549	10	1.77%	2	2	93	93	9.37712000234479E-4	1	1	379	170	4	6	A
B10_BC22_191109_LF_LIB_consensus_vsearch	4148	G	R	565	29	4.86%	2	2	93	93	1.312339580343095E-9	1	1	384	181	2	27	A
B10_BC22_191109_LF_LIB_consensus_vsearch	4149	G	R	573	14	2.32%	2	2	93	93	5.643185488140275E-5	1	1	370	203	8	6	A
B10_BC22_191109_LF_LIB_consensus_vsearch	4150	C	*/+G	576	8	1.34%	2	1	93	93	0.0038131291090651434	1	1	374	202	8	0	+G
B10_BC22_191109_LF_LIB_consensus_vsearch	4151	C	*/-T	553	30	4.98%	2	2	93	93	6.351166760358881E-10	1	1	376	177	5	25	-T
B10_BC22_191109_LF_LIB_consensus_vsearch	4152	T	T	554	5	0.89%	2	2	93	93	0.030970609134842956	1	1	371	183	2	3	C
B10_BC22_191109_LF_LIB_consensus_vsearch	4153	T	*/-G	558	16	2.7%	2	2	93	93	1.3724631247983685E-5	1	1	372	186	1	15	-G
B10_BC22_191109_LF_LIB_consensus_vsearch	4154	G	G	574	4	0.68%	2	1	93	93	0.06217546547116354	1	1	383	191	0	4	C
B10_BC22_191109_LF_LIB_consensus_vsearch	4155	G	*/+A	577	8	1.33%	2	1	93	93	0.0038132873975118887	1	1	371	206	8	0	+A
B10_BC22_191109_LF_LIB_consensus_vsearch	4156	G	G	593	2	0.33%	2	2	93	93	0.24978973927711676	1	1	381	212	1	1	-C
B10_BC22_191109_LF_LIB_consensus_vsearch	4157	C	*/+G	547	32	5.33%	2	1	93	93	1.4989757415508143E-10	1	1	337	210	32	0	+G
B10_BC22_191109_LF_LIB_consensus_vsearch	4158	A	*/-G	545	33	5.58%	2	1	93	93	7.27579918786072E-11	1	1	333	212	33	0	-G
B10_BC22_191109_LF_LIB_consensus_vsearch	4159	G	G	561	3	0.53%	2	1	93	93	0.12466725820763522	1	1	346	215	3	0	-A
B10_BC22_191109_LF_LIB_consensus_vsearch	4160	A	R	582	11	1.84%	2	1	93	93	4.659611953509893E-4	1	1	371	211	11	0	G
B10_BC22_191109_LF_LIB_consensus_vsearch	4161	T	*/+C	583	11	1.83%	2	2	93	93	4.65998228714525E-4	1	1	375	208	9	2	+C
B10_BC22_191109_LF_LIB_consensus_vsearch	4162	T	*/+CC	167	328	54.39%	2	2	93	93	3.2621161623754702E-136	1	1	146	21	188	140	+CC
B10_BC22_191109_LF_LIB_consensus_vsearch	4163	C	*/+G	241	275	45.76%	2	2	93	93	1.309872678288812E-105	1	1	186	55	151	124	+G
B10_BC22_191109_LF_LIB_consensus_vsearch	4164	G	*/+A	576	8	1.33%	2	1	93	93	0.0038131291090651434	1	1	366	210	8	0	+A
B10_BC22_191109_LF_LIB_consensus_vsearch	4165	G	G	593	5	0.83%	2	2	93	93	0.03098882252468081	1	1	382	211	3	2	C
B10_BC22_191109_LF_LIB_consensus_vsearch	4166	G	*/-A	588	10	1.66%	2	2	93	93	9.402179215996255E-4	1	1	375	213	9	1	-A
B10_BC22_191109_LF_LIB_consensus_vsearch	4167	A	R	567	19	3.21%	2	1	93	93	1.6445443098363572E-6	1	1	354	213	19	0	G
B10_BC22_191109_LF_LIB_consensus_vsearch	4168	G	G	590	5	0.83%	2	1	93	93	0.030987506226370864	1	1	375	215	5	0	A
B10_BC22_191109_LF_LIB_consensus_vsearch	4169	C	*/+A	577	8	1.33%	2	1	93	93	0.0038132873975118887	1	1	365	212	8	0	+A
B10_BC22_191109_LF_LIB_consensus_vsearch	4170	A	*/-G	568	13	2.16%	2	2	93	93	1.1406178769493562E-4	1	1	359	209	10	3	-G
B10_BC22_191109_LF_LIB_consensus_vsearch	4171	G	*/+A	577	10	1.7%	2	1	93	93	9.395444569434851E-4	1	1	367	210	10	0	+A
B10_BC22_191109_LF_LIB_consensus_vsearch	4172	G	G	595	2	0.33%	2	1	93	93	0.24979044425840527	1	1	384	211	0	2	+T
B10_BC22_191109_LF_LIB_consensus_vsearch	4173	T	T	590	3	0.5%	2	2	93	93	0.12468354430400949	1	1	381	209	1	2	C
B10_BC22_191109_LF_LIB_consensus_vsearch	4174	C	C	592	3	0.5%	2	2	93	93	0.1246846089151382	1	1	382	210	2	1	-G
B10_BC22_191109_LF_LIB_consensus_vsearch	4175	G	R	584	10	1.68%	2	2	93	93	9.39975879151716E-4	1	1	374	210	9	1	A
B10_BC22_191109_LF_LIB_consensus_vsearch	4176	G	G	596	2	0.33%	2	2	93	93	0.24979079497935539	1	1	384	212	1	1	-C
B10_BC22_191109_LF_LIB_consensus_vsearch	4177	C	C	581	5	0.83%	2	2	93	93	0.030983476501936075	1	1	377	204	4	1	+T
B10_BC22_191109_LF_LIB_consensus_vsearch	4178	A	W	570	7	1.17%	2	2	93	93	0.007670825737374831	1	1	362	208	6	1	T
B10_BC22_191109_LF_LIB_consensus_vsearch	4179	C	Y	567	16	2.68%	2	2	93	93	1.3747404729208327E-5	1	1	365	202	7	9	T
B10_BC22_191109_LF_LIB_consensus_vsearch	4180	T	Y	530	25	4.23%	2	2	93	93	2.260548522244661E-8	1	1	344	186	7	18	C
B10_BC22_191109_LF_LIB_consensus_vsearch	4181	A	R	565	18	3.03%	2	2	93	93	3.3388917550220514E-6	1	1	359	206	17	1	G
B10_BC22_191109_LF_LIB_consensus_vsearch	4182	G	R	561	23	3.87%	2	1	93	93	9.558369752998525E-8	1	1	358	203	23	0	A
B10_BC22_191109_LF_LIB_consensus_vsearch	4183	C	*/-T	537	23	3.85%	2	2	93	93	9.466465233641151E-8	1	1	363	174	13	10	-T
B10_BC22_191109_LF_LIB_consensus_vsearch	4184	T	Y	547	7	1.26%	2	2	93	93	0.0076649653940683155	1	1	359	188	5	2	C
B10_BC22_191109_LF_LIB_consensus_vsearch	4185	T	*/-C	553	15	2.58%	2	1	93	93	2.7789983577292E-5	1	1	354	199	15	0	-C
B10_BC22_191109_LF_LIB_consensus_vsearch	4186	C	*/-AC	552	15	2.57%	2	1	93	93	2.7785335386442196E-5	1	1	345	207	15	0	-AC
B10_BC22_191109_LF_LIB_consensus_vsearch	4187	A	R	566	7	1.21%	2	2	93	93	0.007669840222466952	1	1	355	211	5	2	G
B10_BC22_191109_LF_LIB_consensus_vsearch	4188	C	Y	565	11	1.88%	2	2	93	93	4.6531225052335137E-4	1	1	362	203	6	5	T
B10_BC22_191109_LF_LIB_consensus_vsearch	4189	G	G	591	5	0.84%	2	1	93	93	0.030987946464272845	1	1	379	212	5	0	A
B10_BC22_191109_LF_LIB_consensus_vsearch	4190	G	*/-C	576	9	1.5%	2	1	93	93	0.001893517063995506	1	1	365	211	9	0	-C
B10_BC22_191109_LF_LIB_consensus_vsearch	4191	C	C	583	5	0.85%	2	1	93	93	0.030984382652161722	1	1	376	207	0	5	T
B10_BC22_191109_LF_LIB_consensus_vsearch	4192	C	Y	581	8	1.33%	2	1	93	93	0.0038139152066312184	1	1	379	202	0	8	T
B10_BC22_191109_LF_LIB_consensus_vsearch	4193	G	R	575	20	3.35%	2	1	93	93	8.107753059056237E-7	1	1	363	212	20	0	A
B10_BC22_191109_LF_LIB_consensus_vsearch	4194	G	R	587	9	1.5%	2	2	93	93	0.001894608361560784	1	1	377	210	6	3	A
B10_BC22_191109_LF_LIB_consensus_vsearch	4195	C	C	583	6	1.01%	2	1	93	93	0.015426379128433065	1	1	371	212	6	0	-GC
B10_BC22_191109_LF_LIB_consensus_vsearch	4196	G	R	575	8	1.35%	2	1	93	93	0.0038129702806793094	1	1	364	211	8	0	A
B10_BC22_191109_LF_LIB_consensus_vsearch	4197	C	C	577	3	0.51%	2	2	93	93	0.12467644521108873	1	1	369	208	2	1	+GC
B10_BC22_191109_LF_LIB_consensus_vsearch	4198	C	*/-T	566	12	2%	2	2	93	93	2.3045977381397776E-4	1	1	368	198	5	7	-T
B10_BC22_191109_LF_LIB_consensus_vsearch	4199	T	T	568	5	0.86%	2	2	93	93	0.03097743240611924	1	1	368	200	3	2	C
B10_BC22_191109_LF_LIB_consensus_vsearch	4200	T	*/-C	550	26	4.4%	2	2	93	93	1.1166412049019235E-8	1	1	345	205	23	3	-C
B10_BC22_191109_LF_LIB_consensus_vsearch	4201	C	C	565	1	0.18%	2	1	93	93	0.5000000000008233	1	1	358	207	1	0	+G
B10_BC22_191109_LF_LIB_consensus_vsearch	4202	C	C	593	2	0.34%	2	2	93	93	0.24978973927711676	1	1	380	213	1	1	-A
B10_BC22_191109_LF_LIB_consensus_vsearch	4203	A	A	588	3	0.5%	2	1	93	93	0.12468247248078299	1	1	374	214	3	0	G
B10_BC22_191109_LF_LIB_consensus_vsearch	4204	G	G	583	5	0.84%	2	1	93	93	0.030984382652161722	1	1	375	208	5	0	A
B10_BC22_191109_LF_LIB_consensus_vsearch	4205	C	C	577	6	1.01%	2	1	93	93	0.01542433854516302	1	1	371	206	6	0	-A
B10_BC22_191109_LF_LIB_consensus_vsearch	4206	A	*/-C	432	122	20.75%	2	2	93	93	1.0391585892774024E-40	1	1	238	194	113	9	-C
B10_BC22_191109_LF_LIB_consensus_vsearch	4207	C	C	441	6	1.31%	2	1	93	93	0.015363425358953372	1	1	250	191	0	6	+T
B10_BC22_191109_LF_LIB_consensus_vsearch	4208	C	Y	569	9	1.54%	2	2	93	93	0.0018928011559758858	1	1	367	202	1	8	T
B10_BC22_191109_LF_LIB_consensus_vsearch	4209	C	Y	570	18	3.02%	2	1	93	93	3.3427338331157792E-6	1	1	380	190	0	18	T
B10_BC22_191109_LF_LIB_consensus_vsearch	4210	C	Y	569	12	2%	2	2	93	93	2.305290963962864E-4	1	1	375	194	1	11	T
B10_BC22_191109_LF_LIB_consensus_vsearch	4211	G	G	581	4	0.68%	2	1	93	93	0.062179350443499135	1	1	374	207	4	0	-TG
B10_BC22_191109_LF_LIB_consensus_vsearch	4212	T	Y	585	7	1.18%	2	1	93	93	0.007674403214110395	1	1	379	206	0	7	C
B10_BC22_191109_LF_LIB_consensus_vsearch	4213	G	R	583	7	1.18%	2	2	93	93	0.007673936691127849	1	1	371	212	6	1	A
B10_BC22_191109_LF_LIB_consensus_vsearch	4214	G	G	585	4	0.67%	2	1	93	93	0.06218152895025356	1	1	375	210	4	0	+C
B10_BC22_191109_LF_LIB_consensus_vsearch	4215	C	*/+G	579	8	1.34%	2	1	93	93	0.003813602365568841	1	1	383	196	0	8	+G
B10_BC22_191109_LF_LIB_consensus_vsearch	4216	G	R	578	11	1.85%	2	2	93	93	4.658118229180549E-4	1	1	370	208	10	1	A
B10_BC22_191109_LF_LIB_consensus_vsearch	4217	G	G	596	1	0.17%	2	1	93	93	0.4999999999999138	1	1	382	214	1	0	-A
B10_BC22_191109_LF_LIB_consensus_vsearch	4218	A	A	589	5	0.84%	2	1	93	93	0.030987064506852544	1	1	375	214	5	0	G
B10_BC22_191109_LF_LIB_consensus_vsearch	4219	C	C	586	6	1%	2	1	93	93	0.015427383935577244	1	1	378	208	0	6	T
B10_BC22_191109_LF_LIB_consensus_vsearch	4220	G	*/-C	564	21	3.51%	2	2	93	93	3.972148329114764E-7	1	1	360	204	15	6	-C
B10_BC22_191109_LF_LIB_consensus_vsearch	4221	C	*/+T	562	11	1.91%	2	1	93	93	4.6519379419598136E-4	1	1	365	197	0	11	+T
B10_BC22_191109_LF_LIB_consensus_vsearch	4222	C	C	583	6	1%	2	1	93	93	0.015426379128433065	1	1	373	210	6	0	+G
B10_BC22_191109_LF_LIB_consensus_vsearch	4223	C	*/-T	512	55	9.17%	2	2	93	93	7.009141573881923E-18	1	1	355	157	8	47	-T
B10_BC22_191109_LF_LIB_consensus_vsearch	4224	T	Y	517	9	1.69%	2	2	93	93	0.0018868919421650878	1	1	353	164	7	2	C
B10_BC22_191109_LF_LIB_consensus_vsearch	4225	T	*/-G	537	32	5.46%	2	2	93	93	1.4870888419513183E-10	1	1	339	198	20	12	-G
B10_BC22_191109_LF_LIB_consensus_vsearch	4226	G	R	535	19	3.37%	2	2	93	93	1.6302834445702359E-6	1	1	339	196	18	1	A
B10_BC22_191109_LF_LIB_consensus_vsearch	4227	G	*/-C	553	24	4.02%	2	2	93	93	4.669215729174413E-8	1	1	347	206	23	1	-C
B10_BC22_191109_LF_LIB_consensus_vsearch	4228	C	*/+G	488	56	9.88%	2	1	93	93	3.1206629112941888E-18	1	1	286	202	56	0	+G
B10_BC22_191109_LF_LIB_consensus_vsearch	4229	A	*/-G	472	81	14.04%	2	2	93	93	1.7499802437555317E-26	1	1	272	200	79	2	-G
B10_BC22_191109_LF_LIB_consensus_vsearch	4230	G	*/+A	495	9	1.75%	2	1	93	93	0.0018840283452562008	1	1	289	206	9	0	+A
B10_BC22_191109_LF_LIB_consensus_vsearch	4231	G	R	568	19	3.18%	2	1	93	93	1.644966390386684E-6	1	1	359	209	19	0	A
B10_BC22_191109_LF_LIB_consensus_vsearch	4232	C	Y	565	9	1.51%	2	2	93	93	0.0018923842920326984	1	1	371	194	1	8	T
B10_BC22_191109_LF_LIB_consensus_vsearch	4233	T	T	578	4	0.68%	2	1	93	93	0.06217769690336766	1	1	377	201	0	4	+C
B10_BC22_191109_LF_LIB_consensus_vsearch	4234	T	*/-C	573	11	1.85%	2	2	93	93	4.656222726659411E-4	1	1	375	198	2	9	-C
B10_BC22_191109_LF_LIB_consensus_vsearch	4235	C	*/-G	436	77	13.16%	2	2	93	93	3.026270089170426E-25	1	1	368	68	2	75	-G
B10_BC22_191109_LF_LIB_consensus_vsearch	4236	G	R	445	31	6.37%	2	2	93	93	2.8111236731676504E-10	1	1	362	83	16	15	A
B10_BC22_191109_LF_LIB_consensus_vsearch	4237	G	R	544	13	2.29%	2	2	93	93	1.1372499157560235E-4	1	1	371	173	7	6	A
B10_BC22_191109_LF_LIB_consensus_vsearch	4238	C	M	545	34	5.74%	2	2	93	93	3.5341392770667614E-11	1	1	375	170	1	33	A
B10_BC22_191109_LF_LIB_consensus_vsearch	4239	C	Y	578	13	2.17%	2	2	93	93	1.1419423177491619E-4	1	1	376	202	2	11	T
B10_BC22_191109_LF_LIB_consensus_vsearch	4240	G	R	584	9	1.51%	2	2	93	93	0.0018943147174077597	1	1	374	210	7	2	A
B10_BC22_191109_LF_LIB_consensus_vsearch	4241	T	*/-C	559	26	4.36%	2	2	93	93	1.1217206665689526E-8	1	1	352	207	25	1	-C
B10_BC22_191109_LF_LIB_consensus_vsearch	4242	C	C	569	1	0.17%	2	1	93	93	0.5000000000008233	1	1	358	211	0	1	+A
B10_BC22_191109_LF_LIB_consensus_vsearch	4243	C	C	586	6	1%	2	1	93	93	0.015427383935577244	1	1	379	207	0	6	T
B10_BC22_191109_LF_LIB_consensus_vsearch	4244	G	R	573	18	3.01%	2	2	93	93	3.345009484593413E-6	1	1	363	210	17	1	A
B10_BC22_191109_LF_LIB_consensus_vsearch	4245	G	G	586	5	0.83%	2	1	93	93	0.030985730383315414	1	1	376	210	5	0	T
B10_BC22_191109_LF_LIB_consensus_vsearch	4246	C	C	591	1	0.17%	2	1	93	93	0.5000000000008233	1	1	381	210	1	0	+A
B10_BC22_191109_LF_LIB_consensus_vsearch	4247	G	G	592	3	0.5%	2	1	93	93	0.1246846089151382	1	1	378	214	3	0	A
B10_BC22_191109_LF_LIB_consensus_vsearch	4248	C	C	583	6	1.01%	2	2	93	93	0.015426379128433065	1	1	374	209	2	4	-GCGC
B10_BC22_191109_LF_LIB_consensus_vsearch	4249	G	G	579	6	1.02%	2	2	93	93	0.015425023382419913	1	1	370	209	5	1	A
B10_BC22_191109_LF_LIB_consensus_vsearch	4250	C	*/-GC	436	103	17.4%	2	2	93	93	4.476545193414266E-34	1	1	302	134	36	67	-GC
B10_BC22_191109_LF_LIB_consensus_vsearch	4251	G	*/-CT	432	9	1.95%	2	1	93	93	0.001874264864679625	1	1	296	136	9	0	-CT
B10_BC22_191109_LF_LIB_consensus_vsearch	4252	C	*/-TT	419	31	6.58%	2	2	93	93	2.7275089079502164E-10	1	1	286	133	30	1	-TT
B10_BC22_191109_LF_LIB_consensus_vsearch	4253	T	W	522	8	1.47%	2	2	93	93	0.0038037000521996237	1	1	318	204	7	1	A
B10_BC22_191109_LF_LIB_consensus_vsearch	4254	T	Y	542	16	2.82%	2	1	93	93	1.3682405604174076E-5	1	1	331	211	16	0	C
B10_BC22_191109_LF_LIB_consensus_vsearch	4255	A	A	592	3	0.5%	2	1	93	93	0.1246846089151382	1	1	379	213	3	0	+CA
B10_BC22_191109_LF_LIB_consensus_vsearch	4256	A	A	585	6	1%	2	1	93	93	0.015427050131369397	1	1	377	208	6	0	G
B10_BC22_191109_LF_LIB_consensus_vsearch	4257	C	*/-A	554	10	1.66%	2	2	93	93	9.380524120417961E-4	1	1	352	202	9	1	-A
B10_BC22_191109_LF_LIB_consensus_vsearch	4258	A	A	575	4	0.68%	2	2	93	93	0.062176026221018546	1	1	364	211	2	2	G
B10_BC22_191109_LF_LIB_consensus_vsearch	4259	A	R	542	21	3.54%	2	2	93	93	3.943366191347396E-7	1	1	329	213	20	1	G
B10_BC22_191109_LF_LIB_consensus_vsearch	4260	C	S	557	11	1.91%	2	1	93	93	4.6499362882328774E-4	1	1	347	210	11	0	G
B10_BC22_191109_LF_LIB_consensus_vsearch	4261	C	Y	577	9	1.52%	2	1	93	93	0.0018936179518815892	1	1	366	211	9	0	T
B10_BC22_191109_LF_LIB_consensus_vsearch	4262	A	A	582	4	0.68%	2	1	93	93	0.0621798978595429	1	1	370	212	4	0	G
B10_BC22_191109_LF_LIB_consensus_vsearch	4263	A	R	554	31	5.23%	2	1	93	93	3.0961703229048474E-10	1	1	341	213	31	0	G
B10_BC22_191109_LF_LIB_consensus_vsearch	4264	C	*/-T	562	15	2.5%	2	2	93	93	2.783111683740202E-5	1	1	359	203	9	6	-T
B10_BC22_191109_LF_LIB_consensus_vsearch	4265	T	Y	556	11	1.94%	2	2	93	93	4.6495317860755615E-4	1	1	351	205	8	3	C
B10_BC22_191109_LF_LIB_consensus_vsearch	4266	T	Y	549	13	2.23%	2	2	93	93	1.1379747226400809E-4	1	1	343	206	11	2	C
B10_BC22_191109_LF_LIB_consensus_vsearch	4267	A	A	581	6	1.02%	2	2	93	93	0.015425703561055139	1	1	378	203	2	4	+G
B10_BC22_191109_LF_LIB_consensus_vsearch	4268	G	G	595	2	0.33%	2	1	93	93	0.24979044425840527	1	1	381	214	2	0	A
B10_BC22_191109_LF_LIB_consensus_vsearch	4269	A	A	593	5	0.83%	2	2	93	93	0.03098882252468081	1	1	381	212	3	2	G
B10_BC22_191109_LF_LIB_consensus_vsearch	4270	A	A	595	2	0.33%	2	2	93	93	0.24979044425840527	1	1	383	212	1	1	+T
B10_BC22_191109_LF_LIB_consensus_vsearch	4271	C	C	590	3	0.5%	2	2	93	93	0.12468354430400949	1	1	376	214	2	1	-T
B10_BC22_191109_LF_LIB_consensus_vsearch	4272	T	*/+G	576	7	1.17%	2	1	93	93	0.007672278741851824	1	1	368	208	7	0	+G
B10_BC22_191109_LF_LIB_consensus_vsearch	4273	G	*/+A	576	9	1.52%	2	2	93	93	0.001893517063995506	1	1	365	211	8	1	+A
B10_BC22_191109_LF_LIB_consensus_vsearch	4274	G	G	589	3	0.5%	2	1	93	93	0.1246830092985462	1	1	376	213	3	0	+AG
B10_BC22_191109_LF_LIB_consensus_vsearch	4275	T	T	589	3	0.5%	2	1	93	93	0.1246830092985462	1	1	380	209	0	3	+A
B10_BC22_191109_LF_LIB_consensus_vsearch	4276	A	A	589	3	0.5%	2	2	93	93	0.1246830092985462	1	1	377	212	2	1	G
B10_BC22_191109_LF_LIB_consensus_vsearch	4277	C	*/-G	565	19	3.19%	2	1	93	93	1.6436960696383207E-6	1	1	378	187	0	19	-G
B10_BC22_191109_LF_LIB_consensus_vsearch	4278	G	G	574	4	0.69%	2	1	93	93	0.06217546547116354	1	1	380	194	4	0	A
B10_BC22_191109_LF_LIB_consensus_vsearch	4279	G	G	592	3	0.5%	2	1	93	93	0.1246846089151382	1	1	381	211	0	3	A
B10_BC22_191109_LF_LIB_consensus_vsearch	4280	A	A	591	2	0.34%	2	2	93	93	0.24978902953563295	1	1	379	212	1	1	-C
B10_BC22_191109_LF_LIB_consensus_vsearch	4281	C	*/+A	550	22	3.7%	2	2	93	93	1.9407111842786683E-7	1	1	346	204	20	2	+A
B10_BC22_191109_LF_LIB_consensus_vsearch	4282	A	A	574	6	1.03%	2	2	93	93	0.01542330244911806	1	1	367	207	1	5	+G
B10_BC22_191109_LF_LIB_consensus_vsearch	4283	A	*/+G	248	291	48.58%	2	2	93	93	3.7290474951969466E-112	1	1	213	35	140	151	+G
B10_BC22_191109_LF_LIB_consensus_vsearch	4284	G	G	562	2	0.35%	2	1	93	93	0.24977817213868056	1	1	365	197	2	0	+AG
B10_BC22_191109_LF_LIB_consensus_vsearch	4285	G	G	580	4	0.68%	2	1	93	93	0.06217880115194425	1	1	366	214	4	0	A
B10_BC22_191109_LF_LIB_consensus_vsearch	4286	G	G	592	3	0.5%	2	1	93	93	0.1246846089151382	1	1	379	213	3	0	-A
B10_BC22_191109_LF_LIB_consensus_vsearch	4287	A	A	594	1	0.17%	2	1	93	93	0.5000000000008233	1	1	381	213	0	1	G
B10_BC22_191109_LF_LIB_consensus_vsearch	4288	A	A	588	5	0.83%	2	2	93	93	0.0309866212982286	1	1	378	210	4	1	G
B10_BC22_191109_LF_LIB_consensus_vsearch	4289	T	Y	571	14	2.35%	2	2	93	93	5.6416550871607475E-5	1	1	366	205	11	3	C
B10_BC22_191109_LF_LIB_consensus_vsearch	4290	C	*/-T	572	16	2.68%	2	2	93	93	1.3759767168944509E-5	1	1	367	205	14	2	-T
B10_BC22_191109_LF_LIB_consensus_vsearch	4291	T	T	574	5	0.86%	2	1	93	93	0.030980255699410347	1	1	367	207	0	5	+G
B10_BC22_191109_LF_LIB_consensus_vsearch	4292	G	G	594	2	0.33%	2	1	93	93	0.24979009235977778	1	1	380	214	2	0	A
B10_BC22_191109_LF_LIB_consensus_vsearch	4293	A	R	586	8	1.34%	2	2	93	93	0.00381468814385855	1	1	374	212	7	1	G
B10_BC22_191109_LF_LIB_consensus_vsearch	4294	C	C	594	3	0.5%	2	2	93	93	0.12468566638724124	1	1	381	213	2	1	-T
B10_BC22_191109_LF_LIB_consensus_vsearch	4295	T	T	590	1	0.17%	2	1	93	93	0.5000000000008233	1	1	381	209	0	1	+A
B10_BC22_191109_LF_LIB_consensus_vsearch	4296	G	*/+T	580	9	1.51%	2	1	93	93	0.001893918576967777	1	1	380	200	0	9	+T
B10_BC22_191109_LF_LIB_consensus_vsearch	4297	T	*/+C	583	10	1.68%	2	1	93	93	9.399148640318375E-4	1	1	371	212	10	0	+C
B10_BC22_191109_LF_LIB_consensus_vsearch	4298	C	*/-T	579	14	2.35%	2	2	93	93	5.647716467319973E-5	1	1	379	200	2	12	-T
B10_BC22_191109_LF_LIB_consensus_vsearch	4299	T	T	560	4	0.7%	2	1	93	93	0.06216740609286385	1	1	362	198	4	0	-A
B10_BC22_191109_LF_LIB_consensus_vsearch	4300	A	A	568	5	0.87%	2	1	93	93	0.03097743240611924	1	1	356	212	5	0	G
B10_BC22_191109_LF_LIB_consensus_vsearch	4301	A	A	559	4	0.7%	2	1	93	93	0.062166815078796796	1	1	351	208	4	0	G
B10_BC22_191109_LF_LIB_consensus_vsearch	4302	T	K	551	10	1.78%	2	1	93	93	9.378488845021741E-4	1	1	342	209	10	0	G
B10_BC22_191109_LF_LIB_consensus_vsearch	4303	T	*/-A	499	34	6.18%	2	2	93	93	3.380404097695379E-11	1	1	336	163	1	33	-A
B10_BC22_191109_LF_LIB_consensus_vsearch	4304	A	A	505	2	0.39%	2	2	93	93	0.24975320829221143	1	1	329	176	1	1	C
B10_BC22_191109_LF_LIB_consensus_vsearch	4305	A	A	532	0	0%	2	0	93	0	1.0	1	0	323	209	0	0	
B10_BC22_191109_LF_LIB_consensus_vsearch	4306	A	A	521	1	0.19%	2	1	93	93	0.4999999999999138	1	1	312	209	1	0	G
B10_BC22_191109_LF_LIB_consensus_vsearch	4307	A	A	495	5	1%	2	2	93	93	0.030937657818279934	1	1	288	207	4	1	G
B10_BC22_191109_LF_LIB_consensus_vsearch	4308	C	C	477	0	0%	2	0	93	0	1.0	1	0	272	205	0	0	
B10_BC22_191109_LF_LIB_consensus_vsearch	4309	A	A	450	0	0%	2	0	93	0	1.0	1	0	248	202	0	0	
B10_BC22_191109_LF_LIB_consensus_vsearch	4310	T	T	436	0	0%	2	0	93	0	1.0	1	0	236	200	0	0	
