Chrom	Position	Ref	Cons	Reads1	Reads2	VarFreq	Strands1	Strands2	Qual1	Qual2	Pvalue	MapQual1	MapQual2	Reads1Plus	Reads1Minus	Reads2Plus	Reads2Minus	VarAllele
D3_BC39_191109_LF_LIB_consensus_vsearch	3	G	*/+T	172	7	3.63%	2	2	93	93	0.007359395499810914	1	1	124	48	6	1	+T
D3_BC39_191109_LF_LIB_consensus_vsearch	3	G	*/-T	172	14	7.25%	2	2	93	93	4.734944773282747E-5	1	1	124	48	13	1	-T
D3_BC39_191109_LF_LIB_consensus_vsearch	11	T	*/+G	209	15	6.58%	2	1	93	93	2.3951800712612044E-5	1	1	131	78	15	0	+G
D3_BC39_191109_LF_LIB_consensus_vsearch	12	A	*/-G	207	16	7.05%	2	2	93	93	1.1546128752618848E-5	1	1	131	76	15	1	-G
D3_BC39_191109_LF_LIB_consensus_vsearch	18	T	*/+C	221	8	3.45%	2	1	93	93	0.003670845031231652	1	1	142	79	8	0	+C
D3_BC39_191109_LF_LIB_consensus_vsearch	24	T	*/+C	102	104	44.83%	2	2	93	93	1.0109003786746295E-39	1	1	52	50	81	23	+C
D3_BC39_191109_LF_LIB_consensus_vsearch	24	T	*/-C	102	11	4.74%	2	2	93	93	3.7825617668350777E-4	1	1	52	50	10	1	+C
D3_BC39_191109_LF_LIB_consensus_vsearch	31	T	*/-C	205	22	9.52%	2	1	93	93	1.3972894763610762E-7	1	1	125	80	22	0	-C
D3_BC39_191109_LF_LIB_consensus_vsearch	57	C	*/-A	213	11	4.76%	2	2	93	93	4.305938947768699E-4	1	1	141	72	8	3	-A
D3_BC39_191109_LF_LIB_consensus_vsearch	59	A	*/-G	216	7	3.07%	2	2	93	93	0.007447971960236055	1	1	146	70	4	3	-G
D3_BC39_191109_LF_LIB_consensus_vsearch	61	G	*/-C	209	19	8.19%	2	1	93	93	1.2901274566237775E-6	1	1	128	81	19	0	-C
D3_BC39_191109_LF_LIB_consensus_vsearch	70	C	*/-A	185	19	8.23%	2	2	93	93	1.2293989173894143E-6	1	1	130	55	11	8	-A
D3_BC39_191109_LF_LIB_consensus_vsearch	70	C	*/-AA	185	15	6.49%	2	2	93	93	2.323978273518884E-5	1	1	130	55	2	13	-A
D3_BC39_191109_LF_LIB_consensus_vsearch	74	G	*/+C	82	81	35.22%	2	2	93	93	5.9920464118499635E-31	1	1	56	26	78	3	+C
D3_BC39_191109_LF_LIB_consensus_vsearch	74	G	*/-C	82	34	14.78%	2	2	93	93	3.4016852641626927E-12	1	1	56	26	10	24	+C
D3_BC39_191109_LF_LIB_consensus_vsearch	74	G	*/-CC	82	10	4.35%	2	2	93	93	7.54483973495983E-4	1	1	56	26	1	9	+C
D3_BC39_191109_LF_LIB_consensus_vsearch	74	G	*/-CCC	82	9	3.91%	2	1	93	93	0.0015870180132160528	1	1	56	26	0	9	+C
D3_BC39_191109_LF_LIB_consensus_vsearch	78	C	*/-T	216	7	3.02%	2	1	93	93	0.007447971960236055	1	1	150	66	0	7	-T
D3_BC39_191109_LF_LIB_consensus_vsearch	82	C	*/-G	198	11	4.82%	2	2	93	93	4.2662591196418204E-4	1	1	127	71	6	5	-G
D3_BC39_191109_LF_LIB_consensus_vsearch	90	A	*/-C	191	18	7.86%	2	2	93	93	2.6031386084308115E-6	1	1	122	69	10	8	-C
D3_BC39_191109_LF_LIB_consensus_vsearch	98	A	*/-C	219	8	3.46%	2	2	93	93	0.0036688013849068284	1	1	142	77	6	2	-C
D3_BC39_191109_LF_LIB_consensus_vsearch	104	G	*/+C	187	7	3.06%	2	2	93	93	0.007394057154213738	1	1	107	80	6	1	+C
D3_BC39_191109_LF_LIB_consensus_vsearch	104	G	*/-C	187	27	11.79%	2	1	93	93	3.1063115975699223E-9	1	1	107	80	27	0	-C
D3_BC39_191109_LF_LIB_consensus_vsearch	114	C	*/-T	199	25	10.82%	2	2	93	93	1.4670068930690744E-8	1	1	142	57	3	22	-T
D3_BC39_191109_LF_LIB_consensus_vsearch	120	A	*/-CA	210	13	5.73%	2	2	93	93	1.0196623731956113E-4	1	1	142	68	1	12	-CA
D3_BC39_191109_LF_LIB_consensus_vsearch	129	G	*/-T	218	7	3.07%	2	2	93	93	0.007451182688346346	1	1	150	68	1	6	-T
D3_BC39_191109_LF_LIB_consensus_vsearch	130	T	*/+A	192	10	4.5%	2	1	93	93	8.712766047726398E-4	1	1	125	67	10	0	+A
D3_BC39_191109_LF_LIB_consensus_vsearch	130	T	*/-G	192	14	6.31%	2	1	93	93	4.85721545340522E-5	1	1	125	67	14	0	-G
D3_BC39_191109_LF_LIB_consensus_vsearch	131	G	*/-A	192	18	8.37%	2	2	93	93	2.608089386660468E-6	1	1	116	76	17	1	-A
D3_BC39_191109_LF_LIB_consensus_vsearch	133	G	*/+C	138	11	4.8%	2	2	93	93	4.032454159345352E-4	1	1	80	58	10	1	+C
D3_BC39_191109_LF_LIB_consensus_vsearch	133	G	*/-C	138	47	20.52%	2	2	93	93	2.4850032769228956E-16	1	1	80	58	28	19	-C
D3_BC39_191109_LF_LIB_consensus_vsearch	133	G	*/-CC	138	30	13.1%	2	1	93	93	2.2478876851103153E-10	1	1	80	58	30	0	-C
D3_BC39_191109_LF_LIB_consensus_vsearch	134	C	*/+T	131	13	8.44%	2	1	93	93	9.196237111779333E-5	1	1	84	47	0	13	+T
D3_BC39_191109_LF_LIB_consensus_vsearch	137	C	*/-GC	200	8	3.45%	2	2	93	93	0.003647458600901869	1	1	141	59	5	3	-GC
D3_BC39_191109_LF_LIB_consensus_vsearch	150	T	*/-G	206	15	6.58%	2	2	93	93	2.3870469071571428E-5	1	1	138	68	6	9	-G
D3_BC39_191109_LF_LIB_consensus_vsearch	156	G	*/-CG	197	20	8.7%	2	2	93	93	6.029113548186886E-7	1	1	122	75	18	2	-CG
D3_BC39_191109_LF_LIB_consensus_vsearch	158	G	*/-T	187	8	3.83%	2	2	93	93	0.0036305010705765203	1	1	115	72	7	1	-T
D3_BC39_191109_LF_LIB_consensus_vsearch	162	T	*/+C	219	7	3.02%	2	1	93	93	0.007452766938834958	1	1	141	78	7	0	+C
D3_BC39_191109_LF_LIB_consensus_vsearch	164	G	*/-A	213	11	4.82%	2	1	93	93	4.305938947768699E-4	1	1	135	78	11	0	-A
D3_BC39_191109_LF_LIB_consensus_vsearch	166	A	*/-G	218	10	4.29%	2	1	93	93	8.829313223014774E-4	1	1	141	77	10	0	-G
D3_BC39_191109_LF_LIB_consensus_vsearch	168	G	*/-C	212	12	5.15%	2	1	93	93	2.0987757342671282E-4	1	1	132	80	12	0	-C
D3_BC39_191109_LF_LIB_consensus_vsearch	175	G	*/-TG	202	14	6.14%	2	2	93	93	4.9105420013800674E-5	1	1	141	61	1	13	-TG
D3_BC39_191109_LF_LIB_consensus_vsearch	177	G	*/+C	171	25	11.85%	2	1	93	93	1.3166237659877573E-8	1	1	111	60	25	0	+C
D3_BC39_191109_LF_LIB_consensus_vsearch	177	G	*/-C	171	13	6.16%	2	2	93	93	9.80172223605813E-5	1	1	111	60	12	1	+C
D3_BC39_191109_LF_LIB_consensus_vsearch	178	C	*/+T	202	9	4.21%	2	1	93	93	0.0017902638323438202	1	1	138	64	0	9	+T
D3_BC39_191109_LF_LIB_consensus_vsearch	182	G	*/-C	152	69	29.87%	2	2	93	93	3.05898087216433E-24	1	1	87	65	55	14	-C
D3_BC39_191109_LF_LIB_consensus_vsearch	188	A	*/-G	223	7	3.03%	2	1	93	93	0.007458967428082863	1	1	141	82	7	0	-G
D3_BC39_191109_LF_LIB_consensus_vsearch	190	A	*/-G	220	8	3.46%	2	2	93	93	0.0036698276230520683	1	1	141	79	7	1	-G
D3_BC39_191109_LF_LIB_consensus_vsearch	193	C	*/-A	206	15	6.41%	2	1	93	93	2.3870469071571428E-5	1	1	127	79	15	0	-A
D3_BC39_191109_LF_LIB_consensus_vsearch	193	C	*/-AC	206	9	3.85%	2	1	93	93	0.001793225137980622	1	1	127	79	9	0	-A
D3_BC39_191109_LF_LIB_consensus_vsearch	198	C	*/-T	181	42	17.95%	2	2	93	93	2.6958399310963214E-14	1	1	130	51	17	25	-T
D3_BC39_191109_LF_LIB_consensus_vsearch	206	G	*/-A	220	11	4.72%	2	1	93	93	4.322761391918409E-4	1	1	138	82	11	0	-A
D3_BC39_191109_LF_LIB_consensus_vsearch	207	A	*/-G	212	9	4.05%	2	1	93	93	0.00179747064240055	1	1	130	82	9	0	-G
D3_BC39_191109_LF_LIB_consensus_vsearch	215	G	*/-A	218	11	4.7%	2	2	93	93	4.318055810374596E-4	1	1	138	80	10	1	-A
D3_BC39_191109_LF_LIB_consensus_vsearch	216	A	*/-G	214	8	3.59%	2	1	93	93	0.003663533633296164	1	1	133	81	8	0	-G
D3_BC39_191109_LF_LIB_consensus_vsearch	222	C	*/-TT	209	10	4.31%	2	1	93	93	8.792003591123169E-4	1	1	135	74	10	0	-TT
D3_BC39_191109_LF_LIB_consensus_vsearch	232	T	*/-C	168	50	21.55%	2	2	93	93	3.70025722198237E-17	1	1	113	55	32	18	-C
D3_BC39_191109_LF_LIB_consensus_vsearch	235	C	*/-T	214	9	3.88%	2	2	93	93	0.0017988361772468277	1	1	144	70	4	5	-T
D3_BC39_191109_LF_LIB_consensus_vsearch	239	T	*/-C	220	9	3.86%	2	2	93	93	0.0018027927820038396	1	1	140	80	8	1	-C
D3_BC39_191109_LF_LIB_consensus_vsearch	242	A	*/-CA	217	8	3.49%	2	2	93	93	0.0036667219549938834	1	1	136	81	7	1	-CA
D3_BC39_191109_LF_LIB_consensus_vsearch	259	T	*/-A	211	12	5.15%	2	1	93	93	2.0973150235371546E-4	1	1	134	77	12	0	-A
D3_BC39_191109_LF_LIB_consensus_vsearch	273	C	*/-T	221	7	3%	2	2	93	93	0.007455894130096957	1	1	150	71	1	6	-T
D3_BC39_191109_LF_LIB_consensus_vsearch	275	A	*/+G	209	8	3.49%	2	2	93	93	0.003658026926953576	1	1	144	65	1	7	+G
D3_BC39_191109_LF_LIB_consensus_vsearch	275	A	*/-G	209	9	3.93%	2	1	93	93	0.0017953764342624938	1	1	144	65	0	9	-G
D3_BC39_191109_LF_LIB_consensus_vsearch	277	G	*/-A	227	7	2.99%	2	2	93	93	0.0074649578216797186	1	1	146	81	6	1	-A
D3_BC39_191109_LF_LIB_consensus_vsearch	294	T	*/-G	209	7	3.03%	2	2	93	93	0.007436270701269745	1	1	143	66	3	4	-G
D3_BC39_191109_LF_LIB_consensus_vsearch	307	G	*/-CG	211	9	3.86%	2	2	93	93	0.0017967787753331713	1	1	138	73	3	6	-CG
D3_BC39_191109_LF_LIB_consensus_vsearch	309	G	*/-A	209	9	4.07%	2	1	93	93	0.0017953764342624938	1	1	135	74	9	0	-A
D3_BC39_191109_LF_LIB_consensus_vsearch	312	A	*/-G	203	17	7.56%	2	1	93	93	5.533354906074952E-6	1	1	122	81	17	0	-G
D3_BC39_191109_LF_LIB_consensus_vsearch	313	G	*/-A	160	8	3.79%	2	1	93	93	0.003587066500341587	1	1	85	75	8	0	-A
D3_BC39_191109_LF_LIB_consensus_vsearch	313	G	*/-AG	160	37	17.54%	2	2	93	93	1.1256859288964178E-12	1	1	85	75	31	6	-AG
D3_BC39_191109_LF_LIB_consensus_vsearch	314	A	*/-G	152	19	10.27%	2	1	93	93	1.1239323973559722E-6	1	1	79	73	19	0	-G
D3_BC39_191109_LF_LIB_consensus_vsearch	317	C	*/+A	193	7	3.06%	2	1	93	93	0.007406481321433913	1	1	116	77	7	0	+A
D3_BC39_191109_LF_LIB_consensus_vsearch	317	C	*/-A	193	26	11.35%	2	2	93	93	6.773779009274082E-9	1	1	116	77	25	1	-A
D3_BC39_191109_LF_LIB_consensus_vsearch	333	G	*/+T	186	8	3.4%	2	1	93	93	0.0036291041675517713	1	1	116	70	8	0	+T
D3_BC39_191109_LF_LIB_consensus_vsearch	333	G	*/-T	186	35	14.89%	2	2	93	93	6.7463415254651095E-12	1	1	116	70	28	7	-T
D3_BC39_191109_LF_LIB_consensus_vsearch	338	C	*/-A	200	18	7.73%	2	2	93	93	2.6463038722080364E-6	1	1	127	73	14	4	-A
D3_BC39_191109_LF_LIB_consensus_vsearch	340	A	*/-G	200	20	8.7%	2	2	93	93	6.068719674831118E-7	1	1	144	56	5	15	-G
D3_BC39_191109_LF_LIB_consensus_vsearch	351	A	*/-G	204	13	5.73%	2	2	93	93	1.0144502228683225E-4	1	1	140	64	3	10	-G
D3_BC39_191109_LF_LIB_consensus_vsearch	355	T	*/-AC	214	7	3.04%	2	1	93	93	0.007444703667648697	1	1	137	77	7	0	-AC
D3_BC39_191109_LF_LIB_consensus_vsearch	357	C	*/-G	199	23	10.18%	2	1	93	93	6.53893261033232E-8	1	1	142	57	0	23	-G
D3_BC39_191109_LF_LIB_consensus_vsearch	362	C	*/+A	125	9	3.86%	2	1	93	93	0.0017000847690847789	1	1	81	44	9	0	+A
D3_BC39_191109_LF_LIB_consensus_vsearch	362	C	*/-G	125	88	37.77%	2	2	93	93	3.4821720847329694E-32	1	1	81	44	56	32	-G
D3_BC39_191109_LF_LIB_consensus_vsearch	369	T	*/+C	210	14	6.03%	2	1	93	93	4.950038813942507E-5	1	1	134	76	14	0	+C
D3_BC39_191109_LF_LIB_consensus_vsearch	371	A	*/+G	214	7	3.06%	2	1	93	93	0.007444703667648697	1	1	143	71	0	7	+G
D3_BC39_191109_LF_LIB_consensus_vsearch	373	A	*/+C	200	7	3.03%	2	1	93	93	0.007420075094973923	1	1	124	76	7	0	+C
D3_BC39_191109_LF_LIB_consensus_vsearch	373	A	*/-C	200	20	8.66%	2	2	93	93	6.068719674831118E-7	1	1	124	76	15	5	-C
D3_BC39_191109_LF_LIB_consensus_vsearch	374	C	*/+T	203	8	3.76%	2	1	93	93	0.0036510799339400076	1	1	135	68	0	8	+T
D3_BC39_191109_LF_LIB_consensus_vsearch	381	C	*/-TC	208	14	6.09%	2	1	93	93	4.9404108604884E-5	1	1	147	61	0	14	-TC
D3_BC39_191109_LF_LIB_consensus_vsearch	382	T	*/-C	180	7	3.26%	2	2	93	93	0.007378565932456183	1	1	144	36	3	4	-C
D3_BC39_191109_LF_LIB_consensus_vsearch	382	T	*/-CCT	180	22	10.23%	2	1	93	93	1.3029343376067508E-7	1	1	144	36	0	22	-CCT
D3_BC39_191109_LF_LIB_consensus_vsearch	385	T	*/+C	195	9	4.35%	2	1	93	93	0.0017848089483517727	1	1	140	55	9	0	+C
D3_BC39_191109_LF_LIB_consensus_vsearch	389	C	*/-G	214	11	4.7%	2	2	93	93	4.308403683968055E-4	1	1	146	68	2	9	-G
D3_BC39_191109_LF_LIB_consensus_vsearch	391	G	*/-C	215	14	5.96%	2	2	93	93	4.973428022334695E-5	1	1	135	80	12	2	-C
D3_BC39_191109_LF_LIB_consensus_vsearch	398	C	*/-A	225	7	2.99%	2	1	93	93	0.0074619882138406745	1	1	143	82	7	0	-A
D3_BC39_191109_LF_LIB_consensus_vsearch	399	A	*/-CA	203	17	7.46%	2	2	93	93	5.533354906074952E-6	1	1	126	77	15	2	-CA
D3_BC39_191109_LF_LIB_consensus_vsearch	404	T	*/+C	211	7	3%	2	2	93	93	0.007439689863414905	1	1	133	78	6	1	+C
D3_BC39_191109_LF_LIB_consensus_vsearch	404	T	*/-C	211	12	5.15%	2	2	93	93	2.0973150235371546E-4	1	1	133	78	10	2	-C
D3_BC39_191109_LF_LIB_consensus_vsearch	406	C	*/-G	210	19	8.05%	2	1	93	93	1.2924262145172922E-6	1	1	148	62	0	19	-G
D3_BC39_191109_LF_LIB_consensus_vsearch	410	C	*/+A	219	12	5.08%	2	1	93	93	2.10866409362083E-4	1	1	136	83	12	0	+A
D3_BC39_191109_LF_LIB_consensus_vsearch	411	G	*/+A	216	9	3.83%	2	1	93	93	0.0018001779733764346	1	1	142	74	0	9	+A
D3_BC39_191109_LF_LIB_consensus_vsearch	411	G	*/-A	216	9	3.83%	2	1	93	93	0.0018001779733764346	1	1	142	74	9	0	+A
D3_BC39_191109_LF_LIB_consensus_vsearch	419	T	*/-C	194	32	13.56%	2	2	93	93	7.149728355205515E-11	1	1	149	45	3	29	-C
D3_BC39_191109_LF_LIB_consensus_vsearch	425	G	*/-C	213	9	3.81%	2	2	93	93	0.0017981564163397133	1	1	136	77	8	1	-C
D3_BC39_191109_LF_LIB_consensus_vsearch	426	C	*/+T	210	9	4.05%	2	2	93	93	0.0017960807336148846	1	1	139	71	1	8	+T
D3_BC39_191109_LF_LIB_consensus_vsearch	437	T	*/+C	224	9	3.81%	2	2	93	93	0.0018053197291553536	1	1	145	79	8	1	+C
D3_BC39_191109_LF_LIB_consensus_vsearch	438	C	*/-G	219	10	4.27%	2	1	93	93	8.833283118953115E-4	1	1	150	69	0	10	-G
D3_BC39_191109_LF_LIB_consensus_vsearch	445	C	*/-A	217	11	4.68%	2	1	93	93	4.3156732794080477E-4	1	1	137	80	11	0	-A
D3_BC39_191109_LF_LIB_consensus_vsearch	448	G	*/-A	222	7	3.03%	2	1	93	93	0.007457437428309682	1	1	140	82	7	0	-A
D3_BC39_191109_LF_LIB_consensus_vsearch	453	C	*/+T	214	7	2.99%	2	2	93	93	0.007444703667648697	1	1	140	74	2	5	+T
D3_BC39_191109_LF_LIB_consensus_vsearch	457	T	*/-C	201	24	10.21%	2	2	93	93	3.1195657998345904E-8	1	1	124	77	20	4	-C
D3_BC39_191109_LF_LIB_consensus_vsearch	476	T	*/-C	209	18	7.69%	2	1	93	93	2.686535435987739E-6	1	1	127	82	18	0	-C
D3_BC39_191109_LF_LIB_consensus_vsearch	488	T	*/-AT	216	7	3.02%	2	2	93	93	0.007447971960236055	1	1	146	70	2	5	-AT
D3_BC39_191109_LF_LIB_consensus_vsearch	505	A	*/-C	209	11	4.66%	2	2	93	93	4.2958650804029443E-4	1	1	146	63	2	9	-C
D3_BC39_191109_LF_LIB_consensus_vsearch	507	C	*/+T	216	7	3.06%	2	1	93	93	0.007447971960236055	1	1	153	63	0	7	+T
D3_BC39_191109_LF_LIB_consensus_vsearch	508	T	*/-C	199	12	5.26%	2	1	93	93	2.078764879814198E-4	1	1	149	50	0	12	-C
D3_BC39_191109_LF_LIB_consensus_vsearch	508	T	*/-CCT	199	13	5.7%	2	2	93	93	1.0098964132434686E-4	1	1	149	50	3	10	-CCT
D3_BC39_191109_LF_LIB_consensus_vsearch	511	T	*/+C	195	15	6.91%	2	1	93	93	2.3554302919744083E-5	1	1	132	63	15	0	+C
D3_BC39_191109_LF_LIB_consensus_vsearch	512	C	*/-G	185	36	15.79%	2	2	93	93	3.0830946529165486E-12	1	1	150	35	1	35	-G
D3_BC39_191109_LF_LIB_consensus_vsearch	525	C	*/+A	217	9	3.83%	2	1	93	93	0.0018008401619304512	1	1	138	79	9	0	+A
D3_BC39_191109_LF_LIB_consensus_vsearch	526	G	*/-A	222	9	3.88%	2	1	93	93	0.001804066959286255	1	1	139	83	9	0	-A
D3_BC39_191109_LF_LIB_consensus_vsearch	538	C	*/+T	194	8	3.39%	2	2	93	93	0.003639898683792886	1	1	129	65	7	1	+T
D3_BC39_191109_LF_LIB_consensus_vsearch	538	C	*/-T	194	17	7.2%	2	2	93	93	5.454975141743846E-6	1	1	129	65	8	9	-T
D3_BC39_191109_LF_LIB_consensus_vsearch	541	T	*/-C	158	54	23.48%	2	2	93	93	1.1510890454179998E-18	1	1	119	39	28	26	-C
D3_BC39_191109_LF_LIB_consensus_vsearch	541	T	*/-CC	158	9	3.91%	2	2	93	93	0.0017486067130074762	1	1	119	39	2	7	-C
D3_BC39_191109_LF_LIB_consensus_vsearch	544	C	*/-T	182	13	5.68%	2	2	93	93	9.927932507195894E-5	1	1	142	40	2	11	-T
D3_BC39_191109_LF_LIB_consensus_vsearch	544	C	*/-TT	182	17	7.42%	2	2	93	93	5.340986808569128E-6	1	1	142	40	4	13	-TT
D3_BC39_191109_LF_LIB_consensus_vsearch	551	C	*/-G	208	13	5.56%	2	1	93	93	1.0179544238135389E-4	1	1	149	59	0	13	-G
D3_BC39_191109_LF_LIB_consensus_vsearch	555	C	*/+A	137	11	4.72%	2	1	93	93	4.027050173603899E-4	1	1	97	40	11	0	+A
D3_BC39_191109_LF_LIB_consensus_vsearch	555	C	*/-G	137	77	33.05%	2	2	93	93	1.5010539914537377E-27	1	1	97	40	42	35	-G
D3_BC39_191109_LF_LIB_consensus_vsearch	558	G	*/+C	200	7	2.99%	2	2	93	93	0.007420075094973923	1	1	143	57	1	6	+C
D3_BC39_191109_LF_LIB_consensus_vsearch	563	A	*/-C	203	28	11.91%	2	2	93	93	1.559864420575843E-9	1	1	144	59	4	24	-C
D3_BC39_191109_LF_LIB_consensus_vsearch	564	C	*/+A	158	10	4.81%	2	1	93	93	8.508146096123988E-4	1	1	101	57	10	0	+A
D3_BC39_191109_LF_LIB_consensus_vsearch	564	C	*/+AG	158	14	6.73%	2	1	93	93	4.6341308469083375E-5	1	1	101	57	14	0	+AG
D3_BC39_191109_LF_LIB_consensus_vsearch	565	G	*/+AG	114	105	44.68%	2	2	93	93	1.4471248199794087E-39	1	1	78	36	59	46	+AG
D3_BC39_191109_LF_LIB_consensus_vsearch	565	G	*/-C	114	8	3.4%	2	1	93	93	0.0034700373777167863	1	1	78	36	8	0	+AG
D3_BC39_191109_LF_LIB_consensus_vsearch	567	G	*/+C	207	14	6.01%	2	2	93	93	4.93553660030744E-5	1	1	128	79	13	1	+C
D3_BC39_191109_LF_LIB_consensus_vsearch	568	C	*/+G	192	24	10.62%	2	2	93	93	3.031731300607618E-8	1	1	122	70	20	4	+G
D3_BC39_191109_LF_LIB_consensus_vsearch	571	C	*/-A	186	26	11.06%	2	1	93	93	6.588494101249739E-9	1	1	110	76	26	0	-A
D3_BC39_191109_LF_LIB_consensus_vsearch	572	A	*/+C	176	7	3.38%	2	1	93	93	0.007369187819667051	1	1	94	82	7	0	+C
D3_BC39_191109_LF_LIB_consensus_vsearch	574	G	*/+T	218	7	3%	2	1	93	93	0.007451182688346346	1	1	137	81	7	0	+T
D3_BC39_191109_LF_LIB_consensus_vsearch	579	T	*/-A	204	17	7.23%	2	2	93	93	5.541719766097385E-6	1	1	128	76	14	3	-A
D3_BC39_191109_LF_LIB_consensus_vsearch	581	A	*/-G	186	32	13.85%	2	2	93	93	6.822874621997747E-11	1	1	110	76	31	1	-G
D3_BC39_191109_LF_LIB_consensus_vsearch	592	T	*/+C	70	137	61.99%	2	2	93	93	3.354520426361786E-57	1	1	35	35	110	27	+C
D3_BC39_191109_LF_LIB_consensus_vsearch	592	T	*/-CC	70	10	4.52%	2	1	93	93	7.24035494267502E-4	1	1	35	35	0	10	+C
D3_BC39_191109_LF_LIB_consensus_vsearch	594	C	*/+T	176	23	10.41%	2	1	93	93	6.074653290361054E-8	1	1	140	36	0	23	+T
D3_BC39_191109_LF_LIB_consensus_vsearch	596	C	*/-T	212	8	3.45%	2	2	93	93	0.003661360523321731	1	1	140	72	4	4	-T
D3_BC39_191109_LF_LIB_consensus_vsearch	599	A	*/-G	195	26	11.3%	2	2	93	93	6.825326034146069E-9	1	1	140	55	3	23	-G
D3_BC39_191109_LF_LIB_consensus_vsearch	610	A	*/+C	200	11	4.7%	2	1	93	93	4.27186182801716E-4	1	1	118	82	11	0	+C
D3_BC39_191109_LF_LIB_consensus_vsearch	610	A	*/-C	200	18	7.69%	2	2	93	93	2.6463038722080364E-6	1	1	118	82	17	1	-C
D3_BC39_191109_LF_LIB_consensus_vsearch	638	A	*/-C	211	16	6.84%	2	2	93	93	1.1605032761469583E-5	1	1	134	77	11	5	-C
D3_BC39_191109_LF_LIB_consensus_vsearch	643	T	*/+C	172	9	3.83%	2	2	93	93	0.0017639971126793845	1	1	116	56	5	4	+C
D3_BC39_191109_LF_LIB_consensus_vsearch	643	T	*/-C	172	47	20%	2	2	93	93	4.462661594622456E-16	1	1	116	56	27	20	-C
D3_BC39_191109_LF_LIB_consensus_vsearch	651	T	*/+C	206	25	10.64%	2	1	93	93	1.500696212906936E-8	1	1	124	82	25	0	+C
D3_BC39_191109_LF_LIB_consensus_vsearch	657	T	*/-AC	204	16	6.93%	2	1	93	93	1.1500698432241858E-5	1	1	125	79	16	0	-AC
D3_BC39_191109_LF_LIB_consensus_vsearch	658	A	*/-C	182	7	3.29%	2	2	93	93	0.007383107786177688	1	1	106	76	3	4	-C
D3_BC39_191109_LF_LIB_consensus_vsearch	658	A	*/-CC	182	8	3.76%	2	1	93	93	0.003623372158916335	1	1	106	76	8	0	-CC
D3_BC39_191109_LF_LIB_consensus_vsearch	661	C	*/-G	215	15	6.36%	2	1	93	93	2.4108665249874024E-5	1	1	152	63	0	15	-G
D3_BC39_191109_LF_LIB_consensus_vsearch	670	C	*/-G	179	27	11.64%	2	1	93	93	2.9953751163025596E-9	1	1	101	78	27	0	-G
D3_BC39_191109_LF_LIB_consensus_vsearch	671	G	*/-A	180	17	8.25%	2	1	93	93	5.3208311801134965E-6	1	1	98	82	17	0	-A
D3_BC39_191109_LF_LIB_consensus_vsearch	676	T	*/-A	207	17	7.2%	2	1	93	93	5.56642225097613E-6	1	1	132	75	17	0	-A
D3_BC39_191109_LF_LIB_consensus_vsearch	676	T	*/-AT	207	7	2.97%	2	2	93	93	0.007432788253078562	1	1	132	75	1	6	-A
D3_BC39_191109_LF_LIB_consensus_vsearch	677	A	*/+T	192	8	3.77%	2	2	93	93	0.0036372796311357324	1	1	118	74	6	2	+T
D3_BC39_191109_LF_LIB_consensus_vsearch	677	A	*/-T	192	7	3.3%	2	1	93	93	0.007404462106241813	1	1	118	74	7	0	+T
D3_BC39_191109_LF_LIB_consensus_vsearch	685	C	*/-TAC	219	9	3.85%	2	1	93	93	0.0018021474934649558	1	1	144	75	9	0	-TAC
D3_BC39_191109_LF_LIB_consensus_vsearch	690	A	*/-C	215	10	4.29%	2	2	93	93	8.817198236951184E-4	1	1	135	80	9	1	-C
D3_BC39_191109_LF_LIB_consensus_vsearch	692	C	*/-A	215	7	3.04%	2	2	93	93	0.007446345105805389	1	1	137	78	5	2	-A
D3_BC39_191109_LF_LIB_consensus_vsearch	704	T	*/-A	201	18	7.73%	2	2	93	93	2.6509133703959145E-6	1	1	123	78	16	2	-A
D3_BC39_191109_LF_LIB_consensus_vsearch	705	A	*/-G	155	28	13.02%	2	2	93	93	1.218017738367064E-9	1	1	112	43	20	8	-G
D3_BC39_191109_LF_LIB_consensus_vsearch	705	A	*/-GG	155	10	4.65%	2	1	93	93	8.486212450770172E-4	1	1	112	43	0	10	-G
D3_BC39_191109_LF_LIB_consensus_vsearch	705	A	*/-GGG	155	20	9.3%	2	1	93	93	5.365196666040845E-7	1	1	112	43	0	20	-GGG
D3_BC39_191109_LF_LIB_consensus_vsearch	709	G	*/-C	29	23	9.75%	2	2	93	93	5.134835666107953E-9	1	1	17	12	18	5	-C
D3_BC39_191109_LF_LIB_consensus_vsearch	709	G	-CC/-CC	29	179	75.85%	2	2	93	93	2.1125945412311493E-87	1	1	17	12	114	65	-CC
D3_BC39_191109_LF_LIB_consensus_vsearch	713	C	*/-G	209	8	3.39%	2	2	93	93	0.003658026926953576	1	1	140	69	4	4	-G
D3_BC39_191109_LF_LIB_consensus_vsearch	715	C	*/-T	211	10	4.27%	2	2	93	93	8.800549103686053E-4	1	1	145	66	3	7	-T
D3_BC39_191109_LF_LIB_consensus_vsearch	715	C	*/-TCC	211	7	2.99%	2	1	93	93	0.007439689863414905	1	1	145	66	0	7	-T
D3_BC39_191109_LF_LIB_consensus_vsearch	717	C	*/+A	195	23	10.22%	2	2	93	93	6.46332756739895E-8	1	1	138	57	9	14	+A
D3_BC39_191109_LF_LIB_consensus_vsearch	718	C	*/+AC	114	108	47.58%	2	2	93	93	7.929388937772014E-41	1	1	83	31	67	41	+AC
D3_BC39_191109_LF_LIB_consensus_vsearch	732	C	*/-AC	188	40	16.95%	2	2	93	93	1.3939697247970385E-13	1	1	117	71	32	8	-AC
D3_BC39_191109_LF_LIB_consensus_vsearch	742	C	*/-GC	217	14	5.96%	2	2	93	93	4.982521215421391E-5	1	1	135	82	13	1	-GC
D3_BC39_191109_LF_LIB_consensus_vsearch	747	G	*/-A	223	7	3%	2	1	93	93	0.007458967428082863	1	1	142	81	7	0	-A
D3_BC39_191109_LF_LIB_consensus_vsearch	748	A	*/-C	142	70	31.11%	2	2	93	93	8.91383029577384E-25	1	1	96	46	37	33	-C
D3_BC39_191109_LF_LIB_consensus_vsearch	753	C	*/-AC	209	19	8.05%	2	1	93	93	1.2901274566237775E-6	1	1	131	78	19	0	-AC
D3_BC39_191109_LF_LIB_consensus_vsearch	756	G	*/+C	190	10	4.35%	2	2	93	93	8.702588772443723E-4	1	1	126	64	8	2	+C
D3_BC39_191109_LF_LIB_consensus_vsearch	756	G	*/-C	190	22	9.57%	2	2	93	93	1.342686471864634E-7	1	1	126	64	13	9	-C
D3_BC39_191109_LF_LIB_consensus_vsearch	757	C	*/+T	191	16	7.55%	2	2	93	93	1.1290379746411729E-5	1	1	133	58	4	12	+T
D3_BC39_191109_LF_LIB_consensus_vsearch	758	C	*/+T	216	7	2.98%	2	1	93	93	0.007447971960236055	1	1	149	67	0	7	+T
D3_BC39_191109_LF_LIB_consensus_vsearch	761	C	*/-T	213	13	5.51%	2	2	93	93	1.0221711622714382E-4	1	1	140	73	8	5	-T
D3_BC39_191109_LF_LIB_consensus_vsearch	763	A	*/+C	199	26	11.3%	2	2	93	93	6.926624973953721E-9	1	1	130	69	18	8	+C
D3_BC39_191109_LF_LIB_consensus_vsearch	764	C	*/+ACC	76	140	59.57%	2	2	93	93	6.375179052872553E-58	1	1	58	18	86	54	+ACC
D3_BC39_191109_LF_LIB_consensus_vsearch	767	C	*/+T	199	9	3.81%	2	2	93	93	0.0017879699024036485	1	1	120	79	7	2	+T
D3_BC39_191109_LF_LIB_consensus_vsearch	767	C	*/+TC	199	26	11.02%	2	2	93	93	6.926624973953721E-9	1	1	120	79	24	2	+TC
D3_BC39_191109_LF_LIB_consensus_vsearch	778	T	*/-C	210	14	6.03%	2	2	93	93	4.950038813942507E-5	1	1	134	76	9	5	-C
D3_BC39_191109_LF_LIB_consensus_vsearch	782	G	*/-A	215	11	4.74%	2	1	93	93	4.3108474750487954E-4	1	1	134	81	11	0	-A
D3_BC39_191109_LF_LIB_consensus_vsearch	784	G	*/-AG	213	7	3.11%	2	2	93	93	0.007443047448823043	1	1	133	80	5	2	-AG
D3_BC39_191109_LF_LIB_consensus_vsearch	785	A	*/+G	136	8	3.67%	2	2	93	93	0.0035351105097651617	1	1	71	65	2	6	+G
D3_BC39_191109_LF_LIB_consensus_vsearch	785	A	*/-G	136	70	32.11%	2	2	93	93	6.986944246541197E-25	1	1	71	65	62	8	-G
D3_BC39_191109_LF_LIB_consensus_vsearch	790	C	*/+A	132	12	5.17%	2	1	93	93	1.9228495779173566E-4	1	1	56	76	12	0	+A
D3_BC39_191109_LF_LIB_consensus_vsearch	790	C	*/-G	132	78	33.62%	2	1	93	93	4.7714259146436265E-28	1	1	56	76	78	0	-G
D3_BC39_191109_LF_LIB_consensus_vsearch	791	G	*/-A	110	17	10.97%	2	1	93	93	4.301304510012638E-6	1	1	33	77	17	0	-A
D3_BC39_191109_LF_LIB_consensus_vsearch	796	T	*/+C	217	13	5.53%	2	1	93	93	1.0254206608526479E-4	1	1	138	79	13	0	+C
D3_BC39_191109_LF_LIB_consensus_vsearch	809	T	*/+C	220	15	6.36%	2	1	93	93	2.423379894583162E-5	1	1	137	83	15	0	+C
D3_BC39_191109_LF_LIB_consensus_vsearch	818	T	*/-C	227	7	2.99%	2	1	93	93	0.0074649578216797186	1	1	146	81	7	0	-C
D3_BC39_191109_LF_LIB_consensus_vsearch	821	A	*/+T	174	20	8.62%	2	2	93	93	5.693404765760249E-7	1	1	102	72	14	6	+T
D3_BC39_191109_LF_LIB_consensus_vsearch	821	A	*/-T	174	29	12.5%	2	2	93	93	6.347520132738361E-10	1	1	102	72	25	4	-T
D3_BC39_191109_LF_LIB_consensus_vsearch	827	A	*/-G	206	10	4.31%	2	2	93	93	8.778898007284436E-4	1	1	138	68	1	9	-G
D3_BC39_191109_LF_LIB_consensus_vsearch	829	G	*/+A	223	10	4.26%	2	1	93	93	8.848831932848452E-4	1	1	141	82	10	0	+A
D3_BC39_191109_LF_LIB_consensus_vsearch	832	T	*/+G	208	19	8.09%	2	1	93	93	1.287811711287195E-6	1	1	131	77	19	0	+G
D3_BC39_191109_LF_LIB_consensus_vsearch	833	A	*/-G	202	26	11.06%	2	2	93	93	7.001063960203066E-9	1	1	131	71	18	8	-G
D3_BC39_191109_LF_LIB_consensus_vsearch	836	C	*/-A	219	7	2.98%	2	1	93	93	0.007452766938834958	1	1	151	68	0	7	-A
D3_BC39_191109_LF_LIB_consensus_vsearch	840	T	*/-C	219	8	3.4%	2	1	93	93	0.0036688013849068284	1	1	149	70	0	8	-C
D3_BC39_191109_LF_LIB_consensus_vsearch	858	C	*/-ACA	217	8	3.43%	2	1	93	93	0.0036667219549938834	1	1	138	79	8	0	-ACA
D3_BC39_191109_LF_LIB_consensus_vsearch	860	C	*/-AC	181	33	14.6%	2	2	93	93	3.0589020717531545E-11	1	1	106	75	32	1	-AC
D3_BC39_191109_LF_LIB_consensus_vsearch	863	T	*/-C	200	16	6.96%	2	2	93	93	1.1438379994950568E-5	1	1	135	65	13	3	-C
D3_BC39_191109_LF_LIB_consensus_vsearch	880	C	*/-T	218	8	3.42%	2	2	93	93	0.003667766201363899	1	1	143	75	6	2	-T
D3_BC39_191109_LF_LIB_consensus_vsearch	882	T	*/-C	206	13	5.63%	2	2	93	93	1.016217291023551E-4	1	1	137	69	4	9	-C
D3_BC39_191109_LF_LIB_consensus_vsearch	886	T	*/+A	201	7	3.06%	2	1	93	93	0.007421943123229272	1	1	125	76	7	0	+A
D3_BC39_191109_LF_LIB_consensus_vsearch	895	T	*/-C	225	9	3.81%	2	1	93	93	0.0018059382541162866	1	1	143	82	9	0	-C
D3_BC39_191109_LF_LIB_consensus_vsearch	904	C	*/-T	223	10	4.26%	2	2	93	93	8.848831932848452E-4	1	1	150	73	1	9	-T
D3_BC39_191109_LF_LIB_consensus_vsearch	920	C	*/+T	163	17	7.23%	2	2	93	93	5.134244802812326E-6	1	1	119	44	13	4	+T
D3_BC39_191109_LF_LIB_consensus_vsearch	920	C	*/-T	163	44	18.72%	2	2	93	93	4.397784407238897E-15	1	1	119	44	20	24	-T
D3_BC39_191109_LF_LIB_consensus_vsearch	920	C	*/-TT	163	9	3.83%	2	1	93	93	0.0017543824532390317	1	1	119	44	0	9	-T
D3_BC39_191109_LF_LIB_consensus_vsearch	926	T	*/-G	192	25	10.87%	2	2	93	93	1.4318453833139122E-8	1	1	118	74	21	4	-G
D3_BC39_191109_LF_LIB_consensus_vsearch	933	T	*/+G	207	13	5.63%	2	1	93	93	1.0170895517465024E-4	1	1	148	59	0	13	+G
D3_BC39_191109_LF_LIB_consensus_vsearch	946	G	*/-T	222	7	2.99%	2	2	93	93	0.007457437428309682	1	1	144	78	5	2	-T
D3_BC39_191109_LF_LIB_consensus_vsearch	955	C	*/+T	217	8	3.4%	2	1	93	93	0.0036667219549938834	1	1	150	67	0	8	+T
D3_BC39_191109_LF_LIB_consensus_vsearch	968	T	*/+C	228	7	2.97%	2	1	93	93	0.007466423838535645	1	1	145	83	7	0	+C
D3_BC39_191109_LF_LIB_consensus_vsearch	976	T	*/-C	195	27	11.49%	2	2	93	93	3.212371282433204E-9	1	1	117	78	26	1	-C
D3_BC39_191109_LF_LIB_consensus_vsearch	980	A	*/-CA	216	14	6.01%	2	1	93	93	4.97799291733799E-5	1	1	135	81	14	0	-CA
D3_BC39_191109_LF_LIB_consensus_vsearch	982	A	*/-T	210	10	4.52%	2	1	93	93	8.796295164637225E-4	1	1	137	73	0	10	-T
D3_BC39_191109_LF_LIB_consensus_vsearch	1000	C	*/+A	27	149	63.4%	2	2	93	93	7.737095148556197E-72	1	1	16	11	89	60	+A
D3_BC39_191109_LF_LIB_consensus_vsearch	1010	C	*/-AC	216	10	4.24%	2	1	93	93	8.821271222096345E-4	1	1	136	80	10	0	-AC
D3_BC39_191109_LF_LIB_consensus_vsearch	1018	C	*/-T	214	8	3.42%	2	2	93	93	0.003663533633296164	1	1	146	68	4	4	-T
D3_BC39_191109_LF_LIB_consensus_vsearch	1029	A	*/-C	218	11	4.74%	2	2	93	93	4.318055810374596E-4	1	1	142	76	6	5	-C
D3_BC39_191109_LF_LIB_consensus_vsearch	1031	C	*/-G	218	10	4.26%	2	1	93	93	8.829313223014774E-4	1	1	150	68	0	10	-G
D3_BC39_191109_LF_LIB_consensus_vsearch	1044	T	*/+C	200	22	9.57%	2	1	93	93	1.3797147807810935E-7	1	1	124	76	22	0	+C
D3_BC39_191109_LF_LIB_consensus_vsearch	1045	C	*/+G	188	26	11.16%	2	1	93	93	6.64221947990964E-9	1	1	115	73	26	0	+G
D3_BC39_191109_LF_LIB_consensus_vsearch	1045	C	*/-A	188	9	3.86%	2	2	93	93	0.0017789762439091002	1	1	115	73	5	4	+G
D3_BC39_191109_LF_LIB_consensus_vsearch	1046	A	*/-G	178	30	13.27%	2	1	93	93	3.018793551240132E-10	1	1	105	73	30	0	-G
D3_BC39_191109_LF_LIB_consensus_vsearch	1047	G	*/+A	196	7	3.4%	2	1	93	93	0.007412420836520295	1	1	115	81	7	0	+A
D3_BC39_191109_LF_LIB_consensus_vsearch	1048	A	*/-C	222	7	2.97%	2	2	93	93	0.007457437428309682	1	1	140	82	6	1	-C
D3_BC39_191109_LF_LIB_consensus_vsearch	1049	C	*/-AC	213	8	3.49%	2	2	93	93	0.0036624519192641563	1	1	133	80	7	1	-AC
D3_BC39_191109_LF_LIB_consensus_vsearch	1056	C	*/-G	216	7	2.97%	2	1	93	93	0.007447971960236055	1	1	150	66	0	7	-G
D3_BC39_191109_LF_LIB_consensus_vsearch	1056	C	*/-GG	216	8	3.39%	2	1	93	93	0.003665668526289429	1	1	150	66	0	8	-GG
D3_BC39_191109_LF_LIB_consensus_vsearch	1066	A	*/-CA	182	28	12.23%	2	2	93	93	1.4209132653381032E-9	1	1	114	68	19	9	-CA
D3_BC39_191109_LF_LIB_consensus_vsearch	1068	A	*/-T	180	8	3.96%	2	1	93	93	0.00362041635085765	1	1	109	71	8	0	-T
D3_BC39_191109_LF_LIB_consensus_vsearch	1093	G	*/-C	220	8	3.4%	2	2	93	93	0.0036698276230520683	1	1	139	81	6	2	-C
D3_BC39_191109_LF_LIB_consensus_vsearch	1095	C	*/-AC	219	7	2.97%	2	1	93	93	0.007452766938834958	1	1	136	83	7	0	-AC
D3_BC39_191109_LF_LIB_consensus_vsearch	1100	C	*/+A	215	7	2.98%	2	1	93	93	0.007446345105805389	1	1	138	77	7	0	+A
D3_BC39_191109_LF_LIB_consensus_vsearch	1101	G	*/-A	214	9	3.93%	2	2	93	93	0.0017988361772468277	1	1	137	77	8	1	-A
D3_BC39_191109_LF_LIB_consensus_vsearch	1103	G	*/-C	198	16	6.99%	2	2	93	93	1.1406445395916652E-5	1	1	121	77	14	2	-C
D3_BC39_191109_LF_LIB_consensus_vsearch	1107	C	*/-A	204	17	7.2%	2	2	93	93	5.541719766097385E-6	1	1	139	65	6	11	-A
D3_BC39_191109_LF_LIB_consensus_vsearch	1113	G	*/+C	207	11	4.85%	2	1	93	93	4.2906952287648286E-4	1	1	124	83	11	0	+C
D3_BC39_191109_LF_LIB_consensus_vsearch	1113	G	*/-C	207	7	3.08%	2	1	93	93	0.007432788253078562	1	1	124	83	7	0	+C
D3_BC39_191109_LF_LIB_consensus_vsearch	1126	C	*/+T	202	16	6.96%	2	2	93	93	1.1469793493705302E-5	1	1	130	72	13	3	+T
D3_BC39_191109_LF_LIB_consensus_vsearch	1130	A	*/-C	221	8	3.4%	2	1	93	93	0.003670845031231652	1	1	140	81	8	0	-C
D3_BC39_191109_LF_LIB_consensus_vsearch	1144	C	*/-T	216	7	3.02%	2	2	93	93	0.007447971960236055	1	1	140	76	5	2	-T
D3_BC39_191109_LF_LIB_consensus_vsearch	1150	C	*/-G	215	9	3.86%	2	1	93	93	0.0017995100038167202	1	1	138	77	9	0	-G
D3_BC39_191109_LF_LIB_consensus_vsearch	1151	G	*/-A	214	7	3.11%	2	1	93	93	0.007444703667648697	1	1	133	81	7	0	-A
D3_BC39_191109_LF_LIB_consensus_vsearch	1163	T	*/-C	216	9	3.81%	2	1	93	93	0.0018001779733764346	1	1	134	82	9	0	-C
D3_BC39_191109_LF_LIB_consensus_vsearch	1168	A	*/+G	88	119	51.07%	2	2	93	93	3.653367510615816E-47	1	1	60	28	67	52	+G
D3_BC39_191109_LF_LIB_consensus_vsearch	1168	A	*/+GG	88	7	3%	2	2	93	93	0.006967529026351955	1	1	60	28	5	2	+G
D3_BC39_191109_LF_LIB_consensus_vsearch	1168	A	*/-G	88	8	3.43%	2	1	93	93	0.0033560872797097677	1	1	60	28	8	0	-G
D3_BC39_191109_LF_LIB_consensus_vsearch	1174	C	*/-T	214	12	5.13%	2	1	93	93	2.1016603336412182E-4	1	1	148	66	0	12	-T
D3_BC39_191109_LF_LIB_consensus_vsearch	1176	T	*/+C	208	7	3.04%	2	1	93	93	0.007434537497224064	1	1	141	67	7	0	+C
D3_BC39_191109_LF_LIB_consensus_vsearch	1176	T	*/-CG	208	8	3.48%	2	1	93	93	0.0036568954742723925	1	1	141	67	0	8	-CG
D3_BC39_191109_LF_LIB_consensus_vsearch	1177	C	*/+A	137	8	3.6%	2	1	93	93	0.003537610524775318	1	1	102	35	8	0	+A
D3_BC39_191109_LF_LIB_consensus_vsearch	1177	C	*/+G	137	10	4.5%	2	2	93	93	8.336700359389833E-4	1	1	102	35	7	3	+G
D3_BC39_191109_LF_LIB_consensus_vsearch	1177	C	*/+GG	137	7	3.15%	2	1	93	93	0.0072508471039682155	1	1	102	35	7	0	+G
D3_BC39_191109_LF_LIB_consensus_vsearch	1177	C	*/-G	137	38	17.12%	2	2	93	93	3.815187426743107E-13	1	1	102	35	17	21	-G
D3_BC39_191109_LF_LIB_consensus_vsearch	1177	C	*/-GG	137	13	5.86%	2	2	93	93	9.305663444641845E-5	1	1	102	35	7	6	-G
D3_BC39_191109_LF_LIB_consensus_vsearch	1182	G	*/-A	214	7	2.97%	2	1	93	93	0.007444703667648697	1	1	145	69	7	0	-A
D3_BC39_191109_LF_LIB_consensus_vsearch	1193	T	*/+G	205	14	6.01%	2	1	93	93	4.9256649870734555E-5	1	1	132	73	14	0	+G
D3_BC39_191109_LF_LIB_consensus_vsearch	1194	A	*/-G	211	14	6.09%	2	1	93	93	4.9547934929218304E-5	1	1	137	74	14	0	-G
D3_BC39_191109_LF_LIB_consensus_vsearch	1205	T	*/-A	215	9	3.88%	2	2	93	93	0.0017995100038167202	1	1	137	78	8	1	-A
D3_BC39_191109_LF_LIB_consensus_vsearch	1215	G	*/+C	161	10	4.27%	2	2	93	93	8.529341483590452E-4	1	1	95	66	6	4	+C
D3_BC39_191109_LF_LIB_consensus_vsearch	1215	G	*/-C	161	52	22.22%	2	2	93	93	6.3656725632153566E-18	1	1	95	66	41	11	-C
D3_BC39_191109_LF_LIB_consensus_vsearch	1222	T	*/-A	194	13	5.78%	2	1	93	93	1.0051376512604206E-4	1	1	115	79	13	0	-A
D3_BC39_191109_LF_LIB_consensus_vsearch	1222	T	*/-AC	194	15	6.67%	2	1	93	93	2.3524071874557613E-5	1	1	115	79	15	0	-AC
D3_BC39_191109_LF_LIB_consensus_vsearch	1223	A	*/-C	170	10	4.98%	2	2	93	93	8.588852401034393E-4	1	1	92	78	7	3	-C
D3_BC39_191109_LF_LIB_consensus_vsearch	1226	C	*/-G	213	9	3.81%	2	2	93	93	0.0017981564163397133	1	1	146	67	4	5	-G
D3_BC39_191109_LF_LIB_consensus_vsearch	1233	C	*/-AC	211	15	6.44%	2	1	93	93	2.4004930780571747E-5	1	1	135	76	15	0	-AC
D3_BC39_191109_LF_LIB_consensus_vsearch	1240	G	*/-A	221	7	3%	2	1	93	93	0.007455894130096957	1	1	139	82	7	0	-A
D3_BC39_191109_LF_LIB_consensus_vsearch	1241	A	*/-T	203	14	6.22%	2	2	93	93	4.915625783020227E-5	1	1	127	76	13	1	-T
D3_BC39_191109_LF_LIB_consensus_vsearch	1246	C	*/-AC	195	25	10.82%	2	1	93	93	1.4471003755089968E-8	1	1	121	74	25	0	-AC
D3_BC39_191109_LF_LIB_consensus_vsearch	1247	A	*/+T	196	8	3.83%	2	1	93	93	0.0036424672415343016	1	1	125	71	0	8	+T
D3_BC39_191109_LF_LIB_consensus_vsearch	1251	C	*/+A	228	7	2.97%	2	1	93	93	0.007466423838535645	1	1	145	83	7	0	+A
D3_BC39_191109_LF_LIB_consensus_vsearch	1259	C	*/-T	217	10	4.27%	2	2	93	93	8.825309402840407E-4	1	1	143	74	4	6	-T
D3_BC39_191109_LF_LIB_consensus_vsearch	1277	G	*/-T	220	7	3%	2	1	93	93	0.007454337359329176	1	1	138	82	7	0	-T
D3_BC39_191109_LF_LIB_consensus_vsearch	1280	T	*/-C	224	8	3.4%	2	2	93	93	0.003673845400689721	1	1	147	77	3	5	-C
D3_BC39_191109_LF_LIB_consensus_vsearch	1297	G	*/-C	213	14	5.93%	2	2	93	93	4.9641866600329834E-5	1	1	131	82	13	1	-C
D3_BC39_191109_LF_LIB_consensus_vsearch	1297	G	*/-CC	213	9	3.81%	2	1	93	93	0.0017981564163397133	1	1	131	82	9	0	-C
D3_BC39_191109_LF_LIB_consensus_vsearch	1317	C	*/-T	210	18	7.69%	2	1	93	93	2.6908372666736656E-6	1	1	150	60	0	18	-T
D3_BC39_191109_LF_LIB_consensus_vsearch	1330	T	*/-C	181	37	15.81%	2	2	93	93	1.3704889421474068E-12	1	1	104	77	34	3	-C
D3_BC39_191109_LF_LIB_consensus_vsearch	1330	T	*/-CC	181	7	2.99%	2	1	93	93	0.007380848803681321	1	1	104	77	7	0	-C
D3_BC39_191109_LF_LIB_consensus_vsearch	1340	T	*/+C	209	19	8.15%	2	1	93	93	1.2901274566237775E-6	1	1	133	76	19	0	+C
D3_BC39_191109_LF_LIB_consensus_vsearch	1343	G	*/-C	224	7	2.99%	2	1	93	93	0.007460484300523826	1	1	150	74	0	7	-C
D3_BC39_191109_LF_LIB_consensus_vsearch	1345	C	*/-T	225	7	2.97%	2	2	93	93	0.0074619882138406745	1	1	151	74	1	6	-T
D3_BC39_191109_LF_LIB_consensus_vsearch	1348	G	*/+A	208	9	3.85%	2	1	93	93	0.0017946657928001688	1	1	138	70	9	0	+A
D3_BC39_191109_LF_LIB_consensus_vsearch	1348	G	*/-TG	208	9	3.85%	2	1	93	93	0.0017946657928001688	1	1	138	70	0	9	+A
D3_BC39_191109_LF_LIB_consensus_vsearch	1351	C	*/-A	212	12	5.17%	2	2	93	93	2.0987757342671282E-4	1	1	141	71	8	4	-A
D3_BC39_191109_LF_LIB_consensus_vsearch	1357	C	*/-G	212	9	3.86%	2	2	93	93	0.00179747064240055	1	1	140	72	1	8	-G
D3_BC39_191109_LF_LIB_consensus_vsearch	1368	G	*/-C	86	47	21.17%	2	2	93	93	4.9714785384191944E-17	1	1	61	25	19	28	-C
D3_BC39_191109_LF_LIB_consensus_vsearch	1368	G	*/-CC	86	43	19.37%	2	2	93	93	1.6746858544641356E-15	1	1	61	25	17	26	-C
D3_BC39_191109_LF_LIB_consensus_vsearch	1368	G	*/-CCC	86	30	13.51%	2	2	93	93	1.078573814272681E-10	1	1	61	25	29	1	-C
D3_BC39_191109_LF_LIB_consensus_vsearch	1373	C	*/-T	156	53	22.65%	2	2	93	93	2.5256262042818083E-18	1	1	104	52	37	16	-T
D3_BC39_191109_LF_LIB_consensus_vsearch	1375	T	*/-G	205	7	3.14%	2	2	93	93	0.0074292407456773525	1	1	139	66	2	5	-G
D3_BC39_191109_LF_LIB_consensus_vsearch	1376	G	*/-C	197	7	3.21%	2	2	93	93	0.007414362253072604	1	1	132	65	1	6	-C
D3_BC39_191109_LF_LIB_consensus_vsearch	1377	C	*/-G	198	8	3.65%	2	2	93	93	0.0036449867501809376	1	1	138	60	3	5	-G
D3_BC39_191109_LF_LIB_consensus_vsearch	1382	T	*/-C	221	9	3.83%	2	2	93	93	0.001803432580702911	1	1	147	74	3	6	-C
D3_BC39_191109_LF_LIB_consensus_vsearch	1394	C	*/-TTT	210	7	2.98%	2	2	93	93	0.007437988084800957	1	1	143	67	2	5	-TTT
D3_BC39_191109_LF_LIB_consensus_vsearch	1407	T	*/-C	174	55	23.81%	2	1	93	93	6.920295733939444E-19	1	1	96	78	55	0	-C
D3_BC39_191109_LF_LIB_consensus_vsearch	1413	T	*/-GT	223	9	3.86%	2	1	93	93	0.0018046959863042469	1	1	149	74	0	9	-GT
D3_BC39_191109_LF_LIB_consensus_vsearch	1420	A	*/-C	212	17	7.26%	2	2	93	93	5.606330650645509E-6	1	1	142	70	6	11	-C
D3_BC39_191109_LF_LIB_consensus_vsearch	1422	C	*/+T	223	8	3.42%	2	1	93	93	0.0036728538094896964	1	1	149	74	0	8	+T
D3_BC39_191109_LF_LIB_consensus_vsearch	1423	C	*/-T	224	10	4.26%	2	2	93	93	8.852638500565801E-4	1	1	149	75	2	8	-T
D3_BC39_191109_LF_LIB_consensus_vsearch	1444	C	*/-A	219	7	3%	2	1	93	93	0.007452766938834958	1	1	141	78	7	0	-A
D3_BC39_191109_LF_LIB_consensus_vsearch	1447	T	*/-C	212	10	4.39%	2	2	93	93	8.804765900705064E-4	1	1	141	71	7	3	-C
D3_BC39_191109_LF_LIB_consensus_vsearch	1449	C	*/-T	213	13	5.6%	2	2	93	93	1.0221711622714382E-4	1	1	142	71	7	6	-T
D3_BC39_191109_LF_LIB_consensus_vsearch	1454	T	*/-C	224	7	2.98%	2	1	93	93	0.007460484300523826	1	1	142	82	7	0	-C
D3_BC39_191109_LF_LIB_consensus_vsearch	1468	C	*/-G	219	11	4.68%	2	2	93	93	4.3204184318133837E-4	1	1	152	67	1	10	-G
D3_BC39_191109_LF_LIB_consensus_vsearch	1480	T	*/+G	212	10	4.31%	2	2	93	93	8.804765900705064E-4	1	1	146	66	1	9	+G
D3_BC39_191109_LF_LIB_consensus_vsearch	1485	A	*/-CA	219	9	3.85%	2	2	93	93	0.0018021474934649558	1	1	142	77	7	2	-CA
D3_BC39_191109_LF_LIB_consensus_vsearch	1492	C	*/-A	223	7	2.97%	2	1	93	93	0.007458967428082863	1	1	143	80	7	0	-A
D3_BC39_191109_LF_LIB_consensus_vsearch	1493	A	*/-G	134	83	36.4%	2	2	93	93	5.89490909159776E-30	1	1	87	47	53	30	-G
D3_BC39_191109_LF_LIB_consensus_vsearch	1497	A	*/+G	195	9	4.05%	2	1	93	93	0.0017848089483517727	1	1	115	80	9	0	+G
D3_BC39_191109_LF_LIB_consensus_vsearch	1497	A	*/-G	195	13	5.86%	2	2	93	93	1.0061064586351875E-4	1	1	115	80	10	3	-G
D3_BC39_191109_LF_LIB_consensus_vsearch	1506	C	*/+A	6	11	4.68%	2	2	93	93	4.325794092201044E-5	1	1	4	2	10	1	+A
D3_BC39_191109_LF_LIB_consensus_vsearch	1506	C	+AT/+AT	6	179	76.17%	2	2	93	93	6.248625872620074E-100	1	1	4	2	106	73	+AT
D3_BC39_191109_LF_LIB_consensus_vsearch	1506	C	*/+ATT	6	15	6.38%	2	1	93	93	5.499408630258758E-7	1	1	4	2	15	0	+AT
D3_BC39_191109_LF_LIB_consensus_vsearch	1507	T	*/-GC	220	7	3%	2	2	93	93	0.007454337359329176	1	1	139	81	6	1	-GC
D3_BC39_191109_LF_LIB_consensus_vsearch	1522	T	*/-C	207	17	7.26%	2	2	93	93	5.56642225097613E-6	1	1	140	67	8	9	-C
D3_BC39_191109_LF_LIB_consensus_vsearch	1536	G	*/-A	215	15	6.38%	2	2	93	93	2.4108665249874024E-5	1	1	137	78	13	2	-A
D3_BC39_191109_LF_LIB_consensus_vsearch	1537	A	*/-G	207	7	3.17%	2	1	93	93	0.007432788253078562	1	1	127	80	7	0	-G
D3_BC39_191109_LF_LIB_consensus_vsearch	1551	C	*/-A	206	16	7.02%	2	2	93	93	1.1531106955580906E-5	1	1	130	76	15	1	-A
D3_BC39_191109_LF_LIB_consensus_vsearch	1563	A	*/+C	178	11	4.82%	2	2	93	93	4.204021120137521E-4	1	1	112	66	8	3	+C
D3_BC39_191109_LF_LIB_consensus_vsearch	1563	A	*/-C	178	24	10.53%	2	2	93	93	2.8844281621582218E-8	1	1	112	66	20	4	-C
D3_BC39_191109_LF_LIB_consensus_vsearch	1563	A	*/-CC	178	8	3.51%	2	1	93	93	0.0036173981471315664	1	1	112	66	0	8	-C
D3_BC39_191109_LF_LIB_consensus_vsearch	1568	G	*/-A	211	10	4.31%	2	2	93	93	8.800549103686053E-4	1	1	132	79	9	1	-A
D3_BC39_191109_LF_LIB_consensus_vsearch	1570	A	*/-G	202	22	9.57%	2	2	93	93	1.3868168753729865E-7	1	1	127	75	16	6	-G
D3_BC39_191109_LF_LIB_consensus_vsearch	1571	G	*/+A	194	12	5.71%	2	1	93	93	2.070433166935576E-4	1	1	120	74	12	0	+A
D3_BC39_191109_LF_LIB_consensus_vsearch	1572	G	*/+A	222	10	4.24%	2	1	93	93	8.844993515297029E-4	1	1	141	81	10	0	+A
D3_BC39_191109_LF_LIB_consensus_vsearch	1573	G	*/-C	203	8	3.39%	2	2	93	93	0.0036510799339400076	1	1	122	81	7	1	-C
D3_BC39_191109_LF_LIB_consensus_vsearch	1576	G	*/-A	217	11	4.76%	2	1	93	93	4.3156732794080477E-4	1	1	137	80	11	0	-A
D3_BC39_191109_LF_LIB_consensus_vsearch	1579	T	*/+C	148	19	8.15%	2	2	93	93	1.1089436228201743E-6	1	1	93	55	15	4	+C
D3_BC39_191109_LF_LIB_consensus_vsearch	1579	T	*/-C	148	58	24.89%	2	2	93	93	3.207868724650712E-20	1	1	93	55	44	14	-C
D3_BC39_191109_LF_LIB_consensus_vsearch	1582	C	*/-T	169	51	21.89%	2	2	93	93	1.6666006762739706E-17	1	1	102	67	42	9	-T
D3_BC39_191109_LF_LIB_consensus_vsearch	1582	C	*/-TT	169	7	3%	2	2	93	93	0.007351762655103386	1	1	102	67	6	1	-T
D3_BC39_191109_LF_LIB_consensus_vsearch	1588	G	*/-CCG	218	7	2.97%	2	2	93	93	0.007451182688346346	1	1	140	78	3	4	-CCG
D3_BC39_191109_LF_LIB_consensus_vsearch	1594	T	*/-C	214	7	3.11%	2	1	93	93	0.007444703667648697	1	1	144	70	0	7	-C
D3_BC39_191109_LF_LIB_consensus_vsearch	1596	T	*/-C	204	24	10.34%	2	2	93	93	3.147740029163511E-8	1	1	129	75	20	4	-C
D3_BC39_191109_LF_LIB_consensus_vsearch	1605	C	*/-A	221	8	3.39%	2	1	93	93	0.003670845031231652	1	1	150	71	0	8	-A
D3_BC39_191109_LF_LIB_consensus_vsearch	1608	T	*/-G	208	7	3.06%	2	2	93	93	0.007434537497224064	1	1	149	59	1	6	-G
D3_BC39_191109_LF_LIB_consensus_vsearch	1612	T	*/-C	216	10	4.24%	2	1	93	93	8.821271222096345E-4	1	1	137	79	10	0	-C
D3_BC39_191109_LF_LIB_consensus_vsearch	1614	C	*/-T	223	9	3.81%	2	2	93	93	0.0018046959863042469	1	1	148	75	4	5	-T
D3_BC39_191109_LF_LIB_consensus_vsearch	1619	G	*/-CG	217	15	6.41%	2	2	93	93	2.4159309133094825E-5	1	1	149	68	3	12	-CG
D3_BC39_191109_LF_LIB_consensus_vsearch	1649	A	*/+C	222	10	4.26%	2	1	93	93	8.844993515297029E-4	1	1	139	83	10	0	+C
D3_BC39_191109_LF_LIB_consensus_vsearch	1664	A	*/-G	213	7	3.02%	2	2	93	93	0.007443047448823043	1	1	134	79	5	2	-G
D3_BC39_191109_LF_LIB_consensus_vsearch	1669	A	*/-C	218	7	2.98%	2	2	93	93	0.007451182688346346	1	1	139	79	4	3	-C
D3_BC39_191109_LF_LIB_consensus_vsearch	1671	C	*/-T	208	21	8.94%	2	2	93	93	2.950072630570878E-7	1	1	142	66	5	16	-T
D3_BC39_191109_LF_LIB_consensus_vsearch	1674	T	*/-C	191	36	15.25%	2	2	93	93	3.223727308871872E-12	1	1	128	63	19	17	-C
D3_BC39_191109_LF_LIB_consensus_vsearch	1677	C	*/-T	224	8	3.39%	2	2	93	93	0.003673845400689721	1	1	150	74	1	7	-T
D3_BC39_191109_LF_LIB_consensus_vsearch	1686	C	*/-T	201	8	3.46%	2	2	93	93	0.003648677074969142	1	1	144	57	1	7	-T
D3_BC39_191109_LF_LIB_consensus_vsearch	1686	C	*/-TT	201	8	3.46%	2	2	93	93	0.003648677074969142	1	1	144	57	4	4	-T
D3_BC39_191109_LF_LIB_consensus_vsearch	1691	A	*/-CA	199	28	12.07%	2	1	93	93	1.5345656347841806E-9	1	1	118	81	28	0	-CA
D3_BC39_191109_LF_LIB_consensus_vsearch	1697	G	*/-T	220	9	3.85%	2	1	93	93	0.0018027927820038396	1	1	140	80	9	0	-T
D3_BC39_191109_LF_LIB_consensus_vsearch	1701	C	*/-A	207	20	8.58%	2	1	93	93	6.157812320632015E-7	1	1	127	80	20	0	-A
D3_BC39_191109_LF_LIB_consensus_vsearch	1704	T	*/-C	216	7	3.02%	2	1	93	93	0.007447971960236055	1	1	148	68	0	7	-C
D3_BC39_191109_LF_LIB_consensus_vsearch	1706	T	*/-CT	207	16	6.9%	2	2	93	93	1.1546128752618848E-5	1	1	142	65	9	7	-CT
D3_BC39_191109_LF_LIB_consensus_vsearch	1707	C	*/-T	188	20	9.43%	2	2	93	93	5.904806231127145E-7	1	1	143	45	1	19	-T
D3_BC39_191109_LF_LIB_consensus_vsearch	1710	T	*/-C	206	28	11.86%	2	2	93	93	1.5784952608508668E-9	1	1	125	81	27	1	-C
D3_BC39_191109_LF_LIB_consensus_vsearch	1712	C	*/-A	210	14	5.93%	2	1	93	93	4.950038813942507E-5	1	1	132	78	14	0	-A
D3_BC39_191109_LF_LIB_consensus_vsearch	1712	C	*/-AA	210	8	3.39%	2	2	93	93	0.0036591481612605	1	1	132	78	3	5	-A
D3_BC39_191109_LF_LIB_consensus_vsearch	1719	C	*/+T	193	8	3.4%	2	2	93	93	0.003638595561901328	1	1	120	73	5	3	+T
D3_BC39_191109_LF_LIB_consensus_vsearch	1719	C	*/-T	193	29	12.34%	2	2	93	93	7.00539600710601E-10	1	1	120	73	26	3	-T
D3_BC39_191109_LF_LIB_consensus_vsearch	1727	C	*/-T	214	18	7.63%	2	1	93	93	2.7077251430281975E-6	1	1	149	65	0	18	-T
D3_BC39_191109_LF_LIB_consensus_vsearch	1730	T	*/-C	159	50	21.19%	2	2	93	93	3.165265757580701E-17	1	1	130	29	20	30	-C
D3_BC39_191109_LF_LIB_consensus_vsearch	1730	T	*/-CC	159	19	8.05%	2	2	93	93	1.1488882430925014E-6	1	1	130	29	1	18	-C
D3_BC39_191109_LF_LIB_consensus_vsearch	1768	T	*/-A	216	9	3.83%	2	1	93	93	0.0018001779733764346	1	1	136	80	9	0	-A
D3_BC39_191109_LF_LIB_consensus_vsearch	1769	A	*/-T	205	7	3.17%	2	2	93	93	0.0074292407456773525	1	1	128	77	6	1	-T
D3_BC39_191109_LF_LIB_consensus_vsearch	1775	C	*/-T	212	7	2.99%	2	2	93	93	0.00744137624879223	1	1	139	73	4	3	-T
D3_BC39_191109_LF_LIB_consensus_vsearch	1787	C	*/+T	216	7	3.06%	2	1	93	93	0.007447971960236055	1	1	145	71	0	7	+T
D3_BC39_191109_LF_LIB_consensus_vsearch	1788	C	*/+T	214	8	3.4%	2	1	93	93	0.003663533633296164	1	1	145	69	0	8	+T
D3_BC39_191109_LF_LIB_consensus_vsearch	1793	A	*/-C	213	11	4.78%	2	2	93	93	4.305938947768699E-4	1	1	136	77	5	6	-C
D3_BC39_191109_LF_LIB_consensus_vsearch	1794	C	*/+T	208	7	3.21%	2	2	93	93	0.007434537497224064	1	1	139	69	1	6	+T
D3_BC39_191109_LF_LIB_consensus_vsearch	1827	T	*/-C	215	7	2.97%	2	1	93	93	0.007446345105805389	1	1	146	69	0	7	-C
D3_BC39_191109_LF_LIB_consensus_vsearch	1831	C	*/+A	214	12	5.15%	2	1	93	93	2.1016603336412182E-4	1	1	132	82	12	0	+A
D3_BC39_191109_LF_LIB_consensus_vsearch	1832	G	*/-A	217	16	6.87%	2	2	93	93	1.1689988290222098E-5	1	1	135	82	15	1	-A
D3_BC39_191109_LF_LIB_consensus_vsearch	1838	G	*/-C	214	8	3.4%	2	1	93	93	0.003663533633296164	1	1	146	68	0	8	-C
D3_BC39_191109_LF_LIB_consensus_vsearch	1850	C	*/-G	203	23	9.79%	2	1	93	93	6.612552632176875E-8	1	1	123	80	23	0	-G
D3_BC39_191109_LF_LIB_consensus_vsearch	1853	G	*/-T	223	7	2.99%	2	2	93	93	0.007458967428082863	1	1	148	75	1	6	-T
D3_BC39_191109_LF_LIB_consensus_vsearch	1859	A	*/+C	170	14	5.96%	2	2	93	93	4.721392964410002E-5	1	1	96	74	13	1	+C
D3_BC39_191109_LF_LIB_consensus_vsearch	1859	A	*/-C	170	7	2.98%	2	2	93	93	0.007354335343249384	1	1	96	74	2	5	+C
D3_BC39_191109_LF_LIB_consensus_vsearch	1861	C	*/-G	211	14	5.93%	2	2	93	93	4.9547934929218304E-5	1	1	147	64	2	12	-G
D3_BC39_191109_LF_LIB_consensus_vsearch	1864	A	*/-G	206	19	8.26%	2	1	93	93	1.2831285144228921E-6	1	1	123	83	19	0	-G
D3_BC39_191109_LF_LIB_consensus_vsearch	1873	C	*/-G	191	26	11.56%	2	1	93	93	6.7216213593145134E-9	1	1	141	50	0	26	-G
D3_BC39_191109_LF_LIB_consensus_vsearch	1883	A	*/-C	178	51	21.79%	2	2	93	93	1.9281352750444573E-17	1	1	131	47	16	35	-C
D3_BC39_191109_LF_LIB_consensus_vsearch	1884	C	*/+T	171	7	3.87%	2	1	93	93	0.007356879467164792	1	1	131	40	0	7	+T
D3_BC39_191109_LF_LIB_consensus_vsearch	1886	C	*/-T	223	9	3.86%	2	2	93	93	0.0018046959863042469	1	1	148	75	2	7	-T
D3_BC39_191109_LF_LIB_consensus_vsearch	1887	T	*/-C	210	7	3.12%	2	1	93	93	0.007437988084800957	1	1	146	64	0	7	-C
D3_BC39_191109_LF_LIB_consensus_vsearch	1902	T	*/-C	224	11	4.66%	2	1	93	93	4.3319414411093957E-4	1	1	141	83	11	0	-C
D3_BC39_191109_LF_LIB_consensus_vsearch	1905	A	*/-G	221	9	3.85%	2	2	93	93	0.001803432580702911	1	1	149	72	1	8	-G
D3_BC39_191109_LF_LIB_consensus_vsearch	1916	G	*/-A	203	30	12.77%	2	1	93	93	3.4353315916133834E-10	1	1	120	83	30	0	-A
D3_BC39_191109_LF_LIB_consensus_vsearch	1919	C	*/-T	221	9	3.85%	2	2	93	93	0.001803432580702911	1	1	151	70	1	8	-T
D3_BC39_191109_LF_LIB_consensus_vsearch	1920	T	*/-C	203	15	6.73%	2	1	93	93	2.37871086741396E-5	1	1	132	71	15	0	-C
D3_BC39_191109_LF_LIB_consensus_vsearch	1922	C	*/-G	209	7	2.98%	2	2	93	93	0.007436270701269745	1	1	147	62	1	6	-G
D3_BC39_191109_LF_LIB_consensus_vsearch	1922	C	*/-GG	209	10	4.26%	2	1	93	93	8.792003591123169E-4	1	1	147	62	0	10	-GG
D3_BC39_191109_LF_LIB_consensus_vsearch	1926	T	*/-C	219	7	2.98%	2	2	93	93	0.007452766938834958	1	1	145	74	1	6	-C
D3_BC39_191109_LF_LIB_consensus_vsearch	1934	G	*/+CC	214	7	2.97%	2	1	93	93	0.007444703667648697	1	1	137	77	7	0	+CC
D3_BC39_191109_LF_LIB_consensus_vsearch	1942	C	*/-AC	212	17	7.2%	2	2	93	93	5.606330650645509E-6	1	1	133	79	14	3	-AC
D3_BC39_191109_LF_LIB_consensus_vsearch	1950	T	*/+G	207	8	3.46%	2	2	93	93	0.003655753662936563	1	1	130	77	7	1	+G
D3_BC39_191109_LF_LIB_consensus_vsearch	1956	A	*/+T	202	12	5.22%	2	1	93	93	2.0835870377678545E-4	1	1	136	66	0	12	+T
D3_BC39_191109_LF_LIB_consensus_vsearch	1960	C	*/+T	215	7	3.07%	2	1	93	93	0.007446345105805389	1	1	143	72	0	7	+T
D3_BC39_191109_LF_LIB_consensus_vsearch	1961	T	*/+C	205	11	4.78%	2	2	93	93	4.285433624407098E-4	1	1	135	70	9	2	+C
D3_BC39_191109_LF_LIB_consensus_vsearch	1962	C	*/-G	204	7	3.07%	2	1	93	93	0.007427442022474603	1	1	143	61	0	7	-G
D3_BC39_191109_LF_LIB_consensus_vsearch	1962	C	*/-GG	204	11	4.82%	2	1	93	93	4.2827676494109035E-4	1	1	143	61	0	11	-GG
D3_BC39_191109_LF_LIB_consensus_vsearch	1963	G	*/+A	192	11	5.09%	2	1	93	93	4.248818010929111E-4	1	1	130	62	11	0	+A
D3_BC39_191109_LF_LIB_consensus_vsearch	1966	T	*/+C	208	7	2.99%	2	1	93	93	0.007434537497224064	1	1	137	71	7	0	+C
D3_BC39_191109_LF_LIB_consensus_vsearch	1967	C	*/-G	215	7	3.07%	2	2	93	93	0.007446345105805389	1	1	143	72	1	6	-G
D3_BC39_191109_LF_LIB_consensus_vsearch	1969	G	*/-A	169	59	25.21%	2	1	93	93	2.307003476686565E-20	1	1	90	79	59	0	-A
D3_BC39_191109_LF_LIB_consensus_vsearch	1970	A	*/-G	162	11	6.36%	2	2	93	93	4.144410722870704E-4	1	1	82	80	10	1	-G
D3_BC39_191109_LF_LIB_consensus_vsearch	1972	C	*/+A	174	14	6.03%	2	1	93	93	4.7482349176863256E-5	1	1	95	79	14	0	+A
D3_BC39_191109_LF_LIB_consensus_vsearch	1972	C	*/-G	174	34	14.66%	2	1	93	93	1.3402918175258154E-11	1	1	95	79	34	0	-G
D3_BC39_191109_LF_LIB_consensus_vsearch	1976	G	*/-C	164	52	22.22%	2	2	93	93	6.734734409532361E-18	1	1	94	70	44	8	-C
D3_BC39_191109_LF_LIB_consensus_vsearch	1976	G	*/-CC	164	8	3.42%	2	2	93	93	0.0035943445383436455	1	1	94	70	7	1	-C
D3_BC39_191109_LF_LIB_consensus_vsearch	1984	A	*/-G	223	10	4.24%	2	1	93	93	8.848831932848452E-4	1	1	142	81	10	0	-G
D3_BC39_191109_LF_LIB_consensus_vsearch	1988	T	*/-C	224	7	2.97%	2	2	93	93	0.007460484300523826	1	1	143	81	5	2	-C
D3_BC39_191109_LF_LIB_consensus_vsearch	1991	C	*/-AC	212	12	5.08%	2	2	93	93	2.0987757342671282E-4	1	1	139	73	8	4	-AC
D3_BC39_191109_LF_LIB_consensus_vsearch	1993	C	*/+T	192	8	3.67%	2	1	93	93	0.0036372796311357324	1	1	131	61	0	8	+T
D3_BC39_191109_LF_LIB_consensus_vsearch	1993	C	*/-TT	192	7	3.21%	2	2	93	93	0.007404462106241813	1	1	131	61	6	1	+T
D3_BC39_191109_LF_LIB_consensus_vsearch	2004	T	*/+C	171	13	5.51%	2	2	93	93	9.80172223605813E-5	1	1	132	39	4	9	+C
D3_BC39_191109_LF_LIB_consensus_vsearch	2004	T	*/-C	171	50	21.19%	2	2	93	93	3.885486177041765E-17	1	1	132	39	16	34	-C
D3_BC39_191109_LF_LIB_consensus_vsearch	2012	C	*/-A	220	10	4.26%	2	1	93	93	8.837219519630479E-4	1	1	141	79	10	0	-A
D3_BC39_191109_LF_LIB_consensus_vsearch	2015	T	*/-C	218	8	3.43%	2	2	93	93	0.003667766201363899	1	1	149	69	1	7	-C
D3_BC39_191109_LF_LIB_consensus_vsearch	2025	T	*/+G	94	111	47.23%	2	2	93	93	3.3144258083218895E-43	1	1	49	45	76	35	+G
D3_BC39_191109_LF_LIB_consensus_vsearch	2025	T	*/-G	94	12	5.11%	2	2	93	93	1.7563166789412888E-4	1	1	49	45	10	2	+G
D3_BC39_191109_LF_LIB_consensus_vsearch	2032	T	*/-C	213	12	5.26%	2	2	93	93	2.1002241192895544E-4	1	1	145	68	6	6	-C
D3_BC39_191109_LF_LIB_consensus_vsearch	2034	C	*/-T	219	7	2.98%	2	2	93	93	0.007452766938834958	1	1	145	74	3	4	-T
D3_BC39_191109_LF_LIB_consensus_vsearch	2045	C	*/+T	173	19	8.3%	2	2	93	93	1.1944226389711712E-6	1	1	134	39	5	14	+T
D3_BC39_191109_LF_LIB_consensus_vsearch	2045	C	*/-T	173	27	11.79%	2	2	93	93	2.908812308280772E-9	1	1	134	39	13	14	-T
D3_BC39_191109_LF_LIB_consensus_vsearch	2049	T	*/-C	222	11	4.66%	2	2	93	93	4.3273893004878305E-4	1	1	148	74	5	6	-C
D3_BC39_191109_LF_LIB_consensus_vsearch	2052	T	*/+C	216	14	5.98%	2	2	93	93	4.97799291733799E-5	1	1	137	79	13	1	+C
D3_BC39_191109_LF_LIB_consensus_vsearch	2075	C	*/-A	222	8	3.39%	2	2	93	93	0.0036718537228742883	1	1	145	77	5	3	-A
D3_BC39_191109_LF_LIB_consensus_vsearch	2079	C	*/-G	208	9	3.93%	2	2	93	93	0.0017946657928001688	1	1	143	65	3	6	-G
D3_BC39_191109_LF_LIB_consensus_vsearch	2086	T	*/+C	209	20	8.51%	2	2	93	93	6.182448862155197E-7	1	1	131	78	18	2	+C
D3_BC39_191109_LF_LIB_consensus_vsearch	2097	T	*/+G	210	11	4.74%	2	2	93	93	4.298416344617859E-4	1	1	138	72	2	9	+G
D3_BC39_191109_LF_LIB_consensus_vsearch	2099	A	*/-G	220	7	3.04%	2	2	93	93	0.007454337359329176	1	1	140	80	6	1	-G
D3_BC39_191109_LF_LIB_consensus_vsearch	2116	T	*/-C	197	31	13.19%	2	2	93	93	1.5597419166750035E-10	1	1	118	79	30	1	-C
D3_BC39_191109_LF_LIB_consensus_vsearch	2125	C	*/-A	200	27	11.49%	2	2	93	93	3.276297630265485E-9	1	1	123	77	23	4	-A
D3_BC39_191109_LF_LIB_consensus_vsearch	2131	C	*/-A	219	8	3.43%	2	1	93	93	0.0036688013849068284	1	1	137	82	8	0	-A
D3_BC39_191109_LF_LIB_consensus_vsearch	2134	G	*/+T	142	8	3.42%	2	2	93	93	0.003549622192432461	1	1	67	75	5	3	+T
D3_BC39_191109_LF_LIB_consensus_vsearch	2134	G	*/-T	142	72	30.77%	2	2	93	93	1.55190780104681E-25	1	1	67	75	69	3	-T
D3_BC39_191109_LF_LIB_consensus_vsearch	2140	G	*/-C	221	8	3.42%	2	1	93	93	0.003670845031231652	1	1	140	81	8	0	-C
D3_BC39_191109_LF_LIB_consensus_vsearch	2144	G	*/-AG	195	34	14.53%	2	1	93	93	1.550386275882856E-11	1	1	114	81	34	0	-AG
D3_BC39_191109_LF_LIB_consensus_vsearch	2145	A	*/-G	176	20	10%	2	2	93	93	5.725058565482616E-7	1	1	95	81	19	1	-G
D3_BC39_191109_LF_LIB_consensus_vsearch	2147	G	*/+A	226	9	3.83%	2	1	93	93	0.0018065516263558758	1	1	143	83	9	0	+A
D3_BC39_191109_LF_LIB_consensus_vsearch	2154	T	*/+C	214	10	4.24%	2	2	93	93	8.813089995913842E-4	1	1	146	68	1	9	+C
D3_BC39_191109_LF_LIB_consensus_vsearch	2161	A	*/-G	208	8	3.51%	2	2	93	93	0.0036568954742723925	1	1	133	75	4	4	-G
D3_BC39_191109_LF_LIB_consensus_vsearch	2164	T	*/-C	199	9	3.81%	2	2	93	93	0.0017879699024036485	1	1	119	80	7	2	-C
D3_BC39_191109_LF_LIB_consensus_vsearch	2164	T	*/-CC	199	25	10.59%	2	1	93	93	1.4670068930690744E-8	1	1	119	80	25	0	-CC
D3_BC39_191109_LF_LIB_consensus_vsearch	2183	T	*/+G	208	19	8.12%	2	2	93	93	1.287811711287195E-6	1	1	143	65	3	16	+G
D3_BC39_191109_LF_LIB_consensus_vsearch	2187	C	*/-A	220	7	2.98%	2	2	93	93	0.007454337359329176	1	1	140	80	6	1	-A
D3_BC39_191109_LF_LIB_consensus_vsearch	2193	T	*/+C	214	9	3.91%	2	2	93	93	0.0017988361772468277	1	1	138	76	8	1	+C
D3_BC39_191109_LF_LIB_consensus_vsearch	2195	C	*/-AC	217	7	3.04%	2	1	93	93	0.007449584424390529	1	1	138	79	7	0	-AC
D3_BC39_191109_LF_LIB_consensus_vsearch	2211	C	*/-AC	216	15	6.41%	2	1	93	93	2.4134087137185156E-5	1	1	133	83	15	0	-AC
D3_BC39_191109_LF_LIB_consensus_vsearch	2214	G	*/-TG	217	10	4.27%	2	1	93	93	8.825309402840407E-4	1	1	150	67	0	10	-TG
D3_BC39_191109_LF_LIB_consensus_vsearch	2215	T	*/-G	200	12	5.48%	2	2	93	93	2.0803866112796158E-4	1	1	144	56	2	10	-G
D3_BC39_191109_LF_LIB_consensus_vsearch	2225	C	*/-T	217	14	5.98%	2	2	93	93	4.982521215421391E-5	1	1	138	79	11	3	-T
D3_BC39_191109_LF_LIB_consensus_vsearch	2228	G	*/-TG	210	10	4.26%	2	2	93	93	8.796295164637225E-4	1	1	132	78	9	1	-TG
D3_BC39_191109_LF_LIB_consensus_vsearch	2230	G	*/-CG	202	8	3.57%	2	2	93	93	0.0036498841327700354	1	1	126	76	3	5	-CG
D3_BC39_191109_LF_LIB_consensus_vsearch	2234	A	*/+T	217	7	2.97%	2	1	93	93	0.007449584424390529	1	1	143	74	0	7	+T
D3_BC39_191109_LF_LIB_consensus_vsearch	2237	A	*/-G	216	12	5.13%	2	1	93	93	2.104496857598024E-4	1	1	147	69	0	12	-G
D3_BC39_191109_LF_LIB_consensus_vsearch	2248	T	*/-A	210	17	7.36%	2	2	93	93	5.590552312029508E-6	1	1	145	65	3	14	-A
D3_BC39_191109_LF_LIB_consensus_vsearch	2251	T	*/+AAT	205	7	3.02%	2	1	93	93	0.0074292407456773525	1	1	141	64	7	0	+AAT
D3_BC39_191109_LF_LIB_consensus_vsearch	2251	T	*/+C	205	7	3.02%	2	1	93	93	0.0074292407456773525	1	1	141	64	0	7	+AAT
D3_BC39_191109_LF_LIB_consensus_vsearch	2252	G	*/-CG	219	7	3.04%	2	1	93	93	0.007452766938834958	1	1	150	69	0	7	-CG
D3_BC39_191109_LF_LIB_consensus_vsearch	2255	T	*/+C	208	16	6.81%	2	1	93	93	1.1561030828960615E-5	1	1	131	77	16	0	+C
D3_BC39_191109_LF_LIB_consensus_vsearch	2257	T	*/+G	206	19	8.15%	2	1	93	93	1.2831285144228921E-6	1	1	145	61	0	19	+G
D3_BC39_191109_LF_LIB_consensus_vsearch	2258	G	*/+A	213	8	3.43%	2	1	93	93	0.0036624519192641563	1	1	131	82	8	0	+A
D3_BC39_191109_LF_LIB_consensus_vsearch	2258	G	*/-A	213	9	3.86%	2	1	93	93	0.0017981564163397133	1	1	131	82	9	0	-A
D3_BC39_191109_LF_LIB_consensus_vsearch	2260	A	*/-G	225	9	3.81%	2	2	93	93	0.0018059382541162866	1	1	144	81	8	1	-G
D3_BC39_191109_LF_LIB_consensus_vsearch	2270	C	*/+A	212	11	4.7%	2	1	93	93	4.303452996410444E-4	1	1	130	82	11	0	+A
D3_BC39_191109_LF_LIB_consensus_vsearch	2271	G	*/-A	215	10	4.31%	2	2	93	93	8.817198236951184E-4	1	1	138	77	6	4	-A
D3_BC39_191109_LF_LIB_consensus_vsearch	2276	A	*/-CA	224	7	2.97%	2	2	93	93	0.007460484300523826	1	1	144	80	6	1	-CA
D3_BC39_191109_LF_LIB_consensus_vsearch	2291	C	*/-T	220	14	5.93%	2	2	93	93	4.995890859598848E-5	1	1	152	68	1	13	-T
D3_BC39_191109_LF_LIB_consensus_vsearch	2293	C	*/-GAA	215	10	4.33%	2	1	93	93	8.817198236951184E-4	1	1	140	75	10	0	-GAA
D3_BC39_191109_LF_LIB_consensus_vsearch	2294	G	*/-A	210	8	3.54%	2	1	93	93	0.0036591481612605	1	1	132	78	8	0	-A
D3_BC39_191109_LF_LIB_consensus_vsearch	2303	A	*/-G	221	9	3.91%	2	2	93	93	0.001803432580702911	1	1	139	82	8	1	-G
D3_BC39_191109_LF_LIB_consensus_vsearch	2311	C	*/-G	215	8	3.48%	2	2	93	93	0.0036646057936482192	1	1	138	77	6	2	-G
D3_BC39_191109_LF_LIB_consensus_vsearch	2327	C	*/-AC	221	13	5.53%	2	1	93	93	1.0285657652119606E-4	1	1	138	83	13	0	-AC
D3_BC39_191109_LF_LIB_consensus_vsearch	2328	A	*/-C	200	12	5.43%	2	2	93	93	2.0803866112796158E-4	1	1	130	70	1	11	-C
D3_BC39_191109_LF_LIB_consensus_vsearch	2375	C	*/+A	218	12	5.15%	2	1	93	93	2.1072864956982534E-4	1	1	135	83	12	0	+A
D3_BC39_191109_LF_LIB_consensus_vsearch	2376	G	*/-A	218	11	4.7%	2	2	93	93	4.318055810374596E-4	1	1	138	80	10	1	-A
D3_BC39_191109_LF_LIB_consensus_vsearch	2379	C	*/+A	216	8	3.4%	2	1	93	93	0.003665668526289429	1	1	137	79	8	0	+A
D3_BC39_191109_LF_LIB_consensus_vsearch	2380	G	*/-A	219	8	3.48%	2	1	93	93	0.0036688013849068284	1	1	137	82	8	0	-A
D3_BC39_191109_LF_LIB_consensus_vsearch	2391	A	*/-C	214	14	5.96%	2	1	93	93	4.968826086820383E-5	1	1	134	80	14	0	-C
D3_BC39_191109_LF_LIB_consensus_vsearch	2395	G	*/-AG	215	15	6.38%	2	1	93	93	2.4108665249874024E-5	1	1	132	83	15	0	-AG
D3_BC39_191109_LF_LIB_consensus_vsearch	2396	A	*/-G	195	13	5.99%	2	2	93	93	1.0061064586351875E-4	1	1	122	73	6	7	-G
D3_BC39_191109_LF_LIB_consensus_vsearch	2402	T	*/+G	219	9	3.88%	2	1	93	93	0.0018021474934649558	1	1	149	70	0	9	+G
D3_BC39_191109_LF_LIB_consensus_vsearch	2416	C	*/-A	220	9	3.81%	2	1	93	93	0.0018027927820038396	1	1	140	80	9	0	-A
D3_BC39_191109_LF_LIB_consensus_vsearch	2419	T	*/-C	209	18	7.83%	2	2	93	93	2.686535435987739E-6	1	1	149	60	1	17	-C
D3_BC39_191109_LF_LIB_consensus_vsearch	2424	C	*/-G	224	10	4.26%	2	2	93	93	8.852638500565801E-4	1	1	151	73	1	9	-G
D3_BC39_191109_LF_LIB_consensus_vsearch	2435	C	*/-T	218	7	2.99%	2	1	93	93	0.007451182688346346	1	1	148	70	0	7	-T
D3_BC39_191109_LF_LIB_consensus_vsearch	2436	T	*/+C	192	20	8.81%	2	2	93	93	5.961100290609897E-7	1	1	127	65	16	4	+C
D3_BC39_191109_LF_LIB_consensus_vsearch	2436	T	*/-C	192	12	5.29%	2	2	93	93	2.0669925458579255E-4	1	1	127	65	7	5	+C
D3_BC39_191109_LF_LIB_consensus_vsearch	2439	C	*/+G	198	11	4.68%	2	2	93	93	4.2662591196418204E-4	1	1	141	57	5	6	+G
D3_BC39_191109_LF_LIB_consensus_vsearch	2440	G	*/-A	220	11	4.72%	2	2	93	93	4.322761391918409E-4	1	1	139	81	10	1	-A
D3_BC39_191109_LF_LIB_consensus_vsearch	2441	A	*/-G	206	7	3.12%	2	1	93	93	0.007431022745174962	1	1	127	79	7	0	-G
D3_BC39_191109_LF_LIB_consensus_vsearch	2442	G	*/-AG	215	7	3.07%	2	2	93	93	0.007446345105805389	1	1	138	77	3	4	-AG
D3_BC39_191109_LF_LIB_consensus_vsearch	2443	A	*/-G	204	10	4.46%	2	2	93	93	8.769963348909129E-4	1	1	134	70	4	6	-G
D3_BC39_191109_LF_LIB_consensus_vsearch	2445	G	*/+A	200	24	10.39%	2	1	93	93	3.1100546133066265E-8	1	1	119	81	24	0	+A
D3_BC39_191109_LF_LIB_consensus_vsearch	2447	C	*/+A	211	9	3.85%	2	1	93	93	0.0017967787753331713	1	1	133	78	9	0	+A
D3_BC39_191109_LF_LIB_consensus_vsearch	2450	T	*/-GC	218	9	3.9%	2	1	93	93	0.001801496644156972	1	1	150	68	0	9	-GC
D3_BC39_191109_LF_LIB_consensus_vsearch	2488	C	*/-T	213	8	3.42%	2	2	93	93	0.0036624519192641563	1	1	136	77	3	5	-T
D3_BC39_191109_LF_LIB_consensus_vsearch	2498	C	*/-A	214	8	3.42%	2	1	93	93	0.003663533633296164	1	1	146	68	0	8	-A
D3_BC39_191109_LF_LIB_consensus_vsearch	2504	A	*/-CA	198	25	10.87%	2	2	93	93	1.46207594320913E-8	1	1	124	74	18	7	-CA
D3_BC39_191109_LF_LIB_consensus_vsearch	2511	A	*/+T	210	8	3.48%	2	2	93	93	0.0036591481612605	1	1	130	80	7	1	+T
D3_BC39_191109_LF_LIB_consensus_vsearch	2515	C	*/+T	221	7	2.98%	2	2	93	93	0.007455894130096957	1	1	145	76	2	5	+T
D3_BC39_191109_LF_LIB_consensus_vsearch	2518	A	*/-G	222	8	3.4%	2	1	93	93	0.0036718537228742883	1	1	140	82	8	0	-G
D3_BC39_191109_LF_LIB_consensus_vsearch	2527	C	*/-GC	227	7	2.97%	2	1	93	93	0.0074649578216797186	1	1	146	81	7	0	-GC
D3_BC39_191109_LF_LIB_consensus_vsearch	2551	A	*/+G	74	129	56.58%	2	2	93	93	5.491798437052086E-53	1	1	48	26	74	55	+G
D3_BC39_191109_LF_LIB_consensus_vsearch	2555	T	*/-C	199	33	14.1%	2	2	93	93	3.420487071984168E-11	1	1	118	81	32	1	-C
D3_BC39_191109_LF_LIB_consensus_vsearch	2574	T	*/-A	208	8	3.42%	2	2	93	93	0.0036568954742723925	1	1	139	69	5	3	-A
D3_BC39_191109_LF_LIB_consensus_vsearch	2603	C	*/-T	211	7	3.02%	2	2	93	93	0.007439689863414905	1	1	140	71	2	5	-T
D3_BC39_191109_LF_LIB_consensus_vsearch	2607	A	*/+T	206	8	3.42%	2	1	93	93	0.0036546013500883302	1	1	148	58	0	8	+T
D3_BC39_191109_LF_LIB_consensus_vsearch	2607	A	*/-T	206	15	6.41%	2	1	93	93	2.3870469071571428E-5	1	1	148	58	0	15	-T
D3_BC39_191109_LF_LIB_consensus_vsearch	2609	C	*/-T	201	17	7.42%	2	2	93	93	5.516424489829313E-6	1	1	142	59	4	13	-T
D3_BC39_191109_LF_LIB_consensus_vsearch	2610	T	*/+C	176	12	5.69%	2	1	93	93	2.0369927796885998E-4	1	1	139	37	0	12	+C
D3_BC39_191109_LF_LIB_consensus_vsearch	2610	T	*/-G	176	7	3.32%	2	2	93	93	0.007369187819667051	1	1	139	37	4	3	+C
D3_BC39_191109_LF_LIB_consensus_vsearch	2612	G	*/-C	210	9	3.93%	2	1	93	93	0.0017960807336148846	1	1	136	74	9	0	-C
D3_BC39_191109_LF_LIB_consensus_vsearch	2614	C	*/+A	177	14	5.98%	2	2	93	93	4.76769575020497E-5	1	1	98	79	13	1	+A
D3_BC39_191109_LF_LIB_consensus_vsearch	2614	C	*/-A	177	30	12.82%	2	1	93	93	3.0011207809689923E-10	1	1	98	79	30	0	-A
D3_BC39_191109_LF_LIB_consensus_vsearch	2623	G	*/-C	194	25	10.68%	2	1	93	93	1.4420467684702072E-8	1	1	118	76	25	0	-C
D3_BC39_191109_LF_LIB_consensus_vsearch	2632	G	*/-T	221	7	3%	2	1	93	93	0.007455894130096957	1	1	139	82	7	0	-T
D3_BC39_191109_LF_LIB_consensus_vsearch	2645	C	*/-G	219	8	3.45%	2	1	93	93	0.0036688013849068284	1	1	149	70	0	8	-G
D3_BC39_191109_LF_LIB_consensus_vsearch	2649	A	*/-G	150	42	19%	2	2	93	93	1.8293482451045824E-14	1	1	127	23	23	19	-G
D3_BC39_191109_LF_LIB_consensus_vsearch	2649	A	*/-GG	150	8	3.62%	2	1	93	93	0.0035672943374071937	1	1	127	23	0	8	-G
D3_BC39_191109_LF_LIB_consensus_vsearch	2649	A	*/-GGG	150	11	4.98%	2	1	93	93	4.0923666995498303E-4	1	1	127	23	0	11	-GGG
D3_BC39_191109_LF_LIB_consensus_vsearch	2653	G	*/-CG	220	7	3.06%	2	1	93	93	0.007454337359329176	1	1	152	68	0	7	-CG
D3_BC39_191109_LF_LIB_consensus_vsearch	2654	C	*/+A	200	10	4.41%	2	1	93	93	8.751600144021374E-4	1	1	134	66	10	0	+A
D3_BC39_191109_LF_LIB_consensus_vsearch	2655	G	*/-A	217	8	3.52%	2	1	93	93	0.0036667219549938834	1	1	145	72	8	0	-A
D3_BC39_191109_LF_LIB_consensus_vsearch	2658	C	*/-AC	211	16	6.78%	2	1	93	93	1.1605032761469583E-5	1	1	132	79	16	0	-AC
D3_BC39_191109_LF_LIB_consensus_vsearch	2662	G	*/+C	216	9	3.81%	2	1	93	93	0.0018001779733764346	1	1	134	82	9	0	+C
D3_BC39_191109_LF_LIB_consensus_vsearch	2664	C	*/-G	216	8	3.39%	2	1	93	93	0.003665668526289429	1	1	138	78	8	0	-G
D3_BC39_191109_LF_LIB_consensus_vsearch	2665	G	*/+A	204	7	3.07%	2	1	93	93	0.007427442022474603	1	1	122	82	7	0	+A
D3_BC39_191109_LF_LIB_consensus_vsearch	2665	G	*/-A	204	15	6.58%	2	2	93	93	2.3815125527116474E-5	1	1	122	82	14	1	-A
D3_BC39_191109_LF_LIB_consensus_vsearch	2668	A	*/-C	210	13	5.56%	2	2	93	93	1.0196623731956113E-4	1	1	129	81	12	1	-C
D3_BC39_191109_LF_LIB_consensus_vsearch	2685	C	*/+T	212	7	3.08%	2	2	93	93	0.00744137624879223	1	1	143	69	2	5	+T
D3_BC39_191109_LF_LIB_consensus_vsearch	2691	T	*/+G	205	9	3.9%	2	2	93	93	0.0017924949478988227	1	1	144	61	2	7	+G
D3_BC39_191109_LF_LIB_consensus_vsearch	2691	T	*/-G	205	12	5.19%	2	2	93	93	2.0882828978061456E-4	1	1	144	61	4	8	-G
D3_BC39_191109_LF_LIB_consensus_vsearch	2705	A	*/-C	146	60	26.09%	2	2	93	93	5.584929176349348E-21	1	1	126	20	12	48	-C
D3_BC39_191109_LF_LIB_consensus_vsearch	2705	A	*/-CC	146	9	3.91%	2	2	93	93	0.0017332742159673858	1	1	126	20	3	6	-C
D3_BC39_191109_LF_LIB_consensus_vsearch	2711	C	*/-A	219	9	3.91%	2	2	93	93	0.0018021474934649558	1	1	141	78	8	1	-A
D3_BC39_191109_LF_LIB_consensus_vsearch	2714	T	*/-C	209	14	6.06%	2	2	93	93	4.9452447660699634E-5	1	1	145	64	3	11	-C
D3_BC39_191109_LF_LIB_consensus_vsearch	2730	G	*/-A	225	7	2.98%	2	1	93	93	0.0074619882138406745	1	1	143	82	7	0	-A
D3_BC39_191109_LF_LIB_consensus_vsearch	2731	A	*/-G	213	10	4.39%	2	1	93	93	8.808946039600796E-4	1	1	132	81	10	0	-G
D3_BC39_191109_LF_LIB_consensus_vsearch	2735	C	*/-ACA	208	15	6.47%	2	1	93	93	2.392491102102212E-5	1	1	127	81	15	0	-ACA
D3_BC39_191109_LF_LIB_consensus_vsearch	2737	C	*/-A	178	25	11.57%	2	2	93	93	1.3567495429412638E-8	1	1	99	79	24	1	-A
D3_BC39_191109_LF_LIB_consensus_vsearch	2740	G	*/-A	192	36	15.52%	2	1	93	93	3.246975342351167E-12	1	1	113	79	36	0	-A
D3_BC39_191109_LF_LIB_consensus_vsearch	2742	A	*/+G	180	18	7.73%	2	2	93	93	2.5459166912429538E-6	1	1	125	55	2	16	+G
D3_BC39_191109_LF_LIB_consensus_vsearch	2742	A	*/-G	180	35	15.02%	2	2	93	93	6.45292861291265E-12	1	1	125	55	25	10	-G
D3_BC39_191109_LF_LIB_consensus_vsearch	2747	T	*/+A	207	22	9.4%	2	1	93	93	1.4041535632924546E-7	1	1	125	82	22	0	+A
D3_BC39_191109_LF_LIB_consensus_vsearch	2748	G	*/-TG	166	11	4.7%	2	2	93	93	4.160271719522368E-4	1	1	93	73	6	5	-TG
D3_BC39_191109_LF_LIB_consensus_vsearch	2749	T	*/-G	197	11	5.02%	2	2	93	93	4.263419112240475E-4	1	1	133	64	6	5	-G
D3_BC39_191109_LF_LIB_consensus_vsearch	2754	G	*/-C	188	32	13.97%	2	2	93	93	6.905539526646406E-11	1	1	113	75	25	7	-C
D3_BC39_191109_LF_LIB_consensus_vsearch	2760	G	*/-A	218	16	6.78%	2	2	93	93	1.1703767424993676E-5	1	1	137	81	14	2	-A
D3_BC39_191109_LF_LIB_consensus_vsearch	2761	A	*/+G	63	140	63.64%	2	2	93	93	1.520873445594948E-59	1	1	51	12	74	66	+G
D3_BC39_191109_LF_LIB_consensus_vsearch	2763	G	*/+AG	206	7	2.97%	2	1	93	93	0.007431022745174962	1	1	129	77	7	0	+AG
D3_BC39_191109_LF_LIB_consensus_vsearch	2763	G	*/-C	206	7	2.97%	2	1	93	93	0.007431022745174962	1	1	129	77	7	0	+AG
D3_BC39_191109_LF_LIB_consensus_vsearch	2764	C	*/+T	182	17	7.49%	2	1	93	93	5.340986808569128E-6	1	1	123	59	0	17	+T
D3_BC39_191109_LF_LIB_consensus_vsearch	2767	A	*/-C	220	7	3%	2	2	93	93	0.007454337359329176	1	1	143	77	2	5	-C
D3_BC39_191109_LF_LIB_consensus_vsearch	2782	G	*/+A	216	8	3.48%	2	1	93	93	0.003665668526289429	1	1	135	81	8	0	+A
D3_BC39_191109_LF_LIB_consensus_vsearch	2783	A	*/-G	213	7	3.07%	2	1	93	93	0.007443047448823043	1	1	132	81	7	0	-G
D3_BC39_191109_LF_LIB_consensus_vsearch	2784	G	*/-A	201	9	3.98%	2	1	93	93	0.0017895062981052791	1	1	124	77	9	0	-A
D3_BC39_191109_LF_LIB_consensus_vsearch	2784	G	*/-AG	201	15	6.64%	2	2	93	93	2.373037043728608E-5	1	1	124	77	10	5	-AG
D3_BC39_191109_LF_LIB_consensus_vsearch	2794	G	*/-C	219	7	3.02%	2	2	93	93	0.007452766938834958	1	1	139	80	5	2	-C
D3_BC39_191109_LF_LIB_consensus_vsearch	2796	C	*/-G	222	10	4.27%	2	2	93	93	8.844993515297029E-4	1	1	141	81	9	1	-G
D3_BC39_191109_LF_LIB_consensus_vsearch	2806	C	*/-TT	213	11	4.74%	2	1	93	93	4.305938947768699E-4	1	1	137	76	11	0	-TT
D3_BC39_191109_LF_LIB_consensus_vsearch	2813	G	*/-A	223	9	3.85%	2	1	93	93	0.0018046959863042469	1	1	140	83	9	0	-A
D3_BC39_191109_LF_LIB_consensus_vsearch	2818	T	*/+G	214	10	4.33%	2	2	93	93	8.813089995913842E-4	1	1	141	73	1	9	+G
D3_BC39_191109_LF_LIB_consensus_vsearch	2821	T	*/-C	223	8	3.42%	2	2	93	93	0.0036728538094896964	1	1	145	78	5	3	-C
D3_BC39_191109_LF_LIB_consensus_vsearch	2825	T	*/+C	208	17	7.2%	2	1	93	93	5.574528228215115E-6	1	1	126	82	17	0	+C
D3_BC39_191109_LF_LIB_consensus_vsearch	2830	A	*/-G	211	12	5.17%	2	2	93	93	2.0973150235371546E-4	1	1	130	81	11	1	-G
D3_BC39_191109_LF_LIB_consensus_vsearch	2835	C	*/-ACC	225	8	3.4%	2	1	93	93	0.0036748286042396724	1	1	142	83	8	0	-ACC
D3_BC39_191109_LF_LIB_consensus_vsearch	2841	C	*/-G	219	8	3.48%	2	1	93	93	0.0036688013849068284	1	1	137	82	8	0	-G
D3_BC39_191109_LF_LIB_consensus_vsearch	2843	G	*/-A	224	7	2.98%	2	2	93	93	0.007460484300523826	1	1	143	81	6	1	-A
D3_BC39_191109_LF_LIB_consensus_vsearch	2848	C	*/+T	217	9	3.81%	2	2	93	93	0.0018008401619304512	1	1	141	76	4	5	+T
D3_BC39_191109_LF_LIB_consensus_vsearch	2861	G	*/-TA	220	7	2.98%	2	2	93	93	0.007454337359329176	1	1	140	80	6	1	-TA
D3_BC39_191109_LF_LIB_consensus_vsearch	2866	T	*/-C	216	9	3.85%	2	2	93	93	0.0018001779733764346	1	1	139	77	6	3	-C
D3_BC39_191109_LF_LIB_consensus_vsearch	2869	T	*/+C	214	10	4.37%	2	1	93	93	8.813089995913842E-4	1	1	136	78	10	0	+C
D3_BC39_191109_LF_LIB_consensus_vsearch	2871	T	*/-A	207	8	3.49%	2	1	93	93	0.003655753662936563	1	1	131	76	8	0	-A
D3_BC39_191109_LF_LIB_consensus_vsearch	2891	A	*/+T	228	7	2.98%	2	1	93	93	0.007466423838535645	1	1	152	76	0	7	+T
D3_BC39_191109_LF_LIB_consensus_vsearch	2895	C	*/-TC	204	21	9.25%	2	2	93	93	2.923785526578798E-7	1	1	149	55	2	19	-TC
D3_BC39_191109_LF_LIB_consensus_vsearch	2896	T	*/+C	192	15	7.08%	2	1	93	93	2.3462820410529364E-5	1	1	130	62	15	0	+C
D3_BC39_191109_LF_LIB_consensus_vsearch	2902	A	*/-C	106	95	41.13%	2	2	93	93	9.836973494009223E-36	1	1	81	25	57	38	-C
D3_BC39_191109_LF_LIB_consensus_vsearch	2902	A	*/-CC	106	23	9.96%	2	2	93	93	4.06474458933411E-8	1	1	81	25	7	16	-C
D3_BC39_191109_LF_LIB_consensus_vsearch	2904	C	*/+T	185	11	5.37%	2	2	93	93	4.227182557705049E-4	1	1	126	59	7	4	+T
D3_BC39_191109_LF_LIB_consensus_vsearch	2914	G	*/+C	222	8	3.43%	2	1	93	93	0.0036718537228742883	1	1	144	78	8	0	+C
D3_BC39_191109_LF_LIB_consensus_vsearch	2916	C	*/+G	184	15	6.36%	2	2	93	93	2.3206771680154826E-5	1	1	114	70	13	2	+G
D3_BC39_191109_LF_LIB_consensus_vsearch	2916	C	*/-G	184	27	11.44%	2	2	93	93	3.0652960978242066E-9	1	1	114	70	19	8	-G
D3_BC39_191109_LF_LIB_consensus_vsearch	2919	G	*/+A	217	8	3.39%	2	1	93	93	0.0036667219549938834	1	1	135	82	8	0	+A
D3_BC39_191109_LF_LIB_consensus_vsearch	2928	G	*/-C	207	10	4.35%	2	2	93	93	8.783305527122537E-4	1	1	126	81	9	1	-C
D3_BC39_191109_LF_LIB_consensus_vsearch	2933	T	*/-C	210	18	7.76%	2	2	93	93	2.6908372666736656E-6	1	1	132	78	17	1	-C
D3_BC39_191109_LF_LIB_consensus_vsearch	2935	C	*/+G	218	7	2.97%	2	1	93	93	0.007451182688346346	1	1	148	70	0	7	+G
D3_BC39_191109_LF_LIB_consensus_vsearch	2940	T	*/-C	205	14	6.03%	2	2	93	93	4.9256649870734555E-5	1	1	147	58	3	11	-C
D3_BC39_191109_LF_LIB_consensus_vsearch	2940	T	*/-CCT	205	8	3.45%	2	1	93	93	0.0036534383902297935	1	1	147	58	0	8	-C
D3_BC39_191109_LF_LIB_consensus_vsearch	2944	C	*/-A	211	21	8.97%	2	1	93	93	2.9693129721095895E-7	1	1	132	79	21	0	-A
D3_BC39_191109_LF_LIB_consensus_vsearch	2945	A	*/-C	194	15	7.01%	2	2	93	93	2.3524071874557613E-5	1	1	117	77	12	3	-C
D3_BC39_191109_LF_LIB_consensus_vsearch	2952	C	*/-A	219	11	4.66%	2	1	93	93	4.3204184318133837E-4	1	1	137	82	11	0	-A
D3_BC39_191109_LF_LIB_consensus_vsearch	2955	T	*/-C	207	24	10.3%	2	2	93	93	3.1753861896259835E-8	1	1	150	57	1	23	-C
D3_BC39_191109_LF_LIB_consensus_vsearch	2981	T	*/-GT	204	26	11.11%	2	2	93	93	7.0499754694689025E-9	1	1	139	65	11	15	-GT
D3_BC39_191109_LF_LIB_consensus_vsearch	2985	C	*/+A	166	7	3.03%	2	1	93	93	0.007343868313612718	1	1	89	77	7	0	+A
D3_BC39_191109_LF_LIB_consensus_vsearch	2985	C	*/-A	166	47	20.35%	2	1	93	93	4.0869306569055314E-16	1	1	89	77	47	0	-A
D3_BC39_191109_LF_LIB_consensus_vsearch	2988	A	*/-G	212	15	6.41%	2	2	93	93	2.4031176331551327E-5	1	1	136	76	9	6	-G
D3_BC39_191109_LF_LIB_consensus_vsearch	2990	G	*/+A	188	24	10.21%	2	1	93	93	2.9910218982788557E-8	1	1	106	82	24	0	+A
D3_BC39_191109_LF_LIB_consensus_vsearch	2992	C	*/+G	206	11	4.76%	2	1	93	93	4.288076047440095E-4	1	1	127	79	11	0	+G
D3_BC39_191109_LF_LIB_consensus_vsearch	2993	A	*/-G	164	44	19.05%	2	2	93	93	4.458911413543618E-15	1	1	111	53	18	26	-G
D3_BC39_191109_LF_LIB_consensus_vsearch	2997	A	*/-CA	214	14	6.06%	2	1	93	93	4.968826086820383E-5	1	1	149	65	0	14	-CA
D3_BC39_191109_LF_LIB_consensus_vsearch	3008	G	*/-TG	220	7	3.02%	2	1	93	93	0.007454337359329176	1	1	150	70	0	7	-TG
D3_BC39_191109_LF_LIB_consensus_vsearch	3019	A	*/-C	217	9	3.86%	2	2	93	93	0.0018008401619304512	1	1	140	77	3	6	-C
D3_BC39_191109_LF_LIB_consensus_vsearch	3022	C	*/-AC	224	7	2.99%	2	1	93	93	0.007460484300523826	1	1	143	81	7	0	-AC
D3_BC39_191109_LF_LIB_consensus_vsearch	3030	C	*/+A	212	7	3.03%	2	1	93	93	0.00744137624879223	1	1	132	80	7	0	+A
D3_BC39_191109_LF_LIB_consensus_vsearch	3030	C	*/-G	212	7	3.03%	2	1	93	93	0.00744137624879223	1	1	132	80	7	0	+A
D3_BC39_191109_LF_LIB_consensus_vsearch	3031	G	*/+A	203	7	3.07%	2	1	93	93	0.007425626339083171	1	1	120	83	7	0	+A
D3_BC39_191109_LF_LIB_consensus_vsearch	3031	G	*/-A	203	16	7.02%	2	1	93	93	1.1485308764863282E-5	1	1	120	83	16	0	-A
D3_BC39_191109_LF_LIB_consensus_vsearch	3032	A	*/-G	195	15	6.85%	2	1	93	93	2.3554302919744083E-5	1	1	114	81	15	0	-G
D3_BC39_191109_LF_LIB_consensus_vsearch	3038	T	*/+C	102	123	52.12%	2	2	93	93	5.992776149114285E-48	1	1	95	7	55	68	+C
D3_BC39_191109_LF_LIB_consensus_vsearch	3039	C	*/-A	220	8	3.4%	2	2	93	93	0.0036698276230520683	1	1	146	74	2	6	-A
D3_BC39_191109_LF_LIB_consensus_vsearch	3061	C	*/-A	182	26	11.21%	2	2	93	93	6.479101948423553E-9	1	1	109	73	23	3	-A
D3_BC39_191109_LF_LIB_consensus_vsearch	3061	C	*/-AA	182	13	5.6%	2	2	93	93	9.927932507195894E-5	1	1	109	73	7	6	-A
D3_BC39_191109_LF_LIB_consensus_vsearch	3071	T	*/-C	204	20	8.55%	2	2	93	93	6.120185088270156E-7	1	1	132	72	13	7	-C
D3_BC39_191109_LF_LIB_consensus_vsearch	3080	C	*/+A	220	7	2.97%	2	1	93	93	0.007454337359329176	1	1	138	82	7	0	+A
D3_BC39_191109_LF_LIB_consensus_vsearch	3087	G	*/-A	227	7	2.97%	2	2	93	93	0.0074649578216797186	1	1	146	81	6	1	-A
D3_BC39_191109_LF_LIB_consensus_vsearch	3092	C	*/-A	213	12	5.22%	2	2	93	93	2.1002241192895544E-4	1	1	136	77	11	1	-A
D3_BC39_191109_LF_LIB_consensus_vsearch	3098	A	*/-T	217	12	5.19%	2	2	93	93	2.1058974645692333E-4	1	1	137	80	11	1	-T
D3_BC39_191109_LF_LIB_consensus_vsearch	3101	A	*/-C	212	8	3.48%	2	2	93	93	0.003661360523321731	1	1	134	78	5	3	-C
D3_BC39_191109_LF_LIB_consensus_vsearch	3104	C	*/-A	204	8	3.4%	2	2	93	93	0.0036522646351654408	1	1	142	62	3	5	-A
D3_BC39_191109_LF_LIB_consensus_vsearch	3107	G	*/-C	209	8	3.48%	2	1	93	93	0.003658026926953576	1	1	138	71	0	8	-C
D3_BC39_191109_LF_LIB_consensus_vsearch	3109	C	*/+T	220	8	3.45%	2	1	93	93	0.0036698276230520683	1	1	152	68	0	8	+T
D3_BC39_191109_LF_LIB_consensus_vsearch	3110	T	*/-C	193	34	14.78%	2	1	93	93	1.5309572857714794E-11	1	1	151	42	0	34	-C
D3_BC39_191109_LF_LIB_consensus_vsearch	3111	C	*/-TC	171	21	10.5%	2	2	93	93	2.675089571372386E-7	1	1	142	29	10	11	-TC
D3_BC39_191109_LF_LIB_consensus_vsearch	3115	G	*/-C	220	8	3.45%	2	1	93	93	0.0036698276230520683	1	1	141	79	8	0	-C
D3_BC39_191109_LF_LIB_consensus_vsearch	3117	C	*/+A	183	7	2.98%	2	2	93	93	0.007385343252869138	1	1	107	76	5	2	+A
D3_BC39_191109_LF_LIB_consensus_vsearch	3117	C	*/-A	183	33	14.04%	2	1	93	93	3.100203503251058E-11	1	1	107	76	33	0	-A
D3_BC39_191109_LF_LIB_consensus_vsearch	3127	G	*/-C	207	24	10.3%	2	1	93	93	3.1753861896259835E-8	1	1	127	80	24	0	-C
D3_BC39_191109_LF_LIB_consensus_vsearch	3141	T	*/+C	222	7	2.98%	2	2	93	93	0.007457437428309682	1	1	145	77	6	1	+C
D3_BC39_191109_LF_LIB_consensus_vsearch	3153	G	*/-CG	168	58	25.11%	2	2	93	93	5.1763276130859575E-20	1	1	103	65	43	15	-CG
D3_BC39_191109_LF_LIB_consensus_vsearch	3155	G	*/-T	160	9	5.2%	2	2	93	93	0.001750956793192828	1	1	104	56	2	7	-T
D3_BC39_191109_LF_LIB_consensus_vsearch	3158	C	*/-GG	203	12	5.31%	2	2	93	93	2.0851661109317314E-4	1	1	139	64	4	8	-GG
D3_BC39_191109_LF_LIB_consensus_vsearch	3160	G	*/+C	30	167	74.89%	2	2	93	93	1.5015830543978884E-80	1	1	25	5	108	59	+C
D3_BC39_191109_LF_LIB_consensus_vsearch	3163	A	*/-G	211	10	4.29%	2	1	93	93	8.800549103686053E-4	1	1	143	68	0	10	-G
D3_BC39_191109_LF_LIB_consensus_vsearch	3171	T	*/-A	201	17	7.39%	2	2	93	93	5.516424489829313E-6	1	1	126	75	13	4	-A
D3_BC39_191109_LF_LIB_consensus_vsearch	3173	A	*/-G	206	7	3.02%	2	2	93	93	0.007431022745174962	1	1	131	75	4	3	-G
D3_BC39_191109_LF_LIB_consensus_vsearch	3180	C	*/-A	219	11	4.68%	2	2	93	93	4.3204184318133837E-4	1	1	140	79	10	1	-A
D3_BC39_191109_LF_LIB_consensus_vsearch	3183	A	*/-G	211	11	4.7%	2	1	93	93	4.300945555177922E-4	1	1	132	79	11	0	-G
D3_BC39_191109_LF_LIB_consensus_vsearch	3184	G	*/+A	212	7	3.11%	2	1	93	93	0.00744137624879223	1	1	131	81	7	0	+A
D3_BC39_191109_LF_LIB_consensus_vsearch	3189	G	*/-T	221	10	4.27%	2	2	93	93	8.841122846835742E-4	1	1	140	81	9	1	-T
D3_BC39_191109_LF_LIB_consensus_vsearch	3191	T	*/-A	203	25	10.73%	2	1	93	93	1.486432791549526E-8	1	1	125	78	25	0	-A
D3_BC39_191109_LF_LIB_consensus_vsearch	3208	A	*/+C	201	8	3.43%	2	2	93	93	0.003648677074969142	1	1	125	76	7	1	+C
D3_BC39_191109_LF_LIB_consensus_vsearch	3208	A	*/-C	201	20	8.58%	2	2	93	93	6.081727839654859E-7	1	1	125	76	16	4	-C
D3_BC39_191109_LF_LIB_consensus_vsearch	3220	G	*/-CG	219	9	3.88%	2	2	93	93	0.0018021474934649558	1	1	146	73	2	7	-CG
D3_BC39_191109_LF_LIB_consensus_vsearch	3228	T	*/+C	219	7	3.04%	2	1	93	93	0.007452766938834958	1	1	142	77	7	0	+C
D3_BC39_191109_LF_LIB_consensus_vsearch	3231	G	*/+C	201	8	3.51%	2	1	93	93	0.003648677074969142	1	1	124	77	8	0	+C
D3_BC39_191109_LF_LIB_consensus_vsearch	3244	C	*/-G	211	11	4.78%	2	2	93	93	4.300945555177922E-4	1	1	145	66	1	10	-G
D3_BC39_191109_LF_LIB_consensus_vsearch	3249	C	*/-T	223	7	2.98%	2	2	93	93	0.007458967428082863	1	1	150	73	1	6	-T
D3_BC39_191109_LF_LIB_consensus_vsearch	3250	T	*/-C	214	9	3.93%	2	1	93	93	0.0017988361772468277	1	1	149	65	0	9	-C
D3_BC39_191109_LF_LIB_consensus_vsearch	3252	G	*/+T	209	12	5.13%	2	1	93	93	2.0943559915765036E-4	1	1	131	78	12	0	+T
D3_BC39_191109_LF_LIB_consensus_vsearch	3252	G	*/-T	209	7	2.99%	2	1	93	93	0.007436270701269745	1	1	131	78	7	0	+T
D3_BC39_191109_LF_LIB_consensus_vsearch	3255	T	*/+C	164	10	4.24%	2	2	93	93	8.549835212479261E-4	1	1	94	70	7	3	+C
D3_BC39_191109_LF_LIB_consensus_vsearch	3255	T	*/-C	164	51	21.61%	2	2	93	93	1.5277213318464095E-17	1	1	94	70	44	7	-C
D3_BC39_191109_LF_LIB_consensus_vsearch	3257	C	*/-G	215	16	6.81%	2	2	93	93	1.1662109220663649E-5	1	1	148	67	3	13	-G
D3_BC39_191109_LF_LIB_consensus_vsearch	3261	T	*/-C	215	18	7.63%	2	2	93	93	2.7118689984586317E-6	1	1	134	81	17	1	-C
D3_BC39_191109_LF_LIB_consensus_vsearch	3262	C	*/+A	208	8	3.67%	2	2	93	93	0.0036568954742723925	1	1	131	77	4	4	+A
D3_BC39_191109_LF_LIB_consensus_vsearch	3263	C	*/+A	19	14	5.93%	2	1	93	93	1.0577067317699397E-5	1	1	18	1	14	0	+A
D3_BC39_191109_LF_LIB_consensus_vsearch	3267	T	*/-C	220	11	4.68%	2	1	93	93	4.322761391918409E-4	1	1	138	82	11	0	-C
D3_BC39_191109_LF_LIB_consensus_vsearch	3272	A	*/-CA	177	40	17.39%	2	2	93	93	1.2551052481842306E-13	1	1	122	55	20	20	-CA
D3_BC39_191109_LF_LIB_consensus_vsearch	3273	C	*/-AT	177	7	3.65%	2	2	93	93	0.007371570136883838	1	1	125	52	4	3	-AT
D3_BC39_191109_LF_LIB_consensus_vsearch	3274	A	*/-T	163	7	3.76%	2	1	93	93	0.007335698806984051	1	1	111	52	7	0	-T
D3_BC39_191109_LF_LIB_consensus_vsearch	3276	G	*/-A	222	10	4.26%	2	2	93	93	8.844993515297029E-4	1	1	142	80	8	2	-A
D3_BC39_191109_LF_LIB_consensus_vsearch	3285	G	*/-C	217	13	5.58%	2	2	93	93	1.0254206608526479E-4	1	1	138	79	11	2	-C
D3_BC39_191109_LF_LIB_consensus_vsearch	3291	T	*/-G	183	24	10.39%	2	1	93	93	2.9386090804310453E-8	1	1	115	68	24	0	-G
D3_BC39_191109_LF_LIB_consensus_vsearch	3292	G	*/+A	65	66	32.2%	2	2	93	93	1.9922579480131745E-25	1	1	57	8	39	27	+A
D3_BC39_191109_LF_LIB_consensus_vsearch	3292	G	*/+AG	65	65	31.71%	2	2	93	93	5.305911473794812E-25	1	1	57	8	22	43	+A
D3_BC39_191109_LF_LIB_consensus_vsearch	3298	C	*/+A	194	22	9.36%	2	1	93	93	1.357809470111312E-7	1	1	120	74	22	0	+A
D3_BC39_191109_LF_LIB_consensus_vsearch	3298	C	*/-G	194	8	3.4%	2	1	93	93	0.003639898683792886	1	1	120	74	8	0	+A
D3_BC39_191109_LF_LIB_consensus_vsearch	3299	G	*/-A	195	30	13.22%	2	2	93	93	3.3072076802006337E-10	1	1	114	81	28	2	-A
D3_BC39_191109_LF_LIB_consensus_vsearch	3301	G	*/+C	101	102	43.78%	2	2	93	93	6.395105291749953E-39	1	1	61	40	69	33	+C
D3_BC39_191109_LF_LIB_consensus_vsearch	3301	G	*/+CC	101	7	3%	2	2	93	93	0.007067246419106458	1	1	61	40	6	1	+C
D3_BC39_191109_LF_LIB_consensus_vsearch	3301	G	*/-C	101	8	3.43%	2	2	93	93	0.0034196353640842483	1	1	61	40	4	4	-C
D3_BC39_191109_LF_LIB_consensus_vsearch	3305	C	*/-G	211	15	6.41%	2	2	93	93	2.4004930780571747E-5	1	1	144	67	6	9	-G
D3_BC39_191109_LF_LIB_consensus_vsearch	3313	G	*/-A	223	8	3.42%	2	2	93	93	0.0036728538094896964	1	1	142	81	7	1	-A
D3_BC39_191109_LF_LIB_consensus_vsearch	3314	A	*/+G	189	9	4%	2	2	93	93	0.00177983409863699	1	1	120	69	3	6	+G
D3_BC39_191109_LF_LIB_consensus_vsearch	3314	A	*/-G	189	18	8%	2	2	93	93	2.5931159639340357E-6	1	1	120	69	13	5	-G
D3_BC39_191109_LF_LIB_consensus_vsearch	3317	G	*/-C	216	10	4.24%	2	1	93	93	8.821271222096345E-4	1	1	136	80	10	0	-C
D3_BC39_191109_LF_LIB_consensus_vsearch	3319	C	*/-G	208	14	5.98%	2	1	93	93	4.9404108604884E-5	1	1	131	77	14	0	-G
D3_BC39_191109_LF_LIB_consensus_vsearch	3324	C	*/-G	218	8	3.45%	2	1	93	93	0.003667766201363899	1	1	151	67	0	8	-G
D3_BC39_191109_LF_LIB_consensus_vsearch	3333	T	*/-AT	214	10	4.31%	2	2	93	93	8.813089995913842E-4	1	1	138	76	8	2	-AT
D3_BC39_191109_LF_LIB_consensus_vsearch	3351	C	*/-AC	165	65	27.78%	2	2	93	93	1.3765570814428792E-22	1	1	91	74	57	8	-AC
D3_BC39_191109_LF_LIB_consensus_vsearch	3354	G	*/+T	221	7	2.98%	2	1	93	93	0.007455894130096957	1	1	141	80	7	0	+T
D3_BC39_191109_LF_LIB_consensus_vsearch	3364	C	*/+T	218	8	3.42%	2	1	93	93	0.003667766201363899	1	1	148	70	0	8	+T
D3_BC39_191109_LF_LIB_consensus_vsearch	3373	T	*/+C	219	14	5.93%	2	2	93	93	4.9914697602419593E-5	1	1	137	82	13	1	+C
D3_BC39_191109_LF_LIB_consensus_vsearch	3388	C	*/+A	216	8	3.39%	2	1	93	93	0.003665668526289429	1	1	135	81	8	0	+A
D3_BC39_191109_LF_LIB_consensus_vsearch	3388	C	*/-G	216	7	2.97%	2	2	93	93	0.007447971960236055	1	1	135	81	6	1	+A
D3_BC39_191109_LF_LIB_consensus_vsearch	3389	G	*/-A	215	12	5.26%	2	1	93	93	2.103084529771467E-4	1	1	133	82	12	0	-A
D3_BC39_191109_LF_LIB_consensus_vsearch	3400	C	*/+A	215	7	2.98%	2	1	93	93	0.007446345105805389	1	1	135	80	7	0	+A
D3_BC39_191109_LF_LIB_consensus_vsearch	3401	G	*/-A	219	8	3.45%	2	1	93	93	0.0036688013849068284	1	1	138	81	8	0	-A
D3_BC39_191109_LF_LIB_consensus_vsearch	3419	C	*/-AC	220	8	3.45%	2	1	93	93	0.0036698276230520683	1	1	140	80	8	0	-AC
D3_BC39_191109_LF_LIB_consensus_vsearch	3423	A	*/-C	223	7	3%	2	2	93	93	0.007458967428082863	1	1	142	81	6	1	-C
D3_BC39_191109_LF_LIB_consensus_vsearch	3425	C	*/-ACC	223	7	2.98%	2	2	93	93	0.007458967428082863	1	1	145	78	5	2	-ACC
D3_BC39_191109_LF_LIB_consensus_vsearch	3426	A	*/-C	211	12	5.31%	2	2	93	93	2.0973150235371546E-4	1	1	136	75	8	4	-C
D3_BC39_191109_LF_LIB_consensus_vsearch	3439	T	*/+A	211	9	3.91%	2	1	93	93	0.0017967787753331713	1	1	134	77	9	0	+A
D3_BC39_191109_LF_LIB_consensus_vsearch	3443	A	*/-GA	200	21	9.05%	2	2	93	93	2.896747146375421E-7	1	1	132	68	10	11	-GA
D3_BC39_191109_LF_LIB_consensus_vsearch	3449	A	*/-TA	213	15	6.36%	2	2	93	93	2.4057212275525828E-5	1	1	140	73	7	8	-TA
D3_BC39_191109_LF_LIB_consensus_vsearch	3462	T	*/-C	214	7	3.06%	2	2	93	93	0.007444703667648697	1	1	142	72	4	3	-C
D3_BC39_191109_LF_LIB_consensus_vsearch	3473	T	*/-C	213	16	6.78%	2	1	93	93	1.1633794120125217E-5	1	1	132	81	16	0	-C
D3_BC39_191109_LF_LIB_consensus_vsearch	3478	T	*/-C	214	18	7.66%	2	1	93	93	2.7077251430281975E-6	1	1	131	83	18	0	-C
D3_BC39_191109_LF_LIB_consensus_vsearch	3481	T	*/+G	214	8	3.46%	2	2	93	93	0.003663533633296164	1	1	141	73	1	7	+G
D3_BC39_191109_LF_LIB_consensus_vsearch	3491	T	*/-C	199	34	14.53%	2	2	93	93	1.588871414082148E-11	1	1	121	78	31	3	-C
D3_BC39_191109_LF_LIB_consensus_vsearch	3504	C	*/-A	219	9	3.81%	2	2	93	93	0.0018021474934649558	1	1	145	74	4	5	-A
D3_BC39_191109_LF_LIB_consensus_vsearch	3509	T	*/-AA	192	27	11.54%	2	1	93	93	3.173153759197354E-9	1	1	143	49	0	27	-AA
D3_BC39_191109_LF_LIB_consensus_vsearch	3514	C	*/+A	204	7	2.97%	2	1	93	93	0.007427442022474603	1	1	132	72	7	0	+A
D3_BC39_191109_LF_LIB_consensus_vsearch	3523	C	*/-A	204	9	3.86%	2	2	93	93	0.0017917580621936403	1	1	126	78	8	1	-A
D3_BC39_191109_LF_LIB_consensus_vsearch	3523	C	*/-AC	204	17	7.3%	2	1	93	93	5.541719766097385E-6	1	1	126	78	17	0	-AC
D3_BC39_191109_LF_LIB_consensus_vsearch	3533	T	*/+A	211	15	6.36%	2	1	93	93	2.4004930780571747E-5	1	1	135	76	15	0	+A
D3_BC39_191109_LF_LIB_consensus_vsearch	3536	G	*/-C	205	19	8.3%	2	2	93	93	1.2807606843266436E-6	1	1	130	75	18	1	-C
D3_BC39_191109_LF_LIB_consensus_vsearch	3537	C	*/+T	205	7	3.26%	2	1	93	93	0.0074292407456773525	1	1	132	73	0	7	+T
D3_BC39_191109_LF_LIB_consensus_vsearch	3538	C	*/+T	223	7	2.98%	2	1	93	93	0.007458967428082863	1	1	150	73	0	7	+T
D3_BC39_191109_LF_LIB_consensus_vsearch	3546	C	*/-A	224	8	3.42%	2	2	93	93	0.003673845400689721	1	1	147	77	3	5	-A
D3_BC39_191109_LF_LIB_consensus_vsearch	3550	T	*/-C	219	7	2.99%	2	2	93	93	0.007452766938834958	1	1	146	73	6	1	-C
D3_BC39_191109_LF_LIB_consensus_vsearch	3576	T	-A/-A	12	205	87.61%	2	2	93	93	1.907253642580804E-110	1	1	6	6	130	75	-A
D3_BC39_191109_LF_LIB_consensus_vsearch	3576	T	*/-AA	12	13	5.56%	2	2	93	93	1.4654490222007342E-5	1	1	6	6	12	1	-A
D3_BC39_191109_LF_LIB_consensus_vsearch	3579	C	*/+T	198	16	7.11%	2	1	93	93	1.1406445395916652E-5	1	1	143	55	0	16	+T
D3_BC39_191109_LF_LIB_consensus_vsearch	3580	T	*/+C	135	37	16.3%	2	2	93	93	8.299529342838011E-13	1	1	81	54	32	5	+C
D3_BC39_191109_LF_LIB_consensus_vsearch	3580	T	*/-C	135	42	18.5%	2	2	93	93	1.4342786723303736E-14	1	1	81	54	26	16	-C
D3_BC39_191109_LF_LIB_consensus_vsearch	3587	G	*/-A	219	11	4.72%	2	2	93	93	4.3204184318133837E-4	1	1	138	81	10	1	-A
D3_BC39_191109_LF_LIB_consensus_vsearch	3589	G	*/-C	210	11	4.76%	2	1	93	93	4.298416344617859E-4	1	1	131	79	11	0	-C
D3_BC39_191109_LF_LIB_consensus_vsearch	3592	C	*/-A	203	21	8.94%	2	1	93	93	2.917097565439073E-7	1	1	124	79	21	0	-A
D3_BC39_191109_LF_LIB_consensus_vsearch	3599	T	*/+C	191	24	10.26%	2	2	93	93	3.0216532806748016E-8	1	1	127	64	22	2	+C
D3_BC39_191109_LF_LIB_consensus_vsearch	3599	T	*/-C	191	14	5.98%	2	1	93	93	4.85162064553485E-5	1	1	127	64	0	14	+C
D3_BC39_191109_LF_LIB_consensus_vsearch	3603	A	*/-T	216	11	4.68%	2	2	93	93	4.313270586514381E-4	1	1	148	68	1	10	-T
D3_BC39_191109_LF_LIB_consensus_vsearch	3612	C	*/-G	216	7	3.07%	2	1	93	93	0.007447971960236055	1	1	143	73	0	7	-G
D3_BC39_191109_LF_LIB_consensus_vsearch	3615	G	*/-C	215	9	3.81%	2	2	93	93	0.0017995100038167202	1	1	135	80	7	2	-C
D3_BC39_191109_LF_LIB_consensus_vsearch	3622	C	*/+A	212	17	7.3%	2	1	93	93	5.606330650645509E-6	1	1	130	82	17	0	+A
D3_BC39_191109_LF_LIB_consensus_vsearch	3623	G	*/-A	210	19	8.12%	2	2	93	93	1.2924262145172922E-6	1	1	132	78	17	2	-A
D3_BC39_191109_LF_LIB_consensus_vsearch	3628	G	*/-A	209	12	5.11%	2	2	93	93	2.0943559915765036E-4	1	1	129	80	11	1	-A
D3_BC39_191109_LF_LIB_consensus_vsearch	3628	G	*/-AT	209	12	5.11%	2	2	93	93	2.0943559915765036E-4	1	1	129	80	11	1	-A
D3_BC39_191109_LF_LIB_consensus_vsearch	3632	T	*/+C	219	9	3.81%	2	2	93	93	0.0018021474934649558	1	1	141	78	7	2	+C
D3_BC39_191109_LF_LIB_consensus_vsearch	3644	G	*/-C	207	15	6.44%	2	1	93	93	2.3897801371672697E-5	1	1	125	82	15	0	-C
D3_BC39_191109_LF_LIB_consensus_vsearch	3685	C	*/-T	225	7	2.98%	2	2	93	93	0.0074619882138406745	1	1	147	78	3	4	-T
D3_BC39_191109_LF_LIB_consensus_vsearch	3693	C	*/-T	219	8	3.49%	2	1	93	93	0.0036688013849068284	1	1	146	73	0	8	-T
D3_BC39_191109_LF_LIB_consensus_vsearch	3699	T	*/+C	154	7	3.02%	2	2	93	93	0.007309387540537701	1	1	99	55	4	3	+C
D3_BC39_191109_LF_LIB_consensus_vsearch	3699	T	*/-C	154	50	21.55%	2	2	93	93	2.8824453899339035E-17	1	1	99	55	41	9	-C
D3_BC39_191109_LF_LIB_consensus_vsearch	3699	T	*/-CC	154	19	8.19%	2	2	93	93	1.1312238573323024E-6	1	1	99	55	4	15	-C
D3_BC39_191109_LF_LIB_consensus_vsearch	3708	C	*/-T	222	9	3.83%	2	2	93	93	0.001804066959286255	1	1	150	72	1	8	-T
D3_BC39_191109_LF_LIB_consensus_vsearch	3714	T	*/-C	205	29	12.34%	2	1	93	93	7.390227812181403E-10	1	1	122	83	29	0	-C
D3_BC39_191109_LF_LIB_consensus_vsearch	3725	G	*/-A	208	8	3.54%	2	1	93	93	0.0036568954742723925	1	1	130	78	8	0	-A
D3_BC39_191109_LF_LIB_consensus_vsearch	3731	G	*/-C	197	29	12.45%	2	2	93	93	7.136208771491052E-10	1	1	136	61	15	14	-C
D3_BC39_191109_LF_LIB_consensus_vsearch	3732	C	*/+T	177	25	12.25%	2	1	93	93	1.3511268759586835E-8	1	1	136	41	0	25	+T
D3_BC39_191109_LF_LIB_consensus_vsearch	3733	C	*/+G	209	10	4.26%	2	1	93	93	8.792003591123169E-4	1	1	140	69	10	0	+G
D3_BC39_191109_LF_LIB_consensus_vsearch	3734	C	*/-T	206	13	5.51%	2	2	93	93	1.016217291023551E-4	1	1	141	65	3	10	-T
D3_BC39_191109_LF_LIB_consensus_vsearch	3734	C	*/-TT	206	7	2.97%	2	2	93	93	0.007431022745174962	1	1	141	65	6	1	-T
D3_BC39_191109_LF_LIB_consensus_vsearch	3737	G	*/-C	224	8	3.4%	2	2	93	93	0.003673845400689721	1	1	143	81	7	1	-C
D3_BC39_191109_LF_LIB_consensus_vsearch	3745	C	*/-T	210	7	3%	2	2	93	93	0.007437988084800957	1	1	144	66	2	5	-T
D3_BC39_191109_LF_LIB_consensus_vsearch	3748	T	*/-C	215	13	5.53%	2	2	93	93	1.0238092820754376E-4	1	1	146	69	1	12	-C
D3_BC39_191109_LF_LIB_consensus_vsearch	3751	C	*/+G	204	14	6.14%	2	1	93	93	4.920666598282105E-5	1	1	125	79	14	0	+G
D3_BC39_191109_LF_LIB_consensus_vsearch	3752	A	*/-G	207	19	8.37%	2	1	93	93	1.2854787932019895E-6	1	1	127	80	19	0	-G
D3_BC39_191109_LF_LIB_consensus_vsearch	3754	T	*/+C	211	7	2.98%	2	1	93	93	0.007439689863414905	1	1	141	70	7	0	+C
D3_BC39_191109_LF_LIB_consensus_vsearch	3768	A	*/-G	196	28	12.07%	2	2	93	93	1.515241069806662E-9	1	1	143	53	1	27	-G
D3_BC39_191109_LF_LIB_consensus_vsearch	3778	G	*/-A	195	20	8.51%	2	1	93	93	6.002214170441375E-7	1	1	114	81	20	0	-A
D3_BC39_191109_LF_LIB_consensus_vsearch	3778	G	*/-AT	195	12	5.11%	2	1	93	93	2.0721299272133376E-4	1	1	114	81	12	0	-A
D3_BC39_191109_LF_LIB_consensus_vsearch	3779	A	*/-T	184	8	3.92%	2	2	93	93	0.0036262674855563662	1	1	104	80	7	1	-T
D3_BC39_191109_LF_LIB_consensus_vsearch	3784	A	*/-C	22	105	45.26%	2	2	93	93	7.769101364991657E-50	1	1	14	8	93	12	-C
D3_BC39_191109_LF_LIB_consensus_vsearch	3784	A	*/-CC	22	60	25.86%	2	2	93	93	1.325034486919809E-26	1	1	14	8	18	42	-C
D3_BC39_191109_LF_LIB_consensus_vsearch	3784	A	*/-CCC	22	39	16.81%	2	2	93	93	1.8042791474663063E-16	1	1	14	8	22	17	-C
D3_BC39_191109_LF_LIB_consensus_vsearch	3790	T	*/-C	106	90	40.18%	2	2	93	93	1.176069662352817E-33	1	1	80	26	59	31	-C
D3_BC39_191109_LF_LIB_consensus_vsearch	3790	T	*/-CC	106	23	10.27%	2	2	93	93	4.06474458933411E-8	1	1	80	26	5	18	-C
D3_BC39_191109_LF_LIB_consensus_vsearch	3807	T	*/-G	216	7	3.07%	2	2	93	93	0.007447971960236055	1	1	138	78	6	1	-G
D3_BC39_191109_LF_LIB_consensus_vsearch	3809	G	*/-C	195	12	5.26%	2	2	93	93	2.0721299272133376E-4	1	1	121	74	9	3	-C
D3_BC39_191109_LF_LIB_consensus_vsearch	3809	G	*/-CC	195	10	4.39%	2	1	93	93	8.72767211907752E-4	1	1	121	74	10	0	-C
D3_BC39_191109_LF_LIB_consensus_vsearch	3815	A	*/-G	213	14	6.06%	2	1	93	93	4.9641866600329834E-5	1	1	135	78	14	0	-G
D3_BC39_191109_LF_LIB_consensus_vsearch	3818	A	*/-C	126	75	31.78%	2	2	93	93	5.1339036707484515E-27	1	1	60	66	62	13	-C
D3_BC39_191109_LF_LIB_consensus_vsearch	3818	A	*/-CC	126	21	8.9%	2	1	93	93	2.2110395623800217E-7	1	1	60	66	21	0	-C
D3_BC39_191109_LF_LIB_consensus_vsearch	3818	A	*/-CCC	126	9	3.81%	2	2	93	93	0.0017018904884358202	1	1	60	66	8	1	-C
D3_BC39_191109_LF_LIB_consensus_vsearch	3822	C	*/-T	219	7	2.97%	2	2	93	93	0.007452766938834958	1	1	146	73	3	4	-T
D3_BC39_191109_LF_LIB_consensus_vsearch	3843	T	*/-GC	206	7	3.04%	2	1	93	93	0.007431022745174962	1	1	140	66	0	7	-GC
D3_BC39_191109_LF_LIB_consensus_vsearch	3846	C	*/-A	206	10	4.29%	2	2	93	93	8.778898007284436E-4	1	1	147	59	2	8	-A
D3_BC39_191109_LF_LIB_consensus_vsearch	3880	T	*/-C	225	7	3%	2	2	93	93	0.0074619882138406745	1	1	143	82	6	1	-C
D3_BC39_191109_LF_LIB_consensus_vsearch	3904	C	*/+T	212	8	3.48%	2	2	93	93	0.003661360523321731	1	1	143	69	4	4	+T
D3_BC39_191109_LF_LIB_consensus_vsearch	3904	C	*/-T	212	9	3.91%	2	2	93	93	0.00179747064240055	1	1	143	69	2	7	-T
D3_BC39_191109_LF_LIB_consensus_vsearch	3912	A	*/-C	202	8	3.4%	2	2	93	93	0.0036498841327700354	1	1	128	74	1	7	-C
D3_BC39_191109_LF_LIB_consensus_vsearch	3916	C	*/-AA	211	8	3.4%	2	1	93	93	0.0036602593149509337	1	1	145	66	0	8	-AA
D3_BC39_191109_LF_LIB_consensus_vsearch	3919	G	*/+C	221	9	3.86%	2	1	93	93	0.001803432580702911	1	1	150	71	0	9	+C
D3_BC39_191109_LF_LIB_consensus_vsearch	3935	G	*/-AG	210	19	8.15%	2	1	93	93	1.2924262145172922E-6	1	1	129	81	19	0	-AG
D3_BC39_191109_LF_LIB_consensus_vsearch	3936	A	*/-G	189	18	8.41%	2	1	93	93	2.5931159639340357E-6	1	1	108	81	18	0	-G
D3_BC39_191109_LF_LIB_consensus_vsearch	3939	T	*/+A	206	11	4.66%	2	1	93	93	4.288076047440095E-4	1	1	129	77	11	0	+A
D3_BC39_191109_LF_LIB_consensus_vsearch	3939	T	*/-A	206	12	5.08%	2	2	93	93	2.089820970245861E-4	1	1	129	77	9	3	-A
D3_BC39_191109_LF_LIB_consensus_vsearch	3944	T	*/-C	167	53	22.65%	2	2	93	93	3.1350625712752208E-18	1	1	92	75	50	3	-C
D3_BC39_191109_LF_LIB_consensus_vsearch	3944	T	*/-CC	167	8	3.42%	2	1	93	93	0.003599589021589525	1	1	92	75	8	0	-C
D3_BC39_191109_LF_LIB_consensus_vsearch	3953	T	*/+C	125	57	24.68%	2	2	93	93	3.752714952997172E-20	1	1	78	47	42	15	+C
D3_BC39_191109_LF_LIB_consensus_vsearch	3953	T	*/+CC	125	20	8.66%	2	2	93	93	4.7215741816076004E-7	1	1	78	47	16	4	+C
D3_BC39_191109_LF_LIB_consensus_vsearch	3953	T	*/-C	125	20	8.66%	2	2	93	93	4.7215741816076004E-7	1	1	78	47	10	10	+C
D3_BC39_191109_LF_LIB_consensus_vsearch	3962	G	*/-C	208	8	3.43%	2	1	93	93	0.0036568954742723925	1	1	126	82	8	0	-C
D3_BC39_191109_LF_LIB_consensus_vsearch	3962	G	*/-CC	208	16	6.87%	2	1	93	93	1.1561030828960615E-5	1	1	126	82	16	0	-CC
D3_BC39_191109_LF_LIB_consensus_vsearch	3965	C	*/-G	218	7	2.97%	2	2	93	93	0.007451182688346346	1	1	141	77	3	4	-G
D3_BC39_191109_LF_LIB_consensus_vsearch	3967	G	*/-A	218	13	5.51%	2	1	93	93	1.0262165255618348E-4	1	1	137	81	13	0	-A
D3_BC39_191109_LF_LIB_consensus_vsearch	3981	A	*/-G	211	9	3.95%	2	2	93	93	0.0017967787753331713	1	1	135	76	6	3	-G
D3_BC39_191109_LF_LIB_consensus_vsearch	3987	T	*/+A	178	15	6.47%	2	2	93	93	2.3002287956428228E-5	1	1	107	71	14	1	+A
D3_BC39_191109_LF_LIB_consensus_vsearch	3987	T	*/-A	178	22	9.48%	2	1	93	93	1.294631979695753E-7	1	1	107	71	22	0	-A
D3_BC39_191109_LF_LIB_consensus_vsearch	3989	A	*/-G	212	11	4.78%	2	1	93	93	4.303452996410444E-4	1	1	132	80	11	0	-G
D3_BC39_191109_LF_LIB_consensus_vsearch	3991	A	*/-G	217	8	3.45%	2	1	93	93	0.0036667219549938834	1	1	134	83	8	0	-G
D3_BC39_191109_LF_LIB_consensus_vsearch	3992	G	*/-A	198	12	5.31%	2	1	93	93	2.077128545125299E-4	1	1	120	78	12	0	-A
D3_BC39_191109_LF_LIB_consensus_vsearch	3992	G	*/-AG	198	9	3.98%	2	2	93	93	0.0017871908399793336	1	1	120	78	4	5	-A
D3_BC39_191109_LF_LIB_consensus_vsearch	4006	C	*/+G	194	10	4.26%	2	2	93	93	8.722750499460999E-4	1	1	145	49	1	9	+G
D3_BC39_191109_LF_LIB_consensus_vsearch	4006	C	*/-G	194	16	6.81%	2	2	93	93	1.1340960665062282E-5	1	1	145	49	4	12	-G
D3_BC39_191109_LF_LIB_consensus_vsearch	4006	C	*/-GG	194	12	5.11%	2	1	93	93	2.070433166935576E-4	1	1	145	49	0	12	-G
D3_BC39_191109_LF_LIB_consensus_vsearch	4008	G	*/+A	204	9	4.05%	2	1	93	93	0.0017917580621936403	1	1	135	69	9	0	+A
D3_BC39_191109_LF_LIB_consensus_vsearch	4009	G	*/-C	207	22	9.36%	2	1	93	93	1.4041535632924546E-7	1	1	126	81	22	0	-C
D3_BC39_191109_LF_LIB_consensus_vsearch	4010	C	*/+T	189	17	8.02%	2	1	93	93	5.408873197496746E-6	1	1	129	60	0	17	+T
D3_BC39_191109_LF_LIB_consensus_vsearch	4016	G	*/-A	201	30	12.82%	2	1	93	93	3.4037420009476613E-10	1	1	120	81	30	0	-A
D3_BC39_191109_LF_LIB_consensus_vsearch	4019	C	*/+G	193	7	2.98%	2	2	93	93	0.007406481321433913	1	1	130	63	5	2	+G
D3_BC39_191109_LF_LIB_consensus_vsearch	4019	C	*/-G	193	28	11.91%	2	2	93	93	1.4956098463366234E-9	1	1	130	63	12	16	-G
D3_BC39_191109_LF_LIB_consensus_vsearch	4021	G	*/+A	192	15	6.36%	2	1	93	93	2.3462820410529364E-5	1	1	110	82	15	0	+A
D3_BC39_191109_LF_LIB_consensus_vsearch	4021	G	*/+AA	192	7	2.97%	2	1	93	93	0.007404462106241813	1	1	110	82	7	0	+A
D3_BC39_191109_LF_LIB_consensus_vsearch	4026	T	*/+C	54	175	74.15%	2	2	93	93	1.7416175694672615E-78	1	1	49	5	99	76	+C
D3_BC39_191109_LF_LIB_consensus_vsearch	4027	C	*/+G	222	12	5.08%	2	2	93	93	2.1127296798947417E-4	1	1	151	71	1	11	+G
D3_BC39_191109_LF_LIB_consensus_vsearch	4033	T	*/-C	214	9	3.9%	2	1	93	93	0.0017988361772468277	1	1	137	77	9	0	-C
D3_BC39_191109_LF_LIB_consensus_vsearch	4043	T	*/-C	210	11	4.85%	2	2	93	93	4.298416344617859E-4	1	1	140	70	7	4	-C
D3_BC39_191109_LF_LIB_consensus_vsearch	4050	T	*/+C	220	7	3.02%	2	1	93	93	0.007454337359329176	1	1	147	73	0	7	+C
D3_BC39_191109_LF_LIB_consensus_vsearch	4051	T	*/-C	227	7	2.97%	2	2	93	93	0.0074649578216797186	1	1	151	76	1	6	-C
D3_BC39_191109_LF_LIB_consensus_vsearch	4063	G	*/-T	218	7	2.97%	2	1	93	93	0.007451182688346346	1	1	136	82	7	0	-T
D3_BC39_191109_LF_LIB_consensus_vsearch	4073	C	*/+A	218	8	3.45%	2	1	93	93	0.003667766201363899	1	1	145	73	0	8	+A
D3_BC39_191109_LF_LIB_consensus_vsearch	4095	T	*/-G	226	7	2.97%	2	2	93	93	0.007463479333376833	1	1	152	74	1	6	-G
D3_BC39_191109_LF_LIB_consensus_vsearch	4097	G	*/-A	219	16	6.81%	2	2	93	93	1.1717441248540928E-5	1	1	138	81	15	1	-A
D3_BC39_191109_LF_LIB_consensus_vsearch	4101	T	*/-G	219	10	4.26%	2	2	93	93	8.833283118953115E-4	1	1	146	73	2	8	-G
D3_BC39_191109_LF_LIB_consensus_vsearch	4112	C	*/-G	216	7	2.99%	2	2	93	93	0.007447971960236055	1	1	145	71	1	6	-G
D3_BC39_191109_LF_LIB_consensus_vsearch	4122	C	*/-A	215	14	5.93%	2	1	93	93	4.973428022334695E-5	1	1	134	81	14	0	-A
D3_BC39_191109_LF_LIB_consensus_vsearch	4132	G	*/-C	214	7	3.02%	2	1	93	93	0.007444703667648697	1	1	142	72	7	0	-C
D3_BC39_191109_LF_LIB_consensus_vsearch	4133	C	*/+T	217	8	3.52%	2	1	93	93	0.0036667219549938834	1	1	144	73	0	8	+T
D3_BC39_191109_LF_LIB_consensus_vsearch	4135	C	*/-T	219	10	4.24%	2	2	93	93	8.833283118953115E-4	1	1	144	75	2	8	-T
D3_BC39_191109_LF_LIB_consensus_vsearch	4136	T	*/+C	86	131	57.96%	2	2	93	93	9.423415993373636E-53	1	1	83	3	60	71	+C
D3_BC39_191109_LF_LIB_consensus_vsearch	4161	A	*/-G	204	18	7.86%	2	1	93	93	2.6645289168846238E-6	1	1	142	62	0	18	-G
D3_BC39_191109_LF_LIB_consensus_vsearch	4172	A	-T/-T	48	173	76.21%	2	2	93	93	9.14189712578652E-79	1	1	10	38	134	39	-T
D3_BC39_191109_LF_LIB_consensus_vsearch	4175	T	*/-C	168	49	21.21%	2	2	93	93	8.339957987371984E-17	1	1	106	62	44	5	-C
D3_BC39_191109_LF_LIB_consensus_vsearch	4182	A	*/+G	110	107	46.72%	2	2	93	93	1.3522811095510492E-40	1	1	67	43	71	36	+G
D3_BC39_191109_LF_LIB_consensus_vsearch	4183	G	*/+A	211	14	6.14%	2	1	93	93	4.9547934929218304E-5	1	1	130	81	14	0	+A
D3_BC39_191109_LF_LIB_consensus_vsearch	4184	G	*/-A	205	19	8.12%	2	1	93	93	1.2807606843266436E-6	1	1	130	75	19	0	-A
D3_BC39_191109_LF_LIB_consensus_vsearch	4186	A	*/-C	183	22	9.44%	2	2	93	93	1.315162668616882E-7	1	1	102	81	21	1	-C
D3_BC39_191109_LF_LIB_consensus_vsearch	4186	A	*/-CC	183	24	10.3%	2	1	93	93	2.9386090804310453E-8	1	1	102	81	24	0	-CC
D3_BC39_191109_LF_LIB_consensus_vsearch	4189	C	*/-A	214	10	4.27%	2	1	93	93	8.813089995913842E-4	1	1	134	80	10	0	-A
D3_BC39_191109_LF_LIB_consensus_vsearch	4191	G	*/-AG	207	15	6.41%	2	1	93	93	2.3897801371672697E-5	1	1	127	80	15	0	-AG
D3_BC39_191109_LF_LIB_consensus_vsearch	4192	A	*/+G	177	9	4.25%	2	1	93	93	0.0017689474455757383	1	1	109	68	9	0	+G
D3_BC39_191109_LF_LIB_consensus_vsearch	4192	A	*/-G	177	20	9.43%	2	2	93	93	5.740696079717506E-7	1	1	109	68	6	14	-G
D3_BC39_191109_LF_LIB_consensus_vsearch	4197	T	*/-C	173	45	19.57%	2	2	93	93	2.2545469558958297E-15	1	1	118	55	24	21	-C
D3_BC39_191109_LF_LIB_consensus_vsearch	4207	T	*/-A	211	8	3.4%	2	1	93	93	0.0036602593149509337	1	1	132	79	8	0	-A
D3_BC39_191109_LF_LIB_consensus_vsearch	4208	A	*/-G	201	20	8.89%	2	2	93	93	6.081727839654859E-7	1	1	121	80	19	1	-G
D3_BC39_191109_LF_LIB_consensus_vsearch	4209	G	*/+A	181	18	8.45%	2	1	93	93	2.5513375306020147E-6	1	1	101	80	18	0	+A
D3_BC39_191109_LF_LIB_consensus_vsearch	4217	C	*/-AC	223	7	3.02%	2	1	93	93	0.007458967428082863	1	1	144	79	7	0	-AC
D3_BC39_191109_LF_LIB_consensus_vsearch	4224	T	*/-C	202	16	7.02%	2	2	93	93	1.1469793493705302E-5	1	1	130	72	15	1	-C
D3_BC39_191109_LF_LIB_consensus_vsearch	4236	G	*/-A	222	8	3.42%	2	1	93	93	0.0036718537228742883	1	1	143	79	8	0	-A
D3_BC39_191109_LF_LIB_consensus_vsearch	4239	T	*/-GG	211	8	3.42%	2	1	93	93	0.0036602593149509337	1	1	144	67	0	8	-GG
D3_BC39_191109_LF_LIB_consensus_vsearch	4243	T	*/-A	206	8	3.48%	2	2	93	93	0.0036546013500883302	1	1	142	64	7	1	-A
D3_BC39_191109_LF_LIB_consensus_vsearch	4245	A	*/+T	93	131	55.98%	2	2	93	93	3.676687364594006E-52	1	1	81	12	65	66	+T
D3_BC39_191109_LF_LIB_consensus_vsearch	4247	T	*/-G	205	19	8.12%	2	2	93	93	1.2807606843266436E-6	1	1	140	65	10	9	-G
D3_BC39_191109_LF_LIB_consensus_vsearch	4251	C	*/-GC	217	13	5.56%	2	1	93	93	1.0254206608526479E-4	1	1	139	78	13	0	-GC
D3_BC39_191109_LF_LIB_consensus_vsearch	4259	G	*/-C	211	14	6.11%	2	1	93	93	4.9547934929218304E-5	1	1	133	78	14	0	-C
D3_BC39_191109_LF_LIB_consensus_vsearch	4260	C	*/+G	192	16	7.41%	2	1	93	93	1.1307383330374262E-5	1	1	113	79	16	0	+G
D3_BC39_191109_LF_LIB_consensus_vsearch	4261	C	*/-T	222	7	2.98%	2	2	93	93	0.007457437428309682	1	1	146	76	4	3	-T
D3_BC39_191109_LF_LIB_consensus_vsearch	4263	T	*/-C	213	14	5.98%	2	2	93	93	4.9641866600329834E-5	1	1	136	77	11	3	-C
D3_BC39_191109_LF_LIB_consensus_vsearch	4264	C	*/+G	185	22	10.14%	2	1	93	93	1.3231683048650375E-7	1	1	110	75	22	0	+G
D3_BC39_191109_LF_LIB_consensus_vsearch	4265	C	*/+T	194	7	3.03%	2	1	93	93	0.007408480654387502	1	1	133	61	0	7	+T
D3_BC39_191109_LF_LIB_consensus_vsearch	4265	C	*/-T	194	14	6.06%	2	2	93	93	4.868257057911772E-5	1	1	133	61	6	8	-T
D3_BC39_191109_LF_LIB_consensus_vsearch	4267	T	*/-G	203	14	6.14%	2	2	93	93	4.915625783020227E-5	1	1	135	68	2	12	-G
D3_BC39_191109_LF_LIB_consensus_vsearch	4298	T	*/-C	198	29	12.78%	2	1	93	93	7.168510829164728E-10	1	1	122	76	29	0	-C
D3_BC39_191109_LF_LIB_consensus_vsearch	4300	C	*/-G	208	19	8.3%	2	2	93	93	1.287811711287195E-6	1	1	149	59	2	17	-G
D3_BC39_191109_LF_LIB_consensus_vsearch	4311	T	*/+C	200	18	7.86%	2	1	93	93	2.6463038722080364E-6	1	1	132	68	18	0	+C
D3_BC39_191109_LF_LIB_consensus_vsearch	4311	T	*/-C	200	7	3.06%	2	1	93	93	0.007420075094973923	1	1	132	68	0	7	+C
D3_BC39_191109_LF_LIB_consensus_vsearch	4317	T	*/+C	177	7	2.99%	2	2	93	93	0.007371570136883838	1	1	121	56	6	1	+C
D3_BC39_191109_LF_LIB_consensus_vsearch	4317	T	*/-C	177	42	17.95%	2	2	93	93	2.581913818366105E-14	1	1	121	56	22	20	-C
D3_BC39_191109_LF_LIB_consensus_vsearch	4325	A	*/+C	180	15	6.64%	2	1	93	93	2.3071699351829828E-5	1	1	107	73	15	0	+C
D3_BC39_191109_LF_LIB_consensus_vsearch	4325	A	*/-C	180	19	8.41%	2	2	93	93	1.2152423501020424E-6	1	1	107	73	15	4	-C
D3_BC39_191109_LF_LIB_consensus_vsearch	4328	C	*/-G	168	20	8.66%	2	2	93	93	5.595305034619689E-7	1	1	140	28	2	18	-G
D3_BC39_191109_LF_LIB_consensus_vsearch	4329	G	*/-TG	197	8	3.72%	2	2	93	93	0.003643733038795537	1	1	142	55	1	7	-TG
D3_BC39_191109_LF_LIB_consensus_vsearch	4330	T	*/+A	191	7	3.1%	2	1	93	93	0.007402422710817429	1	1	138	53	7	0	+A
D3_BC39_191109_LF_LIB_consensus_vsearch	4332	A	*/-C	205	16	6.96%	2	2	93	93	1.1515964001761286E-5	1	1	128	77	13	3	-C
D3_BC39_191109_LF_LIB_consensus_vsearch	4333	C	*/+T	195	14	6.51%	2	1	93	93	4.873705147345955E-5	1	1	131	64	0	14	+T
D3_BC39_191109_LF_LIB_consensus_vsearch	4345	T	*/-C	178	54	23.18%	2	1	93	93	1.683139991432418E-18	1	1	97	81	54	0	-C
D3_BC39_191109_LF_LIB_consensus_vsearch	4347	C	*/-A	219	8	3.42%	2	1	93	93	0.0036688013849068284	1	1	138	81	8	0	-A
D3_BC39_191109_LF_LIB_consensus_vsearch	4365	G	*/-TG	216	11	4.7%	2	1	93	93	4.313270586514381E-4	1	1	149	67	0	11	-TG
D3_BC39_191109_LF_LIB_consensus_vsearch	4370	A	*/-G	190	12	5.19%	2	2	93	93	2.0634876616312749E-4	1	1	121	69	1	11	-G
D3_BC39_191109_LF_LIB_consensus_vsearch	4380	C	*/-T	207	13	5.68%	2	2	93	93	1.0170895517465024E-4	1	1	144	63	1	12	-T
D3_BC39_191109_LF_LIB_consensus_vsearch	4383	G	*/-A	219	7	3.03%	2	2	93	93	0.007452766938834958	1	1	143	76	5	2	-A
D3_BC39_191109_LF_LIB_consensus_vsearch	4387	G	*/-A	219	8	3.43%	2	1	93	93	0.0036688013849068284	1	1	142	77	8	0	-A
D3_BC39_191109_LF_LIB_consensus_vsearch	4390	G	*/-C	205	8	3.48%	2	1	93	93	0.0036534383902297935	1	1	147	58	0	8	-C
D3_BC39_191109_LF_LIB_consensus_vsearch	4403	G	*/-AG	214	7	3.11%	2	1	93	93	0.007444703667648697	1	1	135	79	7	0	-AG
D3_BC39_191109_LF_LIB_consensus_vsearch	4409	G	*/-TG	218	8	3.45%	2	1	93	93	0.003667766201363899	1	1	144	74	0	8	-TG
D3_BC39_191109_LF_LIB_consensus_vsearch	4415	T	*/-C	169	61	26.18%	2	1	93	93	4.366317774165601E-21	1	1	89	80	61	0	-C
D3_BC39_191109_LF_LIB_consensus_vsearch	4417	C	*/+A	199	7	2.99%	2	1	93	93	0.007418189114685095	1	1	130	69	7	0	+A
D3_BC39_191109_LF_LIB_consensus_vsearch	4417	C	*/+G	199	10	4.27%	2	2	93	93	8.746903119674215E-4	1	1	130	69	2	8	+G
D3_BC39_191109_LF_LIB_consensus_vsearch	4418	G	*/-A	211	18	7.79%	2	2	93	93	2.6951067980463388E-6	1	1	131	80	17	1	-A
D3_BC39_191109_LF_LIB_consensus_vsearch	4424	T	*/+A	203	10	4.31%	2	1	93	93	8.765435124402236E-4	1	1	124	79	10	0	+A
D3_BC39_191109_LF_LIB_consensus_vsearch	4424	T	*/-A	203	11	4.74%	2	2	93	93	4.280077806644155E-4	1	1	124	79	9	2	-A
D3_BC39_191109_LF_LIB_consensus_vsearch	4446	G	*/+A	219	10	4.29%	2	1	93	93	8.833283118953115E-4	1	1	139	80	10	0	+A
D3_BC39_191109_LF_LIB_consensus_vsearch	4452	A	*/-C	181	36	15.45%	2	2	93	93	2.9882841595712796E-12	1	1	107	74	31	5	-C
D3_BC39_191109_LF_LIB_consensus_vsearch	4462	G	*/+T	194	13	5.6%	2	1	93	93	1.0051376512604206E-4	1	1	114	80	13	0	+T
D3_BC39_191109_LF_LIB_consensus_vsearch	4462	G	*/-T	194	16	6.9%	2	1	93	93	1.1340960665062282E-5	1	1	114	80	16	0	-T
D3_BC39_191109_LF_LIB_consensus_vsearch	4480	A	*/-CA	201	19	8.15%	2	1	93	93	1.2711099418435063E-6	1	1	122	79	19	0	-CA
D3_BC39_191109_LF_LIB_consensus_vsearch	4483	T	*/-C	222	11	4.72%	2	1	93	93	4.3273893004878305E-4	1	1	141	81	11	0	-C
D3_BC39_191109_LF_LIB_consensus_vsearch	4488	T	*/-CT	191	35	15.22%	2	2	93	93	6.987313257985683E-12	1	1	149	42	1	34	-CT
D3_BC39_191109_LF_LIB_consensus_vsearch	4489	C	*/-T	179	9	4.66%	2	2	93	93	0.0017708558237889195	1	1	146	33	1	8	-T
D3_BC39_191109_LF_LIB_consensus_vsearch	4507	G	*/-TG	221	8	3.45%	2	1	93	93	0.003670845031231652	1	1	148	73	0	8	-TG
D3_BC39_191109_LF_LIB_consensus_vsearch	4514	T	*/-GT	218	11	4.7%	2	2	93	93	4.318055810374596E-4	1	1	144	74	5	6	-GT
D3_BC39_191109_LF_LIB_consensus_vsearch	4522	C	*/-TC	209	14	6.14%	2	2	93	93	4.9452447660699634E-5	1	1	138	71	11	3	-TC
D3_BC39_191109_LF_LIB_consensus_vsearch	4527	C	*/-TT	213	8	3.45%	2	2	93	93	0.0036624519192641563	1	1	135	78	7	1	-TT
D3_BC39_191109_LF_LIB_consensus_vsearch	4549	C	*/+G	210	15	6.52%	2	1	93	93	2.3978473096487834E-5	1	1	128	82	15	0	+G
D3_BC39_191109_LF_LIB_consensus_vsearch	4550	A	*/-G	206	16	6.93%	2	2	93	93	1.1531106955580906E-5	1	1	128	78	14	2	-G
D3_BC39_191109_LF_LIB_consensus_vsearch	4561	C	*/-AA	216	9	3.86%	2	2	93	93	0.0018001779733764346	1	1	144	72	1	8	-AA
D3_BC39_191109_LF_LIB_consensus_vsearch	4603	C	*/+T	85	126	54.08%	2	2	93	93	1.4577572036368817E-50	1	1	57	28	83	43	+T
D3_BC39_191109_LF_LIB_consensus_vsearch	4603	C	*/+TT	85	7	3%	2	2	93	93	0.006940610897217693	1	1	57	28	3	4	+T
D3_BC39_191109_LF_LIB_consensus_vsearch	4603	C	*/-T	85	8	3.43%	2	1	93	93	0.0033389965937982964	1	1	57	28	8	0	-T
D3_BC39_191109_LF_LIB_consensus_vsearch	4614	C	*/-T	215	8	3.43%	2	2	93	93	0.0036646057936482192	1	1	141	74	3	5	-T
D3_BC39_191109_LF_LIB_consensus_vsearch	4620	C	*/+T	215	13	5.58%	2	1	93	93	1.0238092820754376E-4	1	1	150	65	0	13	+T
D3_BC39_191109_LF_LIB_consensus_vsearch	4621	T	*/+C	213	7	3.02%	2	1	93	93	0.007443047448823043	1	1	142	71	7	0	+C
D3_BC39_191109_LF_LIB_consensus_vsearch	4622	C	*/-G	191	27	12.05%	2	1	93	93	3.159934639034834E-9	1	1	148	43	0	27	-G
D3_BC39_191109_LF_LIB_consensus_vsearch	4635	C	*/-T	218	7	3.04%	2	2	93	93	0.007451182688346346	1	1	142	76	5	2	-T
D3_BC39_191109_LF_LIB_consensus_vsearch	4641	C	*/+T	200	19	8.19%	2	2	93	93	1.268651398690971E-6	1	1	149	51	2	17	+T
D3_BC39_191109_LF_LIB_consensus_vsearch	4641	C	*/-T	200	8	3.45%	2	1	93	93	0.003647458600901869	1	1	149	51	0	8	+T
D3_BC39_191109_LF_LIB_consensus_vsearch	4644	T	*/-G	222	7	3%	2	2	93	93	0.007457437428309682	1	1	147	75	1	6	-G
