Chrom	Position	Ref	Cons	Reads1	Reads2	VarFreq	Strands1	Strands2	Qual1	Qual2	Pvalue	MapQual1	MapQual2	Reads1Plus	Reads1Minus	Reads2Plus	Reads2Minus	VarAllele
E2_BC50_191109_LF_LIB_consensus_vsearch	3	G	*/+T	188	9	3.95%	2	1	93	93	0.0017789762439091002	1	1	116	72	9	0	+T
E2_BC50_191109_LF_LIB_consensus_vsearch	3	G	*/-T	188	31	13.6%	2	2	93	93	1.4860450255869367E-10	1	1	116	72	29	2	-T
E2_BC50_191109_LF_LIB_consensus_vsearch	11	T	*/+G	223	13	5.37%	2	1	93	93	1.03010072485016E-4	1	1	146	77	13	0	+G
E2_BC50_191109_LF_LIB_consensus_vsearch	12	A	*/-G	224	14	5.83%	2	1	93	93	5.0132304095312896E-5	1	1	145	79	14	0	-G
E2_BC50_191109_LF_LIB_consensus_vsearch	18	T	*/+C	232	11	4.47%	2	1	93	93	4.349428315974289E-4	1	1	152	80	11	0	+C
E2_BC50_191109_LF_LIB_consensus_vsearch	21	G	*/-A	229	9	3.75%	2	2	93	93	0.0018083614623809116	1	1	152	77	6	3	-A
E2_BC50_191109_LF_LIB_consensus_vsearch	24	T	*/-C	125	101	41.22%	2	2	93	93	1.8559153710809995E-37	1	1	85	40	68	33	-C
E2_BC50_191109_LF_LIB_consensus_vsearch	24	T	*/-CC	125	9	3.67%	2	1	93	93	0.0017000847690847789	1	1	85	40	9	0	-C
E2_BC50_191109_LF_LIB_consensus_vsearch	32	T	*/-C	234	10	4.07%	2	1	93	93	8.889036112835749E-4	1	1	154	80	10	0	-C
E2_BC50_191109_LF_LIB_consensus_vsearch	34	C	*/+A	227	7	2.83%	2	1	93	93	0.0074649578216797186	1	1	151	76	7	0	+A
E2_BC50_191109_LF_LIB_consensus_vsearch	37	G	*/-C	229	8	3.27%	2	2	93	93	0.0036786796343901236	1	1	154	75	4	4	-C
E2_BC50_191109_LF_LIB_consensus_vsearch	45	T	*/-G	223	8	3.31%	2	2	93	93	0.0036728538094896964	1	1	159	64	3	5	-G
E2_BC50_191109_LF_LIB_consensus_vsearch	58	C	*/-A	219	16	6.48%	2	2	93	93	1.1717441248540928E-5	1	1	149	70	12	4	-A
E2_BC50_191109_LF_LIB_consensus_vsearch	62	G	*/-C	209	32	12.96%	2	2	93	93	7.735576651372202E-11	1	1	131	78	31	1	-C
E2_BC50_191109_LF_LIB_consensus_vsearch	71	C	*/-A	213	19	7.69%	2	2	93	93	1.2992223780433995E-6	1	1	146	67	13	6	-A
E2_BC50_191109_LF_LIB_consensus_vsearch	76	T	*/-C	235	7	2.83%	2	2	93	93	0.007476349629382664	1	1	156	79	6	1	-C
E2_BC50_191109_LF_LIB_consensus_vsearch	80	C	*/-T	226	10	4.08%	2	2	93	93	8.86015765791995E-4	1	1	155	71	4	6	-T
E2_BC50_191109_LF_LIB_consensus_vsearch	92	A	*/-C	214	20	8.16%	2	2	93	93	6.242524996453359E-7	1	1	153	61	1	19	-C
E2_BC50_191109_LF_LIB_consensus_vsearch	94	C	*/-T	218	22	8.94%	2	2	93	93	1.4403077203574029E-7	1	1	160	58	2	20	-T
E2_BC50_191109_LF_LIB_consensus_vsearch	95	T	*/-C	210	10	4.5%	2	2	93	93	8.796295164637225E-4	1	1	159	51	1	9	-C
E2_BC50_191109_LF_LIB_consensus_vsearch	100	A	*/-C	226	7	2.83%	2	1	93	93	0.007463479333376833	1	1	146	80	7	0	-C
E2_BC50_191109_LF_LIB_consensus_vsearch	107	C	*/-T	221	13	5.35%	2	1	93	93	1.0285657652119606E-4	1	1	158	63	0	13	-T
E2_BC50_191109_LF_LIB_consensus_vsearch	108	T	*/-C	215	11	4.72%	2	1	93	93	4.3108474750487954E-4	1	1	147	68	11	0	-C
E2_BC50_191109_LF_LIB_consensus_vsearch	112	C	*/-T	219	22	9.05%	2	1	93	93	1.4434661999665344E-7	1	1	164	55	0	22	-T
E2_BC50_191109_LF_LIB_consensus_vsearch	113	T	*/-C	216	8	3.54%	2	2	93	93	0.003665668526289429	1	1	160	56	6	2	-C
E2_BC50_191109_LF_LIB_consensus_vsearch	122	A	*/-CA	223	9	3.7%	2	2	93	93	0.0018046959863042469	1	1	151	72	1	8	-CA
E2_BC50_191109_LF_LIB_consensus_vsearch	135	G	*/-C	189	44	17.81%	2	2	93	93	6.0332038715822865E-15	1	1	110	79	42	2	-C
E2_BC50_191109_LF_LIB_consensus_vsearch	147	A	*/-G	222	14	5.71%	2	1	93	93	5.004628793929559E-5	1	1	143	79	14	0	-G
E2_BC50_191109_LF_LIB_consensus_vsearch	148	G	*/-A	195	18	7.83%	2	1	93	93	2.622705226031456E-6	1	1	114	81	18	0	-A
E2_BC50_191109_LF_LIB_consensus_vsearch	148	G	*/-AAT	195	11	4.78%	2	1	93	93	4.2576599996950053E-4	1	1	114	81	11	0	-A
E2_BC50_191109_LF_LIB_consensus_vsearch	158	G	*/-CG	218	25	10.08%	2	1	93	93	1.555259269622697E-8	1	1	164	54	0	25	-CG
E2_BC50_191109_LF_LIB_consensus_vsearch	160	G	*/-T	183	22	10%	2	1	93	93	1.315162668616882E-7	1	1	132	51	22	0	-T
E2_BC50_191109_LF_LIB_consensus_vsearch	165	C	*/+A	96	119	47.98%	2	2	93	93	1.3735001900801818E-46	1	1	76	20	61	58	+A
E2_BC50_191109_LF_LIB_consensus_vsearch	165	C	*/+AA	96	24	9.68%	2	2	93	93	1.66165558050019E-8	1	1	76	20	21	3	+A
E2_BC50_191109_LF_LIB_consensus_vsearch	170	G	*/-C	237	7	2.82%	2	2	93	93	0.007479081856645369	1	1	156	81	6	1	-C
E2_BC50_191109_LF_LIB_consensus_vsearch	177	G	*/-TG	221	12	4.88%	2	2	93	93	2.1113855488095296E-4	1	1	153	68	2	10	-TG
E2_BC50_191109_LF_LIB_consensus_vsearch	179	G	*/+C	188	25	10.73%	2	2	93	93	1.4110585661304756E-8	1	1	122	66	24	1	+C
E2_BC50_191109_LF_LIB_consensus_vsearch	179	G	*/-C	188	11	4.72%	2	1	93	93	4.2366328040616125E-4	1	1	122	66	11	0	+C
E2_BC50_191109_LF_LIB_consensus_vsearch	180	C	*/+T	212	17	7.33%	2	1	93	93	5.606330650645509E-6	1	1	152	60	0	17	+T
E2_BC50_191109_LF_LIB_consensus_vsearch	184	G	*/-C	159	74	29.96%	2	2	93	93	5.21746771863666E-26	1	1	92	67	62	12	-C
E2_BC50_191109_LF_LIB_consensus_vsearch	185	C	*/+T	153	13	7.65%	2	2	93	93	9.56221163141673E-5	1	1	97	56	1	12	+T
E2_BC50_191109_LF_LIB_consensus_vsearch	190	A	*/-G	234	9	3.67%	2	1	93	93	0.0018112805803138848	1	1	153	81	9	0	-G
E2_BC50_191109_LF_LIB_consensus_vsearch	195	C	*/-A	216	26	10.48%	2	1	93	93	7.331947011192114E-9	1	1	137	79	26	0	-A
E2_BC50_191109_LF_LIB_consensus_vsearch	197	C	*/-TC	228	9	3.72%	2	1	93	93	0.001807763167971536	1	1	161	67	0	9	-TC
E2_BC50_191109_LF_LIB_consensus_vsearch	198	T	*/-C	220	10	4.26%	2	2	93	93	8.837219519630479E-4	1	1	155	65	6	4	-C
E2_BC50_191109_LF_LIB_consensus_vsearch	200	C	*/-T	191	42	17%	2	2	93	93	2.981722735673079E-14	1	1	138	53	22	20	-T
E2_BC50_191109_LF_LIB_consensus_vsearch	204	T	*/-CC	223	11	4.45%	2	2	93	93	4.3296747251648046E-4	1	1	147	76	9	2	-CC
E2_BC50_191109_LF_LIB_consensus_vsearch	208	G	*/-A	234	7	2.86%	2	2	93	93	0.007474966656828971	1	1	153	81	6	1	-A
E2_BC50_191109_LF_LIB_consensus_vsearch	209	A	*/-G	218	18	7.53%	2	1	93	93	2.7241185068262107E-6	1	1	138	80	18	0	-G
E2_BC50_191109_LF_LIB_consensus_vsearch	217	G	*/-A	234	10	4.05%	2	1	93	93	8.889036112835749E-4	1	1	153	81	10	0	-A
E2_BC50_191109_LF_LIB_consensus_vsearch	218	A	*/-G	225	10	4.2%	2	2	93	93	8.856413612935507E-4	1	1	144	81	9	1	-G
E2_BC50_191109_LF_LIB_consensus_vsearch	224	C	*/-TT	233	7	2.83%	2	1	93	93	0.007473572259320498	1	1	154	79	7	0	-TT
E2_BC50_191109_LF_LIB_consensus_vsearch	234	T	*/-C	168	69	28.16%	2	2	93	93	5.0612441273140484E-24	1	1	115	53	46	23	-C
E2_BC50_191109_LF_LIB_consensus_vsearch	237	C	*/-T	232	7	2.83%	2	2	93	93	0.007472166294706969	1	1	159	73	3	4	-T
E2_BC50_191109_LF_LIB_consensus_vsearch	241	T	*/-C	231	11	4.44%	2	1	93	93	4.3473033454469255E-4	1	1	149	82	11	0	-C
E2_BC50_191109_LF_LIB_consensus_vsearch	244	A	*/-CA	228	8	3.32%	2	2	93	93	0.00367772893957288	1	1	153	75	5	3	-CA
E2_BC50_191109_LF_LIB_consensus_vsearch	261	T	*/+A	212	8	3.25%	2	1	93	93	0.003661360523321731	1	1	135	77	8	0	+A
E2_BC50_191109_LF_LIB_consensus_vsearch	261	T	*/-A	212	18	7.32%	2	1	93	93	2.699344387350368E-6	1	1	135	77	18	0	-A
E2_BC50_191109_LF_LIB_consensus_vsearch	264	A	*/-G	228	8	3.35%	2	2	93	93	0.00367772893957288	1	1	148	80	7	1	-G
E2_BC50_191109_LF_LIB_consensus_vsearch	276	T	*/-A	228	8	3.32%	2	1	93	93	0.00367772893957288	1	1	154	74	8	0	-A
E2_BC50_191109_LF_LIB_consensus_vsearch	277	A	*/-G	218	16	6.72%	2	2	93	93	1.1703767424993676E-5	1	1	153	65	2	14	-G
E2_BC50_191109_LF_LIB_consensus_vsearch	279	G	*/-A	227	20	8.06%	2	1	93	93	6.38925885661103E-7	1	1	145	82	20	0	-A
E2_BC50_191109_LF_LIB_consensus_vsearch	296	T	*/-G	231	9	3.69%	2	2	93	93	0.0018095434033127298	1	1	155	76	8	1	-G
E2_BC50_191109_LF_LIB_consensus_vsearch	310	C	*/-G	219	9	3.83%	2	1	93	93	0.0018021474934649558	1	1	147	72	9	0	-G
E2_BC50_191109_LF_LIB_consensus_vsearch	315	G	*/-A	165	16	6.87%	2	2	93	93	1.0791087617257083E-5	1	1	95	70	14	2	-A
E2_BC50_191109_LF_LIB_consensus_vsearch	315	G	*/-AG	165	45	19.31%	2	2	93	93	2.0227701328165796E-15	1	1	95	70	36	9	-AG
E2_BC50_191109_LF_LIB_consensus_vsearch	319	C	*/-A	218	7	2.95%	2	1	93	93	0.007451182688346346	1	1	147	71	7	0	-A
E2_BC50_191109_LF_LIB_consensus_vsearch	334	G	*/+T	181	16	6.53%	2	1	93	93	1.1112012077803707E-5	1	1	105	76	16	0	+T
E2_BC50_191109_LF_LIB_consensus_vsearch	334	G	*/-T	181	40	16.33%	2	2	93	93	1.3056639678068584E-13	1	1	105	76	38	2	-T
E2_BC50_191109_LF_LIB_consensus_vsearch	339	C	*/-A	218	12	4.92%	2	2	93	93	2.1072864956982534E-4	1	1	146	72	8	4	-A
E2_BC50_191109_LF_LIB_consensus_vsearch	341	A	*/-G	215	18	7.47%	2	2	93	93	2.7118689984586317E-6	1	1	157	58	5	13	-G
E2_BC50_191109_LF_LIB_consensus_vsearch	356	T	*/-AC	226	9	3.75%	2	2	93	93	0.0018065516263558758	1	1	153	73	7	2	-AC
E2_BC50_191109_LF_LIB_consensus_vsearch	358	C	*/-G	201	23	9.83%	2	1	93	93	6.575986122662666E-8	1	1	154	47	0	23	-G
E2_BC50_191109_LF_LIB_consensus_vsearch	363	C	*/+A	115	13	5.33%	2	1	93	93	8.859978307544659E-5	1	1	81	34	13	0	+A
E2_BC50_191109_LF_LIB_consensus_vsearch	363	C	*/-G	115	98	40.16%	2	2	93	93	1.317313081976956E-36	1	1	81	34	64	34	-G
E2_BC50_191109_LF_LIB_consensus_vsearch	370	T	*/+C	216	18	7.5%	2	1	93	93	2.715982290125382E-6	1	1	141	75	18	0	+C
E2_BC50_191109_LF_LIB_consensus_vsearch	374	A	*/-C	223	12	4.96%	2	2	93	93	2.114062925508352E-4	1	1	145	78	10	2	-C
E2_BC50_191109_LF_LIB_consensus_vsearch	375	C	*/+T	221	8	3.45%	2	1	93	93	0.003670845031231652	1	1	149	72	0	8	+T
E2_BC50_191109_LF_LIB_consensus_vsearch	382	C	*/-TC	228	12	4.94%	2	1	93	93	2.1205703996137238E-4	1	1	163	65	0	12	-TC
E2_BC50_191109_LF_LIB_consensus_vsearch	383	T	*/-C	187	11	4.74%	2	2	93	93	4.2335130867721316E-4	1	1	159	28	4	7	-C
E2_BC50_191109_LF_LIB_consensus_vsearch	383	T	*/-CCT	187	28	12.07%	2	1	93	93	1.4554047345259757E-9	1	1	159	28	0	28	-CCT
E2_BC50_191109_LF_LIB_consensus_vsearch	386	T	*/+C	196	10	4.63%	2	1	93	93	8.7325475503958E-4	1	1	148	48	10	0	+C
E2_BC50_191109_LF_LIB_consensus_vsearch	400	A	*/-CA	224	13	5.42%	2	2	93	93	1.0308590668956199E-4	1	1	146	78	10	3	-CA
E2_BC50_191109_LF_LIB_consensus_vsearch	405	T	*/-C	226	14	5.71%	2	2	93	93	5.0216988599021617E-5	1	1	145	81	13	1	-C
E2_BC50_191109_LF_LIB_consensus_vsearch	407	C	*/-G	214	26	10.53%	2	1	93	93	7.286279215956525E-9	1	1	163	51	0	26	-G
E2_BC50_191109_LF_LIB_consensus_vsearch	411	C	*/+A	221	16	6.48%	2	1	93	93	1.1744477719372386E-5	1	1	143	78	16	0	+A
E2_BC50_191109_LF_LIB_consensus_vsearch	412	G	*/+A	218	8	3.27%	2	1	93	93	0.003667766201363899	1	1	147	71	0	8	+A
E2_BC50_191109_LF_LIB_consensus_vsearch	412	G	*/-A	218	16	6.53%	2	1	93	93	1.1703767424993676E-5	1	1	147	71	16	0	-A
E2_BC50_191109_LF_LIB_consensus_vsearch	420	T	*/+C	195	11	4.49%	2	2	93	93	4.2576599996950053E-4	1	1	151	44	5	6	+C
E2_BC50_191109_LF_LIB_consensus_vsearch	420	T	*/-C	195	34	13.88%	2	2	93	93	1.550386275882856E-11	1	1	151	44	3	31	-C
E2_BC50_191109_LF_LIB_consensus_vsearch	438	T	*/+C	227	12	4.86%	2	2	93	93	2.1192896510056628E-4	1	1	152	75	11	1	+C
E2_BC50_191109_LF_LIB_consensus_vsearch	439	C	*/-G	226	16	6.53%	2	1	93	93	1.1810307374064424E-5	1	1	163	63	0	16	-G
E2_BC50_191109_LF_LIB_consensus_vsearch	446	C	*/-A	211	16	6.56%	2	1	93	93	1.1605032761469583E-5	1	1	132	79	16	0	-A
E2_BC50_191109_LF_LIB_consensus_vsearch	450	A	*/-GA	216	21	8.61%	2	2	93	93	3.000511080365251E-7	1	1	137	79	20	1	-GA
E2_BC50_191109_LF_LIB_consensus_vsearch	455	T	*/-C	225	7	2.94%	2	2	93	93	0.0074619882138406745	1	1	156	69	1	6	-C
E2_BC50_191109_LF_LIB_consensus_vsearch	458	T	*/-C	204	31	12.7%	2	2	93	93	1.6151350762221155E-10	1	1	126	78	29	2	-C
E2_BC50_191109_LF_LIB_consensus_vsearch	477	T	*/-C	219	19	7.76%	2	1	93	93	1.312379928099055E-6	1	1	140	79	19	0	-C
E2_BC50_191109_LF_LIB_consensus_vsearch	489	T	*/-AT	226	9	3.67%	2	2	93	93	0.0018065516263558758	1	1	158	68	1	8	-AT
E2_BC50_191109_LF_LIB_consensus_vsearch	497	G	*/+C	231	7	2.89%	2	1	93	93	0.007470748618496003	1	1	152	79	7	0	+C
E2_BC50_191109_LF_LIB_consensus_vsearch	499	C	*/-GC	227	9	3.66%	2	1	93	93	0.0018071599099638493	1	1	148	79	9	0	-GC
E2_BC50_191109_LF_LIB_consensus_vsearch	501	C	*/-T	221	11	4.64%	2	2	93	93	4.3250849347899065E-4	1	1	144	77	6	5	-T
E2_BC50_191109_LF_LIB_consensus_vsearch	504	G	*/-A	230	12	4.88%	2	1	93	93	2.1231016338203528E-4	1	1	150	80	12	0	-A
E2_BC50_191109_LF_LIB_consensus_vsearch	506	A	*/-C	220	14	5.69%	2	2	93	93	4.995890859598848E-5	1	1	156	64	6	8	-C
E2_BC50_191109_LF_LIB_consensus_vsearch	506	A	*/-CCTC	220	9	3.66%	2	1	93	93	0.0018027927820038396	1	1	156	64	0	9	-C
E2_BC50_191109_LF_LIB_consensus_vsearch	507	C	*/+A	214	7	3.12%	2	1	93	93	0.007444703667648697	1	1	151	63	7	0	+A
E2_BC50_191109_LF_LIB_consensus_vsearch	509	T	*/-C	203	13	5.56%	2	2	93	93	1.0135552209744578E-4	1	1	156	47	4	9	-C
E2_BC50_191109_LF_LIB_consensus_vsearch	509	T	*/-CCT	203	15	6.41%	2	2	93	93	2.37871086741396E-5	1	1	156	47	2	13	-CCT
E2_BC50_191109_LF_LIB_consensus_vsearch	512	T	*/+C	199	19	8.48%	2	1	93	93	1.266174101535565E-6	1	1	138	61	19	0	+C
E2_BC50_191109_LF_LIB_consensus_vsearch	513	C	*/-G	216	22	9.24%	2	2	93	93	1.4339284531411858E-7	1	1	162	54	1	21	-G
E2_BC50_191109_LF_LIB_consensus_vsearch	520	C	*/+AC	211	21	8.57%	2	1	93	93	2.9693129721095895E-7	1	1	131	80	21	0	+AC
E2_BC50_191109_LF_LIB_consensus_vsearch	526	C	*/-G	233	8	3.23%	2	2	93	93	0.0036824046267336483	1	1	160	73	1	7	-G
E2_BC50_191109_LF_LIB_consensus_vsearch	539	C	*/-T	219	15	6.07%	2	2	93	93	2.4209162755784478E-5	1	1	150	69	4	11	-T
E2_BC50_191109_LF_LIB_consensus_vsearch	542	T	*/-C	160	73	29.44%	2	2	93	93	1.2815405083908186E-25	1	1	134	26	25	48	-C
E2_BC50_191109_LF_LIB_consensus_vsearch	544	C	*/+G	227	7	2.92%	2	1	93	93	0.0074649578216797186	1	1	153	74	7	0	+G
E2_BC50_191109_LF_LIB_consensus_vsearch	545	C	*/-TT	200	16	6.56%	2	2	93	93	1.1438379994950568E-5	1	1	147	53	3	13	-TT
E2_BC50_191109_LF_LIB_consensus_vsearch	552	C	*/-G	229	9	3.67%	2	2	93	93	0.0018083614623809116	1	1	161	68	1	8	-G
E2_BC50_191109_LF_LIB_consensus_vsearch	556	C	*/+G	136	8	3.28%	2	2	93	93	0.0035351105097651617	1	1	87	49	4	4	+G
E2_BC50_191109_LF_LIB_consensus_vsearch	556	C	*/-G	136	73	29.92%	2	2	93	93	4.9743317393209974E-26	1	1	87	49	53	20	-G
E2_BC50_191109_LF_LIB_consensus_vsearch	556	C	*/-GGG	136	15	6.15%	2	2	93	93	2.117734039727101E-5	1	1	87	49	11	4	-G
E2_BC50_191109_LF_LIB_consensus_vsearch	566	G	*/-A	220	8	3.39%	2	2	93	93	0.0036698276230520683	1	1	143	77	7	1	-A
E2_BC50_191109_LF_LIB_consensus_vsearch	569	A	*/+C	184	23	9.54%	2	2	93	93	6.244544295921632E-8	1	1	119	65	20	3	+C
E2_BC50_191109_LF_LIB_consensus_vsearch	569	A	*/-C	184	13	5.39%	2	2	93	93	9.949475485699823E-5	1	1	119	65	9	4	+C
E2_BC50_191109_LF_LIB_consensus_vsearch	569	A	*/-CC	184	11	4.56%	2	2	93	93	4.223970856632319E-4	1	1	119	65	5	6	+C
E2_BC50_191109_LF_LIB_consensus_vsearch	577	G	*/+T	231	9	3.64%	2	1	93	93	0.0018095434033127298	1	1	150	81	9	0	+T
E2_BC50_191109_LF_LIB_consensus_vsearch	582	T	*/+A	219	7	2.87%	2	1	93	93	0.007452766938834958	1	1	144	75	7	0	+A
E2_BC50_191109_LF_LIB_consensus_vsearch	582	T	*/-A	219	12	4.92%	2	2	93	93	2.10866409362083E-4	1	1	144	75	10	2	-A
E2_BC50_191109_LF_LIB_consensus_vsearch	584	A	*/+G	184	7	2.87%	2	1	93	93	0.007387555568979833	1	1	109	75	7	0	+G
E2_BC50_191109_LF_LIB_consensus_vsearch	584	A	*/-G	184	36	14.75%	2	1	93	93	3.0594694065327426E-12	1	1	109	75	36	0	-G
E2_BC50_191109_LF_LIB_consensus_vsearch	589	T	+C/+C	26	219	88.31%	2	2	93	93	1.127926276323256E-110	1	1	15	11	148	71	+C
E2_BC50_191109_LF_LIB_consensus_vsearch	590	C	*/-TC	232	14	5.65%	2	2	93	93	5.046335334004922E-5	1	1	160	72	4	10	-TC
E2_BC50_191109_LF_LIB_consensus_vsearch	594	T	*/+C	216	9	3.69%	2	2	93	93	0.0018001779733764346	1	1	143	73	8	1	+C
E2_BC50_191109_LF_LIB_consensus_vsearch	594	T	*/-C	216	17	6.97%	2	2	93	93	5.6371721310563775E-6	1	1	143	73	10	7	-C
E2_BC50_191109_LF_LIB_consensus_vsearch	598	G	*/-T	227	11	4.45%	2	2	93	93	4.3386316031303036E-4	1	1	149	78	10	1	-T
E2_BC50_191109_LF_LIB_consensus_vsearch	601	T	*/-A	236	8	3.23%	2	2	93	93	0.0036851193347710583	1	1	156	80	7	1	-A
E2_BC50_191109_LF_LIB_consensus_vsearch	602	A	*/-G	196	27	11.25%	2	2	93	93	3.2252988485898974E-9	1	1	147	49	1	26	-G
E2_BC50_191109_LF_LIB_consensus_vsearch	613	A	*/+C	200	11	4.53%	2	2	93	93	4.27186182801716E-4	1	1	126	74	10	1	+C
E2_BC50_191109_LF_LIB_consensus_vsearch	613	A	*/-C	200	22	9.05%	2	2	93	93	1.3797147807810935E-7	1	1	126	74	19	3	-C
E2_BC50_191109_LF_LIB_consensus_vsearch	631	T	*/-A	222	16	6.5%	2	2	93	93	1.1757842701133939E-5	1	1	149	73	13	3	-A
E2_BC50_191109_LF_LIB_consensus_vsearch	635	C	*/-A	226	8	3.27%	2	1	93	93	0.003675803526076434	1	1	147	79	8	0	-A
E2_BC50_191109_LF_LIB_consensus_vsearch	636	A	*/+C	215	11	4.62%	2	1	93	93	4.3108474750487954E-4	1	1	133	82	11	0	+C
E2_BC50_191109_LF_LIB_consensus_vsearch	637	C	*/+A	212	9	3.69%	2	1	93	93	0.00179747064240055	1	1	135	77	9	0	+A
E2_BC50_191109_LF_LIB_consensus_vsearch	637	C	*/-G	212	8	3.28%	2	2	93	93	0.003661360523321731	1	1	135	77	5	3	+A
E2_BC50_191109_LF_LIB_consensus_vsearch	639	G	*/-A	234	9	3.64%	2	1	93	93	0.0018112805803138848	1	1	154	80	9	0	-A
E2_BC50_191109_LF_LIB_consensus_vsearch	641	A	*/-C	222	17	6.88%	2	2	93	93	5.681724827274391E-6	1	1	148	74	11	6	-C
E2_BC50_191109_LF_LIB_consensus_vsearch	646	T	*/-C	185	42	17.14%	2	2	93	93	2.810058193335494E-14	1	1	126	59	26	16	-C
E2_BC50_191109_LF_LIB_consensus_vsearch	650	C	*/-AC	233	8	3.24%	2	1	93	93	0.0036824046267336483	1	1	153	80	8	0	-AC
E2_BC50_191109_LF_LIB_consensus_vsearch	654	T	*/+C	220	18	7.41%	2	2	93	93	2.732136395770739E-6	1	1	140	80	17	1	+C
E2_BC50_191109_LF_LIB_consensus_vsearch	660	T	*/-AC	219	18	7.38%	2	1	93	93	2.7281420824837606E-6	1	1	140	79	18	0	-AC
E2_BC50_191109_LF_LIB_consensus_vsearch	661	A	*/-C	188	13	5.78%	2	2	93	93	9.991366545768514E-5	1	1	112	76	7	6	-C
E2_BC50_191109_LF_LIB_consensus_vsearch	661	A	*/-CC	188	11	4.89%	2	1	93	93	4.2366328040616125E-4	1	1	112	76	11	0	-C
E2_BC50_191109_LF_LIB_consensus_vsearch	664	C	*/-G	220	18	7.35%	2	2	93	93	2.732136395770739E-6	1	1	158	62	1	17	-G
E2_BC50_191109_LF_LIB_consensus_vsearch	669	C	*/-G	222	11	4.49%	2	2	93	93	4.3273893004878305E-4	1	1	146	76	10	1	-G
E2_BC50_191109_LF_LIB_consensus_vsearch	669	C	*/-GC	222	8	3.27%	2	2	93	93	0.0036718537228742883	1	1	146	76	5	3	-G
E2_BC50_191109_LF_LIB_consensus_vsearch	671	C	*/+TT	203	12	5.04%	2	1	93	93	2.0851661109317314E-4	1	1	132	71	12	0	+TT
E2_BC50_191109_LF_LIB_consensus_vsearch	673	C	*/-G	167	46	18.7%	2	1	93	93	9.299602692355662E-16	1	1	91	76	46	0	-G
E2_BC50_191109_LF_LIB_consensus_vsearch	674	G	*/-A	173	14	7%	2	1	93	93	4.7416220807620975E-5	1	1	92	81	14	0	-A
E2_BC50_191109_LF_LIB_consensus_vsearch	675	A	*/-G	220	7	3.02%	2	2	93	93	0.007454337359329176	1	1	143	77	4	3	-G
E2_BC50_191109_LF_LIB_consensus_vsearch	679	T	*/-A	217	24	9.68%	2	2	93	93	3.2638989920788505E-8	1	1	143	74	23	1	-A
E2_BC50_191109_LF_LIB_consensus_vsearch	693	A	*/-C	222	9	3.72%	2	1	93	93	0.001804066959286255	1	1	143	79	9	0	-C
E2_BC50_191109_LF_LIB_consensus_vsearch	695	C	*/-A	227	10	4.15%	2	1	93	93	8.863871017160644E-4	1	1	148	79	10	0	-A
E2_BC50_191109_LF_LIB_consensus_vsearch	707	T	*/-A	208	22	8.91%	2	1	93	93	1.4075509936715075E-7	1	1	138	70	22	0	-A
E2_BC50_191109_LF_LIB_consensus_vsearch	709	G	*/-A	234	8	3.25%	2	1	93	93	0.00368331690336814	1	1	153	81	8	0	-A
E2_BC50_191109_LF_LIB_consensus_vsearch	723	C	*/-AC	221	19	7.82%	2	1	93	93	1.316641870203735E-6	1	1	142	79	19	0	-AC
E2_BC50_191109_LF_LIB_consensus_vsearch	729	C	*/-AC	232	8	3.27%	2	1	93	93	0.0036814848550168837	1	1	152	80	8	0	-AC
E2_BC50_191109_LF_LIB_consensus_vsearch	737	C	*/-AC	231	8	3.24%	2	2	93	93	0.0036805574954856175	1	1	156	75	6	2	-AC
E2_BC50_191109_LF_LIB_consensus_vsearch	747	C	*/+A	207	14	5.71%	2	1	93	93	4.93553660030744E-5	1	1	129	78	14	0	+A
E2_BC50_191109_LF_LIB_consensus_vsearch	753	C	*/-T	237	8	3.23%	2	2	93	93	0.003686009667588161	1	1	158	79	5	3	-T
E2_BC50_191109_LF_LIB_consensus_vsearch	756	C	*/+AC	85	151	60.89%	2	2	93	93	4.284575122651538E-62	1	1	62	23	99	52	+AC
E2_BC50_191109_LF_LIB_consensus_vsearch	757	G	*/+C	191	12	4.94%	2	2	93	93	2.0652482483515445E-4	1	1	137	54	8	4	+C
E2_BC50_191109_LF_LIB_consensus_vsearch	757	G	*/-C	191	8	3.29%	2	2	93	93	0.0036359507017874977	1	1	137	54	6	2	+C
E2_BC50_191109_LF_LIB_consensus_vsearch	758	C	*/+G	204	24	10.17%	2	2	93	93	3.147740029163511E-8	1	1	147	57	7	17	+G
E2_BC50_191109_LF_LIB_consensus_vsearch	762	C	*/-T	232	9	3.63%	2	2	93	93	0.0018101271688386934	1	1	159	73	3	6	-T
E2_BC50_191109_LF_LIB_consensus_vsearch	769	T	*/+C	207	8	3.23%	2	2	93	93	0.003655753662936563	1	1	129	78	7	1	+C
E2_BC50_191109_LF_LIB_consensus_vsearch	769	T	*/-C	207	28	11.29%	2	2	93	93	1.5846412514860424E-9	1	1	129	78	27	1	-C
E2_BC50_191109_LF_LIB_consensus_vsearch	778	A	*/+T	233	8	3.24%	2	2	93	93	0.0036824046267336483	1	1	161	72	2	6	+T
E2_BC50_191109_LF_LIB_consensus_vsearch	785	C	*/-A	235	8	3.23%	2	1	93	93	0.003684221776127662	1	1	154	81	8	0	-A
E2_BC50_191109_LF_LIB_consensus_vsearch	789	A	*/-G	177	64	26.23%	2	2	93	93	4.304236961579401E-22	1	1	108	69	52	12	-G
E2_BC50_191109_LF_LIB_consensus_vsearch	794	C	*/+G	81	153	62.7%	1	2	93	93	1.7625136979795384E-63	1	1	81	0	76	77	+G
E2_BC50_191109_LF_LIB_consensus_vsearch	805	A	*/-CA	231	7	2.87%	2	2	93	93	0.007470748618496003	1	1	154	77	6	1	-CA
E2_BC50_191109_LF_LIB_consensus_vsearch	809	G	*/-CT	230	8	3.25%	2	1	93	93	0.0036796224538833875	1	1	150	80	8	0	-CT
E2_BC50_191109_LF_LIB_consensus_vsearch	812	T	*/-A	203	18	7.41%	2	1	93	93	2.660025487728775E-6	1	1	130	73	18	0	-A
E2_BC50_191109_LF_LIB_consensus_vsearch	824	A	*/+T	195	25	10.16%	2	2	93	93	1.4471003755089968E-8	1	1	122	73	21	4	+T
E2_BC50_191109_LF_LIB_consensus_vsearch	824	A	*/-T	195	14	5.69%	2	2	93	93	4.873705147345955E-5	1	1	122	73	10	4	+T
E2_BC50_191109_LF_LIB_consensus_vsearch	828	T	*/+C	231	9	3.63%	2	1	93	93	0.0018095434033127298	1	1	151	80	9	0	+C
E2_BC50_191109_LF_LIB_consensus_vsearch	830	A	*/-G	220	12	4.88%	2	2	93	93	2.1100303986498742E-4	1	1	148	72	4	8	-G
E2_BC50_191109_LF_LIB_consensus_vsearch	835	T	+A/+A	33	208	84.21%	2	2	93	93	9.513555152742819E-102	1	1	24	9	136	72	+A
E2_BC50_191109_LF_LIB_consensus_vsearch	836	G	*/+A	210	24	9.8%	2	1	93	93	3.202517976551975E-8	1	1	137	73	24	0	+A
E2_BC50_191109_LF_LIB_consensus_vsearch	838	C	*/-A	216	12	4.94%	2	1	93	93	2.104496857598024E-4	1	1	160	56	0	12	-A
E2_BC50_191109_LF_LIB_consensus_vsearch	842	T	*/-C	214	18	7.35%	2	2	93	93	2.7077251430281975E-6	1	1	158	56	1	17	-C
E2_BC50_191109_LF_LIB_consensus_vsearch	851	G	*/-A	235	7	2.83%	2	2	93	93	0.007476349629382664	1	1	156	79	6	1	-A
E2_BC50_191109_LF_LIB_consensus_vsearch	852	A	*/-G	223	8	3.32%	2	1	93	93	0.0036728538094896964	1	1	143	80	8	0	-G
E2_BC50_191109_LF_LIB_consensus_vsearch	862	C	*/-A	184	20	8.33%	2	1	93	93	5.846755776787465E-7	1	1	107	77	20	0	-A
E2_BC50_191109_LF_LIB_consensus_vsearch	862	C	*/-AC	184	30	12.5%	2	2	93	93	3.12315858966848E-10	1	1	107	77	29	1	-AC
E2_BC50_191109_LF_LIB_consensus_vsearch	863	A	*/+C	179	7	3.66%	2	2	93	93	0.007376258791632204	1	1	105	74	1	6	+C
E2_BC50_191109_LF_LIB_consensus_vsearch	864	C	*/+T	195	8	3.7%	2	2	93	93	0.003641189182853133	1	1	128	67	1	7	+T
E2_BC50_191109_LF_LIB_consensus_vsearch	865	T	*/-C	205	23	9.43%	2	2	93	93	6.64864113477683E-8	1	1	147	58	17	6	-C
E2_BC50_191109_LF_LIB_consensus_vsearch	882	C	*/-T	225	15	6.1%	2	2	93	93	2.4354161852738932E-5	1	1	152	73	7	8	-T
E2_BC50_191109_LF_LIB_consensus_vsearch	884	T	*/-C	220	11	4.53%	2	2	93	93	4.322761391918409E-4	1	1	144	76	6	5	-C
E2_BC50_191109_LF_LIB_consensus_vsearch	888	T	*/+A	222	8	3.28%	2	1	93	93	0.0036718537228742883	1	1	144	78	8	0	+A
E2_BC50_191109_LF_LIB_consensus_vsearch	890	G	*/-C	227	7	2.83%	2	1	93	93	0.0074649578216797186	1	1	145	82	7	0	-C
E2_BC50_191109_LF_LIB_consensus_vsearch	897	T	*/-C	237	9	3.64%	2	1	93	93	0.0018129762417955753	1	1	156	81	9	0	-C
E2_BC50_191109_LF_LIB_consensus_vsearch	912	C	*/-AC	233	7	2.82%	2	1	93	93	0.007473572259320498	1	1	152	81	7	0	-AC
E2_BC50_191109_LF_LIB_consensus_vsearch	913	A	*/-C	219	10	4.26%	2	2	93	93	8.833283118953115E-4	1	1	140	79	8	2	-C
E2_BC50_191109_LF_LIB_consensus_vsearch	922	C	*/+T	187	12	4.86%	2	2	93	93	2.0581058583041666E-4	1	1	138	49	8	4	+T
E2_BC50_191109_LF_LIB_consensus_vsearch	922	C	*/-T	187	35	14.17%	2	2	93	93	6.794796676990491E-12	1	1	138	49	16	19	-T
E2_BC50_191109_LF_LIB_consensus_vsearch	922	C	*/-TT	187	9	3.64%	2	1	93	93	0.001778109859374632	1	1	138	49	0	9	-T
E2_BC50_191109_LF_LIB_consensus_vsearch	928	T	*/-G	203	29	12.08%	2	2	93	93	7.327656835319677E-10	1	1	128	75	27	2	-G
E2_BC50_191109_LF_LIB_consensus_vsearch	930	G	*/-A	225	11	4.47%	2	1	93	93	4.334189676817625E-4	1	1	145	80	11	0	-A
E2_BC50_191109_LF_LIB_consensus_vsearch	935	T	*/+G	228	11	4.51%	2	1	93	93	4.340825732543977E-4	1	1	160	68	0	11	+G
E2_BC50_191109_LF_LIB_consensus_vsearch	948	G	*/+T	233	7	2.82%	2	2	93	93	0.007473572259320498	1	1	154	79	6	1	+T
E2_BC50_191109_LF_LIB_consensus_vsearch	948	G	*/-T	233	7	2.82%	2	2	93	93	0.007473572259320498	1	1	154	79	6	1	+T
E2_BC50_191109_LF_LIB_consensus_vsearch	978	T	*/-C	195	29	11.84%	2	1	93	93	7.071124992433461E-10	1	1	117	78	29	0	-C
E2_BC50_191109_LF_LIB_consensus_vsearch	978	T	*/-CC	195	10	4.08%	2	1	93	93	8.72767211907752E-4	1	1	117	78	10	0	-C
E2_BC50_191109_LF_LIB_consensus_vsearch	982	A	*/-CA	220	21	8.61%	2	2	93	93	3.0247178099243174E-7	1	1	142	78	19	2	-CA
E2_BC50_191109_LF_LIB_consensus_vsearch	984	A	*/-T	215	8	3.56%	2	1	93	93	0.0036646057936482192	1	1	145	70	0	8	-T
E2_BC50_191109_LF_LIB_consensus_vsearch	999	T	*/-A	184	47	19.42%	2	1	93	93	5.239916197932424E-16	1	1	105	79	47	0	-A
E2_BC50_191109_LF_LIB_consensus_vsearch	1002	C	*/-A	208	24	9.8%	2	2	93	93	3.184486606933522E-8	1	1	146	62	6	18	-A
E2_BC50_191109_LF_LIB_consensus_vsearch	1010	G	*/-C	229	10	4.05%	2	2	93	93	8.87120717393791E-4	1	1	149	80	9	1	-C
E2_BC50_191109_LF_LIB_consensus_vsearch	1013	C	*/-AC	232	10	4.03%	2	1	93	93	8.881990455798616E-4	1	1	150	82	10	0	-AC
E2_BC50_191109_LF_LIB_consensus_vsearch	1034	T	*/-G	207	35	14.29%	2	1	93	93	7.735932555519177E-12	1	1	162	45	0	35	-G
E2_BC50_191109_LF_LIB_consensus_vsearch	1047	T	*/+C	216	17	7.02%	2	1	93	93	5.6371721310563775E-6	1	1	143	73	17	0	+C
E2_BC50_191109_LF_LIB_consensus_vsearch	1048	C	*/+G	215	22	9.02%	2	1	93	93	1.4307072701069838E-7	1	1	139	76	22	0	+G
E2_BC50_191109_LF_LIB_consensus_vsearch	1049	A	*/-G	213	23	9.27%	2	1	93	93	6.788388096024037E-8	1	1	138	75	23	0	-G
E2_BC50_191109_LF_LIB_consensus_vsearch	1054	C	*/-AC	209	33	13.47%	2	2	93	93	3.611537339307505E-11	1	1	141	68	20	13	-AC
E2_BC50_191109_LF_LIB_consensus_vsearch	1057	G	*/-C	235	7	2.85%	2	2	93	93	0.007476349629382664	1	1	158	77	6	1	-C
E2_BC50_191109_LF_LIB_consensus_vsearch	1060	A	*/-G	219	10	4.13%	2	1	93	93	8.833283118953115E-4	1	1	155	64	0	10	-G
E2_BC50_191109_LF_LIB_consensus_vsearch	1069	A	*/-CA	203	35	14.23%	2	2	93	93	7.552046194433072E-12	1	1	132	71	27	8	-CA
E2_BC50_191109_LF_LIB_consensus_vsearch	1071	A	*/+T	196	11	5.21%	2	1	93	93	4.260552860545617E-4	1	1	123	73	11	0	+T
E2_BC50_191109_LF_LIB_consensus_vsearch	1083	A	*/-GA	227	10	4.05%	2	1	93	93	8.863871017160644E-4	1	1	147	80	10	0	-GA
E2_BC50_191109_LF_LIB_consensus_vsearch	1089	C	*/-GC	230	10	4.05%	2	2	93	93	8.874830704141458E-4	1	1	162	68	1	9	-GC
E2_BC50_191109_LF_LIB_consensus_vsearch	1094	A	*/-G	234	8	3.29%	2	2	93	93	0.00368331690336814	1	1	154	80	7	1	-G
E2_BC50_191109_LF_LIB_consensus_vsearch	1096	G	*/-C	229	12	4.88%	2	1	93	93	2.1218410207391174E-4	1	1	148	81	12	0	-C
E2_BC50_191109_LF_LIB_consensus_vsearch	1099	A	*/-CA	225	7	2.88%	2	2	93	93	0.0074619882138406745	1	1	152	73	1	6	-CA
E2_BC50_191109_LF_LIB_consensus_vsearch	1104	G	*/-A	238	7	2.85%	2	1	93	93	0.007480431384223459	1	1	157	81	7	0	-A
E2_BC50_191109_LF_LIB_consensus_vsearch	1106	G	*/-C	212	16	6.61%	2	2	93	93	1.1619469874592578E-5	1	1	136	76	13	3	-C
E2_BC50_191109_LF_LIB_consensus_vsearch	1106	G	*/-CC	212	7	2.89%	2	1	93	93	0.00744137624879223	1	1	136	76	7	0	-C
E2_BC50_191109_LF_LIB_consensus_vsearch	1110	C	*/-A	215	16	6.45%	2	2	93	93	1.1662109220663649E-5	1	1	155	60	3	13	-A
E2_BC50_191109_LF_LIB_consensus_vsearch	1116	G	*/+C	222	7	2.92%	2	1	93	93	0.007457437428309682	1	1	142	80	7	0	+C
E2_BC50_191109_LF_LIB_consensus_vsearch	1116	G	*/-C	222	9	3.75%	2	2	93	93	0.001804066959286255	1	1	142	80	8	1	-C
E2_BC50_191109_LF_LIB_consensus_vsearch	1129	C	*/+T	227	8	3.25%	2	2	93	93	0.003676770270380206	1	1	152	75	5	3	+T
E2_BC50_191109_LF_LIB_consensus_vsearch	1147	C	*/-TT	231	8	3.28%	2	1	93	93	0.0036805574954856175	1	1	151	80	8	0	-TT
E2_BC50_191109_LF_LIB_consensus_vsearch	1150	G	*/-A	235	9	3.63%	2	1	93	93	0.0018118503395958998	1	1	155	80	9	0	-A
E2_BC50_191109_LF_LIB_consensus_vsearch	1154	G	*/-A	233	9	3.66%	2	1	93	93	0.0018107062087977532	1	1	152	81	9	0	-A
E2_BC50_191109_LF_LIB_consensus_vsearch	1166	T	*/+C	213	8	3.23%	2	1	93	93	0.0036624519192641563	1	1	133	80	8	0	+C
E2_BC50_191109_LF_LIB_consensus_vsearch	1166	T	*/-C	213	26	10.48%	2	2	93	93	7.263250744521819E-9	1	1	133	80	25	1	-C
E2_BC50_191109_LF_LIB_consensus_vsearch	1171	A	*/+G	133	12	4.9%	2	2	93	93	1.926151294287903E-4	1	1	69	64	11	1	+G
E2_BC50_191109_LF_LIB_consensus_vsearch	1171	A	*/-G	133	74	30.2%	2	2	93	93	1.7844493302772904E-26	1	1	69	64	57	17	-G
E2_BC50_191109_LF_LIB_consensus_vsearch	1171	A	*/-GG	133	11	4.49%	2	1	93	93	4.0047318276935676E-4	1	1	69	64	11	0	-G
E2_BC50_191109_LF_LIB_consensus_vsearch	1171	A	*/-GGGA	133	12	4.9%	2	1	93	93	1.926151294287903E-4	1	1	69	64	12	0	-GGGA
E2_BC50_191109_LF_LIB_consensus_vsearch	1178	C	*/-T	222	17	6.97%	2	2	93	93	5.681724827274391E-6	1	1	155	67	5	12	-T
E2_BC50_191109_LF_LIB_consensus_vsearch	1180	T	*/-C	218	9	3.7%	2	2	93	93	0.001801496644156972	1	1	147	71	3	6	-C
E2_BC50_191109_LF_LIB_consensus_vsearch	1181	C	*/+G	132	21	8.97%	2	2	93	93	2.2837583304070624E-7	1	1	103	29	15	6	+G
E2_BC50_191109_LF_LIB_consensus_vsearch	1181	C	*/+GG	132	7	2.99%	2	2	93	93	0.007230945949356827	1	1	103	29	6	1	+G
E2_BC50_191109_LF_LIB_consensus_vsearch	1181	C	*/-G	132	46	19.66%	2	2	93	93	5.008992905589457E-16	1	1	103	29	18	28	-G
E2_BC50_191109_LF_LIB_consensus_vsearch	1181	C	*/-GG	132	13	5.56%	2	2	93	93	9.215040364763159E-5	1	1	103	29	8	5	-G
E2_BC50_191109_LF_LIB_consensus_vsearch	1197	T	*/+G	233	8	3.24%	2	1	93	93	0.0036824046267336483	1	1	153	80	8	0	+G
E2_BC50_191109_LF_LIB_consensus_vsearch	1198	A	*/-G	233	7	2.85%	2	1	93	93	0.007473572259320498	1	1	156	77	7	0	-G
E2_BC50_191109_LF_LIB_consensus_vsearch	1204	T	*/+C	236	7	2.85%	2	1	93	93	0.007477721316805575	1	1	164	72	0	7	+C
E2_BC50_191109_LF_LIB_consensus_vsearch	1219	G	*/+C	161	10	4.13%	2	2	93	93	8.529341483590452E-4	1	1	94	67	6	4	+C
E2_BC50_191109_LF_LIB_consensus_vsearch	1219	G	*/-C	161	63	26.03%	2	2	93	93	6.686103288361617E-22	1	1	94	67	54	9	-C
E2_BC50_191109_LF_LIB_consensus_vsearch	1223	C	*/-T	234	10	4.05%	2	2	93	93	8.889036112835749E-4	1	1	160	74	4	6	-T
E2_BC50_191109_LF_LIB_consensus_vsearch	1226	T	*/-A	221	12	4.94%	2	1	93	93	2.1113855488095296E-4	1	1	140	81	12	0	-A
E2_BC50_191109_LF_LIB_consensus_vsearch	1226	T	*/-AC	221	8	3.29%	2	1	93	93	0.003670845031231652	1	1	140	81	8	0	-A
E2_BC50_191109_LF_LIB_consensus_vsearch	1227	A	*/-C	173	16	7.14%	2	2	93	93	1.0957465194659251E-5	1	1	100	73	8	8	-C
E2_BC50_191109_LF_LIB_consensus_vsearch	1230	C	*/-G	228	10	4.03%	2	2	93	93	8.867554066061573E-4	1	1	158	70	5	5	-G
E2_BC50_191109_LF_LIB_consensus_vsearch	1232	G	*/+A	235	7	2.85%	2	1	93	93	0.007476349629382664	1	1	157	78	7	0	+A
E2_BC50_191109_LF_LIB_consensus_vsearch	1237	C	*/-AC	213	23	9.43%	2	1	93	93	6.788388096024037E-8	1	1	140	73	23	0	-AC
E2_BC50_191109_LF_LIB_consensus_vsearch	1244	G	*/-A	231	9	3.67%	2	1	93	93	0.0018095434033127298	1	1	149	82	9	0	-A
E2_BC50_191109_LF_LIB_consensus_vsearch	1245	A	*/-T	214	18	7.66%	2	2	93	93	2.7077251430281975E-6	1	1	134	80	16	2	-T
E2_BC50_191109_LF_LIB_consensus_vsearch	1250	C	*/-AC	210	21	8.79%	2	1	93	93	2.962943854470701E-7	1	1	137	73	21	0	-AC
E2_BC50_191109_LF_LIB_consensus_vsearch	1251	A	*/+T	205	13	5.78%	2	1	93	93	1.0153375468649412E-4	1	1	139	66	0	13	+T
E2_BC50_191109_LF_LIB_consensus_vsearch	1256	A	*/+G	225	11	4.51%	2	2	93	93	4.334189676817625E-4	1	1	154	71	1	10	+G
E2_BC50_191109_LF_LIB_consensus_vsearch	1257	G	*/-A	231	7	2.86%	2	1	93	93	0.007470748618496003	1	1	154	77	7	0	-A
E2_BC50_191109_LF_LIB_consensus_vsearch	1259	A	*/-C	232	8	3.24%	2	1	93	93	0.0036814848550168837	1	1	151	81	8	0	-C
E2_BC50_191109_LF_LIB_consensus_vsearch	1266	C	*/-G	229	8	3.31%	2	1	93	93	0.0036786796343901236	1	1	161	68	0	8	-G
E2_BC50_191109_LF_LIB_consensus_vsearch	1284	T	*/-C	235	9	3.63%	2	2	93	93	0.0018118503395958998	1	1	159	76	4	5	-C
E2_BC50_191109_LF_LIB_consensus_vsearch	1286	C	*/-A	238	7	2.82%	2	1	93	93	0.007480431384223459	1	1	156	82	7	0	-A
E2_BC50_191109_LF_LIB_consensus_vsearch	1297	T	*/+C	205	20	8.1%	2	1	93	93	6.13281842160553E-7	1	1	126	79	20	0	+C
E2_BC50_191109_LF_LIB_consensus_vsearch	1297	T	*/-C	205	16	6.48%	2	2	93	93	1.1515964001761286E-5	1	1	126	79	15	1	+C
E2_BC50_191109_LF_LIB_consensus_vsearch	1300	T	*/-AC	223	14	5.81%	2	1	93	93	5.008946442185716E-5	1	1	143	80	14	0	-AC
E2_BC50_191109_LF_LIB_consensus_vsearch	1301	A	*/-C	188	25	10.92%	2	2	93	93	1.4110585661304756E-8	1	1	109	79	24	1	-C
E2_BC50_191109_LF_LIB_consensus_vsearch	1301	A	*/-CC	188	8	3.49%	2	1	93	93	0.0036318839680821967	1	1	109	79	8	0	-C
E2_BC50_191109_LF_LIB_consensus_vsearch	1321	C	*/-T	225	16	6.5%	2	2	93	93	1.179733827794779E-5	1	1	158	67	2	14	-T
E2_BC50_191109_LF_LIB_consensus_vsearch	1324	T	*/+C	234	8	3.23%	2	1	93	93	0.00368331690336814	1	1	155	79	8	0	+C
E2_BC50_191109_LF_LIB_consensus_vsearch	1325	C	*/-G	224	9	3.7%	2	2	93	93	0.0018053197291553536	1	1	154	70	6	3	-G
E2_BC50_191109_LF_LIB_consensus_vsearch	1330	C	*/-GC	237	8	3.23%	2	1	93	93	0.003686009667588161	1	1	155	82	8	0	-GC
E2_BC50_191109_LF_LIB_consensus_vsearch	1334	T	*/-C	216	25	10.12%	2	2	93	93	1.5464324918800632E-8	1	1	137	79	23	2	-C
E2_BC50_191109_LF_LIB_consensus_vsearch	1336	C	*/-T	221	18	7.32%	2	2	93	93	2.7361017606407482E-6	1	1	148	73	14	4	-T
E2_BC50_191109_LF_LIB_consensus_vsearch	1338	A	*/+C	220	8	3.31%	2	1	93	93	0.0036698276230520683	1	1	141	79	8	0	+C
E2_BC50_191109_LF_LIB_consensus_vsearch	1352	G	*/-TG	233	7	2.83%	2	1	93	93	0.007473572259320498	1	1	160	73	0	7	-TG
E2_BC50_191109_LF_LIB_consensus_vsearch	1357	G	*/-A	214	24	9.84%	2	1	93	93	3.237916453401558E-8	1	1	132	82	24	0	-A
E2_BC50_191109_LF_LIB_consensus_vsearch	1359	G	*/+C	214	10	4.13%	2	1	93	93	8.813089995913842E-4	1	1	138	76	10	0	+C
E2_BC50_191109_LF_LIB_consensus_vsearch	1362	C	*/-G	215	13	5.28%	2	2	93	93	1.0238092820754376E-4	1	1	150	65	2	11	-G
E2_BC50_191109_LF_LIB_consensus_vsearch	1363	G	*/+CA	196	8	3.45%	2	1	93	93	0.0036424672415343016	1	1	127	69	8	0	+CA
E2_BC50_191109_LF_LIB_consensus_vsearch	1371	C	*/-A	224	11	4.47%	2	2	93	93	4.3319414411093957E-4	1	1	151	73	3	8	-A
E2_BC50_191109_LF_LIB_consensus_vsearch	1376	T	*/-C	222	14	5.79%	2	2	93	93	5.004628793929559E-5	1	1	156	66	8	6	-C
E2_BC50_191109_LF_LIB_consensus_vsearch	1378	C	*/+T	218	13	5.31%	2	2	93	93	1.0262165255618348E-4	1	1	155	63	3	10	+T
E2_BC50_191109_LF_LIB_consensus_vsearch	1381	G	*/+C	223	9	3.67%	2	1	93	93	0.0018046959863042469	1	1	145	78	9	0	+C
E2_BC50_191109_LF_LIB_consensus_vsearch	1391	A	*/-G	224	10	4.12%	2	2	93	93	8.852638500565801E-4	1	1	147	77	9	1	-G
E2_BC50_191109_LF_LIB_consensus_vsearch	1399	C	*/-T	213	9	3.7%	2	2	93	93	0.0017981564163397133	1	1	149	64	2	7	-T
E2_BC50_191109_LF_LIB_consensus_vsearch	1399	C	*/-TT	213	10	4.12%	2	2	93	93	8.808946039600796E-4	1	1	149	64	6	4	-TT
E2_BC50_191109_LF_LIB_consensus_vsearch	1403	C	*/-G	226	7	2.92%	2	2	93	93	0.007463479333376833	1	1	156	70	6	1	-G
E2_BC50_191109_LF_LIB_consensus_vsearch	1412	T	*/-C	189	48	19.43%	2	1	93	93	2.5093486142471384E-16	1	1	109	80	48	0	-C
E2_BC50_191109_LF_LIB_consensus_vsearch	1415	A	*/-G	228	8	3.25%	2	1	93	93	0.00367772893957288	1	1	148	80	8	0	-G
E2_BC50_191109_LF_LIB_consensus_vsearch	1425	A	*/-C	221	20	8.06%	2	2	93	93	6.323165738404836E-7	1	1	151	70	9	11	-C
E2_BC50_191109_LF_LIB_consensus_vsearch	1436	C	*/+A	224	9	3.73%	2	2	93	93	0.0018053197291553536	1	1	152	72	8	1	+A
E2_BC50_191109_LF_LIB_consensus_vsearch	1442	C	*/-A	215	18	7.44%	2	2	93	93	2.7118689984586317E-6	1	1	144	71	17	1	-A
E2_BC50_191109_LF_LIB_consensus_vsearch	1449	C	*/-A	206	30	12.24%	2	1	93	93	3.4821734507184283E-10	1	1	131	75	30	0	-A
E2_BC50_191109_LF_LIB_consensus_vsearch	1452	T	*/-C	215	9	3.8%	2	2	93	93	0.0017995100038167202	1	1	152	63	5	4	-C
E2_BC50_191109_LF_LIB_consensus_vsearch	1454	C	*/-T	226	13	5.35%	2	1	93	93	1.032357834289093E-4	1	1	161	65	0	13	-T
E2_BC50_191109_LF_LIB_consensus_vsearch	1459	T	*/-C	238	7	2.82%	2	1	93	93	0.007480431384223459	1	1	156	82	7	0	-C
E2_BC50_191109_LF_LIB_consensus_vsearch	1464	G	*/+T	227	9	3.64%	2	2	93	93	0.0018071599099638493	1	1	151	76	7	2	+T
E2_BC50_191109_LF_LIB_consensus_vsearch	1464	G	*/-T	227	7	2.83%	2	1	93	93	0.0074649578216797186	1	1	151	76	7	0	+T
E2_BC50_191109_LF_LIB_consensus_vsearch	1473	C	*/-G	234	9	3.64%	2	2	93	93	0.0018112805803138848	1	1	159	75	2	7	-G
E2_BC50_191109_LF_LIB_consensus_vsearch	1488	G	*/-C	228	7	2.87%	2	1	93	93	0.007466423838535645	1	1	147	81	7	0	-C
E2_BC50_191109_LF_LIB_consensus_vsearch	1495	G	*/-C	235	7	2.88%	2	2	93	93	0.007476349629382664	1	1	156	79	6	1	-C
E2_BC50_191109_LF_LIB_consensus_vsearch	1512	C	*/-T	219	13	5.35%	2	2	93	93	1.0270059462456098E-4	1	1	160	59	3	10	-T
E2_BC50_191109_LF_LIB_consensus_vsearch	1527	T	*/-C	215	20	8.26%	2	2	93	93	6.254287576406704E-7	1	1	139	76	18	2	-C
E2_BC50_191109_LF_LIB_consensus_vsearch	1533	T	*/+C	232	8	3.23%	2	1	93	93	0.0036814848550168837	1	1	153	79	8	0	+C
E2_BC50_191109_LF_LIB_consensus_vsearch	1538	T	*/-C	197	49	19.76%	2	2	93	93	1.2463363009643638E-16	1	1	117	80	48	1	-C
E2_BC50_191109_LF_LIB_consensus_vsearch	1540	C	*/-GG	232	11	4.44%	2	2	93	93	4.349428315974289E-4	1	1	163	69	1	10	-GG
E2_BC50_191109_LF_LIB_consensus_vsearch	1544	C	*/-AC	203	34	13.88%	2	1	93	93	1.6268580237452926E-11	1	1	129	74	34	0	-AC
E2_BC50_191109_LF_LIB_consensus_vsearch	1548	T	*/-C	235	7	2.83%	2	1	93	93	0.007476349629382664	1	1	164	71	0	7	-C
E2_BC50_191109_LF_LIB_consensus_vsearch	1550	T	*/-G	227	9	3.67%	2	1	93	93	0.0018071599099638493	1	1	160	67	0	9	-G
E2_BC50_191109_LF_LIB_consensus_vsearch	1556	C	*/+GT	219	8	3.28%	2	1	93	93	0.0036688013849068284	1	1	162	57	0	8	+GT
E2_BC50_191109_LF_LIB_consensus_vsearch	1556	C	*/-A	219	9	3.69%	2	1	93	93	0.0018021474934649558	1	1	162	57	0	9	-A
E2_BC50_191109_LF_LIB_consensus_vsearch	1567	C	*/-A	228	7	2.83%	2	1	93	93	0.007466423838535645	1	1	149	79	7	0	-A
E2_BC50_191109_LF_LIB_consensus_vsearch	1568	A	*/+C	194	8	3.43%	2	2	93	93	0.003639898683792886	1	1	124	70	6	2	+C
E2_BC50_191109_LF_LIB_consensus_vsearch	1568	A	*/-C	194	14	6.01%	2	2	93	93	4.868257057911772E-5	1	1	124	70	7	7	-C
E2_BC50_191109_LF_LIB_consensus_vsearch	1574	A	*/+G	115	98	40.33%	2	2	93	93	1.317313081976956E-36	1	1	112	3	29	69	+G
E2_BC50_191109_LF_LIB_consensus_vsearch	1574	A	*/+GG	115	8	3.29%	2	2	93	93	0.003473485862068266	1	1	112	3	5	3	+G
E2_BC50_191109_LF_LIB_consensus_vsearch	1574	A	*/-G	115	12	4.94%	2	2	93	93	1.8595016201014417E-4	1	1	112	3	6	6	-G
E2_BC50_191109_LF_LIB_consensus_vsearch	1583	T	*/-C	232	8	3.24%	2	2	93	93	0.0036814848550168837	1	1	157	75	7	1	-C
E2_BC50_191109_LF_LIB_consensus_vsearch	1587	C	*/-T	235	8	3.27%	2	2	93	93	0.003684221776127662	1	1	159	76	2	6	-T
E2_BC50_191109_LF_LIB_consensus_vsearch	1598	T	*/-C	234	7	2.88%	2	1	93	93	0.007474966656828971	1	1	163	71	0	7	-C
E2_BC50_191109_LF_LIB_consensus_vsearch	1600	T	*/-C	229	8	3.28%	2	2	93	93	0.0036786796343901236	1	1	156	73	3	5	-C
E2_BC50_191109_LF_LIB_consensus_vsearch	1606	T	*/-CC	223	15	6.1%	2	1	93	93	2.4306571682594968E-5	1	1	144	79	15	0	-CC
E2_BC50_191109_LF_LIB_consensus_vsearch	1617	T	*/+C	232	12	4.86%	2	1	93	93	2.1255933043139825E-4	1	1	153	79	12	0	+C
E2_BC50_191109_LF_LIB_consensus_vsearch	1625	A	*/-T	234	12	4.86%	2	1	93	93	2.1280463299094273E-4	1	1	165	69	0	12	-T
E2_BC50_191109_LF_LIB_consensus_vsearch	1635	C	*/-AC	238	7	2.83%	2	1	93	93	0.007480431384223459	1	1	156	82	7	0	-AC
E2_BC50_191109_LF_LIB_consensus_vsearch	1643	G	*/-A	220	14	5.86%	2	1	93	93	4.995890859598848E-5	1	1	146	74	14	0	-A
E2_BC50_191109_LF_LIB_consensus_vsearch	1668	A	*/+C	222	10	4.1%	2	1	93	93	8.844993515297029E-4	1	1	145	77	10	0	+C
E2_BC50_191109_LF_LIB_consensus_vsearch	1669	C	*/-TAGC	216	10	4.07%	2	1	93	93	8.821271222096345E-4	1	1	141	75	10	0	-TAGC
E2_BC50_191109_LF_LIB_consensus_vsearch	1681	T	*/-C	176	54	21.95%	2	2	93	93	1.6258994281863522E-18	1	1	145	31	14	40	-C
E2_BC50_191109_LF_LIB_consensus_vsearch	1681	T	*/-CC	176	10	4.07%	2	2	93	93	8.625446222228462E-4	1	1	145	31	2	8	-C
E2_BC50_191109_LF_LIB_consensus_vsearch	1684	C	*/-T	230	14	5.69%	2	1	93	93	5.038248401810262E-5	1	1	162	68	0	14	-T
E2_BC50_191109_LF_LIB_consensus_vsearch	1688	T	*/+A	232	10	4.07%	2	1	93	93	8.881990455798616E-4	1	1	150	82	10	0	+A
E2_BC50_191109_LF_LIB_consensus_vsearch	1693	C	*/-T	220	9	3.7%	2	2	93	93	0.0018027927820038396	1	1	156	64	2	7	-T
E2_BC50_191109_LF_LIB_consensus_vsearch	1704	G	*/-T	236	8	3.23%	2	2	93	93	0.0036851193347710583	1	1	156	80	7	1	-T
E2_BC50_191109_LF_LIB_consensus_vsearch	1708	C	*/-A	211	31	12.5%	2	1	93	93	1.6688872476793795E-10	1	1	130	81	31	0	-A
E2_BC50_191109_LF_LIB_consensus_vsearch	1713	T	*/-CT	220	21	8.57%	2	2	93	93	3.0247178099243174E-7	1	1	150	70	14	7	-CT
E2_BC50_191109_LF_LIB_consensus_vsearch	1714	C	*/-T	199	17	7.66%	2	2	93	93	5.499221151421095E-6	1	1	149	50	3	14	-T
E2_BC50_191109_LF_LIB_consensus_vsearch	1717	T	*/-C	214	32	12.9%	2	2	93	93	7.923207179030619E-11	1	1	137	77	28	4	-C
E2_BC50_191109_LF_LIB_consensus_vsearch	1719	C	*/-A	219	20	8.06%	2	1	93	93	6.300524183115758E-7	1	1	141	78	20	0	-A
E2_BC50_191109_LF_LIB_consensus_vsearch	1726	C	*/-T	204	30	12.2%	2	2	93	93	3.4510175432707476E-10	1	1	133	71	25	5	-T
E2_BC50_191109_LF_LIB_consensus_vsearch	1730	T	*/-C	232	7	2.83%	2	2	93	93	0.007472166294706969	1	1	157	75	2	5	-C
E2_BC50_191109_LF_LIB_consensus_vsearch	1734	C	*/-T	216	24	9.76%	2	2	93	93	3.2552911535867905E-8	1	1	158	58	4	20	-T
E2_BC50_191109_LF_LIB_consensus_vsearch	1737	T	*/+C	159	8	3.24%	2	2	93	93	0.0035851936379921044	1	1	137	22	3	5	+C
E2_BC50_191109_LF_LIB_consensus_vsearch	1737	T	*/-C	159	53	21.46%	2	2	93	93	2.6858744393099945E-18	1	1	137	22	24	29	-C
E2_BC50_191109_LF_LIB_consensus_vsearch	1737	T	*/-CC	159	19	7.69%	2	1	93	93	1.1488882430925014E-6	1	1	137	22	0	19	-C
E2_BC50_191109_LF_LIB_consensus_vsearch	1761	C	*/-G	233	11	4.45%	2	1	93	93	4.351536507121341E-4	1	1	164	69	0	11	-G
E2_BC50_191109_LF_LIB_consensus_vsearch	1775	T	*/-A	239	7	2.83%	2	2	93	93	0.0074817700326852326	1	1	158	81	6	1	-A
E2_BC50_191109_LF_LIB_consensus_vsearch	1782	C	*/+TT	219	7	2.86%	2	2	93	93	0.007452766938834958	1	1	153	66	3	4	+TT
E2_BC50_191109_LF_LIB_consensus_vsearch	1782	C	*/-T	219	12	4.9%	2	2	93	93	2.10866409362083E-4	1	1	153	66	5	7	-T
E2_BC50_191109_LF_LIB_consensus_vsearch	1795	C	*/-T	232	10	4.1%	2	2	93	93	8.881990455798616E-4	1	1	156	76	8	2	-T
E2_BC50_191109_LF_LIB_consensus_vsearch	1799	C	*/-AC	212	12	4.88%	2	2	93	93	2.0987757342671282E-4	1	1	145	67	11	1	-AC
E2_BC50_191109_LF_LIB_consensus_vsearch	1805	A	*/-T	236	7	2.82%	2	2	93	93	0.007477721316805575	1	1	157	79	5	2	-T
E2_BC50_191109_LF_LIB_consensus_vsearch	1820	C	*/+A	199	9	3.8%	2	2	93	93	0.0017879699024036485	1	1	123	76	8	1	+A
E2_BC50_191109_LF_LIB_consensus_vsearch	1820	C	*/+G	199	14	5.91%	2	2	93	93	4.8950273206615416E-5	1	1	123	76	13	1	+G
E2_BC50_191109_LF_LIB_consensus_vsearch	1821	G	*/-A	218	9	3.75%	2	1	93	93	0.001801496644156972	1	1	142	76	9	0	-A
E2_BC50_191109_LF_LIB_consensus_vsearch	1838	C	*/+A	219	18	7.41%	2	1	93	93	2.7281420824837606E-6	1	1	140	79	18	0	+A
E2_BC50_191109_LF_LIB_consensus_vsearch	1839	G	*/-A	216	26	10.53%	2	1	93	93	7.331947011192114E-9	1	1	138	78	26	0	-A
E2_BC50_191109_LF_LIB_consensus_vsearch	1848	T	*/-C	231	7	2.87%	2	2	93	93	0.007470748618496003	1	1	158	73	4	3	-C
E2_BC50_191109_LF_LIB_consensus_vsearch	1849	C	*/-A	221	9	3.73%	2	1	93	93	0.001803432580702911	1	1	149	72	9	0	-A
E2_BC50_191109_LF_LIB_consensus_vsearch	1853	A	*/-G	205	38	15.38%	2	1	93	93	7.574119716951079E-13	1	1	123	82	38	0	-G
E2_BC50_191109_LF_LIB_consensus_vsearch	1855	C	*/+TT	231	10	4.08%	2	1	93	93	8.878425014170833E-4	1	1	151	80	10	0	+TT
E2_BC50_191109_LF_LIB_consensus_vsearch	1858	G	*/+A	225	9	3.75%	2	1	93	93	0.0018059382541162866	1	1	145	80	9	0	+A
E2_BC50_191109_LF_LIB_consensus_vsearch	1867	C	*/+G	206	7	2.83%	2	2	93	93	0.007431022745174962	1	1	146	60	4	3	+G
E2_BC50_191109_LF_LIB_consensus_vsearch	1870	G	*/-A	218	19	7.76%	2	1	93	93	1.3102261317189997E-6	1	1	138	80	19	0	-A
E2_BC50_191109_LF_LIB_consensus_vsearch	1880	C	*/-G	207	28	11.57%	2	2	93	93	1.5846412514860424E-9	1	1	155	52	2	26	-G
E2_BC50_191109_LF_LIB_consensus_vsearch	1890	A	*/-C	198	42	17.21%	2	2	93	93	3.182156280344266E-14	1	1	158	40	4	38	-C
E2_BC50_191109_LF_LIB_consensus_vsearch	1897	G	*/-TG	231	8	3.25%	2	2	93	93	0.0036805574954856175	1	1	155	76	3	5	-TG
E2_BC50_191109_LF_LIB_consensus_vsearch	1898	T	*/+A	224	7	2.98%	2	2	93	93	0.007460484300523826	1	1	151	73	5	2	+A
E2_BC50_191109_LF_LIB_consensus_vsearch	1899	G	*/-A	223	8	3.38%	2	1	93	93	0.0036728538094896964	1	1	148	75	8	0	-A
E2_BC50_191109_LF_LIB_consensus_vsearch	1906	C	*/-T	226	12	4.84%	2	2	93	93	2.1179986535711708E-4	1	1	157	69	3	9	-T
E2_BC50_191109_LF_LIB_consensus_vsearch	1909	T	*/-C	226	19	7.69%	2	2	93	93	1.3270377047246745E-6	1	1	146	80	17	2	-C
E2_BC50_191109_LF_LIB_consensus_vsearch	1918	C	*/-TT	205	25	10.12%	2	1	93	93	1.4959704044964924E-8	1	1	123	82	25	0	-TT
E2_BC50_191109_LF_LIB_consensus_vsearch	1918	C	*/-TTA	205	9	3.64%	2	1	93	93	0.0017924949478988227	1	1	123	82	9	0	-TT
E2_BC50_191109_LF_LIB_consensus_vsearch	1920	T	*/+A	144	7	3.35%	2	2	93	93	0.007276525855895998	1	1	84	60	3	4	+A
E2_BC50_191109_LF_LIB_consensus_vsearch	1920	T	*/-A	144	37	17.7%	2	2	93	93	9.363073163136788E-13	1	1	84	60	19	18	-A
E2_BC50_191109_LF_LIB_consensus_vsearch	1920	T	*/-AA	144	7	3.35%	2	1	93	93	0.007276525855895998	1	1	84	60	7	0	-A
E2_BC50_191109_LF_LIB_consensus_vsearch	1929	C	*/-GG	221	7	2.93%	2	1	93	93	0.007455894130096957	1	1	157	64	0	7	-GG
E2_BC50_191109_LF_LIB_consensus_vsearch	1936	C	*/+A	228	7	2.85%	2	2	93	93	0.007466423838535645	1	1	155	73	6	1	+A
E2_BC50_191109_LF_LIB_consensus_vsearch	1942	C	*/+G	211	9	3.78%	2	2	93	93	0.0017967787753331713	1	1	147	64	5	4	+G
E2_BC50_191109_LF_LIB_consensus_vsearch	1942	C	*/-G	211	8	3.36%	2	2	93	93	0.0036602593149509337	1	1	147	64	6	2	+G
E2_BC50_191109_LF_LIB_consensus_vsearch	1944	G	*/-A	230	9	3.67%	2	2	93	93	0.0018089548541641684	1	1	161	69	3	6	-A
E2_BC50_191109_LF_LIB_consensus_vsearch	1958	T	*/+A	220	10	4.05%	2	1	93	93	8.837219519630479E-4	1	1	139	81	10	0	+A
E2_BC50_191109_LF_LIB_consensus_vsearch	1958	T	*/+G	220	8	3.24%	2	1	93	93	0.0036698276230520683	1	1	139	81	8	0	+A
E2_BC50_191109_LF_LIB_consensus_vsearch	1963	C	*/+A	222	7	2.9%	2	1	93	93	0.007457437428309682	1	1	149	73	0	7	+A
E2_BC50_191109_LF_LIB_consensus_vsearch	1968	C	*/+T	235	8	3.27%	2	1	93	93	0.003684221776127662	1	1	165	70	0	8	+T
E2_BC50_191109_LF_LIB_consensus_vsearch	1969	T	*/+C	228	10	4.05%	2	2	93	93	8.867554066061573E-4	1	1	159	69	7	3	+C
E2_BC50_191109_LF_LIB_consensus_vsearch	1970	C	*/-GG	228	7	2.87%	2	1	93	93	0.007466423838535645	1	1	162	66	0	7	-GG
E2_BC50_191109_LF_LIB_consensus_vsearch	1971	G	*/+A	200	8	3.38%	2	1	93	93	0.003647458600901869	1	1	133	67	8	0	+A
E2_BC50_191109_LF_LIB_consensus_vsearch	1975	C	*/-A	227	11	4.51%	2	2	93	93	4.3386316031303036E-4	1	1	149	78	10	1	-A
E2_BC50_191109_LF_LIB_consensus_vsearch	1982	T	*/+A	220	11	4.55%	2	1	93	93	4.322761391918409E-4	1	1	143	77	11	0	+A
E2_BC50_191109_LF_LIB_consensus_vsearch	1983	G	*/-A	223	13	5.44%	2	1	93	93	1.03010072485016E-4	1	1	145	78	13	0	-A
E2_BC50_191109_LF_LIB_consensus_vsearch	1985	G	*/-C	230	9	3.7%	2	2	93	93	0.0018089548541641684	1	1	152	78	5	4	-C
E2_BC50_191109_LF_LIB_consensus_vsearch	1987	C	*/-A	220	8	3.24%	2	2	93	93	0.0036698276230520683	1	1	147	73	5	3	-A
E2_BC50_191109_LF_LIB_consensus_vsearch	2002	C	*/+T	209	7	2.92%	2	2	93	93	0.007436270701269745	1	1	141	68	1	6	+T
E2_BC50_191109_LF_LIB_consensus_vsearch	2002	C	*/-TT	209	15	6.25%	2	2	93	93	2.3951800712612044E-5	1	1	141	68	14	1	-TT
E2_BC50_191109_LF_LIB_consensus_vsearch	2013	T	*/+C	171	7	2.83%	2	2	93	93	0.007356879467164792	1	1	135	36	4	3	+C
E2_BC50_191109_LF_LIB_consensus_vsearch	2013	T	*/-C	171	68	27.53%	2	2	93	93	1.2851130687450026E-23	1	1	135	36	25	43	-C
E2_BC50_191109_LF_LIB_consensus_vsearch	2017	T	*/-CT	232	8	3.28%	2	1	93	93	0.0036814848550168837	1	1	164	68	0	8	-CT
E2_BC50_191109_LF_LIB_consensus_vsearch	2018	C	*/-TTC	226	8	3.38%	2	2	93	93	0.003675803526076434	1	1	161	65	4	4	-TTC
E2_BC50_191109_LF_LIB_consensus_vsearch	2021	C	*/-A	228	8	3.35%	2	1	93	93	0.00367772893957288	1	1	152	76	8	0	-A
E2_BC50_191109_LF_LIB_consensus_vsearch	2024	T	*/-C	230	12	4.86%	2	1	93	93	2.1231016338203528E-4	1	1	162	68	0	12	-C
E2_BC50_191109_LF_LIB_consensus_vsearch	2025	C	*/+TC	223	7	2.97%	2	1	93	93	0.007458967428082863	1	1	156	67	7	0	+TC
E2_BC50_191109_LF_LIB_consensus_vsearch	2034	T	*/-G	135	76	31.02%	2	2	93	93	3.317367931869077E-27	1	1	92	43	48	28	-G
E2_BC50_191109_LF_LIB_consensus_vsearch	2034	T	*/-GG	135	13	5.31%	2	2	93	93	9.270076455967652E-5	1	1	92	43	9	4	-G
E2_BC50_191109_LF_LIB_consensus_vsearch	2034	T	*/-GGG	135	9	3.67%	2	1	93	93	0.0017170536761717077	1	1	92	43	9	0	-G
E2_BC50_191109_LF_LIB_consensus_vsearch	2042	T	*/-C	234	11	4.47%	2	2	93	93	4.353628116613763E-4	1	1	159	75	7	4	-C
E2_BC50_191109_LF_LIB_consensus_vsearch	2043	C	*/+T	222	9	3.83%	2	1	93	93	0.001804066959286255	1	1	155	67	0	9	+T
E2_BC50_191109_LF_LIB_consensus_vsearch	2050	A	*/-G	232	7	2.87%	2	2	93	93	0.007472166294706969	1	1	156	76	5	2	-G
E2_BC50_191109_LF_LIB_consensus_vsearch	2055	C	*/-T	193	24	10.08%	2	2	93	93	3.041744078539526E-8	1	1	149	44	12	12	-T
E2_BC50_191109_LF_LIB_consensus_vsearch	2059	T	*/-C	232	8	3.24%	2	2	93	93	0.0036814848550168837	1	1	158	74	3	5	-C
E2_BC50_191109_LF_LIB_consensus_vsearch	2085	C	*/-A	231	8	3.29%	2	2	93	93	0.0036805574954856175	1	1	157	74	5	3	-A
E2_BC50_191109_LF_LIB_consensus_vsearch	2096	T	*/+C	211	16	6.48%	2	1	93	93	1.1605032761469583E-5	1	1	134	77	16	0	+C
E2_BC50_191109_LF_LIB_consensus_vsearch	2096	T	*/-C	211	11	4.45%	2	2	93	93	4.300945555177922E-4	1	1	134	77	7	4	+C
E2_BC50_191109_LF_LIB_consensus_vsearch	2099	C	*/-A	220	7	2.83%	2	1	93	93	0.007454337359329176	1	1	146	74	7	0	-A
E2_BC50_191109_LF_LIB_consensus_vsearch	2099	C	*/-AC	220	12	4.86%	2	1	93	93	2.1100303986498742E-4	1	1	146	74	12	0	-AC
E2_BC50_191109_LF_LIB_consensus_vsearch	2100	A	*/+C	184	8	3.49%	2	2	93	93	0.0036262674855563662	1	1	104	80	7	1	+C
E2_BC50_191109_LF_LIB_consensus_vsearch	2100	A	*/-C	184	20	8.73%	2	1	93	93	5.846755776787465E-7	1	1	104	80	20	0	-C
E2_BC50_191109_LF_LIB_consensus_vsearch	2100	A	*/-CC	184	12	5.24%	2	1	93	93	2.052568958466569E-4	1	1	104	80	12	0	-C
E2_BC50_191109_LF_LIB_consensus_vsearch	2107	T	*/+G	223	10	4.08%	2	2	93	93	8.848831932848452E-4	1	1	149	74	5	5	+G
E2_BC50_191109_LF_LIB_consensus_vsearch	2130	G	*/-CG	232	7	2.82%	2	2	93	93	0.007472166294706969	1	1	155	77	4	3	-CG
E2_BC50_191109_LF_LIB_consensus_vsearch	2131	C	*/-G	219	12	5%	2	1	93	93	2.10866409362083E-4	1	1	156	63	0	12	-G
E2_BC50_191109_LF_LIB_consensus_vsearch	2140	G	*/-C	222	14	5.69%	2	2	93	93	5.004628793929559E-5	1	1	155	67	3	11	-C
E2_BC50_191109_LF_LIB_consensus_vsearch	2141	C	*/+T	214	7	3.03%	2	1	93	93	0.007444703667648697	1	1	155	59	0	7	+T
E2_BC50_191109_LF_LIB_consensus_vsearch	2149	G	*/+A	230	10	4.08%	2	1	93	93	8.874830704141458E-4	1	1	150	80	10	0	+A
E2_BC50_191109_LF_LIB_consensus_vsearch	2152	G	*/+T	188	18	7.29%	2	2	93	93	2.5880431248781214E-6	1	1	124	64	8	10	+T
E2_BC50_191109_LF_LIB_consensus_vsearch	2152	G	*/-T	188	34	13.77%	2	2	93	93	1.4818439561515572E-11	1	1	124	64	31	3	-T
E2_BC50_191109_LF_LIB_consensus_vsearch	2157	G	*/-C	190	50	20.16%	2	2	93	93	5.1282277234029064E-17	1	1	121	69	37	13	-C
E2_BC50_191109_LF_LIB_consensus_vsearch	2160	C	*/+A	125	11	4.45%	2	1	93	93	3.956424382708704E-4	1	1	81	44	11	0	+A
E2_BC50_191109_LF_LIB_consensus_vsearch	2160	C	*/-G	125	58	23.48%	2	2	93	93	1.5833372678412436E-20	1	1	81	44	32	26	-G
E2_BC50_191109_LF_LIB_consensus_vsearch	2169	G	*/+A	230	8	3.27%	2	1	93	93	0.0036796224538833875	1	1	153	77	8	0	+A
E2_BC50_191109_LF_LIB_consensus_vsearch	2172	T	*/+G	226	8	3.23%	2	2	93	93	0.003675803526076434	1	1	155	71	6	2	+G
E2_BC50_191109_LF_LIB_consensus_vsearch	2185	C	*/-A	216	9	3.73%	2	2	93	93	0.0018001779733764346	1	1	141	75	7	2	-A
E2_BC50_191109_LF_LIB_consensus_vsearch	2199	G	*/-C	209	17	6.97%	2	2	93	93	5.582571341748222E-6	1	1	146	63	6	11	-C
E2_BC50_191109_LF_LIB_consensus_vsearch	2203	C	*/-A	212	7	2.83%	2	2	93	93	0.00744137624879223	1	1	154	58	2	5	-A
E2_BC50_191109_LF_LIB_consensus_vsearch	2207	C	*/-A	231	10	4.07%	2	2	93	93	8.878425014170833E-4	1	1	154	77	9	1	-A
E2_BC50_191109_LF_LIB_consensus_vsearch	2210	T	*/-C	220	9	3.77%	2	2	93	93	0.0018027927820038396	1	1	156	64	7	2	-C
E2_BC50_191109_LF_LIB_consensus_vsearch	2221	A	*/-CA	224	17	6.88%	2	2	93	93	5.696139726468511E-6	1	1	148	76	16	1	-CA
E2_BC50_191109_LF_LIB_consensus_vsearch	2228	T	*/-A	238	7	2.82%	2	1	93	93	0.007480431384223459	1	1	156	82	7	0	-A
E2_BC50_191109_LF_LIB_consensus_vsearch	2234	A	*/-CA	227	12	4.96%	2	2	93	93	2.1192896510056628E-4	1	1	148	79	10	2	-CA
E2_BC50_191109_LF_LIB_consensus_vsearch	2236	A	*/-G	219	7	3%	2	1	93	93	0.007452766938834958	1	1	140	79	7	0	-G
E2_BC50_191109_LF_LIB_consensus_vsearch	2244	A	*/+C	233	7	2.83%	2	1	93	93	0.007473572259320498	1	1	159	74	0	7	+C
E2_BC50_191109_LF_LIB_consensus_vsearch	2246	T	*/+C	225	7	2.86%	2	2	93	93	0.0074619882138406745	1	1	162	63	1	6	+C
E2_BC50_191109_LF_LIB_consensus_vsearch	2247	C	*/-G	223	8	3.33%	2	2	93	93	0.0036728538094896964	1	1	155	68	5	3	-G
E2_BC50_191109_LF_LIB_consensus_vsearch	2251	C	*/-TC	215	27	11.07%	2	2	93	93	3.4578614725272816E-9	1	1	155	60	9	18	-TC
E2_BC50_191109_LF_LIB_consensus_vsearch	2274	T	*/+C	230	9	3.69%	2	2	93	93	0.0018089548541641684	1	1	153	77	8	1	+C
E2_BC50_191109_LF_LIB_consensus_vsearch	2280	C	*/-AC	232	15	6.05%	2	1	93	93	2.4515158468444498E-5	1	1	150	82	15	0	-AC
E2_BC50_191109_LF_LIB_consensus_vsearch	2283	G	*/-CG	231	7	2.87%	2	2	93	93	0.007470748618496003	1	1	154	77	4	3	-CG
E2_BC50_191109_LF_LIB_consensus_vsearch	2298	C	*/+A	215	13	5.26%	2	1	93	93	1.0238092820754376E-4	1	1	144	71	13	0	+A
E2_BC50_191109_LF_LIB_consensus_vsearch	2308	C	*/-G	211	13	5.31%	2	1	93	93	1.0205056322589528E-4	1	1	142	69	13	0	-G
E2_BC50_191109_LF_LIB_consensus_vsearch	2312	G	*/-C	222	12	4.94%	2	2	93	93	2.1127296798947417E-4	1	1	143	79	10	2	-C
E2_BC50_191109_LF_LIB_consensus_vsearch	2316	G	*/-A	230	10	4.1%	2	1	93	93	8.874830704141458E-4	1	1	151	79	10	0	-A
E2_BC50_191109_LF_LIB_consensus_vsearch	2318	G	*/-C	226	16	6.5%	2	1	93	93	1.1810307374064424E-5	1	1	145	81	16	0	-C
E2_BC50_191109_LF_LIB_consensus_vsearch	2321	C	*/-A	223	11	4.45%	2	1	93	93	4.3296747251648046E-4	1	1	147	76	11	0	-A
E2_BC50_191109_LF_LIB_consensus_vsearch	2326	T	*/+A	236	7	2.83%	2	1	93	93	0.007477721316805575	1	1	154	82	7	0	+A
E2_BC50_191109_LF_LIB_consensus_vsearch	2328	C	*/-TT	232	7	2.82%	2	1	93	93	0.007472166294706969	1	1	153	79	7	0	-TT
E2_BC50_191109_LF_LIB_consensus_vsearch	2336	C	*/+G	234	7	2.87%	2	1	93	93	0.007474966656828971	1	1	156	78	7	0	+G
E2_BC50_191109_LF_LIB_consensus_vsearch	2337	A	*/-G	231	8	3.28%	2	1	93	93	0.0036805574954856175	1	1	155	76	8	0	-G
E2_BC50_191109_LF_LIB_consensus_vsearch	2353	T	*/-G	231	16	6.45%	2	1	93	93	1.1873730197672824E-5	1	1	165	66	0	16	-G
E2_BC50_191109_LF_LIB_consensus_vsearch	2357	T	*/-A	227	16	6.45%	2	2	93	93	1.182318022827354E-5	1	1	146	81	15	1	-A
E2_BC50_191109_LF_LIB_consensus_vsearch	2368	G	*/-TG	227	11	4.53%	2	2	93	93	4.3386316031303036E-4	1	1	155	72	5	6	-TG
E2_BC50_191109_LF_LIB_consensus_vsearch	2371	C	*/+A	222	8	3.29%	2	1	93	93	0.0036718537228742883	1	1	159	63	0	8	+A
E2_BC50_191109_LF_LIB_consensus_vsearch	2407	T	*/-C	217	10	4.03%	2	1	93	93	8.825309402840407E-4	1	1	135	82	10	0	-C
E2_BC50_191109_LF_LIB_consensus_vsearch	2407	T	*/-CC	217	19	7.66%	2	1	93	93	1.3080569041578427E-6	1	1	135	82	19	0	-CC
E2_BC50_191109_LF_LIB_consensus_vsearch	2415	T	*/+G	229	8	3.28%	2	1	93	93	0.0036786796343901236	1	1	162	67	0	8	+G
E2_BC50_191109_LF_LIB_consensus_vsearch	2416	G	*/-A	236	7	2.82%	2	2	93	93	0.007477721316805575	1	1	155	81	6	1	-A
E2_BC50_191109_LF_LIB_consensus_vsearch	2430	C	*/-A	225	19	7.66%	2	1	93	93	1.3249875312819313E-6	1	1	145	80	19	0	-A
E2_BC50_191109_LF_LIB_consensus_vsearch	2433	T	*/+C	208	8	3.24%	2	2	93	93	0.0036568954742723925	1	1	158	50	7	1	+C
E2_BC50_191109_LF_LIB_consensus_vsearch	2433	T	*/-C	208	29	11.74%	2	1	93	93	7.482940474197358E-10	1	1	158	50	0	29	-C
E2_BC50_191109_LF_LIB_consensus_vsearch	2437	T	*/+C	233	8	3.25%	2	1	93	93	0.0036824046267336483	1	1	157	76	8	0	+C
E2_BC50_191109_LF_LIB_consensus_vsearch	2438	C	*/+A	223	12	4.86%	2	1	93	93	2.114062925508352E-4	1	1	150	73	12	0	+A
E2_BC50_191109_LF_LIB_consensus_vsearch	2438	C	*/-G	223	7	2.83%	2	2	93	93	0.007458967428082863	1	1	150	73	3	4	+A
E2_BC50_191109_LF_LIB_consensus_vsearch	2450	T	*/+C	228	8	3.31%	2	2	93	93	0.00367772893957288	1	1	155	73	7	1	+C
E2_BC50_191109_LF_LIB_consensus_vsearch	2453	C	*/+A	119	91	36.69%	2	2	93	93	1.376935075972998E-33	1	1	112	7	31	60	+A
E2_BC50_191109_LF_LIB_consensus_vsearch	2453	C	*/+AA	119	7	2.82%	2	2	93	93	0.007171936613333159	1	1	112	7	4	3	+A
E2_BC50_191109_LF_LIB_consensus_vsearch	2453	C	*/-A	119	15	6.05%	2	2	93	93	2.016356768781431E-5	1	1	112	7	14	1	-A
E2_BC50_191109_LF_LIB_consensus_vsearch	2458	G	*/+A	230	16	6.48%	2	1	93	93	1.1861231863206785E-5	1	1	148	82	16	0	+A
E2_BC50_191109_LF_LIB_consensus_vsearch	2490	C	*/-AC	235	8	3.25%	2	1	93	93	0.003684221776127662	1	1	155	80	8	0	-AC
E2_BC50_191109_LF_LIB_consensus_vsearch	2501	C	*/-T	228	8	3.23%	2	2	93	93	0.00367772893957288	1	1	153	75	2	6	-T
E2_BC50_191109_LF_LIB_consensus_vsearch	2501	C	*/-TT	228	7	2.82%	2	2	93	93	0.007466423838535645	1	1	153	75	6	1	-T
E2_BC50_191109_LF_LIB_consensus_vsearch	2504	T	*/+G	237	8	3.24%	2	2	93	93	0.003686009667588161	1	1	163	74	1	7	+G
E2_BC50_191109_LF_LIB_consensus_vsearch	2505	G	*/-A	239	7	2.82%	2	1	93	93	0.0074817700326852326	1	1	157	82	7	0	-A
E2_BC50_191109_LF_LIB_consensus_vsearch	2513	A	*/-T	235	7	2.83%	2	2	93	93	0.007476349629382664	1	1	161	74	1	6	-T
E2_BC50_191109_LF_LIB_consensus_vsearch	2517	A	*/-CA	216	23	9.43%	2	2	93	93	6.838966941093143E-8	1	1	144	72	16	7	-CA
E2_BC50_191109_LF_LIB_consensus_vsearch	2522	A	*/-CA	217	19	7.66%	2	1	93	93	1.3080569041578427E-6	1	1	139	78	19	0	-CA
E2_BC50_191109_LF_LIB_consensus_vsearch	2524	A	*/+T	207	8	3.56%	2	2	93	93	0.003655753662936563	1	1	133	74	4	4	+T
E2_BC50_191109_LF_LIB_consensus_vsearch	2524	A	*/-T	207	7	3.11%	2	2	93	93	0.007432788253078562	1	1	133	74	5	2	+T
E2_BC50_191109_LF_LIB_consensus_vsearch	2563	G	+A/+A	49	191	77.64%	2	2	93	93	7.397255693566797E-88	1	1	44	5	116	75	+A
E2_BC50_191109_LF_LIB_consensus_vsearch	2566	G	*/+A	42	144	58.06%	2	2	93	93	3.438199164866272E-65	1	1	40	2	94	50	+A
E2_BC50_191109_LF_LIB_consensus_vsearch	2598	T	*/-AT	230	14	5.65%	2	2	93	93	5.038248401810262E-5	1	1	156	74	8	6	-AT
E2_BC50_191109_LF_LIB_consensus_vsearch	2605	T	*/+A	219	8	3.27%	2	1	93	93	0.0036688013849068284	1	1	142	77	8	0	+A
E2_BC50_191109_LF_LIB_consensus_vsearch	2605	T	*/-A	219	10	4.08%	2	2	93	93	8.833283118953115E-4	1	1	142	77	9	1	-A
E2_BC50_191109_LF_LIB_consensus_vsearch	2607	A	*/-G	230	10	4.1%	2	1	93	93	8.874830704141458E-4	1	1	151	79	10	0	-G
E2_BC50_191109_LF_LIB_consensus_vsearch	2627	G	*/-C	235	9	3.64%	2	1	93	93	0.0018118503395958998	1	1	154	81	9	0	-C
E2_BC50_191109_LF_LIB_consensus_vsearch	2633	G	*/-C	220	15	6.22%	2	2	93	93	2.423379894583162E-5	1	1	155	65	3	12	-C
E2_BC50_191109_LF_LIB_consensus_vsearch	2635	C	*/-T	220	10	4.07%	2	1	93	93	8.837219519630479E-4	1	1	160	60	0	10	-T
E2_BC50_191109_LF_LIB_consensus_vsearch	2636	T	*/-C	219	11	4.68%	2	2	93	93	4.3204184318133837E-4	1	1	161	58	1	10	-C
E2_BC50_191109_LF_LIB_consensus_vsearch	2644	C	*/-T	236	7	2.85%	2	2	93	93	0.007477721316805575	1	1	158	78	5	2	-T
E2_BC50_191109_LF_LIB_consensus_vsearch	2658	C	*/-A	226	7	2.9%	2	2	93	93	0.007463479333376833	1	1	154	72	4	3	-A
E2_BC50_191109_LF_LIB_consensus_vsearch	2664	G	*/+A	51	118	50%	1	2	93	93	1.420340260529165E-50	1	1	51	0	41	77	+A
E2_BC50_191109_LF_LIB_consensus_vsearch	2669	T	*/-CC	216	18	7.35%	2	1	93	93	2.715982290125382E-6	1	1	135	81	18	0	-CC
E2_BC50_191109_LF_LIB_consensus_vsearch	2681	A	*/-T	216	10	4.22%	2	2	93	93	8.821271222096345E-4	1	1	141	75	8	2	-T
E2_BC50_191109_LF_LIB_consensus_vsearch	2685	T	*/+C	239	7	2.83%	2	1	93	93	0.0074817700326852326	1	1	158	81	7	0	+C
E2_BC50_191109_LF_LIB_consensus_vsearch	2686	C	*/-A	236	9	3.63%	2	2	93	93	0.0018124155419458562	1	1	156	80	8	1	-A
E2_BC50_191109_LF_LIB_consensus_vsearch	2690	T	*/-C	215	25	10.12%	2	1	93	93	1.541980020120082E-8	1	1	133	82	25	0	-C
E2_BC50_191109_LF_LIB_consensus_vsearch	2717	A	*/-G	216	10	4.26%	2	2	93	93	8.821271222096345E-4	1	1	155	61	5	5	-G
E2_BC50_191109_LF_LIB_consensus_vsearch	2726	C	*/-GC	164	67	27.46%	2	2	93	93	2.4634698312139095E-23	1	1	115	49	39	28	-GC
E2_BC50_191109_LF_LIB_consensus_vsearch	2728	C	*/-T	160	9	5.14%	2	2	93	93	0.001750956793192828	1	1	115	45	5	4	-T
E2_BC50_191109_LF_LIB_consensus_vsearch	2732	A	*/-C	233	11	4.45%	2	1	93	93	4.351536507121341E-4	1	1	152	81	11	0	-C
E2_BC50_191109_LF_LIB_consensus_vsearch	2733	C	*/+A	57	42	17.87%	2	2	93	93	8.682341969292357E-16	1	1	44	13	27	15	+A
E2_BC50_191109_LF_LIB_consensus_vsearch	2733	C	*/+AC	57	129	54.89%	2	2	93	93	4.665022112440456E-55	1	1	44	13	80	49	+AC
E2_BC50_191109_LF_LIB_consensus_vsearch	2735	C	*/+T	219	14	5.67%	2	2	93	93	4.9914697602419593E-5	1	1	156	63	1	13	+T
E2_BC50_191109_LF_LIB_consensus_vsearch	2739	T	*/+C	230	8	3.25%	2	2	93	93	0.0036796224538833875	1	1	159	71	5	3	+C
E2_BC50_191109_LF_LIB_consensus_vsearch	2747	G	*/-TG	219	15	6.12%	2	2	93	93	2.4209162755784478E-5	1	1	144	75	12	3	-TG
E2_BC50_191109_LF_LIB_consensus_vsearch	2749	G	*/+A	211	7	3.07%	2	2	93	93	0.007439689863414905	1	1	145	66	1	6	+A
E2_BC50_191109_LF_LIB_consensus_vsearch	2749	G	*/-A	211	7	3.07%	2	2	93	93	0.007439689863414905	1	1	145	66	3	4	+A
E2_BC50_191109_LF_LIB_consensus_vsearch	2755	C	*/+G	196	8	3.43%	2	2	93	93	0.0036424672415343016	1	1	148	48	5	3	+G
E2_BC50_191109_LF_LIB_consensus_vsearch	2755	C	*/-G	196	17	7.3%	2	2	93	93	5.472889986979232E-6	1	1	148	48	1	16	-G
E2_BC50_191109_LF_LIB_consensus_vsearch	2760	C	*/-G	178	33	13.58%	2	2	93	93	2.996425916922213E-11	1	1	132	46	25	8	-G
E2_BC50_191109_LF_LIB_consensus_vsearch	2760	C	*/-GG	178	18	7.41%	2	2	93	93	2.5349365835156024E-6	1	1	132	46	2	16	-G
E2_BC50_191109_LF_LIB_consensus_vsearch	2763	G	*/+A	206	9	3.72%	2	1	93	93	0.001793225137980622	1	1	133	73	9	0	+A
E2_BC50_191109_LF_LIB_consensus_vsearch	2767	T	*/-AA	221	7	2.9%	2	1	93	93	0.007455894130096957	1	1	151	70	0	7	-AA
E2_BC50_191109_LF_LIB_consensus_vsearch	2770	G	*/-C	199	17	7.2%	2	2	93	93	5.499221151421095E-6	1	1	138	61	3	14	-C
E2_BC50_191109_LF_LIB_consensus_vsearch	2771	C	*/+T	209	7	3.18%	2	1	93	93	0.007436270701269745	1	1	156	53	0	7	+T
E2_BC50_191109_LF_LIB_consensus_vsearch	2773	C	*/-TC	235	11	4.44%	2	1	93	93	4.3557033390967853E-4	1	1	166	69	0	11	-TC
E2_BC50_191109_LF_LIB_consensus_vsearch	2774	T	*/-C	223	8	3.38%	2	2	93	93	0.0036728538094896964	1	1	159	64	1	7	-C
E2_BC50_191109_LF_LIB_consensus_vsearch	2780	C	*/-A	215	16	6.48%	2	2	93	93	1.1662109220663649E-5	1	1	153	62	6	10	-A
E2_BC50_191109_LF_LIB_consensus_vsearch	2788	G	*/-TG	231	7	2.85%	2	2	93	93	0.007470748618496003	1	1	152	79	6	1	-TG
E2_BC50_191109_LF_LIB_consensus_vsearch	2795	T	*/-G	232	7	2.86%	2	2	93	93	0.007472166294706969	1	1	154	78	4	3	-G
E2_BC50_191109_LF_LIB_consensus_vsearch	2804	G	*/-A	197	45	18.37%	2	1	93	93	2.9764529146901247E-15	1	1	115	82	45	0	-A
E2_BC50_191109_LF_LIB_consensus_vsearch	2806	A	*/-G	187	49	20%	2	2	93	93	1.0987715463966233E-16	1	1	117	70	40	9	-G
E2_BC50_191109_LF_LIB_consensus_vsearch	2809	G	*/-A	236	8	3.27%	2	2	93	93	0.0036851193347710583	1	1	157	79	7	1	-A
E2_BC50_191109_LF_LIB_consensus_vsearch	2812	T	*/-A	233	10	4.05%	2	2	93	93	8.885527375126605E-4	1	1	155	78	6	4	-A
E2_BC50_191109_LF_LIB_consensus_vsearch	2824	C	*/+T	193	8	3.25%	2	1	93	93	0.003638595561901328	1	1	134	59	8	0	+T
E2_BC50_191109_LF_LIB_consensus_vsearch	2824	C	*/-T	193	37	15.04%	2	2	93	93	1.5068420072513817E-12	1	1	134	59	17	20	-T
E2_BC50_191109_LF_LIB_consensus_vsearch	2831	C	*/+G	179	8	3.25%	2	1	93	93	0.0036189151712300786	1	1	100	79	8	0	+G
E2_BC50_191109_LF_LIB_consensus_vsearch	2831	C	*/-AC	179	51	20.73%	2	1	93	93	1.95805667906443E-17	1	1	100	79	51	0	-AC
E2_BC50_191109_LF_LIB_consensus_vsearch	2841	T	*/+C	186	9	3.72%	2	2	93	93	0.0017772348172719874	1	1	130	56	8	1	+C
E2_BC50_191109_LF_LIB_consensus_vsearch	2841	T	*/-C	186	43	17.77%	2	2	93	93	1.2888823337018511E-14	1	1	130	56	24	19	-C
E2_BC50_191109_LF_LIB_consensus_vsearch	2845	C	*/+T	221	7	2.82%	2	1	93	93	0.007455894130096957	1	1	159	62	0	7	+T
E2_BC50_191109_LF_LIB_consensus_vsearch	2845	C	*/-A	221	7	2.82%	2	2	93	93	0.007455894130096957	1	1	159	62	6	1	+T
E2_BC50_191109_LF_LIB_consensus_vsearch	2850	C	*/-GC	223	15	6.17%	2	2	93	93	2.4306571682594968E-5	1	1	152	71	7	8	-GC
E2_BC50_191109_LF_LIB_consensus_vsearch	2855	T	*/+G	220	12	4.9%	2	1	93	93	2.1100303986498742E-4	1	1	156	64	0	12	+G
E2_BC50_191109_LF_LIB_consensus_vsearch	2862	C	*/-T	223	9	3.64%	2	2	93	93	0.0018046959863042469	1	1	151	72	5	4	-T
E2_BC50_191109_LF_LIB_consensus_vsearch	2864	T	*/-C	222	8	3.32%	2	2	93	93	0.0036718537228742883	1	1	149	73	5	3	-C
E2_BC50_191109_LF_LIB_consensus_vsearch	2867	G	*/-C	231	9	3.67%	2	1	93	93	0.0018095434033127298	1	1	151	80	9	0	-C
E2_BC50_191109_LF_LIB_consensus_vsearch	2887	C	*/-TT	215	21	8.57%	2	2	93	93	2.994356366197985E-7	1	1	150	65	11	10	-TT
E2_BC50_191109_LF_LIB_consensus_vsearch	2897	C	*/-A	237	9	3.66%	2	2	93	93	0.0018129762417955753	1	1	157	80	7	2	-A
E2_BC50_191109_LF_LIB_consensus_vsearch	2926	C	*/-G	219	18	7.44%	2	2	93	93	2.7281420824837606E-6	1	1	142	77	15	3	-G
E2_BC50_191109_LF_LIB_consensus_vsearch	2938	T	*/-AC	225	9	3.69%	2	2	93	93	0.0018059382541162866	1	1	147	78	8	1	-AC
E2_BC50_191109_LF_LIB_consensus_vsearch	2943	C	*/-T	223	7	2.88%	2	2	93	93	0.007458967428082863	1	1	145	78	5	2	-T
E2_BC50_191109_LF_LIB_consensus_vsearch	2946	G	*/-TA	229	9	3.73%	2	1	93	93	0.0018083614623809116	1	1	149	80	9	0	-TA
E2_BC50_191109_LF_LIB_consensus_vsearch	2954	T	*/+C	228	7	2.89%	2	1	93	93	0.007466423838535645	1	1	156	72	7	0	+C
E2_BC50_191109_LF_LIB_consensus_vsearch	2956	T	*/-A	223	8	3.35%	2	2	93	93	0.0036728538094896964	1	1	150	73	7	1	-A
E2_BC50_191109_LF_LIB_consensus_vsearch	2972	A	*/+G	234	7	2.85%	2	1	93	93	0.007474966656828971	1	1	154	80	7	0	+G
E2_BC50_191109_LF_LIB_consensus_vsearch	2974	A	*/-GA	204	29	12.03%	2	2	93	93	7.359019144785383E-10	1	1	138	66	14	15	-GA
E2_BC50_191109_LF_LIB_consensus_vsearch	2977	C	*/-T	230	7	2.86%	2	2	93	93	0.0074693190837354945	1	1	161	69	3	4	-T
E2_BC50_191109_LF_LIB_consensus_vsearch	2979	T	*/-C	222	8	3.28%	2	2	93	93	0.0036718537228742883	1	1	156	66	1	7	-C
E2_BC50_191109_LF_LIB_consensus_vsearch	2980	C	*/-TC	223	8	3.38%	2	2	93	93	0.0036728538094896964	1	1	159	64	2	6	-TC
E2_BC50_191109_LF_LIB_consensus_vsearch	2981	T	*/+C	221	8	3.36%	2	1	93	93	0.003670845031231652	1	1	148	73	8	0	+C
E2_BC50_191109_LF_LIB_consensus_vsearch	2984	A	*/+C	162	7	2.86%	2	2	93	93	0.007332911989892741	1	1	118	44	5	2	+C
E2_BC50_191109_LF_LIB_consensus_vsearch	2984	A	*/-C	162	45	18.37%	2	2	93	93	1.9374023199453137E-15	1	1	118	44	15	30	-C
E2_BC50_191109_LF_LIB_consensus_vsearch	2984	A	*/-CC	162	7	2.86%	2	2	93	93	0.007332911989892741	1	1	118	44	4	3	-C
E2_BC50_191109_LF_LIB_consensus_vsearch	2984	A	*/-CCC	162	7	2.86%	2	2	93	93	0.007332911989892741	1	1	118	44	5	2	-C
E2_BC50_191109_LF_LIB_consensus_vsearch	2988	C	*/+T	200	30	12.2%	2	2	93	93	3.3878376895849755E-10	1	1	128	72	27	3	+T
E2_BC50_191109_LF_LIB_consensus_vsearch	2989	C	*/-T	191	41	16.67%	2	2	93	93	6.540099396646005E-14	1	1	118	73	33	8	-T
E2_BC50_191109_LF_LIB_consensus_vsearch	2989	C	*/-TC	191	10	4.07%	2	1	93	93	8.707701860076834E-4	1	1	118	73	10	0	-T
E2_BC50_191109_LF_LIB_consensus_vsearch	2990	T	*/+C	112	55	28.5%	2	2	93	93	1.3215328790463906E-19	1	1	55	57	45	10	+C
E2_BC50_191109_LF_LIB_consensus_vsearch	2990	T	*/+CC	112	12	6.22%	2	2	93	93	1.8466917912817257E-4	1	1	55	57	10	2	+C
E2_BC50_191109_LF_LIB_consensus_vsearch	2990	T	*/-C	112	8	4.15%	2	2	93	93	0.0034629730479968997	1	1	55	57	5	3	+C
E2_BC50_191109_LF_LIB_consensus_vsearch	2994	C	*/+T	230	10	4.05%	2	1	93	93	8.874830704141458E-4	1	1	163	67	0	10	+T
E2_BC50_191109_LF_LIB_consensus_vsearch	3001	A	*/-G	220	16	6.5%	2	2	93	93	1.1731010954670857E-5	1	1	150	70	7	9	-G
E2_BC50_191109_LF_LIB_consensus_vsearch	3016	A	*/-T	235	7	2.82%	2	1	93	93	0.007476349629382664	1	1	160	75	0	7	-T
E2_BC50_191109_LF_LIB_consensus_vsearch	3017	T	*/-C	227	12	4.98%	2	1	93	93	2.1192896510056628E-4	1	1	152	75	12	0	-C
E2_BC50_191109_LF_LIB_consensus_vsearch	3022	C	*/-T	234	8	3.27%	2	2	93	93	0.00368331690336814	1	1	162	72	2	6	-T
E2_BC50_191109_LF_LIB_consensus_vsearch	3024	T	*/+C	212	9	3.63%	2	2	93	93	0.00179747064240055	1	1	154	58	4	5	+C
E2_BC50_191109_LF_LIB_consensus_vsearch	3024	T	*/-C	212	17	6.85%	2	2	93	93	5.606330650645509E-6	1	1	154	58	5	12	-C
E2_BC50_191109_LF_LIB_consensus_vsearch	3027	T	*/-C	228	7	2.92%	2	2	93	93	0.007466423838535645	1	1	158	70	2	5	-C
E2_BC50_191109_LF_LIB_consensus_vsearch	3028	C	*/-A	215	22	9.17%	2	1	93	93	1.4307072701069838E-7	1	1	139	76	22	0	-A
E2_BC50_191109_LF_LIB_consensus_vsearch	3029	A	*/-C	210	7	3.12%	2	1	93	93	0.007437988084800957	1	1	130	80	7	0	-C
E2_BC50_191109_LF_LIB_consensus_vsearch	3031	C	*/-AA	228	7	2.83%	2	2	93	93	0.007466423838535645	1	1	153	75	2	5	-AA
E2_BC50_191109_LF_LIB_consensus_vsearch	3039	T	*/-C	224	18	7.26%	2	2	93	93	2.7478272386502084E-6	1	1	161	63	1	17	-C
E2_BC50_191109_LF_LIB_consensus_vsearch	3064	G	*/-T	209	34	13.82%	2	2	93	93	1.6829019354286142E-11	1	1	149	60	16	18	-T
E2_BC50_191109_LF_LIB_consensus_vsearch	3065	T	+G/+G	1	195	91.55%	1	2	93	93	4.84939847024578E-115	1	1	1	0	140	55	+G
E2_BC50_191109_LF_LIB_consensus_vsearch	3065	T	*/+GTG	1	5	2.35%	1	2	93	93	0.007575757575757551	1	1	1	0	4	1	+G
E2_BC50_191109_LF_LIB_consensus_vsearch	3068	C	*/+A	187	7	2.85%	2	2	93	93	0.007394057154213738	1	1	115	72	6	1	+A
E2_BC50_191109_LF_LIB_consensus_vsearch	3068	C	*/-A	187	40	16.26%	2	2	93	93	1.38137361282474E-13	1	1	115	72	37	3	-A
E2_BC50_191109_LF_LIB_consensus_vsearch	3071	A	*/-G	234	8	3.23%	2	2	93	93	0.00368331690336814	1	1	158	76	6	2	-G
E2_BC50_191109_LF_LIB_consensus_vsearch	3072	G	*/+A	223	9	3.77%	2	1	93	93	0.0018046959863042469	1	1	148	75	9	0	+A
E2_BC50_191109_LF_LIB_consensus_vsearch	3073	G	*/+A	199	25	10.12%	2	1	93	93	1.4670068930690744E-8	1	1	118	81	25	0	+A
E2_BC50_191109_LF_LIB_consensus_vsearch	3075	C	*/+G	220	14	5.67%	2	1	93	93	4.995890859598848E-5	1	1	140	80	14	0	+G
E2_BC50_191109_LF_LIB_consensus_vsearch	3076	A	*/+G	185	7	2.92%	2	2	93	93	0.007389745092191117	1	1	129	56	6	1	+G
E2_BC50_191109_LF_LIB_consensus_vsearch	3076	A	*/-G	185	40	16.67%	2	2	93	93	1.356160251041353E-13	1	1	129	56	16	24	-G
E2_BC50_191109_LF_LIB_consensus_vsearch	3091	G	*/-TG	233	10	4.05%	2	2	93	93	8.885527375126605E-4	1	1	161	72	1	9	-TG
E2_BC50_191109_LF_LIB_consensus_vsearch	3092	T	*/-G	216	15	6.3%	2	2	93	93	2.4134087137185156E-5	1	1	150	66	10	5	-G
E2_BC50_191109_LF_LIB_consensus_vsearch	3102	A	*/+C	224	12	4.92%	2	1	93	93	2.1153854171006224E-4	1	1	144	80	12	0	+C
E2_BC50_191109_LF_LIB_consensus_vsearch	3105	C	*/-A	227	13	5.28%	2	1	93	93	1.033098399812127E-4	1	1	149	78	13	0	-A
E2_BC50_191109_LF_LIB_consensus_vsearch	3107	C	*/-A	223	7	2.85%	2	2	93	93	0.007458967428082863	1	1	145	78	5	2	-A
E2_BC50_191109_LF_LIB_consensus_vsearch	3109	A	*/-T	227	7	2.87%	2	2	93	93	0.0074649578216797186	1	1	152	75	2	5	-T
E2_BC50_191109_LF_LIB_consensus_vsearch	3113	C	*/-G	221	9	3.75%	2	1	93	93	0.001803432580702911	1	1	146	75	9	0	-G
E2_BC50_191109_LF_LIB_consensus_vsearch	3115	A	*/-G	221	15	6.22%	2	1	93	93	2.4258244372323037E-5	1	1	143	78	15	0	-G
E2_BC50_191109_LF_LIB_consensus_vsearch	3117	G	*/+AG	228	8	3.27%	2	1	93	93	0.00367772893957288	1	1	149	79	8	0	+AG
E2_BC50_191109_LF_LIB_consensus_vsearch	3121	T	*/+C	97	142	57.96%	2	2	93	93	8.371086327297041E-57	1	1	91	6	72	70	+C
E2_BC50_191109_LF_LIB_consensus_vsearch	3129	C	*/-A	227	7	2.85%	2	1	93	93	0.0074649578216797186	1	1	149	78	7	0	-A
E2_BC50_191109_LF_LIB_consensus_vsearch	3132	G	*/-A	236	7	2.85%	2	1	93	93	0.007477721316805575	1	1	155	81	7	0	-A
E2_BC50_191109_LF_LIB_consensus_vsearch	3141	T	*/+C	235	8	3.24%	2	1	93	93	0.003684221776127662	1	1	154	81	8	0	+C
E2_BC50_191109_LF_LIB_consensus_vsearch	3142	C	*/-A	220	12	4.92%	2	1	93	93	2.1100303986498742E-4	1	1	139	81	12	0	-A
E2_BC50_191109_LF_LIB_consensus_vsearch	3142	C	*/-ACA	220	7	2.87%	2	1	93	93	0.007454337359329176	1	1	139	81	7	0	-A
E2_BC50_191109_LF_LIB_consensus_vsearch	3144	C	*/-A	176	29	12.34%	2	2	93	93	6.419707547610548E-10	1	1	103	73	25	4	-A
E2_BC50_191109_LF_LIB_consensus_vsearch	3144	C	*/-AA	176	9	3.83%	2	2	93	93	0.001767978203561041	1	1	103	73	7	2	-A
E2_BC50_191109_LF_LIB_consensus_vsearch	3154	T	*/-C	214	29	11.74%	2	2	93	93	7.664332129830562E-10	1	1	140	74	22	7	-C
E2_BC50_191109_LF_LIB_consensus_vsearch	3163	C	*/+A	225	13	5.26%	2	2	93	93	1.0316114131630932E-4	1	1	147	78	12	1	+A
E2_BC50_191109_LF_LIB_consensus_vsearch	3164	G	*/-A	225	17	6.94%	2	1	93	93	5.7032680908834166E-6	1	1	143	82	17	0	-A
E2_BC50_191109_LF_LIB_consensus_vsearch	3168	G	*/-CG	229	15	6.05%	2	2	93	93	2.4447196886404097E-5	1	1	161	68	1	14	-CG
E2_BC50_191109_LF_LIB_consensus_vsearch	3175	C	*/-A	196	40	16.26%	2	1	93	93	1.494419848126757E-13	1	1	117	79	40	0	-A
E2_BC50_191109_LF_LIB_consensus_vsearch	3176	A	*/-CA	171	9	4.41%	2	1	93	93	0.0017629749665283802	1	1	100	71	0	9	-CA
E2_BC50_191109_LF_LIB_consensus_vsearch	3177	C	*/+T	174	9	3.88%	2	1	93	93	0.0017660088144097936	1	1	102	72	9	0	+T
E2_BC50_191109_LF_LIB_consensus_vsearch	3178	A	*/-G	178	8	3.38%	2	2	93	93	0.0036173981471315664	1	1	112	66	6	2	-G
E2_BC50_191109_LF_LIB_consensus_vsearch	3181	A	*/-T	231	9	3.73%	2	2	93	93	0.0018095434033127298	1	1	150	81	8	1	-T
E2_BC50_191109_LF_LIB_consensus_vsearch	3183	T	*/-AC	237	9	3.64%	2	1	93	93	0.0018129762417955753	1	1	156	81	9	0	-AC
E2_BC50_191109_LF_LIB_consensus_vsearch	3184	A	*/-C	221	11	4.62%	2	2	93	93	4.3250849347899065E-4	1	1	142	79	9	2	-C
E2_BC50_191109_LF_LIB_consensus_vsearch	3187	C	*/-A	219	11	4.44%	2	2	93	93	4.3204184318133837E-4	1	1	158	61	3	8	-A
E2_BC50_191109_LF_LIB_consensus_vsearch	3192	C	*/+T	234	7	2.83%	2	1	93	93	0.007474966656828971	1	1	165	69	0	7	+T
E2_BC50_191109_LF_LIB_consensus_vsearch	3194	C	*/-TC	222	17	7%	2	2	93	93	5.681724827274391E-6	1	1	159	63	6	11	-TC
E2_BC50_191109_LF_LIB_consensus_vsearch	3199	C	*/+A	98	138	56.33%	2	2	93	93	6.5063103753798324E-55	1	1	96	2	62	76	+A
E2_BC50_191109_LF_LIB_consensus_vsearch	3201	A	*/+G	224	16	6.45%	2	1	93	93	1.1784271864232843E-5	1	1	146	78	16	0	+G
E2_BC50_191109_LF_LIB_consensus_vsearch	3208	T	*/-A	231	10	4.05%	2	1	93	93	8.878425014170833E-4	1	1	152	79	10	0	-A
E2_BC50_191109_LF_LIB_consensus_vsearch	3209	A	*/-C	204	17	7.26%	2	2	93	93	5.541719766097385E-6	1	1	128	76	13	4	-C
E2_BC50_191109_LF_LIB_consensus_vsearch	3223	T	*/+C	232	7	2.87%	2	1	93	93	0.007472166294706969	1	1	158	74	7	0	+C
E2_BC50_191109_LF_LIB_consensus_vsearch	3227	T	*/-G	228	8	3.25%	2	2	93	93	0.00367772893957288	1	1	155	73	7	1	-G
E2_BC50_191109_LF_LIB_consensus_vsearch	3235	G	*/-CG	182	54	22.59%	2	2	93	93	1.8001320689748625E-18	1	1	129	53	30	24	-CG
E2_BC50_191109_LF_LIB_consensus_vsearch	3242	G	*/-C	225	9	3.69%	2	1	93	93	0.0018059382541162866	1	1	143	82	9	0	-C
E2_BC50_191109_LF_LIB_consensus_vsearch	3246	A	*/-G	226	12	4.92%	2	1	93	93	2.1179986535711708E-4	1	1	157	69	0	12	-G
E2_BC50_191109_LF_LIB_consensus_vsearch	3252	T	*/+C	235	9	3.64%	2	1	93	93	0.0018118503395958998	1	1	154	81	9	0	+C
E2_BC50_191109_LF_LIB_consensus_vsearch	3254	T	*/+A	216	13	5.37%	2	1	93	93	1.0246182731202857E-4	1	1	141	75	13	0	+A
E2_BC50_191109_LF_LIB_consensus_vsearch	3256	A	*/-G	225	10	4.07%	2	2	93	93	8.856413612935507E-4	1	1	151	74	5	5	-G
E2_BC50_191109_LF_LIB_consensus_vsearch	3272	G	*/-T	233	10	4.03%	2	2	93	93	8.885527375126605E-4	1	1	155	78	7	3	-T
E2_BC50_191109_LF_LIB_consensus_vsearch	3274	T	*/-A	212	20	8.2%	2	1	93	93	6.218749809509289E-7	1	1	136	76	20	0	-A
E2_BC50_191109_LF_LIB_consensus_vsearch	3274	T	*/-ATT	212	7	2.87%	2	2	93	93	0.00744137624879223	1	1	136	76	6	1	-A
E2_BC50_191109_LF_LIB_consensus_vsearch	3280	C	*/+G	233	8	3.24%	2	2	93	93	0.0036824046267336483	1	1	154	79	7	1	+G
E2_BC50_191109_LF_LIB_consensus_vsearch	3281	A	*/-G	231	10	4.07%	2	1	93	93	8.878425014170833E-4	1	1	152	79	10	0	-G
E2_BC50_191109_LF_LIB_consensus_vsearch	3285	A	*/-C	235	7	2.85%	2	2	93	93	0.007476349629382664	1	1	163	72	1	6	-C
E2_BC50_191109_LF_LIB_consensus_vsearch	3291	A	*/-C	210	28	11.34%	2	2	93	93	1.6028891907036817E-9	1	1	133	77	23	5	-C
E2_BC50_191109_LF_LIB_consensus_vsearch	3292	C	*/+T	203	8	3.67%	2	1	93	93	0.0036510799339400076	1	1	137	66	0	8	+T
E2_BC50_191109_LF_LIB_consensus_vsearch	3303	G	*/-CG	229	10	4.07%	2	2	93	93	8.87120717393791E-4	1	1	157	72	2	8	-CG
E2_BC50_191109_LF_LIB_consensus_vsearch	3311	T	*/+C	227	8	3.24%	2	1	93	93	0.003676770270380206	1	1	147	80	8	0	+C
E2_BC50_191109_LF_LIB_consensus_vsearch	3311	T	*/-C	227	7	2.83%	2	1	93	93	0.0074649578216797186	1	1	147	80	7	0	+C
E2_BC50_191109_LF_LIB_consensus_vsearch	3313	C	*/+A	216	7	2.86%	2	2	93	93	0.007447971960236055	1	1	144	72	6	1	+A
E2_BC50_191109_LF_LIB_consensus_vsearch	3314	G	*/+C	200	10	4.17%	2	1	93	93	8.751600144021374E-4	1	1	121	79	10	0	+C
E2_BC50_191109_LF_LIB_consensus_vsearch	3323	G	*/+A	226	11	4.45%	2	1	93	93	4.336419657096737E-4	1	1	146	80	11	0	+A
E2_BC50_191109_LF_LIB_consensus_vsearch	3328	C	*/-G	228	7	2.86%	2	2	93	93	0.007466423838535645	1	1	155	73	1	6	-G
E2_BC50_191109_LF_LIB_consensus_vsearch	3332	C	*/+T	236	7	2.83%	2	2	93	93	0.007477721316805575	1	1	163	73	1	6	+T
E2_BC50_191109_LF_LIB_consensus_vsearch	3335	A	*/-T	215	14	5.76%	2	2	93	93	4.973428022334695E-5	1	1	141	74	13	1	-T
E2_BC50_191109_LF_LIB_consensus_vsearch	3338	T	*/+C	229	9	3.66%	2	2	93	93	0.0018083614623809116	1	1	154	75	7	2	+C
E2_BC50_191109_LF_LIB_consensus_vsearch	3345	T	*/+C	231	13	5.24%	2	1	93	93	1.0360034592464177E-4	1	1	149	82	13	0	+C
E2_BC50_191109_LF_LIB_consensus_vsearch	3347	A	*/-G	223	18	7.38%	2	1	93	93	2.7439468789888166E-6	1	1	143	80	18	0	-G
E2_BC50_191109_LF_LIB_consensus_vsearch	3353	T	*/-C	219	12	5%	2	2	93	93	2.10866409362083E-4	1	1	142	77	11	1	-C
E2_BC50_191109_LF_LIB_consensus_vsearch	3357	C	*/-AC	214	27	11.02%	2	1	93	93	3.4462131426831007E-9	1	1	134	80	27	0	-AC
E2_BC50_191109_LF_LIB_consensus_vsearch	3359	C	*/-G	200	10	4.59%	2	1	93	93	8.751600144021374E-4	1	1	120	80	10	0	-G
E2_BC50_191109_LF_LIB_consensus_vsearch	3360	G	*/-A	216	17	7.17%	2	2	93	93	5.6371721310563775E-6	1	1	136	80	16	1	-A
E2_BC50_191109_LF_LIB_consensus_vsearch	3369	T	*/+C	91	140	56.68%	2	2	93	93	2.043073081345369E-56	1	1	79	12	80	60	+C
E2_BC50_191109_LF_LIB_consensus_vsearch	3369	T	*/+CCC	91	8	3.24%	2	2	93	93	0.0033721799226566103	1	1	79	12	2	6	+C
E2_BC50_191109_LF_LIB_consensus_vsearch	3370	C	*/+A	228	19	7.66%	2	2	93	93	1.3310955951274927E-6	1	1	156	72	10	9	+A
E2_BC50_191109_LF_LIB_consensus_vsearch	3371	C	*/+A	37	8	3.23%	2	2	93	93	0.002780774624353704	1	1	23	14	5	3	+A
E2_BC50_191109_LF_LIB_consensus_vsearch	3371	C	+AC/+AC	37	191	77.02%	2	2	93	93	3.4206966411720923E-91	1	1	23	14	128	63	+AC
E2_BC50_191109_LF_LIB_consensus_vsearch	3376	A	*/-G	231	7	2.87%	2	1	93	93	0.007470748618496003	1	1	152	79	7	0	-G
E2_BC50_191109_LF_LIB_consensus_vsearch	3377	G	*/-C	201	15	6.3%	2	2	93	93	2.373037043728608E-5	1	1	122	79	14	1	-C
E2_BC50_191109_LF_LIB_consensus_vsearch	3379	C	*/-G	202	18	7.29%	2	2	93	93	2.655487106225235E-6	1	1	130	72	17	1	-G
E2_BC50_191109_LF_LIB_consensus_vsearch	3379	C	*/-GA	202	13	5.26%	2	2	93	93	1.0126524414330837E-4	1	1	130	72	12	1	-G
E2_BC50_191109_LF_LIB_consensus_vsearch	3380	G	*/-A	201	10	4.65%	2	2	93	93	8.756254095238223E-4	1	1	124	77	9	1	-A
E2_BC50_191109_LF_LIB_consensus_vsearch	3385	T	*/+C	228	12	4.96%	2	1	93	93	2.1205703996137238E-4	1	1	150	78	12	0	+C
E2_BC50_191109_LF_LIB_consensus_vsearch	3386	C	*/+A	215	8	3.24%	2	1	93	93	0.0036646057936482192	1	1	135	80	8	0	+A
E2_BC50_191109_LF_LIB_consensus_vsearch	3386	C	*/-GA	215	10	4.05%	2	2	93	93	8.817198236951184E-4	1	1	135	80	8	2	-GA
E2_BC50_191109_LF_LIB_consensus_vsearch	3392	C	*/-AC	229	11	4.51%	2	2	93	93	4.343002259471887E-4	1	1	150	79	10	1	-AC
E2_BC50_191109_LF_LIB_consensus_vsearch	3406	A	*/-C	223	7	2.87%	2	2	93	93	0.007458967428082863	1	1	145	78	4	3	-C
E2_BC50_191109_LF_LIB_consensus_vsearch	3407	C	*/+T	222	9	3.81%	2	1	93	93	0.001804066959286255	1	1	153	69	0	9	+T
E2_BC50_191109_LF_LIB_consensus_vsearch	3410	G	*/-A	207	32	13.11%	2	1	93	93	7.659466202251093E-11	1	1	128	79	32	0	-A
E2_BC50_191109_LF_LIB_consensus_vsearch	3412	A	*/-G	214	29	11.74%	2	1	93	93	7.664332129830562E-10	1	1	135	79	29	0	-G
E2_BC50_191109_LF_LIB_consensus_vsearch	3420	G	*/-CC	207	29	11.84%	2	1	93	93	7.452187626409408E-10	1	1	126	81	29	0	-CC
E2_BC50_191109_LF_LIB_consensus_vsearch	3424	G	*/+A	196	26	10.66%	2	1	93	93	6.850873449275763E-9	1	1	115	81	26	0	+A
E2_BC50_191109_LF_LIB_consensus_vsearch	3424	G	*/-A	196	19	7.79%	2	1	93	93	1.258627563292186E-6	1	1	115	81	19	0	+A
E2_BC50_191109_LF_LIB_consensus_vsearch	3426	A	*/-G	231	14	5.69%	2	2	93	93	5.0423072249628895E-5	1	1	150	81	13	1	-G
E2_BC50_191109_LF_LIB_consensus_vsearch	3431	T	*/-G	213	21	8.71%	2	2	93	93	2.981920422412607E-7	1	1	147	66	11	10	-G
E2_BC50_191109_LF_LIB_consensus_vsearch	3437	T	*/-G	219	11	4.55%	2	2	93	93	4.3204184318133837E-4	1	1	146	73	4	7	-G
E2_BC50_191109_LF_LIB_consensus_vsearch	3446	T	*/-A	216	19	7.76%	2	2	93	93	1.3058720819263143E-6	1	1	152	64	6	13	-A
E2_BC50_191109_LF_LIB_consensus_vsearch	3464	C	*/-AC	167	72	29.75%	2	2	93	93	3.809084623592575E-25	1	1	96	71	63	9	-AC
E2_BC50_191109_LF_LIB_consensus_vsearch	3467	G	*/+T	237	8	3.27%	2	1	93	93	0.003686009667588161	1	1	155	82	8	0	+T
E2_BC50_191109_LF_LIB_consensus_vsearch	3477	C	*/+T	234	7	2.83%	2	1	93	93	0.007474966656828971	1	1	162	72	0	7	+T
E2_BC50_191109_LF_LIB_consensus_vsearch	3486	T	*/+C	227	8	3.27%	2	1	93	93	0.003676770270380206	1	1	148	79	8	0	+C
E2_BC50_191109_LF_LIB_consensus_vsearch	3487	C	*/-G	227	9	3.69%	2	2	93	93	0.0018071599099638493	1	1	152	75	4	5	-G
E2_BC50_191109_LF_LIB_consensus_vsearch	3498	A	*/-G	236	8	3.24%	2	2	93	93	0.0036851193347710583	1	1	156	80	7	1	-G
E2_BC50_191109_LF_LIB_consensus_vsearch	3501	C	*/+A	216	7	2.82%	2	1	93	93	0.007447971960236055	1	1	137	79	7	0	+A
E2_BC50_191109_LF_LIB_consensus_vsearch	3501	C	*/-G	216	19	7.66%	2	1	93	93	1.3058720819263143E-6	1	1	137	79	19	0	-G
E2_BC50_191109_LF_LIB_consensus_vsearch	3514	G	*/-A	238	7	2.85%	2	1	93	93	0.007480431384223459	1	1	157	81	7	0	-A
E2_BC50_191109_LF_LIB_consensus_vsearch	3518	T	*/-A	216	11	4.55%	2	2	93	93	4.313270586514381E-4	1	1	146	70	10	1	-A
E2_BC50_191109_LF_LIB_consensus_vsearch	3539	A	*/-C	227	10	4.13%	2	2	93	93	8.863871017160644E-4	1	1	153	74	5	5	-C
E2_BC50_191109_LF_LIB_consensus_vsearch	3544	T	*/-G	232	7	2.83%	2	2	93	93	0.007472166294706969	1	1	156	76	6	1	-G
E2_BC50_191109_LF_LIB_consensus_vsearch	3556	A	*/-GA	219	23	9.35%	2	2	93	93	6.888591285553083E-8	1	1	154	65	9	14	-GA
E2_BC50_191109_LF_LIB_consensus_vsearch	3562	A	*/-TA	226	15	6.12%	2	2	93	93	2.4377685733588186E-5	1	1	151	75	9	6	-TA
E2_BC50_191109_LF_LIB_consensus_vsearch	3575	T	*/-C	223	12	4.98%	2	2	93	93	2.114062925508352E-4	1	1	153	70	7	5	-C
E2_BC50_191109_LF_LIB_consensus_vsearch	3586	T	*/-C	228	15	6.1%	2	2	93	93	2.4424201260992723E-5	1	1	148	80	14	1	-C
E2_BC50_191109_LF_LIB_consensus_vsearch	3591	T	*/-C	219	21	8.54%	2	1	93	93	3.018727139923481E-7	1	1	139	80	21	0	-C
E2_BC50_191109_LF_LIB_consensus_vsearch	3594	T	*/+G	229	9	3.69%	2	1	93	93	0.0018083614623809116	1	1	159	70	0	9	+G
E2_BC50_191109_LF_LIB_consensus_vsearch	3598	G	*/-A	238	8	3.24%	2	2	93	93	0.0036868928614731586	1	1	158	80	7	1	-A
E2_BC50_191109_LF_LIB_consensus_vsearch	3604	T	*/-C	204	36	14.52%	2	2	93	93	3.521515078250777E-12	1	1	124	80	35	1	-C
E2_BC50_191109_LF_LIB_consensus_vsearch	3612	T	*/-G	232	7	2.82%	2	1	93	93	0.007472166294706969	1	1	152	80	7	0	-G
E2_BC50_191109_LF_LIB_consensus_vsearch	3622	T	*/-A	204	9	3.63%	2	2	93	93	0.0017917580621936403	1	1	161	43	2	7	-A
E2_BC50_191109_LF_LIB_consensus_vsearch	3622	T	*/-AA	204	28	11.29%	2	1	93	93	1.5661070491200039E-9	1	1	161	43	0	28	-AA
E2_BC50_191109_LF_LIB_consensus_vsearch	3636	C	*/-AC	210	26	10.66%	2	2	93	93	7.1933750583549526E-9	1	1	133	77	25	1	-AC
E2_BC50_191109_LF_LIB_consensus_vsearch	3639	G	*/+C	228	8	3.33%	2	1	93	93	0.00367772893957288	1	1	146	82	8	0	+C
E2_BC50_191109_LF_LIB_consensus_vsearch	3642	T	*/+A	224	13	5.28%	2	1	93	93	1.0308590668956199E-4	1	1	149	75	13	0	+A
E2_BC50_191109_LF_LIB_consensus_vsearch	3644	G	*/+C	15	7	2.82%	2	1	93	93	0.004450455953575614	1	1	14	1	0	7	+C
E2_BC50_191109_LF_LIB_consensus_vsearch	3644	G	+T/+T	15	196	79.03%	2	2	93	93	2.3185113408831966E-103	1	1	14	1	128	68	+T
E2_BC50_191109_LF_LIB_consensus_vsearch	3645	T	*/+A	218	25	10.08%	2	1	93	93	1.555259269622697E-8	1	1	136	82	25	0	+A
E2_BC50_191109_LF_LIB_consensus_vsearch	3648	G	*/-C	225	13	5.26%	2	2	93	93	1.0316114131630932E-4	1	1	149	76	12	1	-C
E2_BC50_191109_LF_LIB_consensus_vsearch	3658	C	*/-A	232	9	3.66%	2	2	93	93	0.0018101271688386934	1	1	158	74	1	8	-A
E2_BC50_191109_LF_LIB_consensus_vsearch	3660	A	*/+T	229	11	4.44%	2	2	93	93	4.343002259471887E-4	1	1	160	69	4	7	+T
E2_BC50_191109_LF_LIB_consensus_vsearch	3664	C	*/-T	229	11	4.45%	2	2	93	93	4.343002259471887E-4	1	1	161	68	1	10	-T
E2_BC50_191109_LF_LIB_consensus_vsearch	3667	T	*/-A	216	12	4.86%	2	2	93	93	2.104496857598024E-4	1	1	148	68	10	2	-A
E2_BC50_191109_LF_LIB_consensus_vsearch	3667	T	*/-AA	216	12	4.86%	2	1	93	93	2.104496857598024E-4	1	1	148	68	0	12	-A
E2_BC50_191109_LF_LIB_consensus_vsearch	3673	T	*/+C	229	10	4.03%	2	2	93	93	8.87120717393791E-4	1	1	151	78	9	1	+C
E2_BC50_191109_LF_LIB_consensus_vsearch	3688	T	*/-A	232	7	2.92%	2	1	93	93	0.007472166294706969	1	1	154	78	7	0	-A
E2_BC50_191109_LF_LIB_consensus_vsearch	3689	A	*/-C	217	14	5.98%	2	2	93	93	4.982521215421391E-5	1	1	148	69	4	10	-C
E2_BC50_191109_LF_LIB_consensus_vsearch	3691	T	*/-C	17	55	22.54%	2	2	93	93	5.120409220402227E-25	1	1	7	10	41	14	-C
E2_BC50_191109_LF_LIB_consensus_vsearch	3691	T	*/-CC	17	117	47.95%	2	2	93	93	5.2698789900593626E-58	1	1	7	10	81	36	-CC
E2_BC50_191109_LF_LIB_consensus_vsearch	3691	T	*/-CCC	17	44	18.03%	2	2	93	93	1.6364689339286008E-19	1	1	7	10	27	17	-CC
E2_BC50_191109_LF_LIB_consensus_vsearch	3700	G	*/-A	228	11	4.51%	2	2	93	93	4.340825732543977E-4	1	1	149	79	10	1	-A
E2_BC50_191109_LF_LIB_consensus_vsearch	3702	G	+C/+C	50	184	75.41%	2	2	93	93	5.514420407533728E-84	1	1	46	4	109	75	+C
E2_BC50_191109_LF_LIB_consensus_vsearch	3704	C	*/-A	227	9	3.64%	2	1	93	93	0.0018071599099638493	1	1	151	76	9	0	-A
E2_BC50_191109_LF_LIB_consensus_vsearch	3711	T	*/+C	210	18	7.41%	2	1	93	93	2.6908372666736656E-6	1	1	143	67	18	0	+C
E2_BC50_191109_LF_LIB_consensus_vsearch	3711	T	*/-C	210	10	4.12%	2	1	93	93	8.796295164637225E-4	1	1	143	67	0	10	+C
E2_BC50_191109_LF_LIB_consensus_vsearch	3715	A	*/-T	232	13	5.26%	2	2	93	93	1.0367157527188826E-4	1	1	162	70	2	11	-T
E2_BC50_191109_LF_LIB_consensus_vsearch	3724	C	*/-G	227	12	4.94%	2	1	93	93	2.1192896510056628E-4	1	1	159	68	0	12	-G
E2_BC50_191109_LF_LIB_consensus_vsearch	3731	C	*/-AGC	233	10	4.03%	2	1	93	93	8.885527375126605E-4	1	1	154	79	10	0	-AGC
E2_BC50_191109_LF_LIB_consensus_vsearch	3734	C	*/+A	204	26	11.11%	2	1	93	93	7.0499754694689025E-9	1	1	126	78	26	0	+A
E2_BC50_191109_LF_LIB_consensus_vsearch	3735	G	*/-A	215	23	9.43%	2	1	93	93	6.822214666934832E-8	1	1	138	77	23	0	-A
E2_BC50_191109_LF_LIB_consensus_vsearch	3740	G	*/-A	215	22	8.87%	2	1	93	93	1.4307072701069838E-7	1	1	133	82	22	0	-A
E2_BC50_191109_LF_LIB_consensus_vsearch	3740	G	*/-AT	215	9	3.63%	2	1	93	93	0.0017995100038167202	1	1	133	82	9	0	-A
E2_BC50_191109_LF_LIB_consensus_vsearch	3744	T	*/+C	220	16	6.48%	2	2	93	93	1.1731010954670857E-5	1	1	147	73	14	2	+C
E2_BC50_191109_LF_LIB_consensus_vsearch	3745	C	*/+G	231	7	2.9%	2	2	93	93	0.007470748618496003	1	1	160	71	4	3	+G
E2_BC50_191109_LF_LIB_consensus_vsearch	3752	C	*/-A	223	8	3.23%	2	2	93	93	0.0036728538094896964	1	1	150	73	7	1	-A
E2_BC50_191109_LF_LIB_consensus_vsearch	3752	C	*/-AA	223	7	2.82%	2	2	93	93	0.007458967428082863	1	1	150	73	2	5	-A
E2_BC50_191109_LF_LIB_consensus_vsearch	3771	G	*/-T	228	14	5.69%	2	1	93	93	5.030037202373037E-5	1	1	147	81	14	0	-T
E2_BC50_191109_LF_LIB_consensus_vsearch	3797	C	*/-T	227	8	3.27%	2	2	93	93	0.003676770270380206	1	1	150	77	5	3	-T
E2_BC50_191109_LF_LIB_consensus_vsearch	3811	T	*/-C	152	64	26.23%	2	2	93	93	2.2193953313022384E-22	1	1	101	51	50	14	-C
E2_BC50_191109_LF_LIB_consensus_vsearch	3811	T	*/-CC	152	22	9.02%	2	2	93	93	1.1745012526097133E-7	1	1	101	51	9	13	-C
E2_BC50_191109_LF_LIB_consensus_vsearch	3826	T	*/-C	212	34	13.71%	2	1	93	93	1.710503124155606E-11	1	1	132	80	34	0	-C
E2_BC50_191109_LF_LIB_consensus_vsearch	3832	T	*/+C	236	9	3.64%	2	1	93	93	0.0018124155419458562	1	1	156	80	9	0	+C
E2_BC50_191109_LF_LIB_consensus_vsearch	3836	T	*/-GA	221	9	3.72%	2	1	93	93	0.001803432580702911	1	1	144	77	9	0	-GA
E2_BC50_191109_LF_LIB_consensus_vsearch	3843	G	*/-C	210	33	13.36%	2	2	93	93	3.6302598892823876E-11	1	1	146	64	18	15	-C
E2_BC50_191109_LF_LIB_consensus_vsearch	3844	C	*/+T	187	19	8.96%	2	1	93	93	1.2349038260840205E-6	1	1	144	43	0	19	+T
E2_BC50_191109_LF_LIB_consensus_vsearch	3845	C	*/+T	217	10	4.07%	2	1	93	93	8.825309402840407E-4	1	1	155	62	0	10	+T
E2_BC50_191109_LF_LIB_consensus_vsearch	3846	C	*/-T	213	13	5.26%	2	2	93	93	1.0221711622714382E-4	1	1	156	57	1	12	-T
E2_BC50_191109_LF_LIB_consensus_vsearch	3846	C	*/-TT	213	9	3.64%	2	2	93	93	0.0017981564163397133	1	1	156	57	7	2	-T
E2_BC50_191109_LF_LIB_consensus_vsearch	3849	G	*/-C	229	11	4.51%	2	2	93	93	4.343002259471887E-4	1	1	153	76	7	4	-C
E2_BC50_191109_LF_LIB_consensus_vsearch	3857	C	*/-T	213	10	4.12%	2	2	93	93	8.808946039600796E-4	1	1	149	64	3	7	-T
E2_BC50_191109_LF_LIB_consensus_vsearch	3857	C	*/-TT	213	10	4.12%	2	2	93	93	8.808946039600796E-4	1	1	149	64	6	4	-T
E2_BC50_191109_LF_LIB_consensus_vsearch	3860	T	*/-C	229	14	5.67%	2	2	93	93	5.0341585131799904E-5	1	1	161	68	1	13	-C
E2_BC50_191109_LF_LIB_consensus_vsearch	3863	C	*/+G	229	10	4.15%	2	1	93	93	8.87120717393791E-4	1	1	149	80	10	0	+G
E2_BC50_191109_LF_LIB_consensus_vsearch	3864	A	*/-G	223	12	4.94%	2	1	93	93	2.114062925508352E-4	1	1	147	76	12	0	-G
E2_BC50_191109_LF_LIB_consensus_vsearch	3880	A	*/-G	222	13	5.33%	2	1	93	93	1.0293363152588527E-4	1	1	158	64	0	13	-G
E2_BC50_191109_LF_LIB_consensus_vsearch	3890	G	*/-A	195	32	12.96%	2	1	93	93	7.18987399696108E-11	1	1	114	81	32	0	-A
E2_BC50_191109_LF_LIB_consensus_vsearch	3890	G	*/-AT	195	18	7.29%	2	1	93	93	2.622705226031456E-6	1	1	114	81	18	0	-A
E2_BC50_191109_LF_LIB_consensus_vsearch	3891	A	*/-T	181	9	4.57%	2	2	93	93	0.0017727250885016482	1	1	101	80	8	1	-T
E2_BC50_191109_LF_LIB_consensus_vsearch	3896	A	*/+C	120	7	2.87%	2	2	93	93	0.007176897439051797	1	1	108	12	6	1	+C
E2_BC50_191109_LF_LIB_consensus_vsearch	3896	A	*/-C	120	74	30.33%	2	2	93	93	9.104418035181996E-27	1	1	108	12	33	41	-C
E2_BC50_191109_LF_LIB_consensus_vsearch	3896	A	*/-CC	120	40	16.39%	2	2	93	93	5.586213966966059E-14	1	1	108	12	14	26	-C
E2_BC50_191109_LF_LIB_consensus_vsearch	3901	T	*/-C	121	94	38.52%	2	2	93	93	9.704096580505732E-35	1	1	89	32	65	29	-C
E2_BC50_191109_LF_LIB_consensus_vsearch	3901	T	*/-CC	121	24	9.84%	2	2	93	93	2.1131063645638065E-8	1	1	89	32	4	20	-C
E2_BC50_191109_LF_LIB_consensus_vsearch	3918	T	*/-G	231	7	2.86%	2	2	93	93	0.007470748618496003	1	1	155	76	6	1	-G
E2_BC50_191109_LF_LIB_consensus_vsearch	3920	G	*/-C	213	18	7.32%	2	2	93	93	2.703550386671577E-6	1	1	137	76	14	4	-C
E2_BC50_191109_LF_LIB_consensus_vsearch	3920	G	*/-CC	213	7	2.85%	2	1	93	93	0.007443047448823043	1	1	137	76	7	0	-C
E2_BC50_191109_LF_LIB_consensus_vsearch	3924	C	*/+G	206	8	3.23%	2	1	93	93	0.0036546013500883302	1	1	146	60	0	8	+G
E2_BC50_191109_LF_LIB_consensus_vsearch	3925	G	*/+A	234	7	2.83%	2	1	93	93	0.007474966656828971	1	1	153	81	7	0	+A
E2_BC50_191109_LF_LIB_consensus_vsearch	3926	A	*/-G	224	12	4.9%	2	1	93	93	2.1153854171006224E-4	1	1	144	80	12	0	-G
E2_BC50_191109_LF_LIB_consensus_vsearch	3927	G	*/-C	192	18	7.86%	2	1	93	93	2.608089386660468E-6	1	1	112	80	18	0	-C
E2_BC50_191109_LF_LIB_consensus_vsearch	3927	G	*/-CC	192	7	3.06%	2	1	93	93	0.007404462106241813	1	1	112	80	7	0	-C
E2_BC50_191109_LF_LIB_consensus_vsearch	3928	C	*/+A	92	111	51.39%	2	2	93	93	2.4629817845639545E-43	1	1	70	22	56	55	+A
E2_BC50_191109_LF_LIB_consensus_vsearch	3934	A	*/-T	230	7	2.83%	2	2	93	93	0.0074693190837354945	1	1	154	76	1	6	-T
E2_BC50_191109_LF_LIB_consensus_vsearch	3940	C	*/-A	235	9	3.63%	2	1	93	93	0.0018118503395958998	1	1	157	78	9	0	-A
E2_BC50_191109_LF_LIB_consensus_vsearch	3949	G	*/-A	240	7	2.82%	2	2	93	93	0.007483097933064014	1	1	160	80	6	1	-A
E2_BC50_191109_LF_LIB_consensus_vsearch	3951	T	*/+A	229	13	5.24%	2	2	93	93	1.0345622368198715E-4	1	1	160	69	4	9	+A
E2_BC50_191109_LF_LIB_consensus_vsearch	3952	G	*/-TG	221	7	2.82%	2	2	93	93	0.007455894130096957	1	1	156	65	3	4	-TG
E2_BC50_191109_LF_LIB_consensus_vsearch	3954	G	*/-C	205	11	4.7%	2	2	93	93	4.285433624407098E-4	1	1	134	71	9	2	-C
E2_BC50_191109_LF_LIB_consensus_vsearch	3956	C	*/-A	213	13	5.31%	2	2	93	93	1.0221711622714382E-4	1	1	152	61	4	9	-A
E2_BC50_191109_LF_LIB_consensus_vsearch	3990	T	*/-C	230	9	3.69%	2	2	93	93	0.0018089548541641684	1	1	155	75	6	3	-C
E2_BC50_191109_LF_LIB_consensus_vsearch	4014	C	*/+T	222	7	2.87%	2	2	93	93	0.007457437428309682	1	1	153	69	6	1	+T
E2_BC50_191109_LF_LIB_consensus_vsearch	4014	C	*/-T	222	7	2.87%	2	2	93	93	0.007457437428309682	1	1	153	69	1	6	+T
E2_BC50_191109_LF_LIB_consensus_vsearch	4022	A	*/-C	219	9	3.64%	2	1	93	93	0.0018021474934649558	1	1	149	70	0	9	-C
E2_BC50_191109_LF_LIB_consensus_vsearch	4025	T	*/+C	235	7	2.85%	2	1	93	93	0.007476349629382664	1	1	156	79	7	0	+C
E2_BC50_191109_LF_LIB_consensus_vsearch	4026	C	*/+A	226	8	3.24%	2	2	93	93	0.003675803526076434	1	1	154	72	7	1	+A
E2_BC50_191109_LF_LIB_consensus_vsearch	4031	G	*/-CG	231	12	4.92%	2	2	93	93	2.124352356435401E-4	1	1	159	72	4	8	-CG
E2_BC50_191109_LF_LIB_consensus_vsearch	4033	G	*/+CG	217	7	3.03%	2	2	93	93	0.007449584424390529	1	1	153	64	1	6	+CG
E2_BC50_191109_LF_LIB_consensus_vsearch	4044	C	*/+G	226	10	4.05%	2	1	93	93	8.86015765791995E-4	1	1	156	70	0	10	+G
E2_BC50_191109_LF_LIB_consensus_vsearch	4044	C	*/-G	226	7	2.83%	2	1	93	93	0.007463479333376833	1	1	156	70	7	0	+G
E2_BC50_191109_LF_LIB_consensus_vsearch	4045	G	*/-AG	209	25	10.42%	2	1	93	93	1.5147044483682217E-8	1	1	128	81	25	0	-AG
E2_BC50_191109_LF_LIB_consensus_vsearch	4046	A	*/-G	199	13	5.96%	2	1	93	93	1.0098964132434686E-4	1	1	119	80	13	0	-G
E2_BC50_191109_LF_LIB_consensus_vsearch	4049	T	*/+A	224	7	2.86%	2	1	93	93	0.007460484300523826	1	1	149	75	7	0	+A
E2_BC50_191109_LF_LIB_consensus_vsearch	4049	T	*/-A	224	8	3.27%	2	2	93	93	0.003673845400689721	1	1	149	75	4	4	-A
E2_BC50_191109_LF_LIB_consensus_vsearch	4054	T	*/-C	217	27	10.93%	2	2	93	93	3.480970439200084E-9	1	1	139	78	24	3	-C
E2_BC50_191109_LF_LIB_consensus_vsearch	4058	G	*/-TG	227	10	4.07%	2	2	93	93	8.863871017160644E-4	1	1	152	75	7	3	-TG
E2_BC50_191109_LF_LIB_consensus_vsearch	4062	C	*/-T	218	8	3.28%	2	1	93	93	0.003667766201363899	1	1	156	62	0	8	-T
E2_BC50_191109_LF_LIB_consensus_vsearch	4063	T	*/+C	122	70	29.66%	2	2	93	93	3.675688294681629E-25	1	1	78	44	56	14	+C
E2_BC50_191109_LF_LIB_consensus_vsearch	4063	T	*/+CC	122	19	8.05%	2	2	93	93	9.96233422346714E-7	1	1	78	44	15	4	+C
E2_BC50_191109_LF_LIB_consensus_vsearch	4063	T	*/-C	122	14	5.93%	2	2	93	93	4.2916674266011074E-5	1	1	78	44	6	8	+C
E2_BC50_191109_LF_LIB_consensus_vsearch	4072	G	+C/+C	29	203	82.19%	2	2	93	93	1.5419666787535933E-100	1	1	19	10	133	70	+C
E2_BC50_191109_LF_LIB_consensus_vsearch	4072	G	*/-C	29	11	4.45%	2	1	93	93	2.2064064637520943E-4	1	1	19	10	11	0	+C
E2_BC50_191109_LF_LIB_consensus_vsearch	4076	G	*/-A	238	9	3.63%	2	1	93	93	0.0018135324927119494	1	1	156	82	9	0	-A
E2_BC50_191109_LF_LIB_consensus_vsearch	4096	T	*/+A	191	10	4.12%	2	1	93	93	8.707701860076834E-4	1	1	119	72	10	0	+A
E2_BC50_191109_LF_LIB_consensus_vsearch	4096	T	*/-A	191	29	11.93%	2	1	93	93	6.939015054291681E-10	1	1	119	72	29	0	-A
E2_BC50_191109_LF_LIB_consensus_vsearch	4099	G	*/-A	232	9	3.7%	2	1	93	93	0.0018101271688386934	1	1	150	82	9	0	-A
E2_BC50_191109_LF_LIB_consensus_vsearch	4115	T	*/-G	221	15	6.12%	2	2	93	93	2.4258244372323037E-5	1	1	155	66	3	12	-G
E2_BC50_191109_LF_LIB_consensus_vsearch	4118	G	*/-C	224	16	6.48%	2	2	93	93	1.1784271864232843E-5	1	1	145	79	14	2	-C
E2_BC50_191109_LF_LIB_consensus_vsearch	4119	C	*/+T	214	7	3.08%	2	1	93	93	0.007444703667648697	1	1	144	70	0	7	+T
E2_BC50_191109_LF_LIB_consensus_vsearch	4124	C	*/-A	216	9	3.67%	2	2	93	93	0.0018001779733764346	1	1	147	69	4	5	-A
E2_BC50_191109_LF_LIB_consensus_vsearch	4128	C	*/-G	217	13	5.42%	2	2	93	93	1.0254206608526479E-4	1	1	151	66	7	6	-G
E2_BC50_191109_LF_LIB_consensus_vsearch	4135	T	*/-C	189	50	20.66%	2	2	93	93	5.060118231772742E-17	1	1	114	75	48	2	-C
E2_BC50_191109_LF_LIB_consensus_vsearch	4146	G	*/-C	222	21	8.5%	2	2	93	93	3.036579492608799E-7	1	1	141	81	20	1	-C
E2_BC50_191109_LF_LIB_consensus_vsearch	4154	C	*/-T	237	8	3.24%	2	2	93	93	0.003686009667588161	1	1	161	76	4	4	-T
E2_BC50_191109_LF_LIB_consensus_vsearch	4173	G	*/-T	229	8	3.24%	2	2	93	93	0.0036786796343901236	1	1	149	80	7	1	-T
E2_BC50_191109_LF_LIB_consensus_vsearch	4180	C	*/-T	237	7	2.85%	2	2	93	93	0.007479081856645369	1	1	159	78	5	2	-T
E2_BC50_191109_LF_LIB_consensus_vsearch	4183	C	*/+A	232	8	3.25%	2	1	93	93	0.0036814848550168837	1	1	160	72	0	8	+A
E2_BC50_191109_LF_LIB_consensus_vsearch	4205	T	*/-G	229	16	6.48%	2	2	93	93	1.1848641435763499E-5	1	1	163	66	1	15	-G
E2_BC50_191109_LF_LIB_consensus_vsearch	4207	G	*/-A	230	18	7.26%	2	2	93	93	2.770537046121591E-6	1	1	149	81	17	1	-A
E2_BC50_191109_LF_LIB_consensus_vsearch	4232	C	*/-A	219	16	6.53%	2	1	93	93	1.1717441248540928E-5	1	1	140	79	16	0	-A
E2_BC50_191109_LF_LIB_consensus_vsearch	4239	C	*/-TT	224	9	3.67%	2	1	93	93	0.0018053197291553536	1	1	144	80	9	0	-TT
E2_BC50_191109_LF_LIB_consensus_vsearch	4242	G	*/-C	226	11	4.47%	2	1	93	93	4.336419657096737E-4	1	1	150	76	11	0	-C
E2_BC50_191109_LF_LIB_consensus_vsearch	4244	C	*/+T	227	7	2.83%	2	2	93	93	0.0074649578216797186	1	1	152	75	3	4	+T
E2_BC50_191109_LF_LIB_consensus_vsearch	4245	C	*/-T	225	15	6.05%	2	2	93	93	2.4354161852738932E-5	1	1	150	75	8	7	-T
E2_BC50_191109_LF_LIB_consensus_vsearch	4246	T	*/+C	93	130	56.03%	2	2	93	93	1.0368954271117904E-51	1	1	92	1	58	72	+C
E2_BC50_191109_LF_LIB_consensus_vsearch	4261	C	*/-AC	228	13	5.26%	2	2	93	93	1.0338331781904129E-4	1	1	149	79	12	1	-AC
E2_BC50_191109_LF_LIB_consensus_vsearch	4264	G	*/-TG	228	13	5.26%	2	2	93	93	1.0338331781904129E-4	1	1	161	67	2	11	-TG
E2_BC50_191109_LF_LIB_consensus_vsearch	4282	A	*/+T	206	27	11.02%	2	2	93	93	3.350714940083685E-9	1	1	147	59	11	16	+T
E2_BC50_191109_LF_LIB_consensus_vsearch	4284	T	*/-C	200	41	16.73%	2	2	93	93	7.079769963009505E-14	1	1	126	74	38	3	-C
E2_BC50_191109_LF_LIB_consensus_vsearch	4286	C	*/-A	230	10	4.05%	2	2	93	93	8.874830704141458E-4	1	1	163	67	2	8	-A
E2_BC50_191109_LF_LIB_consensus_vsearch	4290	T	*/+A	225	10	4.03%	2	2	93	93	8.856413612935507E-4	1	1	150	75	9	1	+A
E2_BC50_191109_LF_LIB_consensus_vsearch	4291	A	*/-G	182	53	21.37%	2	2	93	93	4.056756959265124E-18	1	1	137	45	18	35	-G
E2_BC50_191109_LF_LIB_consensus_vsearch	4294	G	*/-A	209	23	9.35%	2	1	93	93	6.719419108419964E-8	1	1	132	77	23	0	-A
E2_BC50_191109_LF_LIB_consensus_vsearch	4296	A	*/-C	188	18	7.53%	2	2	93	93	2.5880431248781214E-6	1	1	109	79	17	1	-C
E2_BC50_191109_LF_LIB_consensus_vsearch	4296	A	*/-CC	188	27	11.3%	2	1	93	93	3.1198303617757218E-9	1	1	109	79	27	0	-CC
E2_BC50_191109_LF_LIB_consensus_vsearch	4299	C	*/-A	229	7	2.86%	2	1	93	93	0.007467877541059236	1	1	150	79	7	0	-A
E2_BC50_191109_LF_LIB_consensus_vsearch	4301	G	*/-AG	213	21	8.71%	2	2	93	93	2.981920422412607E-7	1	1	135	78	20	1	-AG
E2_BC50_191109_LF_LIB_consensus_vsearch	4302	A	*/+G	185	7	3.23%	2	1	93	93	0.007389745092191117	1	1	113	72	7	0	+G
E2_BC50_191109_LF_LIB_consensus_vsearch	4302	A	*/-G	185	15	6.91%	2	2	93	93	2.323978273518884E-5	1	1	113	72	10	5	-G
E2_BC50_191109_LF_LIB_consensus_vsearch	4307	T	*/-C	175	54	22.41%	2	2	93	93	1.5975997008653735E-18	1	1	123	52	36	18	-C
E2_BC50_191109_LF_LIB_consensus_vsearch	4317	T	*/+G	219	12	4.88%	2	1	93	93	2.10866409362083E-4	1	1	139	80	12	0	+G
E2_BC50_191109_LF_LIB_consensus_vsearch	4318	A	*/-G	219	20	8.26%	2	1	93	93	6.300524183115758E-7	1	1	137	82	20	0	-G
E2_BC50_191109_LF_LIB_consensus_vsearch	4319	G	*/+A	174	33	14.6%	2	1	93	93	2.9121523783930724E-11	1	1	92	82	33	0	+A
E2_BC50_191109_LF_LIB_consensus_vsearch	4320	G	*/+C	223	12	4.86%	2	2	93	93	2.114062925508352E-4	1	1	142	81	11	1	+C
E2_BC50_191109_LF_LIB_consensus_vsearch	4327	C	*/-AC	231	8	3.28%	2	1	93	93	0.0036805574954856175	1	1	151	80	8	0	-AC
E2_BC50_191109_LF_LIB_consensus_vsearch	4332	C	*/+T	231	7	2.89%	2	2	93	93	0.007470748618496003	1	1	160	71	1	6	+T
E2_BC50_191109_LF_LIB_consensus_vsearch	4334	T	*/-C	216	16	6.69%	2	2	93	93	1.1676102632271101E-5	1	1	145	71	14	2	-C
E2_BC50_191109_LF_LIB_consensus_vsearch	4346	G	*/-A	236	7	2.87%	2	1	93	93	0.007477721316805575	1	1	156	80	7	0	-A
E2_BC50_191109_LF_LIB_consensus_vsearch	4349	T	*/-GG	233	7	2.82%	2	1	93	93	0.007473572259320498	1	1	163	70	0	7	-GG
E2_BC50_191109_LF_LIB_consensus_vsearch	4355	A	*/-T	184	58	23.67%	2	1	93	93	7.110780052671212E-20	1	1	104	80	58	0	-T
E2_BC50_191109_LF_LIB_consensus_vsearch	4362	C	*/-GC	199	38	15.51%	2	2	93	93	7.253546004805775E-13	1	1	126	73	34	4	-GC
E2_BC50_191109_LF_LIB_consensus_vsearch	4368	C	*/-TGC	233	8	3.23%	2	2	93	93	0.0036824046267336483	1	1	156	77	4	4	-TGC
E2_BC50_191109_LF_LIB_consensus_vsearch	4370	G	*/-C	216	13	5.53%	2	1	93	93	1.0246182731202857E-4	1	1	138	78	13	0	-C
E2_BC50_191109_LF_LIB_consensus_vsearch	4371	C	*/+G	203	11	4.91%	2	1	93	93	4.280077806644155E-4	1	1	127	76	11	0	+G
E2_BC50_191109_LF_LIB_consensus_vsearch	4374	T	*/-C	217	23	9.35%	2	2	93	93	6.855613166772501E-8	1	1	140	77	19	4	-C
E2_BC50_191109_LF_LIB_consensus_vsearch	4375	C	*/+G	195	13	5.96%	2	1	93	93	1.0061064586351875E-4	1	1	118	77	13	0	+G
E2_BC50_191109_LF_LIB_consensus_vsearch	4378	T	*/-G	217	14	5.81%	2	1	93	93	4.982521215421391E-5	1	1	152	65	0	14	-G
E2_BC50_191109_LF_LIB_consensus_vsearch	4386	G	*/-TAG	234	7	2.83%	2	2	93	93	0.007474966656828971	1	1	155	79	4	3	-TAG
E2_BC50_191109_LF_LIB_consensus_vsearch	4393	T	*/-GT	231	8	3.23%	2	2	93	93	0.0036805574954856175	1	1	158	73	2	6	-GT
E2_BC50_191109_LF_LIB_consensus_vsearch	4409	T	*/-C	199	42	17.21%	2	1	93	93	3.2107800285803864E-14	1	1	121	78	42	0	-C
E2_BC50_191109_LF_LIB_consensus_vsearch	4411	C	*/-G	219	19	7.76%	2	2	93	93	1.312379928099055E-6	1	1	159	60	3	16	-G
E2_BC50_191109_LF_LIB_consensus_vsearch	4422	T	*/+C	212	22	9.13%	2	1	93	93	1.420915100612845E-7	1	1	136	76	22	0	+C
E2_BC50_191109_LF_LIB_consensus_vsearch	4423	C	*/-T	230	9	3.67%	2	2	93	93	0.0018089548541641684	1	1	162	68	1	8	-T
E2_BC50_191109_LF_LIB_consensus_vsearch	4428	T	*/-C	175	60	24.39%	2	2	93	93	1.1454958292953679E-20	1	1	124	51	35	25	-C
E2_BC50_191109_LF_LIB_consensus_vsearch	4428	T	*/-CC	175	8	3.25%	2	2	93	93	0.0036127494603351348	1	1	124	51	4	4	-C
E2_BC50_191109_LF_LIB_consensus_vsearch	4435	T	*/-A	236	7	2.83%	2	1	93	93	0.007477721316805575	1	1	157	79	7	0	-A
E2_BC50_191109_LF_LIB_consensus_vsearch	4436	A	*/+C	199	12	4.98%	2	1	93	93	2.078764879814198E-4	1	1	122	77	12	0	+C
E2_BC50_191109_LF_LIB_consensus_vsearch	4436	A	*/-C	199	14	5.81%	2	2	93	93	4.8950273206615416E-5	1	1	122	77	10	4	-C
E2_BC50_191109_LF_LIB_consensus_vsearch	4439	C	*/-G	168	17	6.85%	2	2	93	93	5.192137088615319E-6	1	1	157	11	1	16	-G
E2_BC50_191109_LF_LIB_consensus_vsearch	4443	A	*/-C	222	19	7.69%	2	2	93	93	1.3187503319271603E-6	1	1	144	78	16	3	-C
E2_BC50_191109_LF_LIB_consensus_vsearch	4444	C	*/+T	216	7	3.08%	2	1	93	93	0.007447971960236055	1	1	146	70	0	7	+T
E2_BC50_191109_LF_LIB_consensus_vsearch	4447	G	*/+C	235	8	3.25%	2	1	93	93	0.003684221776127662	1	1	163	72	0	8	+C
E2_BC50_191109_LF_LIB_consensus_vsearch	4456	T	*/-C	181	64	25.91%	2	1	93	93	4.716154241712798E-22	1	1	100	81	64	0	-C
E2_BC50_191109_LF_LIB_consensus_vsearch	4458	C	*/-A	231	10	4.03%	2	1	93	93	8.878425014170833E-4	1	1	152	79	10	0	-A
E2_BC50_191109_LF_LIB_consensus_vsearch	4481	A	*/-G	197	17	7.11%	2	2	93	93	5.481738321341071E-6	1	1	134	63	3	14	-G
E2_BC50_191109_LF_LIB_consensus_vsearch	4491	C	*/-T	219	9	3.83%	2	2	93	93	0.0018021474934649558	1	1	154	65	2	7	-T
E2_BC50_191109_LF_LIB_consensus_vsearch	4494	G	*/-A	236	8	3.25%	2	1	93	93	0.0036851193347710583	1	1	158	78	8	0	-A
E2_BC50_191109_LF_LIB_consensus_vsearch	4498	G	*/-A	232	12	4.9%	2	2	93	93	2.1255933043139825E-4	1	1	152	80	11	1	-A
E2_BC50_191109_LF_LIB_consensus_vsearch	4515	A	*/-G	224	8	3.32%	2	2	93	93	0.003673845400689721	1	1	147	77	6	2	-G
E2_BC50_191109_LF_LIB_consensus_vsearch	4527	T	*/-C	187	59	23.89%	2	1	93	93	3.310215269729228E-20	1	1	106	81	59	0	-C
E2_BC50_191109_LF_LIB_consensus_vsearch	4530	G	*/-A	237	10	4.05%	2	1	93	93	8.89939656217755E-4	1	1	155	82	10	0	-A
E2_BC50_191109_LF_LIB_consensus_vsearch	4536	T	*/-A	229	7	2.88%	2	2	93	93	0.007467877541059236	1	1	154	75	3	4	-A
E2_BC50_191109_LF_LIB_consensus_vsearch	4558	G	*/+A	223	16	6.48%	2	1	93	93	1.177110704126969E-5	1	1	142	81	16	0	+A
E2_BC50_191109_LF_LIB_consensus_vsearch	4559	G	*/+T	232	7	2.82%	2	1	93	93	0.007472166294706969	1	1	155	77	7	0	+T
E2_BC50_191109_LF_LIB_consensus_vsearch	4564	A	*/-C	188	40	16.6%	2	2	93	93	1.3939697247970385E-13	1	1	118	70	33	7	-C
E2_BC50_191109_LF_LIB_consensus_vsearch	4564	A	*/-CC	188	7	2.9%	2	2	93	93	0.007396180372504935	1	1	118	70	4	3	-C
E2_BC50_191109_LF_LIB_consensus_vsearch	4565	C	*/+T	183	7	3.61%	2	1	93	93	0.007385343252869138	1	1	119	64	0	7	+T
E2_BC50_191109_LF_LIB_consensus_vsearch	4574	G	*/+T	189	16	6.5%	2	2	93	93	1.1255933590740409E-5	1	1	120	69	14	2	+T
E2_BC50_191109_LF_LIB_consensus_vsearch	4574	G	*/-T	189	20	8.13%	2	1	93	93	5.91904135964308E-7	1	1	120	69	20	0	-T
E2_BC50_191109_LF_LIB_consensus_vsearch	4577	T	*/+G	227	10	4.05%	2	1	93	93	8.863871017160644E-4	1	1	162	65	0	10	+G
E2_BC50_191109_LF_LIB_consensus_vsearch	4592	A	*/-CA	206	34	13.77%	2	1	93	93	1.655020358940504E-11	1	1	127	79	34	0	-CA
E2_BC50_191109_LF_LIB_consensus_vsearch	4595	T	*/-C	231	14	5.67%	2	1	93	93	5.0423072249628895E-5	1	1	150	81	14	0	-C
E2_BC50_191109_LF_LIB_consensus_vsearch	4600	T	*/-C	232	7	2.83%	2	1	93	93	0.007472166294706969	1	1	162	70	0	7	-C
E2_BC50_191109_LF_LIB_consensus_vsearch	4600	T	*/-CT	232	7	2.83%	2	2	93	93	0.007472166294706969	1	1	162	70	2	5	-C
E2_BC50_191109_LF_LIB_consensus_vsearch	4601	C	*/-T	217	13	5.58%	2	1	93	93	1.0254206608526479E-4	1	1	161	56	0	13	-T
E2_BC50_191109_LF_LIB_consensus_vsearch	4619	G	*/-TG	224	15	6.07%	2	1	93	93	2.433045785761445E-5	1	1	160	64	0	15	-TG
E2_BC50_191109_LF_LIB_consensus_vsearch	4626	T	*/-GT	227	9	3.7%	2	2	93	93	0.0018071599099638493	1	1	153	74	6	3	-GT
E2_BC50_191109_LF_LIB_consensus_vsearch	4634	C	*/-TC	227	9	3.67%	2	2	93	93	0.0018071599099638493	1	1	157	70	6	3	-TC
E2_BC50_191109_LF_LIB_consensus_vsearch	4635	T	*/-C	221	8	3.43%	2	2	93	93	0.003670845031231652	1	1	152	69	4	4	-C
E2_BC50_191109_LF_LIB_consensus_vsearch	4641	T	*/-GCC	232	7	2.89%	2	1	93	93	0.007472166294706969	1	1	151	81	7	0	-GCC
E2_BC50_191109_LF_LIB_consensus_vsearch	4673	C	*/-A	231	9	3.64%	2	2	93	93	0.0018095434033127298	1	1	161	70	3	6	-A
E2_BC50_191109_LF_LIB_consensus_vsearch	4713	C	*/-A	232	7	2.86%	2	2	93	93	0.007472166294706969	1	1	157	75	6	1	-A
E2_BC50_191109_LF_LIB_consensus_vsearch	4715	C	*/+T	90	139	56.97%	2	2	93	93	4.757600968618408E-56	1	1	64	26	89	50	+T
E2_BC50_191109_LF_LIB_consensus_vsearch	4726	C	*/+T	214	8	3.25%	2	2	93	93	0.003663533633296164	1	1	143	71	7	1	+T
E2_BC50_191109_LF_LIB_consensus_vsearch	4726	C	*/-TT	214	7	2.85%	2	1	93	93	0.007444703667648697	1	1	143	71	7	0	+T
E2_BC50_191109_LF_LIB_consensus_vsearch	4733	T	*/+C	223	13	5.31%	2	1	93	93	1.03010072485016E-4	1	1	150	73	13	0	+C
E2_BC50_191109_LF_LIB_consensus_vsearch	4733	T	*/-C	223	7	2.86%	2	1	93	93	0.007458967428082863	1	1	150	73	0	7	+C
E2_BC50_191109_LF_LIB_consensus_vsearch	4734	C	*/-G	203	27	11.3%	2	2	93	93	3.31381335430995E-9	1	1	160	43	1	26	-G
E2_BC50_191109_LF_LIB_consensus_vsearch	4753	C	*/+T	213	13	5.37%	2	2	93	93	1.0221711622714382E-4	1	1	158	55	4	9	+T
E2_BC50_191109_LF_LIB_consensus_vsearch	4753	C	*/-T	213	13	5.37%	2	2	93	93	1.0221711622714382E-4	1	1	158	55	2	11	+T
E2_BC50_191109_LF_LIB_consensus_vsearch	4756	T	*/-G	230	7	2.83%	2	2	93	93	0.0074693190837354945	1	1	159	71	1	6	-G
