Chrom	Position	Ref	Cons	Reads1	Reads2	VarFreq	Strands1	Strands2	Qual1	Qual2	Pvalue	MapQual1	MapQual2	Reads1Plus	Reads1Minus	Reads2Plus	Reads2Minus	VarAllele
G4_BC76_191109_LF_LIB_consensus_vsearch	1	G	G	287	0	0%	2	0	93	0	1.0	1	0	138	149	0	0	
G4_BC76_191109_LF_LIB_consensus_vsearch	2	T	T	302	0	0%	2	0	93	0	1.0	1	0	138	164	0	0	
G4_BC76_191109_LF_LIB_consensus_vsearch	3	A	A	325	0	0%	2	0	93	0	1.0	1	0	140	185	0	0	
G4_BC76_191109_LF_LIB_consensus_vsearch	4	G	G	334	1	0.3%	2	1	93	93	0.4999999999999138	1	1	140	194	0	1	-T
G4_BC76_191109_LF_LIB_consensus_vsearch	5	T	T	340	2	0.58%	2	2	93	93	0.24963396778913263	1	1	141	199	1	1	-C
G4_BC76_191109_LF_LIB_consensus_vsearch	6	C	C	355	1	0.28%	2	1	93	93	0.5000000000003686	1	1	144	211	0	1	+A
G4_BC76_191109_LF_LIB_consensus_vsearch	7	A	A	363	2	0.54%	2	1	93	93	0.24965706447191202	1	1	142	221	0	2	+G
G4_BC76_191109_LF_LIB_consensus_vsearch	8	T	*/-AT	372	7	1.84%	2	2	93	93	0.007597206160798333	1	1	144	228	2	5	-AT
G4_BC76_191109_LF_LIB_consensus_vsearch	9	A	A	381	4	1.03%	2	1	93	93	0.062012671598070994	1	1	138	243	4	0	-T
G4_BC76_191109_LF_LIB_consensus_vsearch	10	T	T	381	2	0.52%	2	1	93	93	0.24967320261436957	1	1	140	241	0	2	+AA
G4_BC76_191109_LF_LIB_consensus_vsearch	11	G	G	387	3	0.75%	2	2	93	93	0.12451861360729544	1	1	141	246	2	1	+C
G4_BC76_191109_LF_LIB_consensus_vsearch	12	C	Y	360	27	6.82%	2	1	93	93	4.658197549772413E-9	1	1	142	218	0	27	T
G4_BC76_191109_LF_LIB_consensus_vsearch	13	T	T	395	2	0.5%	2	1	93	93	0.24968474148789518	1	1	143	252	0	2	C
G4_BC76_191109_LF_LIB_consensus_vsearch	14	T	T	396	4	0.99%	2	1	93	93	0.06203095776871511	1	1	145	251	0	4	+CT
G4_BC76_191109_LF_LIB_consensus_vsearch	15	G	G	403	2	0.49%	2	2	93	93	0.24969097651407932	1	1	145	258	1	1	A
G4_BC76_191109_LF_LIB_consensus_vsearch	16	T	T	399	3	0.74%	2	2	93	93	0.12453300124551302	1	1	142	257	2	1	+C
G4_BC76_191109_LF_LIB_consensus_vsearch	17	C	C	401	2	0.5%	2	1	93	93	0.24968944099344345	1	1	144	257	0	2	T
G4_BC76_191109_LF_LIB_consensus_vsearch	18	C	C	403	3	0.74%	2	2	93	93	0.12453760789147728	1	1	145	258	2	1	+G
G4_BC76_191109_LF_LIB_consensus_vsearch	19	A	A	400	2	0.49%	2	1	93	93	0.24968866749695368	1	1	145	255	0	2	-T
G4_BC76_191109_LF_LIB_consensus_vsearch	20	T	*/+C	386	10	2.47%	2	1	93	93	9.219853921161506E-4	1	1	130	256	10	0	+C
G4_BC76_191109_LF_LIB_consensus_vsearch	21	C	*/-G	369	30	7.44%	2	1	93	93	5.287042225454686E-10	1	1	142	227	0	30	-G
G4_BC76_191109_LF_LIB_consensus_vsearch	22	G	G	370	4	1.06%	2	1	93	93	0.061998328885973654	1	1	146	224	0	4	T
G4_BC76_191109_LF_LIB_consensus_vsearch	23	G	G	406	1	0.25%	2	1	93	93	0.4999999999999138	1	1	148	258	0	1	A
G4_BC76_191109_LF_LIB_consensus_vsearch	24	A	A	401	3	0.74%	2	1	93	93	0.1245353159851805	1	1	142	259	3	0	+C
G4_BC76_191109_LF_LIB_consensus_vsearch	25	C	C	400	2	0.49%	2	1	93	93	0.24968866749695368	1	1	144	256	0	2	-T
G4_BC76_191109_LF_LIB_consensus_vsearch	26	T	Y	382	7	1.73%	2	2	93	93	0.0076027118384171	1	1	141	241	4	3	C
G4_BC76_191109_LF_LIB_consensus_vsearch	27	A	A	387	2	0.51%	2	1	93	93	0.24967824967779578	1	1	145	242	0	2	C
G4_BC76_191109_LF_LIB_consensus_vsearch	28	A	A	393	2	0.5%	2	2	93	93	0.24968314321918028	1	1	145	248	1	1	-G
G4_BC76_191109_LF_LIB_consensus_vsearch	29	G	G	397	2	0.49%	2	1	93	93	0.24968632371350802	1	1	143	254	0	2	-C
G4_BC76_191109_LF_LIB_consensus_vsearch	30	C	Y	390	8	1.98%	2	1	93	93	0.0037699692796093966	1	1	146	244	0	8	T
G4_BC76_191109_LF_LIB_consensus_vsearch	31	C	Y	391	10	2.46%	2	2	93	93	9.226547240173711E-4	1	1	146	245	1	9	T
G4_BC76_191109_LF_LIB_consensus_vsearch	32	A	A	391	3	0.74%	2	1	93	93	0.12452350698836272	1	1	147	244	0	3	T
G4_BC76_191109_LF_LIB_consensus_vsearch	33	T	T	385	6	1.49%	2	1	93	93	0.01532605917062568	1	1	146	239	0	6	C
G4_BC76_191109_LF_LIB_consensus_vsearch	34	G	G	395	5	1.25%	2	2	93	93	0.030859622206549208	1	1	142	253	4	1	A
G4_BC76_191109_LF_LIB_consensus_vsearch	35	C	C	389	5	1.24%	2	1	93	93	0.030853681237272182	1	1	144	245	0	5	T
G4_BC76_191109_LF_LIB_consensus_vsearch	36	A	A	393	2	0.5%	2	1	93	93	0.24968314321918028	1	1	143	250	2	0	-TG
G4_BC76_191109_LF_LIB_consensus_vsearch	37	T	T	390	3	0.75%	2	2	93	93	0.12452229299364298	1	1	140	250	1	2	C
G4_BC76_191109_LF_LIB_consensus_vsearch	38	G	R	387	10	2.49%	2	2	93	93	9.221205845541368E-4	1	1	133	254	9	1	A
G4_BC76_191109_LF_LIB_consensus_vsearch	39	C	C	383	6	1.49%	2	2	93	93	0.015324526212125619	1	1	135	248	1	5	T
G4_BC76_191109_LF_LIB_consensus_vsearch	40	G	G	387	2	0.5%	2	1	93	93	0.24967824967779578	1	1	136	251	2	0	-A
G4_BC76_191109_LF_LIB_consensus_vsearch	41	A	*/-G	363	25	6.25%	2	2	93	93	1.9991640013982084E-8	1	1	109	254	24	1	-G
G4_BC76_191109_LF_LIB_consensus_vsearch	42	G	*/-AG	280	94	24.93%	2	2	93	93	6.20657456324965E-32	1	1	32	248	85	9	-AG
G4_BC76_191109_LF_LIB_consensus_vsearch	43	A	A	299	5	1.62%	2	1	93	93	0.030736449412491887	1	1	51	248	5	0	-G
G4_BC76_191109_LF_LIB_consensus_vsearch	44	G	G	302	2	0.65%	2	1	93	93	0.24958813838556218	1	1	54	248	2	0	C
G4_BC76_191109_LF_LIB_consensus_vsearch	45	T	T	401	3	0.74%	2	1	93	93	0.1245353159851805	1	1	148	253	0	3	C
G4_BC76_191109_LF_LIB_consensus_vsearch	46	T	T	399	4	0.99%	2	2	93	93	0.06203445155203153	1	1	143	256	3	1	+C
G4_BC76_191109_LF_LIB_consensus_vsearch	47	C	*/-A	380	11	2.71%	2	2	93	93	4.546826533185083E-4	1	1	126	254	10	1	-A
G4_BC76_191109_LF_LIB_consensus_vsearch	48	A	*/+G	376	7	1.77%	2	2	93	93	0.007599442747600996	1	1	127	249	2	5	+G
G4_BC76_191109_LF_LIB_consensus_vsearch	49	G	G	397	3	0.75%	2	1	93	93	0.12453066332921275	1	1	138	259	3	0	+A
G4_BC76_191109_LF_LIB_consensus_vsearch	50	A	A	399	3	0.74%	2	2	93	93	0.12453300124551302	1	1	145	254	1	2	-GA
G4_BC76_191109_LF_LIB_consensus_vsearch	51	G	G	401	2	0.5%	2	1	93	93	0.24968944099344345	1	1	144	257	2	0	-A
G4_BC76_191109_LF_LIB_consensus_vsearch	52	A	*/-C	386	9	2.24%	2	2	93	93	0.0018651929543866046	1	1	143	243	1	8	-C
G4_BC76_191109_LF_LIB_consensus_vsearch	53	C	C	394	1	0.25%	2	1	93	93	0.4999999999999138	1	1	146	248	0	1	+G
G4_BC76_191109_LF_LIB_consensus_vsearch	54	C	*/-T	371	19	4.68%	2	1	93	93	1.5236904962679662E-6	1	1	142	229	0	19	-T
G4_BC76_191109_LF_LIB_consensus_vsearch	55	T	T	379	1	0.26%	2	1	93	93	0.4999999999999138	1	1	143	236	0	1	C
G4_BC76_191109_LF_LIB_consensus_vsearch	56	T	*/+A	379	7	1.75%	2	1	93	93	0.007601089929303789	1	1	143	236	0	7	+A
G4_BC76_191109_LF_LIB_consensus_vsearch	57	A	A	396	5	1.24%	2	1	93	93	0.03086059509471206	1	1	148	248	0	5	C
G4_BC76_191109_LF_LIB_consensus_vsearch	58	A	A	406	1	0.25%	2	1	93	93	0.4999999999999138	1	1	147	259	1	0	G
G4_BC76_191109_LF_LIB_consensus_vsearch	59	A	A	401	5	1.23%	2	2	93	93	0.030865387693025832	1	1	144	257	4	1	G
G4_BC76_191109_LF_LIB_consensus_vsearch	60	C	*/-A	394	9	2.22%	2	2	93	93	0.0018669176476072253	1	1	142	252	5	4	-A
G4_BC76_191109_LF_LIB_consensus_vsearch	61	A	A	395	2	0.5%	2	2	93	93	0.24968474148789518	1	1	142	253	1	1	G
G4_BC76_191109_LF_LIB_consensus_vsearch	62	A	A	401	3	0.74%	2	2	93	93	0.1245353159851805	1	1	146	255	1	2	G
G4_BC76_191109_LF_LIB_consensus_vsearch	63	T	T	395	5	1.23%	2	1	93	93	0.030859622206549208	1	1	142	253	5	0	G
G4_BC76_191109_LF_LIB_consensus_vsearch	64	T	*/+G	387	9	2.22%	2	2	93	93	0.0018654123049784304	1	1	138	249	7	2	+G
G4_BC76_191109_LF_LIB_consensus_vsearch	65	G	*/-A	394	7	1.73%	2	2	93	93	0.007608958034696689	1	1	145	249	1	6	-A
G4_BC76_191109_LF_LIB_consensus_vsearch	66	A	A	397	2	0.5%	2	1	93	93	0.24968632371350802	1	1	146	251	0	2	G
G4_BC76_191109_LF_LIB_consensus_vsearch	67	A	A	402	3	0.74%	2	2	93	93	0.1245364647713705	1	1	145	257	1	2	G
G4_BC76_191109_LF_LIB_consensus_vsearch	68	A	R	396	9	2.21%	2	1	93	93	0.0018673383028544072	1	1	139	257	9	0	G
G4_BC76_191109_LF_LIB_consensus_vsearch	69	C	C	396	5	1.23%	2	2	93	93	0.03086059509471206	1	1	141	255	4	1	+T
G4_BC76_191109_LF_LIB_consensus_vsearch	70	T	T	394	4	0.99%	2	2	93	93	0.06202859930052086	1	1	144	250	1	3	C
G4_BC76_191109_LF_LIB_consensus_vsearch	71	G	G	398	5	1.23%	2	2	93	93	0.030862526395586183	1	1	144	254	2	3	A
G4_BC76_191109_LF_LIB_consensus_vsearch	72	C	*/+A	377	12	2.96%	2	2	93	93	2.2399764271290005E-4	1	1	133	244	11	1	+A
G4_BC76_191109_LF_LIB_consensus_vsearch	73	G	*/-A	389	8	1.98%	2	1	93	93	0.0037696288519149155	1	1	135	254	8	0	-A
G4_BC76_191109_LF_LIB_consensus_vsearch	74	A	A	396	1	0.25%	2	1	93	93	0.4999999999999138	1	1	139	257	0	1	+G
G4_BC76_191109_LF_LIB_consensus_vsearch	75	A	A	401	1	0.25%	2	1	93	93	0.5000000000008233	1	1	145	256	1	0	+G
G4_BC76_191109_LF_LIB_consensus_vsearch	76	T	T	398	3	0.74%	2	1	93	93	0.12453183520605009	1	1	146	252	0	3	-G
G4_BC76_191109_LF_LIB_consensus_vsearch	77	G	R	391	8	1.99%	2	1	93	93	0.003770308015149166	1	1	137	254	8	0	A
G4_BC76_191109_LF_LIB_consensus_vsearch	78	G	G	393	6	1.48%	2	1	93	93	0.015332037719180692	1	1	145	248	0	6	+C
G4_BC76_191109_LF_LIB_consensus_vsearch	79	C	C	394	5	1.24%	2	2	93	93	0.030858644444955494	1	1	144	250	1	4	-T
G4_BC76_191109_LF_LIB_consensus_vsearch	80	T	Y	385	9	2.25%	2	2	93	93	0.001864972504119446	1	1	142	243	3	6	C
G4_BC76_191109_LF_LIB_consensus_vsearch	81	C	C	395	2	0.5%	2	1	93	93	0.24968474148789518	1	1	146	249	0	2	+T
G4_BC76_191109_LF_LIB_consensus_vsearch	82	A	A	390	6	1.49%	2	2	93	93	0.015329823997787357	1	1	143	247	2	4	G
G4_BC76_191109_LF_LIB_consensus_vsearch	83	T	T	393	2	0.5%	2	1	93	93	0.24968314321918028	1	1	145	248	0	2	C
G4_BC76_191109_LF_LIB_consensus_vsearch	84	T	T	392	5	1.23%	2	2	93	93	0.030856674154206513	1	1	141	251	3	2	+A
G4_BC76_191109_LF_LIB_consensus_vsearch	85	A	A	396	2	0.5%	2	1	93	93	0.24968553459123424	1	1	145	251	0	2	C
G4_BC76_191109_LF_LIB_consensus_vsearch	86	A	A	402	2	0.49%	2	1	93	93	0.2496902106567468	1	1	146	256	2	0	C
G4_BC76_191109_LF_LIB_consensus_vsearch	87	A	A	399	4	0.98%	2	2	93	93	0.06203445155203153	1	1	146	253	2	2	G
G4_BC76_191109_LF_LIB_consensus_vsearch	88	T	T	390	6	1.49%	2	2	93	93	0.015329823997787357	1	1	143	247	1	5	C
G4_BC76_191109_LF_LIB_consensus_vsearch	89	C	C	392	4	0.99%	2	2	93	93	0.06202621699451153	1	1	140	252	2	2	-A
G4_BC76_191109_LF_LIB_consensus_vsearch	90	A	R	383	14	3.47%	2	1	93	93	5.4317819652484023E-5	1	1	130	253	14	0	G
G4_BC76_191109_LF_LIB_consensus_vsearch	91	G	G	398	2	0.49%	2	1	93	93	0.249687108886017	1	1	144	254	0	2	+C
G4_BC76_191109_LF_LIB_consensus_vsearch	92	T	Y	396	7	1.72%	2	1	93	93	0.007609963086240239	1	1	147	249	0	7	C
G4_BC76_191109_LF_LIB_consensus_vsearch	93	T	T	394	5	1.23%	2	2	93	93	0.030858644444955494	1	1	145	249	2	3	C
G4_BC76_191109_LF_LIB_consensus_vsearch	94	A	R	390	10	2.46%	2	2	93	93	9.225221739189795E-4	1	1	144	246	2	8	G
G4_BC76_191109_LF_LIB_consensus_vsearch	95	T	Y	378	12	2.99%	2	2	93	93	2.2404784900264377E-4	1	1	139	239	5	7	C
G4_BC76_191109_LF_LIB_consensus_vsearch	96	G	G	396	3	0.74%	2	1	93	93	0.12452948557099502	1	1	143	253	0	3	C
G4_BC76_191109_LF_LIB_consensus_vsearch	97	A	A	397	2	0.5%	2	2	93	93	0.24968632371350802	1	1	145	252	1	1	-T
G4_BC76_191109_LF_LIB_consensus_vsearch	98	T	T	396	4	0.99%	2	1	93	93	0.06203095776871511	1	1	146	250	0	4	+C
G4_BC76_191109_LF_LIB_consensus_vsearch	99	T	T	398	6	1.48%	2	2	93	93	0.015335654379945	1	1	146	252	1	5	C
G4_BC76_191109_LF_LIB_consensus_vsearch	100	C	C	399	3	0.74%	2	2	93	93	0.12453300124551302	1	1	146	253	2	1	-A
G4_BC76_191109_LF_LIB_consensus_vsearch	101	A	R	384	11	2.73%	2	2	93	93	4.5501547153779163E-4	1	1	131	253	9	2	G
G4_BC76_191109_LF_LIB_consensus_vsearch	102	C	Y	367	12	3.01%	2	1	93	93	2.2348143552523473E-4	1	1	132	235	0	12	T
G4_BC76_191109_LF_LIB_consensus_vsearch	103	T	T	385	2	0.51%	2	2	93	93	0.24967658473511495	1	1	130	255	1	1	C
G4_BC76_191109_LF_LIB_consensus_vsearch	104	T	*/+G	375	13	3.25%	2	2	93	93	1.102148449959401E-4	1	1	130	245	3	10	+G
G4_BC76_191109_LF_LIB_consensus_vsearch	105	G	G	397	3	0.74%	2	2	93	93	0.12453066332921275	1	1	142	255	1	2	+A
G4_BC76_191109_LF_LIB_consensus_vsearch	106	A	A	400	1	0.25%	2	1	93	93	0.4999999999999138	1	1	142	258	1	0	+G
G4_BC76_191109_LF_LIB_consensus_vsearch	107	A	A	393	6	1.49%	2	1	93	93	0.015332037719180692	1	1	136	257	6	0	-G
G4_BC76_191109_LF_LIB_consensus_vsearch	108	G	G	383	5	1.25%	2	2	93	93	0.030847556649813805	1	1	129	254	4	1	+A
G4_BC76_191109_LF_LIB_consensus_vsearch	109	A	A	390	5	1.25%	2	1	93	93	0.030854683924238017	1	1	136	254	0	5	-G
G4_BC76_191109_LF_LIB_consensus_vsearch	110	G	G	395	1	0.25%	2	1	93	93	0.5000000000008233	1	1	143	252	0	1	+TT
G4_BC76_191109_LF_LIB_consensus_vsearch	111	T	T	396	6	1.48%	2	1	93	93	0.015334218484153218	1	1	144	252	0	6	C
G4_BC76_191109_LF_LIB_consensus_vsearch	112	C	*/-G	369	28	6.93%	2	2	93	93	2.274791707195234E-9	1	1	117	252	27	1	-G
G4_BC76_191109_LF_LIB_consensus_vsearch	113	G	G	373	3	0.79%	2	2	93	93	0.1245006657791147	1	1	118	255	1	2	-A
G4_BC76_191109_LF_LIB_consensus_vsearch	114	A	A	401	2	0.5%	2	2	93	93	0.24968944099344345	1	1	145	256	1	1	G
G4_BC76_191109_LF_LIB_consensus_vsearch	115	A	*/-T	320	64	15.76%	2	2	93	93	3.087549461764847E-21	1	1	129	191	9	55	-T
G4_BC76_191109_LF_LIB_consensus_vsearch	116	T	T	338	2	0.59%	2	1	93	93	0.24963181148734975	1	1	139	199	0	2	+C
G4_BC76_191109_LF_LIB_consensus_vsearch	117	T	T	396	5	1.23%	2	1	93	93	0.03086059509471206	1	1	147	249	0	5	C
G4_BC76_191109_LF_LIB_consensus_vsearch	118	T	T	403	4	0.98%	2	2	93	93	0.062039029761584305	1	1	145	258	3	1	C
G4_BC76_191109_LF_LIB_consensus_vsearch	119	T	T	390	6	1.47%	2	2	93	93	0.015329823997787357	1	1	143	247	4	2	-G
G4_BC76_191109_LF_LIB_consensus_vsearch	120	G	G	388	3	0.75%	2	1	93	93	0.12451984635071693	1	1	141	247	0	3	+C
G4_BC76_191109_LF_LIB_consensus_vsearch	121	T	Y	376	18	4.49%	2	2	93	93	3.127618879946835E-6	1	1	145	231	1	17	C
G4_BC76_191109_LF_LIB_consensus_vsearch	122	A	A	386	6	1.49%	2	2	93	93	0.015326819799317902	1	1	139	247	2	4	G
G4_BC76_191109_LF_LIB_consensus_vsearch	123	C	Y	386	7	1.75%	2	2	93	93	0.0076048360660226225	1	1	138	248	1	6	T
G4_BC76_191109_LF_LIB_consensus_vsearch	124	A	A	391	2	0.5%	2	2	93	93	0.24968152866242077	1	1	136	255	1	1	G
G4_BC76_191109_LF_LIB_consensus_vsearch	125	T	*/-G	385	8	1.98%	2	2	93	93	0.0037682499633968467	1	1	141	244	2	6	-G
G4_BC76_191109_LF_LIB_consensus_vsearch	126	G	G	389	6	1.51%	2	2	93	93	0.015329078637527195	1	1	140	249	5	1	A
G4_BC76_191109_LF_LIB_consensus_vsearch	127	G	G	399	3	0.74%	2	2	93	93	0.12453300124551302	1	1	146	253	2	1	-C
G4_BC76_191109_LF_LIB_consensus_vsearch	128	C	C	392	4	0.99%	2	2	93	93	0.06202621699451153	1	1	145	247	1	3	T
G4_BC76_191109_LF_LIB_consensus_vsearch	129	T	Y	387	10	2.48%	2	1	93	93	9.221205845541368E-4	1	1	145	242	0	10	C
G4_BC76_191109_LF_LIB_consensus_vsearch	130	A	*/-GC	380	12	2.99%	2	1	93	93	2.2414751491838127E-4	1	1	144	236	0	12	-GC
G4_BC76_191109_LF_LIB_consensus_vsearch	131	G	*/-C	377	8	2.05%	2	2	93	93	0.003765406973524696	1	1	138	239	6	2	-C
G4_BC76_191109_LF_LIB_consensus_vsearch	132	C	C	376	3	0.78%	2	1	93	93	0.12450462351395263	1	1	137	239	0	3	A
G4_BC76_191109_LF_LIB_consensus_vsearch	133	C	C	390	4	0.99%	2	2	93	93	0.062023810487337606	1	1	138	252	2	2	A
G4_BC76_191109_LF_LIB_consensus_vsearch	134	G	*/-TG	377	14	3.47%	2	2	93	93	5.421900571236966E-5	1	1	135	242	3	11	-TG
G4_BC76_191109_LF_LIB_consensus_vsearch	135	T	T	385	2	0.51%	2	1	93	93	0.24967658473511495	1	1	145	240	0	2	C
G4_BC76_191109_LF_LIB_consensus_vsearch	136	G	G	385	3	0.77%	2	1	93	93	0.12451612903217696	1	1	145	240	0	3	+TG
G4_BC76_191109_LF_LIB_consensus_vsearch	137	A	A	400	3	0.74%	2	1	93	93	0.12453416149047736	1	1	144	256	3	0	+C
G4_BC76_191109_LF_LIB_consensus_vsearch	138	C	Y	388	8	1.97%	2	2	93	93	0.0037692867193449852	1	1	144	244	1	7	T
G4_BC76_191109_LF_LIB_consensus_vsearch	139	A	A	396	1	0.25%	2	1	93	93	0.4999999999999138	1	1	144	252	1	0	+GA
G4_BC76_191109_LF_LIB_consensus_vsearch	140	A	A	406	1	0.25%	2	1	93	93	0.4999999999999138	1	1	148	258	0	1	+C
G4_BC76_191109_LF_LIB_consensus_vsearch	141	A	A	396	5	1.23%	2	1	93	93	0.03086059509471206	1	1	146	250	0	5	-T
G4_BC76_191109_LF_LIB_consensus_vsearch	142	T	T	396	3	0.75%	2	1	93	93	0.12452948557099502	1	1	148	248	0	3	+C
G4_BC76_191109_LF_LIB_consensus_vsearch	143	T	T	394	6	1.47%	2	1	93	93	0.015332768266138878	1	1	145	249	0	6	-C
G4_BC76_191109_LF_LIB_consensus_vsearch	144	C	C	394	4	1%	2	1	93	93	0.06202859930052086	1	1	143	251	4	0	-A
G4_BC76_191109_LF_LIB_consensus_vsearch	145	A	*/-G	343	38	9.43%	2	2	93	93	1.378051721953068E-12	1	1	125	218	3	35	-G
G4_BC76_191109_LF_LIB_consensus_vsearch	146	G	G	363	3	0.82%	2	1	93	93	0.12448700410399625	1	1	145	218	0	3	+T
G4_BC76_191109_LF_LIB_consensus_vsearch	147	G	G	397	4	0.99%	2	1	93	93	0.062032128175275904	1	1	144	253	4	0	-A
G4_BC76_191109_LF_LIB_consensus_vsearch	148	A	A	389	6	1.49%	2	2	93	93	0.015329078637527195	1	1	137	252	2	4	G
G4_BC76_191109_LF_LIB_consensus_vsearch	149	G	G	397	3	0.74%	2	1	93	93	0.12453066332921275	1	1	138	259	3	0	-A
G4_BC76_191109_LF_LIB_consensus_vsearch	150	A	A	395	2	0.5%	2	2	93	93	0.24968474148789518	1	1	138	257	1	1	+G
G4_BC76_191109_LF_LIB_consensus_vsearch	151	T	*/-A	384	8	1.98%	2	1	93	93	0.0037679008816766993	1	1	129	255	8	0	-A
G4_BC76_191109_LF_LIB_consensus_vsearch	152	A	A	392	2	0.51%	2	1	93	93	0.24968233799211464	1	1	133	259	2	0	G
G4_BC76_191109_LF_LIB_consensus_vsearch	153	A	M	376	7	1.74%	2	2	93	93	0.007599442747600996	1	1	126	250	4	3	C
G4_BC76_191109_LF_LIB_consensus_vsearch	154	T	*/-A	376	7	1.77%	2	1	93	93	0.007599442747600996	1	1	124	252	7	0	-A
G4_BC76_191109_LF_LIB_consensus_vsearch	155	A	M	379	8	2.02%	2	1	93	93	0.0037661286454389806	1	1	130	249	8	0	C
G4_BC76_191109_LF_LIB_consensus_vsearch	156	C	Y	386	11	2.74%	2	2	93	93	4.551794212032011E-4	1	1	145	241	1	10	T
G4_BC76_191109_LF_LIB_consensus_vsearch	157	A	A	394	3	0.75%	2	2	93	93	0.1245271122321419	1	1	144	250	2	1	G
G4_BC76_191109_LF_LIB_consensus_vsearch	158	T	Y	382	9	2.23%	2	2	93	93	0.00186430447199865	1	1	137	245	4	5	C
G4_BC76_191109_LF_LIB_consensus_vsearch	159	G	G	389	6	1.51%	2	1	93	93	0.015329078637527195	1	1	135	254	6	0	A
G4_BC76_191109_LF_LIB_consensus_vsearch	160	C	*/+A	381	8	2%	2	1	93	93	0.003766842960150322	1	1	137	244	0	8	+A
G4_BC76_191109_LF_LIB_consensus_vsearch	161	A	A	389	6	1.49%	2	2	93	93	0.015329078637527195	1	1	136	253	4	2	-CA
G4_BC76_191109_LF_LIB_consensus_vsearch	162	C	Y	384	10	2.51%	2	2	93	93	9.217129834227815E-4	1	1	141	243	1	9	T
G4_BC76_191109_LF_LIB_consensus_vsearch	163	A	A	389	4	1.01%	2	1	93	93	0.06202259804292181	1	1	138	251	4	0	T
G4_BC76_191109_LF_LIB_consensus_vsearch	164	A	R	389	8	1.99%	2	1	93	93	0.0037696288519149155	1	1	135	254	8	0	G
G4_BC76_191109_LF_LIB_consensus_vsearch	165	C	C	391	4	1%	2	2	93	93	0.06202501678889606	1	1	142	249	3	1	T
G4_BC76_191109_LF_LIB_consensus_vsearch	166	A	A	393	6	1.49%	2	1	93	93	0.015332037719180692	1	1	141	252	6	0	G
G4_BC76_191109_LF_LIB_consensus_vsearch	167	G	G	402	1	0.25%	2	1	93	93	0.4999999999999138	1	1	146	256	1	0	+A
G4_BC76_191109_LF_LIB_consensus_vsearch	168	T	*/-C	385	17	4.19%	2	2	93	93	6.419225802716349E-6	1	1	134	251	11	6	-C
G4_BC76_191109_LF_LIB_consensus_vsearch	169	C	C	385	1	0.26%	2	1	93	93	0.4999999999999138	1	1	133	252	1	0	+T
G4_BC76_191109_LF_LIB_consensus_vsearch	170	C	C	400	3	0.74%	2	1	93	93	0.12453416149047736	1	1	144	256	0	3	+T
G4_BC76_191109_LF_LIB_consensus_vsearch	171	C	Y	391	12	2.95%	2	2	93	93	2.2467848276270147E-4	1	1	146	245	1	11	T
G4_BC76_191109_LF_LIB_consensus_vsearch	172	A	A	402	2	0.49%	2	2	93	93	0.2496902106567468	1	1	146	256	1	1	T
G4_BC76_191109_LF_LIB_consensus_vsearch	173	A	R	384	16	3.93%	2	2	93	93	1.309436672524504E-5	1	1	133	251	15	1	G
G4_BC76_191109_LF_LIB_consensus_vsearch	174	C	C	402	2	0.49%	2	1	93	93	0.2496902106567468	1	1	146	256	2	0	-TC
G4_BC76_191109_LF_LIB_consensus_vsearch	175	T	T	389	6	1.49%	2	2	93	93	0.015329078637527195	1	1	140	249	5	1	+C
G4_BC76_191109_LF_LIB_consensus_vsearch	176	C	*/-A	370	24	5.96%	2	2	93	93	4.1539988169801786E-8	1	1	119	251	23	1	-A
G4_BC76_191109_LF_LIB_consensus_vsearch	177	A	A	373	2	0.53%	2	2	93	93	0.24966622162921065	1	1	122	251	1	1	+G
G4_BC76_191109_LF_LIB_consensus_vsearch	178	A	A	396	3	0.75%	2	1	93	93	0.12452948557099502	1	1	143	253	3	0	-G
G4_BC76_191109_LF_LIB_consensus_vsearch	179	G	*/-AG	370	15	3.73%	2	2	93	93	2.6557536805524368E-5	1	1	118	252	14	1	-AG
G4_BC76_191109_LF_LIB_consensus_vsearch	180	A	A	381	3	0.78%	2	2	93	93	0.12451108213814827	1	1	128	253	1	2	-G
G4_BC76_191109_LF_LIB_consensus_vsearch	181	G	G	382	3	0.78%	2	1	93	93	0.12451235370608407	1	1	133	249	0	3	-TG
G4_BC76_191109_LF_LIB_consensus_vsearch	182	T	*/-G	376	21	5.25%	2	1	93	93	3.6345306648054725E-7	1	1	148	228	0	21	-G
G4_BC76_191109_LF_LIB_consensus_vsearch	183	G	G	378	1	0.26%	2	1	93	93	0.4999999999999138	1	1	148	230	0	1	+CA
G4_BC76_191109_LF_LIB_consensus_vsearch	184	G	G	404	1	0.25%	2	1	93	93	0.4999999999999138	1	1	147	257	0	1	-AC
G4_BC76_191109_LF_LIB_consensus_vsearch	185	A	A	398	2	0.49%	2	1	93	93	0.249687108886017	1	1	146	252	0	2	-CG
G4_BC76_191109_LF_LIB_consensus_vsearch	186	C	C	398	3	0.75%	2	1	93	93	0.12453183520605009	1	1	145	253	3	0	+A
G4_BC76_191109_LF_LIB_consensus_vsearch	187	G	*/-TG	360	35	8.64%	2	1	93	93	1.3237296611577087E-11	1	1	138	222	0	35	-TG
G4_BC76_191109_LF_LIB_consensus_vsearch	188	T	T	368	1	0.27%	2	1	93	93	0.4999999999999138	1	1	148	220	0	1	+A
G4_BC76_191109_LF_LIB_consensus_vsearch	189	G	G	356	6	1.62%	2	1	93	93	0.015302178085640468	1	1	145	211	0	6	+C
G4_BC76_191109_LF_LIB_consensus_vsearch	190	C	C	398	2	0.5%	2	2	93	93	0.249687108886017	1	1	145	253	1	1	-T
G4_BC76_191109_LF_LIB_consensus_vsearch	191	T	T	394	5	1.24%	2	2	93	93	0.030858644444955494	1	1	143	251	3	2	C
G4_BC76_191109_LF_LIB_consensus_vsearch	192	C	*/-A	391	7	1.74%	2	1	93	93	0.007607431615374521	1	1	139	252	7	0	-A
G4_BC76_191109_LF_LIB_consensus_vsearch	193	A	*/-T	380	7	1.76%	2	1	93	93	0.007601633344865528	1	1	137	243	0	7	-T
G4_BC76_191109_LF_LIB_consensus_vsearch	194	T	K	375	8	2.04%	2	1	93	93	0.003764677830168862	1	1	134	241	8	0	G
G4_BC76_191109_LF_LIB_consensus_vsearch	195	T	Y	378	9	2.24%	2	2	93	93	0.0018633978545959287	1	1	133	245	3	6	C
G4_BC76_191109_LF_LIB_consensus_vsearch	196	A	*/+G	362	14	3.53%	2	2	93	93	5.395878332906229E-5	1	1	130	232	1	13	+G
G4_BC76_191109_LF_LIB_consensus_vsearch	197	G	G	393	6	1.49%	2	1	93	93	0.015332037719180692	1	1	139	254	6	0	-A
G4_BC76_191109_LF_LIB_consensus_vsearch	198	A	R	385	10	2.51%	2	1	93	93	9.218495267512253E-4	1	1	132	253	10	0	G
G4_BC76_191109_LF_LIB_consensus_vsearch	199	T	*/-C	353	46	11.33%	2	1	93	93	3.588564266208836E-15	1	1	98	255	46	0	-C
G4_BC76_191109_LF_LIB_consensus_vsearch	200	C	C	355	4	1.11%	2	1	93	93	0.061977353190804614	1	1	100	255	0	4	T
G4_BC76_191109_LF_LIB_consensus_vsearch	201	C	*/-A	386	10	2.46%	2	2	93	93	9.219853921161506E-4	1	1	143	243	2	8	-A
G4_BC76_191109_LF_LIB_consensus_vsearch	202	A	A	393	2	0.5%	2	2	93	93	0.24968314321918028	1	1	143	250	1	1	G
G4_BC76_191109_LF_LIB_consensus_vsearch	203	A	A	405	1	0.25%	2	1	93	93	0.5000000000008233	1	1	147	258	0	1	+G
G4_BC76_191109_LF_LIB_consensus_vsearch	204	A	*/-C	320	71	17.44%	2	2	93	93	1.2810120160444428E-23	1	1	142	178	1	70	-C
G4_BC76_191109_LF_LIB_consensus_vsearch	205	C	*/+T	317	7	2.09%	2	1	93	93	0.007560888445766803	1	1	147	170	0	7	+T
G4_BC76_191109_LF_LIB_consensus_vsearch	206	C	*/-T	386	10	2.46%	2	1	93	93	9.219853921161506E-4	1	1	147	239	0	10	-T
G4_BC76_191109_LF_LIB_consensus_vsearch	207	T	Y	378	12	3.03%	2	2	93	93	2.2404784900264377E-4	1	1	145	233	2	10	C
G4_BC76_191109_LF_LIB_consensus_vsearch	208	C	C	393	2	0.5%	2	1	93	93	0.24968314321918028	1	1	145	248	0	2	+GG
G4_BC76_191109_LF_LIB_consensus_vsearch	209	G	G	400	3	0.74%	2	1	93	93	0.12453416149047736	1	1	145	255	0	3	A
G4_BC76_191109_LF_LIB_consensus_vsearch	210	T	*/-C	389	7	1.72%	2	1	93	93	0.0076064012202881484	1	1	138	251	7	0	-C
G4_BC76_191109_LF_LIB_consensus_vsearch	211	C	C	395	1	0.25%	2	1	93	93	0.5000000000008233	1	1	137	258	1	0	+A
G4_BC76_191109_LF_LIB_consensus_vsearch	212	C	C	396	2	0.49%	2	1	93	93	0.24968553459123424	1	1	144	252	0	2	+T
G4_BC76_191109_LF_LIB_consensus_vsearch	213	T	Y	324	72	17.91%	2	1	93	93	6.0621536090447545E-24	1	1	142	182	0	72	C
G4_BC76_191109_LF_LIB_consensus_vsearch	214	G	G	399	2	0.5%	2	1	93	93	0.24968789013733722	1	1	142	257	2	0	A
G4_BC76_191109_LF_LIB_consensus_vsearch	215	C	Y	323	63	15.56%	2	1	93	93	6.888148679403869E-21	1	1	134	189	0	63	T
G4_BC76_191109_LF_LIB_consensus_vsearch	216	T	T	387	2	0.51%	2	2	93	93	0.24967824967779578	1	1	134	253	1	1	C
G4_BC76_191109_LF_LIB_consensus_vsearch	217	T	T	385	6	1.5%	2	1	93	93	0.01532605917062568	1	1	133	252	6	0	+AC
G4_BC76_191109_LF_LIB_consensus_vsearch	218	G	S	390	7	1.73%	2	1	93	93	0.007606917708857565	1	1	133	257	7	0	C
G4_BC76_191109_LF_LIB_consensus_vsearch	219	C	*/+G	380	8	1.98%	2	1	93	93	0.003766486715388715	1	1	135	245	8	0	+G
G4_BC76_191109_LF_LIB_consensus_vsearch	220	A	*/-G	365	10	2.53%	2	2	93	93	9.189827643807342E-4	1	1	130	235	9	1	-G
G4_BC76_191109_LF_LIB_consensus_vsearch	221	G	G	376	1	0.26%	2	1	93	93	0.5000000000003686	1	1	138	238	0	1	+T
G4_BC76_191109_LF_LIB_consensus_vsearch	222	G	G	390	2	0.51%	2	1	93	93	0.24968071519789278	1	1	145	245	2	0	-C
G4_BC76_191109_LF_LIB_consensus_vsearch	223	C	*/-A	356	20	5.09%	2	2	93	93	7.357615280798297E-7	1	1	128	228	8	12	-A
G4_BC76_191109_LF_LIB_consensus_vsearch	224	A	A	367	2	0.54%	2	1	93	93	0.24966078697405694	1	1	138	229	0	2	G
G4_BC76_191109_LF_LIB_consensus_vsearch	225	A	*/-GGT	384	9	2.23%	2	1	93	93	0.0018647509458963453	1	1	147	237	0	9	-GGT
G4_BC76_191109_LF_LIB_consensus_vsearch	226	G	G	386	2	0.51%	2	1	93	93	0.24967741935460958	1	1	147	239	0	2	+C
G4_BC76_191109_LF_LIB_consensus_vsearch	227	G	G	390	2	0.5%	2	1	93	93	0.24968071519789278	1	1	147	243	0	2	-T
G4_BC76_191109_LF_LIB_consensus_vsearch	228	T	Y	381	8	2.03%	2	2	93	93	0.003766842960150322	1	1	144	237	3	5	C
G4_BC76_191109_LF_LIB_consensus_vsearch	229	G	G	400	2	0.49%	2	1	93	93	0.24968866749695368	1	1	145	255	0	2	C
G4_BC76_191109_LF_LIB_consensus_vsearch	230	A	*/+C	384	7	1.72%	2	1	93	93	0.007603779356567615	1	1	146	238	0	7	+C
G4_BC76_191109_LF_LIB_consensus_vsearch	231	C	*/-T	382	11	2.74%	2	1	93	93	4.548498903980809E-4	1	1	145	237	0	11	-T
G4_BC76_191109_LF_LIB_consensus_vsearch	232	T	*/+C	362	13	3.3%	2	1	93	93	1.0981855360452989E-4	1	1	143	219	0	13	+C
G4_BC76_191109_LF_LIB_consensus_vsearch	233	C	C	385	3	0.76%	2	1	93	93	0.12451612903217696	1	1	143	242	3	0	+GC
G4_BC76_191109_LF_LIB_consensus_vsearch	234	A	A	395	4	0.99%	2	2	93	93	0.06202978149183676	1	1	142	253	3	1	G
G4_BC76_191109_LF_LIB_consensus_vsearch	235	T	*/-A	371	17	4.2%	2	2	93	93	6.378476759468224E-6	1	1	137	234	2	15	-A
G4_BC76_191109_LF_LIB_consensus_vsearch	236	A	R	378	10	2.56%	2	1	93	93	9.208791978192084E-4	1	1	147	231	0	10	G
G4_BC76_191109_LF_LIB_consensus_vsearch	237	A	*/-G	380	13	3.19%	2	1	93	93	1.1036052804577572E-4	1	1	146	234	0	13	-G
G4_BC76_191109_LF_LIB_consensus_vsearch	238	G	*/-C	379	11	2.78%	2	1	93	93	4.5459840602315744E-4	1	1	146	233	0	11	-C
G4_BC76_191109_LF_LIB_consensus_vsearch	239	C	C	391	3	0.76%	2	1	93	93	0.12452350698836272	1	1	146	245	0	3	A
G4_BC76_191109_LF_LIB_consensus_vsearch	240	A	A	402	1	0.25%	2	1	93	93	0.4999999999999138	1	1	145	257	0	1	+C
G4_BC76_191109_LF_LIB_consensus_vsearch	241	T	T	401	4	0.98%	2	2	93	93	0.06203675196794108	1	1	145	256	2	2	C
G4_BC76_191109_LF_LIB_consensus_vsearch	242	C	C	401	3	0.74%	2	1	93	93	0.1245353159851805	1	1	146	255	0	3	T
G4_BC76_191109_LF_LIB_consensus_vsearch	243	A	*/-T	380	21	5.19%	2	2	93	93	3.644649314175973E-7	1	1	142	238	1	20	-T
G4_BC76_191109_LF_LIB_consensus_vsearch	244	T	*/+C	376	8	2.07%	2	1	93	93	0.0037650433430064176	1	1	147	229	0	8	+C
G4_BC76_191109_LF_LIB_consensus_vsearch	245	T	*/+C	367	21	5.15%	2	2	93	93	3.611088560552585E-7	1	1	119	248	19	2	+C
G4_BC76_191109_LF_LIB_consensus_vsearch	246	C	*/-G	310	87	21.75%	2	1	93	93	3.2228983689101044E-29	1	1	147	163	0	87	-G
G4_BC76_191109_LF_LIB_consensus_vsearch	247	G	K	294	21	6.58%	2	1	93	93	3.378377046976539E-7	1	1	146	148	0	21	T
G4_BC76_191109_LF_LIB_consensus_vsearch	248	G	G	402	2	0.49%	2	1	93	93	0.2496902106567468	1	1	146	256	0	2	A
G4_BC76_191109_LF_LIB_consensus_vsearch	249	A	A	398	4	0.99%	2	2	93	93	0.06203329275530562	1	1	144	254	2	2	+C
G4_BC76_191109_LF_LIB_consensus_vsearch	250	C	C	403	3	0.74%	2	2	93	93	0.12453760789147728	1	1	146	257	2	1	T
G4_BC76_191109_LF_LIB_consensus_vsearch	251	C	C	394	5	1.23%	2	1	93	93	0.030858644444955494	1	1	143	251	0	5	T
G4_BC76_191109_LF_LIB_consensus_vsearch	252	G	*/+C	386	7	1.72%	2	1	93	93	0.0076048360660226225	1	1	140	246	0	7	+C
G4_BC76_191109_LF_LIB_consensus_vsearch	253	C	C	403	1	0.25%	2	1	93	93	0.4999999999999138	1	1	147	256	1	0	+TT
G4_BC76_191109_LF_LIB_consensus_vsearch	254	T	Y	387	11	2.7%	2	1	93	93	4.5526079174589983E-4	1	1	147	240	0	11	C
G4_BC76_191109_LF_LIB_consensus_vsearch	255	C	C	394	2	0.5%	2	1	93	93	0.24968394437400754	1	1	145	249	2	0	+GG
G4_BC76_191109_LF_LIB_consensus_vsearch	256	A	*/+G	316	57	14.04%	2	2	93	93	6.837421298934542E-19	1	1	142	174	2	55	+G
G4_BC76_191109_LF_LIB_consensus_vsearch	257	G	G	377	2	0.53%	2	1	93	93	0.2496697490095177	1	1	146	231	2	0	+A
G4_BC76_191109_LF_LIB_consensus_vsearch	258	G	*/+C	387	8	2%	2	1	93	93	0.0037689428690762675	1	1	149	238	0	8	+C
G4_BC76_191109_LF_LIB_consensus_vsearch	259	C	*/-T	260	122	30.42%	2	2	93	93	1.7989811668603422E-42	1	1	145	115	2	120	-T
G4_BC76_191109_LF_LIB_consensus_vsearch	260	T	Y	246	25	9.09%	2	1	93	93	1.668750206804489E-8	1	1	146	100	0	25	C
G4_BC76_191109_LF_LIB_consensus_vsearch	261	T	*/-C	342	28	6.98%	2	1	93	93	2.1912824638093567E-9	1	1	146	196	0	28	-C
G4_BC76_191109_LF_LIB_consensus_vsearch	262	C	*/-A	358	9	2.37%	2	2	93	93	0.0018585722679615095	1	1	146	212	1	8	-A
G4_BC76_191109_LF_LIB_consensus_vsearch	263	A	A	386	5	1.27%	2	2	93	93	0.030850642423789317	1	1	145	241	2	3	G
G4_BC76_191109_LF_LIB_consensus_vsearch	264	T	T	395	5	1.24%	2	2	93	93	0.030859622206549208	1	1	147	248	1	4	C
G4_BC76_191109_LF_LIB_consensus_vsearch	265	G	G	398	3	0.74%	2	1	93	93	0.12453183520605009	1	1	147	251	0	3	+TG
G4_BC76_191109_LF_LIB_consensus_vsearch	266	C	C	400	1	0.25%	2	1	93	93	0.4999999999999138	1	1	147	253	1	0	+AC
G4_BC76_191109_LF_LIB_consensus_vsearch	267	C	C	397	6	1.47%	2	2	93	93	0.015334938209013941	1	1	146	251	2	4	T
G4_BC76_191109_LF_LIB_consensus_vsearch	268	G	G	401	4	0.99%	2	2	93	93	0.06203675196794108	1	1	146	255	3	1	A
G4_BC76_191109_LF_LIB_consensus_vsearch	269	G	G	405	3	0.74%	2	2	93	93	0.1245398773006808	1	1	147	258	2	1	A
G4_BC76_191109_LF_LIB_consensus_vsearch	270	C	*/-GGC	397	7	1.72%	2	2	93	93	0.00761046189928152	1	1	144	253	5	2	-GGC
G4_BC76_191109_LF_LIB_consensus_vsearch	271	G	R	386	13	3.26%	2	1	93	93	1.1053069410618301E-4	1	1	131	255	13	0	A
G4_BC76_191109_LF_LIB_consensus_vsearch	272	G	G	399	1	0.25%	2	1	93	93	0.4999999999999138	1	1	144	255	0	1	+TGG
G4_BC76_191109_LF_LIB_consensus_vsearch	273	C	C	392	4	1%	2	2	93	93	0.06202621699451153	1	1	139	253	2	2	+A
G4_BC76_191109_LF_LIB_consensus_vsearch	274	G	G	393	5	1.24%	2	1	93	93	0.03085766177318207	1	1	145	248	0	5	-CT
G4_BC76_191109_LF_LIB_consensus_vsearch	275	C	*/-T	359	24	6.02%	2	2	93	93	4.109779394937169E-8	1	1	120	239	17	7	-T
G4_BC76_191109_LF_LIB_consensus_vsearch	276	T	T	371	2	0.53%	2	1	93	93	0.24966442953001958	1	1	125	246	2	0	C
G4_BC76_191109_LF_LIB_consensus_vsearch	277	T	*/-C	376	10	2.48%	2	2	93	93	9.205956089622115E-4	1	1	121	255	8	2	-C
G4_BC76_191109_LF_LIB_consensus_vsearch	278	C	C	379	5	1.27%	2	1	93	93	0.030843367333892417	1	1	123	256	5	0	-A
G4_BC76_191109_LF_LIB_consensus_vsearch	279	A	R	381	9	2.24%	2	2	93	93	0.0018640795393290628	1	1	132	249	7	2	G
G4_BC76_191109_LF_LIB_consensus_vsearch	280	T	T	387	5	1.26%	2	1	93	93	0.030851660526274274	1	1	139	248	5	0	G
G4_BC76_191109_LF_LIB_consensus_vsearch	281	T	T	394	4	0.99%	2	2	93	93	0.06202859930052086	1	1	141	253	2	2	-C
G4_BC76_191109_LF_LIB_consensus_vsearch	282	C	*/-A	371	13	3.24%	2	2	93	93	1.10095664708683E-4	1	1	131	240	7	6	-A
G4_BC76_191109_LF_LIB_consensus_vsearch	283	A	R	367	7	1.82%	2	2	93	93	0.0075943435189384555	1	1	133	234	2	5	G
G4_BC76_191109_LF_LIB_consensus_vsearch	284	A	R	374	13	3.25%	2	2	93	93	1.1018527269038747E-4	1	1	139	235	1	12	G
G4_BC76_191109_LF_LIB_consensus_vsearch	285	G	G	387	4	1.01%	2	2	93	93	0.062020154536760255	1	1	140	247	1	3	+C
G4_BC76_191109_LF_LIB_consensus_vsearch	286	T	Y	383	9	2.23%	2	1	93	93	0.001864528271344425	1	1	144	239	0	9	C
G4_BC76_191109_LF_LIB_consensus_vsearch	287	A	A	392	5	1.25%	2	2	93	93	0.030856674154206513	1	1	142	250	1	4	C
G4_BC76_191109_LF_LIB_consensus_vsearch	288	A	R	389	7	1.72%	2	2	93	93	0.0076064012202881484	1	1	141	248	5	2	G
G4_BC76_191109_LF_LIB_consensus_vsearch	289	C	*/-T	390	7	1.72%	2	1	93	93	0.007606917708857565	1	1	142	248	0	7	-T
G4_BC76_191109_LF_LIB_consensus_vsearch	290	T	Y	382	9	2.25%	2	1	93	93	0.00186430447199865	1	1	148	234	0	9	C
G4_BC76_191109_LF_LIB_consensus_vsearch	291	G	*/-C	376	16	3.94%	2	2	93	93	1.3052723597432312E-5	1	1	127	249	15	1	-C
G4_BC76_191109_LF_LIB_consensus_vsearch	292	C	Y	375	8	2.06%	2	1	93	93	0.003764677830168862	1	1	131	244	0	8	T
G4_BC76_191109_LF_LIB_consensus_vsearch	293	C	Y	387	16	3.94%	2	1	93	93	1.3109581232264456E-5	1	1	147	240	0	16	T
G4_BC76_191109_LF_LIB_consensus_vsearch	294	C	C	400	5	1.23%	2	1	93	93	0.030864438634128317	1	1	149	251	0	5	-T
G4_BC76_191109_LF_LIB_consensus_vsearch	295	T	Y	369	29	7.2%	2	2	93	93	1.0973366285617566E-9	1	1	145	224	1	28	C
G4_BC76_191109_LF_LIB_consensus_vsearch	296	A	A	406	0	0%	2	0	93	0	1.0	1	0	147	259	0	0	
G4_BC76_191109_LF_LIB_consensus_vsearch	297	T	T	399	5	1.23%	2	2	93	93	0.030863484879977227	1	1	143	256	2	3	C
G4_BC76_191109_LF_LIB_consensus_vsearch	298	C	*/-AC	392	14	3.43%	2	2	93	93	5.446078876839059E-5	1	1	135	257	12	2	-AC
G4_BC76_191109_LF_LIB_consensus_vsearch	299	A	A	387	1	0.26%	2	1	93	93	0.4999999999999138	1	1	133	254	0	1	+GA
G4_BC76_191109_LF_LIB_consensus_vsearch	300	C	C	389	1	0.25%	2	1	93	93	0.4999999999990043	1	1	134	255	1	0	+AC
G4_BC76_191109_LF_LIB_consensus_vsearch	301	G	G	399	2	0.49%	2	1	93	93	0.24968789013733722	1	1	145	254	0	2	+CG
G4_BC76_191109_LF_LIB_consensus_vsearch	302	T	Y	397	10	2.45%	2	1	93	93	9.234365709559712E-4	1	1	148	249	0	10	C
G4_BC76_191109_LF_LIB_consensus_vsearch	303	T	T	402	2	0.49%	2	1	93	93	0.2496902106567468	1	1	147	255	0	2	C
G4_BC76_191109_LF_LIB_consensus_vsearch	304	G	G	405	3	0.74%	2	2	93	93	0.1245398773006808	1	1	147	258	2	1	A
G4_BC76_191109_LF_LIB_consensus_vsearch	305	T	T	400	4	0.98%	2	2	93	93	0.06203560460879861	1	1	143	257	3	1	C
G4_BC76_191109_LF_LIB_consensus_vsearch	306	C	C	395	4	0.98%	2	1	93	93	0.06202978149183676	1	1	144	251	0	4	-G
G4_BC76_191109_LF_LIB_consensus_vsearch	307	G	R	386	17	4.21%	2	2	93	93	6.422035363153751E-6	1	1	134	252	15	2	A
G4_BC76_191109_LF_LIB_consensus_vsearch	308	G	G	392	6	1.47%	2	2	93	93	0.015331303510572384	1	1	142	250	4	2	T
G4_BC76_191109_LF_LIB_consensus_vsearch	309	T	Y	393	11	2.71%	2	1	93	93	4.557407392548745E-4	1	1	149	244	0	11	C
G4_BC76_191109_LF_LIB_consensus_vsearch	310	T	T	391	5	1.23%	2	2	93	93	0.030855681550508444	1	1	142	249	4	1	+A
G4_BC76_191109_LF_LIB_consensus_vsearch	311	G	G	391	4	0.99%	2	1	93	93	0.06202501678889606	1	1	139	252	4	0	T
G4_BC76_191109_LF_LIB_consensus_vsearch	312	T	Y	376	11	2.73%	2	2	93	93	4.5434311102034934E-4	1	1	137	239	5	6	C
G4_BC76_191109_LF_LIB_consensus_vsearch	313	G	G	389	4	1.01%	2	1	93	93	0.06202259804292181	1	1	142	247	0	4	A
G4_BC76_191109_LF_LIB_consensus_vsearch	314	T	T	388	3	0.76%	2	2	93	93	0.12451984635071693	1	1	139	249	1	2	C
G4_BC76_191109_LF_LIB_consensus_vsearch	315	C	*/-T	389	14	3.46%	2	1	93	93	5.441381266881181E-5	1	1	148	241	0	14	-T
G4_BC76_191109_LF_LIB_consensus_vsearch	316	T	T	390	2	0.51%	2	1	93	93	0.24968071519789278	1	1	149	241	0	2	C
G4_BC76_191109_LF_LIB_consensus_vsearch	317	T	*/-G	306	96	23.59%	2	1	93	93	1.9834390735225643E-32	1	1	149	157	0	96	-G
G4_BC76_191109_LF_LIB_consensus_vsearch	318	G	G	309	2	0.64%	2	1	93	93	0.2495974235104258	1	1	149	160	0	2	T
G4_BC76_191109_LF_LIB_consensus_vsearch	319	G	G	402	3	0.74%	2	2	93	93	0.1245364647713705	1	1	148	254	1	2	A
G4_BC76_191109_LF_LIB_consensus_vsearch	320	A	A	401	3	0.74%	2	1	93	93	0.1245353159851805	1	1	143	258	3	0	-C
G4_BC76_191109_LF_LIB_consensus_vsearch	321	C	C	401	2	0.49%	2	1	93	93	0.24968944099344345	1	1	146	255	0	2	T
G4_BC76_191109_LF_LIB_consensus_vsearch	322	C	C	398	4	0.98%	2	2	93	93	0.06203329275530562	1	1	146	252	1	3	-ACC
G4_BC76_191109_LF_LIB_consensus_vsearch	323	A	A	395	6	1.49%	2	1	93	93	0.015333495178783761	1	1	139	256	6	0	G
G4_BC76_191109_LF_LIB_consensus_vsearch	324	C	C	398	2	0.5%	2	1	93	93	0.249687108886017	1	1	145	253	0	2	+T
G4_BC76_191109_LF_LIB_consensus_vsearch	325	C	Y	378	10	2.48%	2	1	93	93	9.208791978192084E-4	1	1	143	235	0	10	T
G4_BC76_191109_LF_LIB_consensus_vsearch	326	G	G	397	6	1.47%	2	1	93	93	0.015334938209013941	1	1	140	257	6	0	-A
G4_BC76_191109_LF_LIB_consensus_vsearch	327	A	A	389	4	1%	2	2	93	93	0.06202259804292181	1	1	138	251	3	1	G
G4_BC76_191109_LF_LIB_consensus_vsearch	328	G	G	395	3	0.74%	2	2	93	93	0.12452830188671389	1	1	148	247	1	2	+AG
G4_BC76_191109_LF_LIB_consensus_vsearch	329	C	*/-G	377	13	3.23%	2	1	93	93	1.1027355068065241E-4	1	1	147	230	0	13	-G
G4_BC76_191109_LF_LIB_consensus_vsearch	330	G	G	386	5	1.27%	2	1	93	93	0.030850642423789317	1	1	148	238	0	5	T
G4_BC76_191109_LF_LIB_consensus_vsearch	331	G	G	406	1	0.25%	2	1	93	93	0.4999999999999138	1	1	149	257	0	1	C
G4_BC76_191109_LF_LIB_consensus_vsearch	332	A	A	402	4	0.98%	2	2	93	93	0.06203789367157223	1	1	146	256	3	1	G
G4_BC76_191109_LF_LIB_consensus_vsearch	333	C	C	395	6	1.47%	2	2	93	93	0.015333495178783761	1	1	144	251	1	5	T
G4_BC76_191109_LF_LIB_consensus_vsearch	334	G	G	394	3	0.74%	2	1	93	93	0.1245271122321419	1	1	145	249	0	3	+TG
G4_BC76_191109_LF_LIB_consensus_vsearch	335	A	*/-C	390	8	1.98%	2	1	93	93	0.0037699692796093966	1	1	144	246	0	8	-C
G4_BC76_191109_LF_LIB_consensus_vsearch	336	C	*/-GGGT	361	20	5.08%	2	2	93	93	7.383372372820942E-7	1	1	140	221	2	18	-GGGT
G4_BC76_191109_LF_LIB_consensus_vsearch	337	G	R	261	100	26.74%	2	2	93	93	2.6836118064058333E-34	1	1	41	220	99	1	A
G4_BC76_191109_LF_LIB_consensus_vsearch	338	G	S	358	9	2.36%	2	2	93	93	0.0018585722679615095	1	1	134	224	1	8	C
G4_BC76_191109_LF_LIB_consensus_vsearch	339	G	*/-TGG	348	11	2.88%	2	2	93	93	4.5175963040571215E-4	1	1	139	209	1	10	-TGG
G4_BC76_191109_LF_LIB_consensus_vsearch	340	T	-GGT/-GGT	50	286	79.22%	2	2	93	93	4.214660050367408E-138	1	1	37	13	94	192	-GGT
G4_BC76_191109_LF_LIB_consensus_vsearch	341	G	R	52	42	39.62%	2	2	93	93	5.876108741725841E-16	1	1	13	39	33	9	A
G4_BC76_191109_LF_LIB_consensus_vsearch	342	G	R	50	37	33.33%	2	2	93	93	5.406695262466474E-14	1	1	11	39	31	6	A
G4_BC76_191109_LF_LIB_consensus_vsearch	343	T	Y	43	50	48.08%	2	2	93	93	9.136793584391389E-20	1	1	9	34	32	18	C
G4_BC76_191109_LF_LIB_consensus_vsearch	344	A	R	369	12	3.06%	2	2	93	93	2.2358678146341607E-4	1	1	132	237	5	7	G
G4_BC76_191109_LF_LIB_consensus_vsearch	345	A	R	341	49	12.25%	2	2	93	93	3.5548578435639285E-16	1	1	108	233	34	15	G
G4_BC76_191109_LF_LIB_consensus_vsearch	346	C	*/+GGG	16	224	55.86%	2	2	93	93	8.869835698707358E-119	1	1	12	4	37	187	+GGG
G4_BC76_191109_LF_LIB_consensus_vsearch	347	G	*/+A	394	8	1.97%	2	1	93	93	0.0037713141940397903	1	1	140	254	8	0	+A
G4_BC76_191109_LF_LIB_consensus_vsearch	348	A	R	375	21	5.2%	2	2	93	93	3.6319726630784847E-7	1	1	120	255	20	1	G
G4_BC76_191109_LF_LIB_consensus_vsearch	349	A	*/-T	375	16	3.94%	2	2	93	93	1.3047405506016577E-5	1	1	127	248	12	4	-T
G4_BC76_191109_LF_LIB_consensus_vsearch	350	T	K	361	24	6.15%	2	2	93	93	4.1179774318729316E-8	1	1	111	250	23	1	G
G4_BC76_191109_LF_LIB_consensus_vsearch	351	T	*/-A	374	8	1.96%	2	2	93	93	0.003764310420345661	1	1	127	247	5	3	-A
G4_BC76_191109_LF_LIB_consensus_vsearch	352	A	*/+G	341	33	8.25%	2	2	93	93	5.564349157603608E-11	1	1	128	213	2	31	+G
G4_BC76_191109_LF_LIB_consensus_vsearch	353	G	*/-A	381	11	2.79%	2	2	93	93	4.547664803982017E-4	1	1	132	249	7	4	-A
G4_BC76_191109_LF_LIB_consensus_vsearch	354	A	*/-G	380	7	1.79%	2	2	93	93	0.007601633344865528	1	1	132	248	5	2	-G
G4_BC76_191109_LF_LIB_consensus_vsearch	355	G	G	387	3	0.76%	2	2	93	93	0.12451861360729544	1	1	141	246	1	2	-T
G4_BC76_191109_LF_LIB_consensus_vsearch	356	T	T	396	4	0.99%	2	1	93	93	0.06203095776871511	1	1	147	249	0	4	C
G4_BC76_191109_LF_LIB_consensus_vsearch	357	T	T	391	5	1.23%	2	2	93	93	0.030855681550508444	1	1	142	249	4	1	+C
G4_BC76_191109_LF_LIB_consensus_vsearch	358	C	C	394	2	0.5%	2	1	93	93	0.24968394437400754	1	1	147	247	0	2	+G
G4_BC76_191109_LF_LIB_consensus_vsearch	359	G	G	405	0	0%	2	0	93	0	1.0	1	0	149	256	0	0	
G4_BC76_191109_LF_LIB_consensus_vsearch	360	A	A	399	4	0.98%	2	1	93	93	0.06203445155203153	1	1	148	251	0	4	-T
G4_BC76_191109_LF_LIB_consensus_vsearch	361	T	T	395	4	0.99%	2	1	93	93	0.06202978149183676	1	1	148	247	0	4	+C
G4_BC76_191109_LF_LIB_consensus_vsearch	362	T	*/-C	367	35	8.6%	2	2	93	93	1.3428530067355015E-11	1	1	125	242	23	12	-C
G4_BC76_191109_LF_LIB_consensus_vsearch	363	C	C	373	0	0%	2	0	93	0	1.0	1	0	126	247	0	0	
G4_BC76_191109_LF_LIB_consensus_vsearch	364	C	*/-G	322	77	18.87%	2	2	93	93	1.1379445748395653E-25	1	1	145	177	1	76	-G
G4_BC76_191109_LF_LIB_consensus_vsearch	365	G	G	322	3	0.91%	2	1	93	93	0.1244221879814613	1	1	147	175	0	3	T
G4_BC76_191109_LF_LIB_consensus_vsearch	366	G	G	403	2	0.49%	2	1	93	93	0.24969097651407932	1	1	148	255	0	2	-A
G4_BC76_191109_LF_LIB_consensus_vsearch	367	A	A	396	2	0.5%	2	2	93	93	0.24968553459123424	1	1	145	251	1	1	+G
G4_BC76_191109_LF_LIB_consensus_vsearch	368	G	*/-A	346	46	11.44%	2	2	93	93	3.4960344793831906E-15	1	1	100	246	44	2	-A
G4_BC76_191109_LF_LIB_consensus_vsearch	369	A	A	345	6	1.69%	2	2	93	93	0.015292090471053536	1	1	100	245	2	4	G
G4_BC76_191109_LF_LIB_consensus_vsearch	370	A	A	394	3	0.75%	2	1	93	93	0.1245271122321419	1	1	144	250	3	0	+G
G4_BC76_191109_LF_LIB_consensus_vsearch	371	A	A	399	4	0.99%	2	1	93	93	0.06203445155203153	1	1	148	251	0	4	G
G4_BC76_191109_LF_LIB_consensus_vsearch	372	G	G	390	3	0.74%	2	1	93	93	0.12452229299364298	1	1	143	247	0	3	+C
G4_BC76_191109_LF_LIB_consensus_vsearch	373	A	A	389	5	1.25%	2	1	93	93	0.030853681237272182	1	1	142	247	0	5	-G
G4_BC76_191109_LF_LIB_consensus_vsearch	374	G	G	392	2	0.5%	2	1	93	93	0.24968233799211464	1	1	145	247	2	0	+AG
G4_BC76_191109_LF_LIB_consensus_vsearch	375	C	C	394	4	0.99%	2	2	93	93	0.06202859930052086	1	1	147	247	2	2	-AT
G4_BC76_191109_LF_LIB_consensus_vsearch	376	A	A	392	5	1.24%	2	2	93	93	0.030856674154206513	1	1	144	248	1	4	-T
G4_BC76_191109_LF_LIB_consensus_vsearch	377	T	Y	378	8	2.01%	2	2	93	93	0.00376576873622069	1	1	140	238	2	6	C
G4_BC76_191109_LF_LIB_consensus_vsearch	378	G	G	399	3	0.74%	2	2	93	93	0.12453300124551302	1	1	147	252	1	2	-A
G4_BC76_191109_LF_LIB_consensus_vsearch	379	A	A	384	6	1.49%	2	2	93	93	0.015325294651568566	1	1	136	248	3	3	G
G4_BC76_191109_LF_LIB_consensus_vsearch	380	G	G	391	2	0.5%	2	1	93	93	0.24968152866242077	1	1	138	253	2	0	+A
G4_BC76_191109_LF_LIB_consensus_vsearch	381	A	A	392	4	1%	2	2	93	93	0.06202621699451153	1	1	140	252	2	2	G
G4_BC76_191109_LF_LIB_consensus_vsearch	382	C	C	384	6	1.49%	2	2	93	93	0.015325294651568566	1	1	132	252	4	2	-AC
G4_BC76_191109_LF_LIB_consensus_vsearch	383	A	A	384	6	1.52%	2	2	93	93	0.015325294651568566	1	1	133	251	4	2	T
G4_BC76_191109_LF_LIB_consensus_vsearch	384	C	C	380	5	1.25%	2	2	93	93	0.030844422818352438	1	1	133	247	2	3	+T
G4_BC76_191109_LF_LIB_consensus_vsearch	385	G	G	394	5	1.24%	2	2	93	93	0.030858644444955494	1	1	140	254	1	4	T
G4_BC76_191109_LF_LIB_consensus_vsearch	386	G	G	393	4	0.98%	2	1	93	93	0.0620274111497499	1	1	146	247	0	4	+C
G4_BC76_191109_LF_LIB_consensus_vsearch	387	C	*/-T	380	21	5.2%	2	2	93	93	3.644649314175973E-7	1	1	145	235	3	18	-T
G4_BC76_191109_LF_LIB_consensus_vsearch	388	T	*/-C	377	7	1.81%	2	1	93	93	0.007599994652592844	1	1	145	232	0	7	-C
G4_BC76_191109_LF_LIB_consensus_vsearch	389	C	*/-T	306	86	21.45%	2	1	93	93	6.810913355656308E-29	1	1	147	159	0	86	-T
G4_BC76_191109_LF_LIB_consensus_vsearch	390	T	T	313	3	0.94%	2	2	93	93	0.12440570522969861	1	1	147	166	1	2	C
G4_BC76_191109_LF_LIB_consensus_vsearch	391	T	T	395	6	1.49%	2	1	93	93	0.015333495178783761	1	1	147	248	0	6	C
G4_BC76_191109_LF_LIB_consensus_vsearch	392	A	A	393	4	0.99%	2	2	93	93	0.0620274111497499	1	1	143	250	3	1	G
G4_BC76_191109_LF_LIB_consensus_vsearch	393	C	C	399	3	0.74%	2	2	93	93	0.12453300124551302	1	1	147	252	1	2	T
G4_BC76_191109_LF_LIB_consensus_vsearch	394	A	A	397	3	0.74%	2	2	93	93	0.12453066332921275	1	1	144	253	1	2	-T
G4_BC76_191109_LF_LIB_consensus_vsearch	395	T	*/-C	378	20	4.95%	2	2	93	93	7.466592461095931E-7	1	1	125	253	19	1	-C
G4_BC76_191109_LF_LIB_consensus_vsearch	396	C	C	383	2	0.52%	2	1	93	93	0.24967490247067214	1	1	126	257	2	0	+A
G4_BC76_191109_LF_LIB_consensus_vsearch	397	C	*/-A	339	35	8.6%	2	2	93	93	1.2636983434840876E-11	1	1	125	214	8	27	-A
G4_BC76_191109_LF_LIB_consensus_vsearch	398	A	M	346	8	2.2%	2	2	93	93	0.003753188125502644	1	1	134	212	5	3	C
G4_BC76_191109_LF_LIB_consensus_vsearch	399	A	*/-G	368	9	2.26%	2	2	93	93	0.0018610482319175187	1	1	138	230	6	3	-G
G4_BC76_191109_LF_LIB_consensus_vsearch	400	G	K	347	27	6.84%	2	1	93	93	4.579987684166445E-9	1	1	142	205	0	27	T
G4_BC76_191109_LF_LIB_consensus_vsearch	401	G	*/+A	358	19	4.7%	2	1	93	93	1.5116395094531598E-6	1	1	123	235	19	0	+A
G4_BC76_191109_LF_LIB_consensus_vsearch	402	A	A	385	4	1.02%	2	1	93	93	0.06201768588877767	1	1	141	244	0	4	T
G4_BC76_191109_LF_LIB_consensus_vsearch	403	A	*/-G	367	23	5.71%	2	2	93	93	8.535664699388439E-8	1	1	142	225	2	21	-G
G4_BC76_191109_LF_LIB_consensus_vsearch	404	G	*/+C	358	14	3.69%	2	1	93	93	5.388600494176372E-5	1	1	144	214	0	14	+C
G4_BC76_191109_LF_LIB_consensus_vsearch	405	G	G	400	2	0.49%	2	1	93	93	0.24968866749695368	1	1	147	253	0	2	+T
G4_BC76_191109_LF_LIB_consensus_vsearch	406	C	C	388	5	1.23%	2	2	93	93	0.030852673450990298	1	1	144	244	1	4	-A
G4_BC76_191109_LF_LIB_consensus_vsearch	407	A	A	391	3	0.75%	2	2	93	93	0.12452350698836272	1	1	142	249	1	2	-G
G4_BC76_191109_LF_LIB_consensus_vsearch	408	G	R	373	15	3.72%	2	2	93	93	2.6586639991105327E-5	1	1	128	245	13	2	A
G4_BC76_191109_LF_LIB_consensus_vsearch	409	C	C	386	3	0.76%	2	2	93	93	0.12451737451743523	1	1	142	244	2	1	+G
G4_BC76_191109_LF_LIB_consensus_vsearch	410	A	A	382	3	0.76%	2	2	93	93	0.12451235370608407	1	1	140	242	1	2	T
G4_BC76_191109_LF_LIB_consensus_vsearch	411	G	G	384	3	0.77%	2	1	93	93	0.12451487710233766	1	1	140	244	0	3	A
G4_BC76_191109_LF_LIB_consensus_vsearch	412	G	G	399	2	0.5%	2	1	93	93	0.24968789013733722	1	1	147	252	0	2	-C
G4_BC76_191109_LF_LIB_consensus_vsearch	413	C	C	394	3	0.75%	2	2	93	93	0.1245271122321419	1	1	144	250	1	2	T
G4_BC76_191109_LF_LIB_consensus_vsearch	414	G	R	395	8	1.98%	2	2	93	93	0.00377164628554966	1	1	141	254	7	1	A
G4_BC76_191109_LF_LIB_consensus_vsearch	415	C	*/-GC	340	41	10.12%	2	2	93	93	1.458565920881173E-13	1	1	126	214	17	24	-GC
G4_BC76_191109_LF_LIB_consensus_vsearch	416	G	G	337	5	1.44%	2	2	93	93	0.030793467534351974	1	1	124	213	3	2	A
G4_BC76_191109_LF_LIB_consensus_vsearch	417	C	*/-A	256	81	23.08%	2	2	93	93	1.7313070407824527E-27	1	1	122	134	4	77	-A
G4_BC76_191109_LF_LIB_consensus_vsearch	418	A	A	307	1	0.32%	2	1	93	93	0.5000000000003686	1	1	144	163	0	1	G
G4_BC76_191109_LF_LIB_consensus_vsearch	419	A	A	400	1	0.25%	2	1	93	93	0.4999999999999138	1	1	146	254	0	1	+C
G4_BC76_191109_LF_LIB_consensus_vsearch	420	A	*/-T	388	11	2.71%	2	2	93	93	4.5534176337797E-4	1	1	145	243	1	10	-T
G4_BC76_191109_LF_LIB_consensus_vsearch	421	T	T	383	5	1.27%	2	1	93	93	0.030847556649813805	1	1	143	240	5	0	G
G4_BC76_191109_LF_LIB_consensus_vsearch	422	T	*/-AC	378	15	3.7%	2	2	93	93	2.663420769821532E-5	1	1	132	246	14	1	-AC
G4_BC76_191109_LF_LIB_consensus_vsearch	423	A	R	374	7	1.8%	2	2	93	93	0.007598330292913895	1	1	124	250	4	3	G
G4_BC76_191109_LF_LIB_consensus_vsearch	424	C	C	370	6	1.55%	2	1	93	93	0.015314165556293042	1	1	126	244	0	6	+T
G4_BC76_191109_LF_LIB_consensus_vsearch	425	C	S	382	14	3.44%	2	2	93	93	5.430154987343997E-5	1	1	132	250	13	1	G
G4_BC76_191109_LF_LIB_consensus_vsearch	426	C	Y	375	22	5.39%	2	2	93	93	1.7678958990507014E-7	1	1	143	232	4	18	T
G4_BC76_191109_LF_LIB_consensus_vsearch	427	A	A	394	3	0.75%	2	2	93	93	0.1245271122321419	1	1	144	250	2	1	+C
G4_BC76_191109_LF_LIB_consensus_vsearch	428	A	A	396	5	1.23%	2	1	93	93	0.03086059509471206	1	1	146	250	0	5	C
G4_BC76_191109_LF_LIB_consensus_vsearch	429	T	Y	385	13	3.2%	2	2	93	93	1.1050267709682812E-4	1	1	142	243	4	9	C
G4_BC76_191109_LF_LIB_consensus_vsearch	430	A	A	402	3	0.74%	2	2	93	93	0.1245364647713705	1	1	146	256	1	2	C
G4_BC76_191109_LF_LIB_consensus_vsearch	431	C	C	401	3	0.74%	2	1	93	93	0.1245353159851805	1	1	144	257	3	0	-AC
G4_BC76_191109_LF_LIB_consensus_vsearch	432	A	A	403	2	0.49%	2	1	93	93	0.24969097651407932	1	1	146	257	0	2	-C
G4_BC76_191109_LF_LIB_consensus_vsearch	433	C	*/+AC	252	140	34.74%	2	2	93	93	1.7664194560969623E-49	1	1	80	172	63	77	+AC
G4_BC76_191109_LF_LIB_consensus_vsearch	434	G	R	253	147	36.12%	2	2	93	93	3.598830552421152E-52	1	1	128	125	19	128	A
G4_BC76_191109_LF_LIB_consensus_vsearch	435	T	Y	255	147	36.39%	2	2	93	93	3.9871971139817526E-52	1	1	128	127	20	127	C
G4_BC76_191109_LF_LIB_consensus_vsearch	436	G	G	395	6	1.48%	2	1	93	93	0.015333495178783761	1	1	148	247	0	6	-TGTG
G4_BC76_191109_LF_LIB_consensus_vsearch	437	T	Y	389	8	2.01%	2	2	93	93	0.0037696288519149155	1	1	148	241	1	7	C
G4_BC76_191109_LF_LIB_consensus_vsearch	438	G	*/-TG	344	52	13.03%	2	2	93	93	3.6993821840945534E-17	1	1	140	204	7	45	-TG
G4_BC76_191109_LF_LIB_consensus_vsearch	439	T	T	334	3	0.87%	2	1	93	93	0.12444279346210338	1	1	135	199	3	0	+A
G4_BC76_191109_LF_LIB_consensus_vsearch	440	G	*/-AG	331	9	2.6%	2	1	93	93	0.0018511701245308928	1	1	129	202	9	0	-AG
G4_BC76_191109_LF_LIB_consensus_vsearch	441	A	*/-G	358	21	5.32%	2	2	93	93	3.5866641692660115E-7	1	1	109	249	19	2	-G
G4_BC76_191109_LF_LIB_consensus_vsearch	442	G	G	366	5	1.33%	2	1	93	93	0.03082912861416539	1	1	113	253	5	0	+A
G4_BC76_191109_LF_LIB_consensus_vsearch	443	G	G	403	2	0.49%	2	2	93	93	0.24969097651407932	1	1	147	256	1	1	A
G4_BC76_191109_LF_LIB_consensus_vsearch	444	T	Y	389	10	2.45%	2	1	93	93	9.223889705434762E-4	1	1	148	241	0	10	C
G4_BC76_191109_LF_LIB_consensus_vsearch	445	A	A	398	6	1.47%	2	2	93	93	0.015335654379945	1	1	143	255	5	1	G
G4_BC76_191109_LF_LIB_consensus_vsearch	446	G	G	393	5	1.23%	2	1	93	93	0.03085766177318207	1	1	149	244	0	5	-C
G4_BC76_191109_LF_LIB_consensus_vsearch	447	C	C	387	5	1.25%	2	1	93	93	0.030851660526274274	1	1	146	241	0	5	A
G4_BC76_191109_LF_LIB_consensus_vsearch	448	G	G	396	3	0.74%	2	1	93	93	0.12452948557099502	1	1	145	251	0	3	+CG
G4_BC76_191109_LF_LIB_consensus_vsearch	449	A	A	403	2	0.49%	2	1	93	93	0.24969097651407932	1	1	144	259	2	0	G
G4_BC76_191109_LF_LIB_consensus_vsearch	450	C	C	393	6	1.48%	2	2	93	93	0.015332037719180692	1	1	143	250	2	4	T
G4_BC76_191109_LF_LIB_consensus_vsearch	451	A	A	399	2	0.49%	2	1	93	93	0.24968789013733722	1	1	146	253	0	2	+G
G4_BC76_191109_LF_LIB_consensus_vsearch	452	G	G	391	4	0.99%	2	1	93	93	0.06202501678889606	1	1	142	249	0	4	-TA
G4_BC76_191109_LF_LIB_consensus_vsearch	453	T	Y	389	7	1.75%	2	1	93	93	0.0076064012202881484	1	1	147	242	0	7	C
G4_BC76_191109_LF_LIB_consensus_vsearch	454	A	A	395	2	0.5%	2	1	93	93	0.24968474148789518	1	1	147	248	0	2	-CA
G4_BC76_191109_LF_LIB_consensus_vsearch	455	C	C	396	4	0.99%	2	2	93	93	0.06203095776871511	1	1	146	250	1	3	T
G4_BC76_191109_LF_LIB_consensus_vsearch	456	A	*/+CA	390	11	2.72%	2	1	93	93	4.555025215794059E-4	1	1	135	255	11	0	+CA
G4_BC76_191109_LF_LIB_consensus_vsearch	457	T	T	389	5	1.23%	2	1	93	93	0.030853681237272182	1	1	146	243	0	5	+A
G4_BC76_191109_LF_LIB_consensus_vsearch	458	A	A	400	1	0.25%	2	1	93	93	0.4999999999999138	1	1	148	252	0	1	+C
G4_BC76_191109_LF_LIB_consensus_vsearch	459	A	A	394	4	0.99%	2	1	93	93	0.06202859930052086	1	1	145	249	0	4	+T
G4_BC76_191109_LF_LIB_consensus_vsearch	460	C	C	395	4	0.99%	2	1	93	93	0.06202978149183676	1	1	145	250	0	4	A
G4_BC76_191109_LF_LIB_consensus_vsearch	461	A	A	401	2	0.5%	2	2	93	93	0.24968944099344345	1	1	145	256	1	1	+CA
G4_BC76_191109_LF_LIB_consensus_vsearch	462	A	A	398	2	0.49%	2	1	93	93	0.249687108886017	1	1	146	252	0	2	-TGG
G4_BC76_191109_LF_LIB_consensus_vsearch	463	T	*/-G	370	18	4.46%	2	2	93	93	3.117806163061259E-6	1	1	142	228	5	13	-G
G4_BC76_191109_LF_LIB_consensus_vsearch	464	G	G	377	2	0.52%	2	1	93	93	0.2496697490095177	1	1	140	237	0	2	+TG
G4_BC76_191109_LF_LIB_consensus_vsearch	465	G	G	398	3	0.75%	2	1	93	93	0.12453183520605009	1	1	148	250	0	3	A
G4_BC76_191109_LF_LIB_consensus_vsearch	466	G	G	396	5	1.23%	2	2	93	93	0.03086059509471206	1	1	146	250	1	4	A
G4_BC76_191109_LF_LIB_consensus_vsearch	467	G	G	395	6	1.48%	2	2	93	93	0.015333495178783761	1	1	145	250	3	3	A
G4_BC76_191109_LF_LIB_consensus_vsearch	468	C	*/-GC	382	11	2.73%	2	2	93	93	4.548498903980809E-4	1	1	144	238	3	8	-GC
G4_BC76_191109_LF_LIB_consensus_vsearch	469	G	G	377	6	1.53%	2	1	93	93	0.01531983153360656	1	1	137	240	6	0	A
G4_BC76_191109_LF_LIB_consensus_vsearch	470	C	*/+A	339	33	8.35%	2	1	93	93	5.5412884600981906E-11	1	1	137	202	0	33	+A
G4_BC76_191109_LF_LIB_consensus_vsearch	471	A	A	391	4	0.99%	2	1	93	93	0.06202501678889606	1	1	141	250	0	4	+T
G4_BC76_191109_LF_LIB_consensus_vsearch	472	C	Y	351	44	10.86%	2	2	93	93	1.5995953842466595E-14	1	1	137	214	5	39	T
G4_BC76_191109_LF_LIB_consensus_vsearch	473	G	G	396	3	0.74%	2	1	93	93	0.12452948557099502	1	1	142	254	3	0	-A
G4_BC76_191109_LF_LIB_consensus_vsearch	474	A	A	393	5	1.24%	2	2	93	93	0.03085766177318207	1	1	141	252	1	4	-G
G4_BC76_191109_LF_LIB_consensus_vsearch	475	G	G	393	4	1%	2	1	93	93	0.0620274111497499	1	1	142	251	4	0	A
G4_BC76_191109_LF_LIB_consensus_vsearch	476	C	C	393	5	1.23%	2	2	93	93	0.03085766177318207	1	1	144	249	2	3	-A
G4_BC76_191109_LF_LIB_consensus_vsearch	477	A	A	394	6	1.49%	2	2	93	93	0.015332768266138878	1	1	145	249	2	4	G
G4_BC76_191109_LF_LIB_consensus_vsearch	478	A	A	398	5	1.23%	2	2	93	93	0.030862526395586183	1	1	144	254	3	2	G
G4_BC76_191109_LF_LIB_consensus_vsearch	479	T	Y	398	7	1.73%	2	1	93	93	0.007610958261497833	1	1	148	250	0	7	C
G4_BC76_191109_LF_LIB_consensus_vsearch	480	G	*/-TG	376	24	5.9%	2	2	93	93	4.1772503633731856E-8	1	1	146	230	1	23	-TG
G4_BC76_191109_LF_LIB_consensus_vsearch	481	T	T	368	5	1.32%	2	1	93	93	0.03083138374265857	1	1	147	221	0	5	+G
G4_BC76_191109_LF_LIB_consensus_vsearch	482	G	G	381	2	0.52%	2	1	93	93	0.24967320261436957	1	1	146	235	2	0	-A
G4_BC76_191109_LF_LIB_consensus_vsearch	483	A	*/+C	381	11	2.71%	2	1	93	93	4.547664803982017E-4	1	1	126	255	11	0	+C
G4_BC76_191109_LF_LIB_consensus_vsearch	484	C	*/+T	389	7	1.76%	2	1	93	93	0.0076064012202881484	1	1	141	248	0	7	+T
G4_BC76_191109_LF_LIB_consensus_vsearch	485	C	*/+T	392	8	1.96%	2	1	93	93	0.0037706450711110975	1	1	149	243	0	8	+T
G4_BC76_191109_LF_LIB_consensus_vsearch	486	T	*/-A	364	33	8.19%	2	2	93	93	5.8182551504492375E-11	1	1	116	248	32	1	-A
G4_BC76_191109_LF_LIB_consensus_vsearch	487	A	A	374	1	0.27%	2	1	93	93	0.5000000000003686	1	1	117	257	0	1	C
G4_BC76_191109_LF_LIB_consensus_vsearch	488	A	R	398	7	1.72%	2	1	93	93	0.007610958261497833	1	1	139	259	7	0	G
G4_BC76_191109_LF_LIB_consensus_vsearch	489	T	K	375	28	6.88%	2	1	93	93	2.2921605699551973E-9	1	1	119	256	28	0	G
G4_BC76_191109_LF_LIB_consensus_vsearch	490	T	*/-G	309	95	23.28%	2	2	93	93	4.7466323506048654E-32	1	1	144	165	2	93	-G
G4_BC76_191109_LF_LIB_consensus_vsearch	491	G	G	310	1	0.32%	2	1	93	93	0.5000000000003686	1	1	145	165	1	0	+A
G4_BC76_191109_LF_LIB_consensus_vsearch	492	G	G	401	3	0.74%	2	1	93	93	0.1245353159851805	1	1	146	255	0	3	A
G4_BC76_191109_LF_LIB_consensus_vsearch	493	A	A	401	4	0.99%	2	2	93	93	0.06203675196794108	1	1	145	256	2	2	G
G4_BC76_191109_LF_LIB_consensus_vsearch	494	A	A	403	3	0.74%	2	2	93	93	0.12453760789147728	1	1	146	257	2	1	G
G4_BC76_191109_LF_LIB_consensus_vsearch	495	T	T	390	6	1.47%	2	1	93	93	0.015329823997787357	1	1	139	251	6	0	+A
G4_BC76_191109_LF_LIB_consensus_vsearch	496	G	G	397	6	1.48%	2	2	93	93	0.015334938209013941	1	1	144	253	4	2	-A
G4_BC76_191109_LF_LIB_consensus_vsearch	497	A	A	398	1	0.25%	2	1	93	93	0.4999999999999138	1	1	143	255	1	0	-G
G4_BC76_191109_LF_LIB_consensus_vsearch	498	G	*/-C	391	13	3.2%	2	2	93	93	1.1066876939038198E-4	1	1	134	257	12	1	-C
G4_BC76_191109_LF_LIB_consensus_vsearch	499	C	*/+T	345	38	9.64%	2	1	93	93	1.3854231282380954E-12	1	1	137	208	0	38	+T
G4_BC76_191109_LF_LIB_consensus_vsearch	500	C	*/-T	352	32	7.84%	2	1	93	93	1.1870610073943106E-10	1	1	148	204	0	32	-T
G4_BC76_191109_LF_LIB_consensus_vsearch	501	T	*/+C	348	9	2.39%	2	1	93	93	0.001855959493097644	1	1	146	202	0	9	+C
G4_BC76_191109_LF_LIB_consensus_vsearch	502	A	A	398	6	1.47%	2	1	93	93	0.015335654379945	1	1	149	249	0	6	G
G4_BC76_191109_LF_LIB_consensus_vsearch	503	A	A	396	4	0.98%	2	1	93	93	0.06203095776871511	1	1	148	248	0	4	-T
G4_BC76_191109_LF_LIB_consensus_vsearch	504	T	Y	384	10	2.48%	2	2	93	93	9.217129834227815E-4	1	1	140	244	1	9	C
G4_BC76_191109_LF_LIB_consensus_vsearch	505	C	*/-T	395	8	1.96%	2	2	93	93	0.00377164628554966	1	1	147	248	1	7	-T
G4_BC76_191109_LF_LIB_consensus_vsearch	506	T	Y	351	17	4.26%	2	2	93	93	6.31527859295257E-6	1	1	130	221	2	15	C
G4_BC76_191109_LF_LIB_consensus_vsearch	507	A	A	380	5	1.29%	2	1	93	93	0.030844422818352438	1	1	134	246	0	5	G
G4_BC76_191109_LF_LIB_consensus_vsearch	508	A	A	394	4	1%	2	1	93	93	0.06202859930052086	1	1	146	248	0	4	G
G4_BC76_191109_LF_LIB_consensus_vsearch	509	A	A	396	4	0.98%	2	2	93	93	0.06203095776871511	1	1	143	253	3	1	-G
G4_BC76_191109_LF_LIB_consensus_vsearch	510	G	*/+C	392	7	1.73%	2	2	93	93	0.007607942959128091	1	1	144	248	1	6	+C
G4_BC76_191109_LF_LIB_consensus_vsearch	511	C	*/-T	381	20	4.94%	2	1	93	93	7.480618802321155E-7	1	1	149	232	0	20	-T
G4_BC76_191109_LF_LIB_consensus_vsearch	512	T	Y	368	10	2.58%	2	1	93	93	9.194317755037062E-4	1	1	146	222	0	10	C
G4_BC76_191109_LF_LIB_consensus_vsearch	513	C	C	399	3	0.74%	2	2	93	93	0.12453300124551302	1	1	146	253	1	2	-T
G4_BC76_191109_LF_LIB_consensus_vsearch	514	T	*/+G	373	17	4.22%	2	2	93	93	6.384464791951477E-6	1	1	142	231	1	16	+G
G4_BC76_191109_LF_LIB_consensus_vsearch	515	G	*/-A	387	13	3.23%	2	2	93	93	1.1055857583867697E-4	1	1	132	255	12	1	-A
G4_BC76_191109_LF_LIB_consensus_vsearch	516	A	A	388	5	1.27%	2	2	93	93	0.030852673450990298	1	1	134	254	3	2	-G
G4_BC76_191109_LF_LIB_consensus_vsearch	517	G	*/-T	339	54	13.4%	2	1	93	93	7.855867966944029E-18	1	1	142	197	0	54	-T
G4_BC76_191109_LF_LIB_consensus_vsearch	518	T	T	344	3	0.85%	2	1	93	93	0.12445887445888035	1	1	149	195	0	3	A
G4_BC76_191109_LF_LIB_consensus_vsearch	519	G	G	400	3	0.74%	2	2	93	93	0.12453416149047736	1	1	148	252	1	2	-A
G4_BC76_191109_LF_LIB_consensus_vsearch	520	A	A	400	4	0.99%	2	2	93	93	0.06203560460879861	1	1	146	254	2	2	-G
G4_BC76_191109_LF_LIB_consensus_vsearch	521	G	G	397	2	0.5%	2	1	93	93	0.24968632371350802	1	1	143	254	2	0	-C
G4_BC76_191109_LF_LIB_consensus_vsearch	522	C	*/+A	388	7	1.73%	2	1	93	93	0.007605882130108492	1	1	142	246	0	7	+A
G4_BC76_191109_LF_LIB_consensus_vsearch	523	A	A	398	2	0.5%	2	1	93	93	0.249687108886017	1	1	140	258	2	0	+GCA
G4_BC76_191109_LF_LIB_consensus_vsearch	524	A	R	393	7	1.73%	2	1	93	93	0.007608451759263046	1	1	138	255	7	0	G
G4_BC76_191109_LF_LIB_consensus_vsearch	525	C	C	392	6	1.49%	2	2	93	93	0.015331303510572384	1	1	140	252	2	4	T
G4_BC76_191109_LF_LIB_consensus_vsearch	526	G	*/-A	398	7	1.73%	2	1	93	93	0.007610958261497833	1	1	140	258	7	0	-A
G4_BC76_191109_LF_LIB_consensus_vsearch	527	A	A	397	2	0.5%	2	1	93	93	0.24968632371350802	1	1	140	257	0	2	-T
G4_BC76_191109_LF_LIB_consensus_vsearch	528	T	T	398	5	1.23%	2	1	93	93	0.030862526395586183	1	1	143	255	5	0	G
G4_BC76_191109_LF_LIB_consensus_vsearch	529	T	*/-G	265	135	33.09%	2	1	93	93	2.6150527282023966E-47	1	1	145	120	0	135	-G
G4_BC76_191109_LF_LIB_consensus_vsearch	530	G	G	264	3	1.1%	2	1	93	93	0.1242964352720778	1	1	148	116	0	3	+A
G4_BC76_191109_LF_LIB_consensus_vsearch	531	G	G	399	5	1.23%	2	2	93	93	0.030863484879977227	1	1	146	253	1	4	-A
G4_BC76_191109_LF_LIB_consensus_vsearch	532	A	*/-G	363	21	5.24%	2	2	93	93	3.600358141784112E-7	1	1	131	232	7	14	-G
G4_BC76_191109_LF_LIB_consensus_vsearch	533	G	*/+A	365	8	2.08%	2	1	93	93	0.0037609158733080306	1	1	129	236	8	0	+A
G4_BC76_191109_LF_LIB_consensus_vsearch	534	G	*/+A	360	35	8.6%	2	1	93	93	1.3237296611577087E-11	1	1	103	257	35	0	+A
G4_BC76_191109_LF_LIB_consensus_vsearch	535	G	R	375	18	4.41%	2	2	93	93	3.1260025940381716E-6	1	1	123	252	16	2	A
G4_BC76_191109_LF_LIB_consensus_vsearch	536	C	*/-A	371	10	2.49%	2	2	93	93	9.198738399151659E-4	1	1	131	240	6	4	-A
G4_BC76_191109_LF_LIB_consensus_vsearch	537	A	A	381	6	1.55%	2	1	93	93	0.01532297745106865	1	1	136	245	6	0	+G
G4_BC76_191109_LF_LIB_consensus_vsearch	538	A	A	391	4	1%	2	1	93	93	0.06202501678889606	1	1	142	249	4	0	G
G4_BC76_191109_LF_LIB_consensus_vsearch	539	G	R	389	7	1.72%	2	1	93	93	0.0076064012202881484	1	1	138	251	7	0	A
G4_BC76_191109_LF_LIB_consensus_vsearch	540	T	Y	396	9	2.22%	2	2	93	93	0.0018673383028544072	1	1	148	248	1	8	C
G4_BC76_191109_LF_LIB_consensus_vsearch	541	C	C	393	6	1.47%	2	2	93	93	0.015332037719180692	1	1	145	248	1	5	-T
G4_BC76_191109_LF_LIB_consensus_vsearch	542	T	*/-G	329	48	11.94%	2	2	93	93	7.1885520247645515E-16	1	1	139	190	1	47	-G
G4_BC76_191109_LF_LIB_consensus_vsearch	543	G	G	345	4	1.12%	2	2	93	93	0.061962366978748344	1	1	141	204	3	1	A
G4_BC76_191109_LF_LIB_consensus_vsearch	544	G	S	382	9	2.22%	2	1	93	93	0.00186430447199865	1	1	143	239	0	9	C
G4_BC76_191109_LF_LIB_consensus_vsearch	545	T	Y	335	47	11.63%	2	2	93	93	1.5733122586236098E-15	1	1	145	190	1	46	C
G4_BC76_191109_LF_LIB_consensus_vsearch	546	G	G	394	2	0.5%	2	1	93	93	0.24968394437400754	1	1	145	249	2	0	+C
G4_BC76_191109_LF_LIB_consensus_vsearch	547	C	C	393	3	0.75%	2	2	93	93	0.12452591656124207	1	1	146	247	2	1	T
G4_BC76_191109_LF_LIB_consensus_vsearch	548	C	C	391	4	0.99%	2	2	93	93	0.06202501678889606	1	1	144	247	1	3	T
G4_BC76_191109_LF_LIB_consensus_vsearch	549	A	A	389	4	1%	2	1	93	93	0.06202259804292181	1	1	145	244	0	4	T
G4_BC76_191109_LF_LIB_consensus_vsearch	550	G	G	396	2	0.5%	2	1	93	93	0.24968553459123424	1	1	142	254	2	0	A
G4_BC76_191109_LF_LIB_consensus_vsearch	551	C	C	396	5	1.23%	2	2	93	93	0.03086059509471206	1	1	144	252	2	3	T
G4_BC76_191109_LF_LIB_consensus_vsearch	552	A	A	397	3	0.74%	2	2	93	93	0.12453066332921275	1	1	142	255	1	2	T
G4_BC76_191109_LF_LIB_consensus_vsearch	553	G	G	388	6	1.49%	2	1	93	93	0.015328329503561841	1	1	134	254	6	0	-C
G4_BC76_191109_LF_LIB_consensus_vsearch	554	C	C	389	4	1.01%	2	2	93	93	0.06202259804292181	1	1	136	253	2	2	T
G4_BC76_191109_LF_LIB_consensus_vsearch	555	C	C	392	5	1.24%	2	2	93	93	0.030856674154206513	1	1	140	252	1	4	T
G4_BC76_191109_LF_LIB_consensus_vsearch	556	G	G	392	4	0.99%	2	2	93	93	0.06202621699451153	1	1	136	256	3	1	A
G4_BC76_191109_LF_LIB_consensus_vsearch	557	C	Y	383	17	4.18%	2	2	93	93	6.413567375628306E-6	1	1	140	243	6	11	T
G4_BC76_191109_LF_LIB_consensus_vsearch	558	G	R	383	18	4.44%	2	2	93	93	3.13872460829863E-6	1	1	131	252	16	2	A
G4_BC76_191109_LF_LIB_consensus_vsearch	559	G	G	403	3	0.74%	2	1	93	93	0.12453760789147728	1	1	144	259	3	0	A
G4_BC76_191109_LF_LIB_consensus_vsearch	560	T	*/-A	395	9	2.21%	2	2	93	93	0.0018671284895574335	1	1	143	252	4	5	-A
G4_BC76_191109_LF_LIB_consensus_vsearch	561	A	A	395	3	0.75%	2	1	93	93	0.12452830188671389	1	1	142	253	3	0	G
G4_BC76_191109_LF_LIB_consensus_vsearch	562	A	A	399	5	1.23%	2	1	93	93	0.030863484879977227	1	1	148	251	0	5	-T
G4_BC76_191109_LF_LIB_consensus_vsearch	563	T	T	394	4	1%	2	1	93	93	0.06202859930052086	1	1	148	246	0	4	C
G4_BC76_191109_LF_LIB_consensus_vsearch	564	T	*/-C	386	17	4.17%	2	2	93	93	6.422035363153751E-6	1	1	135	251	11	6	-C
G4_BC76_191109_LF_LIB_consensus_vsearch	565	C	C	389	1	0.26%	2	1	93	93	0.4999999999990043	1	1	138	251	0	1	G
G4_BC76_191109_LF_LIB_consensus_vsearch	566	C	C	396	4	0.98%	2	2	93	93	0.06203095776871511	1	1	144	252	1	3	T
G4_BC76_191109_LF_LIB_consensus_vsearch	567	A	A	392	4	1%	2	2	93	93	0.06202621699451153	1	1	141	251	3	1	G
G4_BC76_191109_LF_LIB_consensus_vsearch	568	G	G	396	4	0.99%	2	1	93	93	0.06203095776871511	1	1	140	256	4	0	A
G4_BC76_191109_LF_LIB_consensus_vsearch	569	C	*/-T	382	20	4.94%	2	2	93	93	7.485252334873302E-7	1	1	146	236	1	19	-T
G4_BC76_191109_LF_LIB_consensus_vsearch	570	T	T	375	3	0.78%	2	2	93	93	0.1245033112582789	1	1	140	235	2	1	-C
G4_BC76_191109_LF_LIB_consensus_vsearch	571	C	C	400	1	0.25%	2	1	93	93	0.4999999999999138	1	1	143	257	0	1	+A
G4_BC76_191109_LF_LIB_consensus_vsearch	572	C	C	397	3	0.74%	2	2	93	93	0.12453066332921275	1	1	141	256	2	1	+G
G4_BC76_191109_LF_LIB_consensus_vsearch	573	A	A	398	1	0.25%	2	1	93	93	0.4999999999999138	1	1	140	258	1	0	+G
G4_BC76_191109_LF_LIB_consensus_vsearch	574	C	C	392	6	1.48%	2	2	93	93	0.015331303510572384	1	1	140	252	3	3	T
G4_BC76_191109_LF_LIB_consensus_vsearch	575	G	G	395	4	0.99%	2	1	93	93	0.06202978149183676	1	1	141	254	4	0	-A
G4_BC76_191109_LF_LIB_consensus_vsearch	576	A	A	397	3	0.75%	2	2	93	93	0.12453066332921275	1	1	141	256	2	1	-G
G4_BC76_191109_LF_LIB_consensus_vsearch	577	G	G	398	2	0.5%	2	2	93	93	0.249687108886017	1	1	144	254	1	1	-CG
G4_BC76_191109_LF_LIB_consensus_vsearch	578	C	C	396	2	0.5%	2	1	93	93	0.24968553459123424	1	1	147	249	0	2	+G
G4_BC76_191109_LF_LIB_consensus_vsearch	579	G	*/-T	392	7	1.74%	2	2	93	93	0.007607942959128091	1	1	146	246	1	6	-T
G4_BC76_191109_LF_LIB_consensus_vsearch	580	T	T	391	5	1.25%	2	1	93	93	0.030855681550508444	1	1	147	244	0	5	-A
G4_BC76_191109_LF_LIB_consensus_vsearch	581	A	A	395	3	0.75%	2	1	93	93	0.12452830188671389	1	1	146	249	0	3	G
G4_BC76_191109_LF_LIB_consensus_vsearch	582	T	*/-AT	372	18	4.47%	2	2	93	93	3.121107952031818E-6	1	1	135	237	8	10	-AT
G4_BC76_191109_LF_LIB_consensus_vsearch	583	A	R	369	9	2.35%	2	2	93	93	0.001861288716262604	1	1	134	235	3	6	G
G4_BC76_191109_LF_LIB_consensus_vsearch	584	T	Y	365	8	2.09%	2	1	93	93	0.0037609158733080306	1	1	136	229	0	8	C
G4_BC76_191109_LF_LIB_consensus_vsearch	585	G	*/-TG	364	26	6.45%	2	2	93	93	9.685292343917265E-9	1	1	134	230	5	21	-TG
G4_BC76_191109_LF_LIB_consensus_vsearch	586	T	T	358	5	1.35%	2	2	93	93	0.030819859779619867	1	1	132	226	3	2	+G
G4_BC76_191109_LF_LIB_consensus_vsearch	587	G	*/-A	358	7	1.84%	2	1	93	93	0.007588994233841693	1	1	128	230	7	0	-A
G4_BC76_191109_LF_LIB_consensus_vsearch	588	A	R	382	8	2%	2	2	93	93	0.0037671973936205536	1	1	127	255	6	2	G
G4_BC76_191109_LF_LIB_consensus_vsearch	589	G	G	388	4	0.99%	2	1	93	93	0.0620213794085142	1	1	133	255	4	0	+A
G4_BC76_191109_LF_LIB_consensus_vsearch	590	T	Y	387	13	3.23%	2	1	93	93	1.1055857583867697E-4	1	1	142	245	0	13	C
G4_BC76_191109_LF_LIB_consensus_vsearch	591	T	*/+A	385	12	2.95%	2	1	93	93	2.2439240943114192E-4	1	1	133	252	12	0	+A
G4_BC76_191109_LF_LIB_consensus_vsearch	592	G	K	381	12	2.96%	2	1	93	93	2.2419697823514463E-4	1	1	126	255	12	0	T
G4_BC76_191109_LF_LIB_consensus_vsearch	593	T	Y	384	19	4.69%	2	2	93	93	1.5350322571760348E-6	1	1	148	236	1	18	C
G4_BC76_191109_LF_LIB_consensus_vsearch	594	T	T	400	3	0.74%	2	1	93	93	0.12453416149047736	1	1	147	253	0	3	C
G4_BC76_191109_LF_LIB_consensus_vsearch	595	G	G	389	4	0.99%	2	2	93	93	0.06202259804292181	1	1	140	249	3	1	C
G4_BC76_191109_LF_LIB_consensus_vsearch	596	C	C	388	5	1.24%	2	2	93	93	0.030852673450990298	1	1	144	244	1	4	-A
G4_BC76_191109_LF_LIB_consensus_vsearch	597	A	R	379	13	3.26%	2	2	93	93	1.1033167832753745E-4	1	1	134	245	9	4	G
G4_BC76_191109_LF_LIB_consensus_vsearch	598	G	*/-T	384	9	2.24%	2	2	93	93	0.0018647509458963453	1	1	139	245	3	6	-T
G4_BC76_191109_LF_LIB_consensus_vsearch	599	T	T	391	3	0.76%	2	1	93	93	0.12452350698836272	1	1	146	245	0	3	C
G4_BC76_191109_LF_LIB_consensus_vsearch	600	T	*/-A	343	39	9.68%	2	2	93	93	6.547100251732815E-13	1	1	142	201	2	37	-A
G4_BC76_191109_LF_LIB_consensus_vsearch	601	A	A	357	6	1.63%	2	2	93	93	0.015303064911388683	1	1	144	213	1	5	C
G4_BC76_191109_LF_LIB_consensus_vsearch	602	A	A	403	3	0.74%	2	2	93	93	0.12453760789147728	1	1	147	256	1	2	G
G4_BC76_191109_LF_LIB_consensus_vsearch	603	A	A	404	1	0.25%	2	1	93	93	0.4999999999999138	1	1	147	257	1	0	+G
G4_BC76_191109_LF_LIB_consensus_vsearch	604	A	A	401	4	0.98%	2	2	93	93	0.06203675196794108	1	1	146	255	2	2	G
G4_BC76_191109_LF_LIB_consensus_vsearch	605	C	C	399	3	0.74%	2	1	93	93	0.12453300124551302	1	1	145	254	3	0	+A
G4_BC76_191109_LF_LIB_consensus_vsearch	606	G	*/-TG	368	25	6.16%	2	2	93	93	2.0096772623453192E-8	1	1	138	230	1	24	-TG
G4_BC76_191109_LF_LIB_consensus_vsearch	607	T	T	369	6	1.57%	2	2	93	93	0.015313338910416455	1	1	145	224	1	5	C
G4_BC76_191109_LF_LIB_consensus_vsearch	608	G	G	372	2	0.52%	2	1	93	93	0.24966532797869725	1	1	142	230	0	2	+TG
G4_BC76_191109_LF_LIB_consensus_vsearch	609	C	C	400	2	0.5%	2	1	93	93	0.24968866749695368	1	1	144	256	2	0	A
G4_BC76_191109_LF_LIB_consensus_vsearch	610	G	G	400	4	0.99%	2	1	93	93	0.06203560460879861	1	1	142	258	4	0	A
G4_BC76_191109_LF_LIB_consensus_vsearch	611	T	*/-A	384	7	1.72%	2	1	93	93	0.007603779356567615	1	1	143	241	0	7	-A
G4_BC76_191109_LF_LIB_consensus_vsearch	612	A	A	390	6	1.5%	2	2	93	93	0.015329823997787357	1	1	146	244	1	5	G
G4_BC76_191109_LF_LIB_consensus_vsearch	613	G	G	387	4	0.99%	2	2	93	93	0.062020154536760255	1	1	137	250	3	1	-T
G4_BC76_191109_LF_LIB_consensus_vsearch	614	T	Y	377	26	6.45%	2	2	93	93	9.825347123970612E-9	1	1	145	232	1	25	C
G4_BC76_191109_LF_LIB_consensus_vsearch	615	T	T	400	4	0.98%	2	2	93	93	0.06203560460879861	1	1	147	253	1	3	C
G4_BC76_191109_LF_LIB_consensus_vsearch	616	G	G	403	2	0.49%	2	1	93	93	0.24969097651407932	1	1	149	254	0	2	-ATG
G4_BC76_191109_LF_LIB_consensus_vsearch	617	A	A	400	5	1.23%	2	2	93	93	0.030864438634128317	1	1	148	252	1	4	G
G4_BC76_191109_LF_LIB_consensus_vsearch	618	T	T	400	3	0.74%	2	2	93	93	0.12453416149047736	1	1	146	254	1	2	C
G4_BC76_191109_LF_LIB_consensus_vsearch	619	G	G	397	3	0.74%	2	1	93	93	0.12453066332921275	1	1	145	252	0	3	+C
G4_BC76_191109_LF_LIB_consensus_vsearch	620	C	*/-T	396	8	1.98%	2	2	93	93	0.0037719767465882576	1	1	144	252	2	6	-T
G4_BC76_191109_LF_LIB_consensus_vsearch	621	T	Y	370	14	3.51%	2	1	93	93	5.409998888327447E-5	1	1	132	238	0	14	C
G4_BC76_191109_LF_LIB_consensus_vsearch	622	C	C	391	5	1.23%	2	2	93	93	0.030855681550508444	1	1	138	253	3	2	-A
G4_BC76_191109_LF_LIB_consensus_vsearch	623	A	*/-G	266	95	23.87%	2	2	93	93	1.9958401009747206E-32	1	1	96	170	39	56	-G
G4_BC76_191109_LF_LIB_consensus_vsearch	624	G	G	286	3	1.02%	2	2	93	93	0.12435008665509122	1	1	107	179	1	2	T
G4_BC76_191109_LF_LIB_consensus_vsearch	625	G	R	378	9	2.3%	2	2	93	93	0.0018633978545959287	1	1	142	236	6	3	A
G4_BC76_191109_LF_LIB_consensus_vsearch	626	G	R	383	9	2.27%	2	2	93	93	0.001864528271344425	1	1	137	246	7	2	A
G4_BC76_191109_LF_LIB_consensus_vsearch	627	G	G	397	6	1.47%	2	1	93	93	0.015334938209013941	1	1	140	257	6	0	-C
G4_BC76_191109_LF_LIB_consensus_vsearch	628	C	C	396	3	0.75%	2	2	93	93	0.12452948557099502	1	1	140	256	1	2	+G
G4_BC76_191109_LF_LIB_consensus_vsearch	629	C	Y	397	8	1.97%	2	2	93	93	0.003772305589141729	1	1	144	253	3	5	T
G4_BC76_191109_LF_LIB_consensus_vsearch	630	G	G	402	1	0.25%	2	1	93	93	0.4999999999999138	1	1	146	256	0	1	-CG
G4_BC76_191109_LF_LIB_consensus_vsearch	631	C	*/-GC	394	7	1.72%	2	2	93	93	0.007608958034696689	1	1	142	252	6	1	-GC
G4_BC76_191109_LF_LIB_consensus_vsearch	632	G	G	390	6	1.5%	2	2	93	93	0.015329823997787357	1	1	136	254	5	1	-C
G4_BC76_191109_LF_LIB_consensus_vsearch	633	C	*/+T	381	9	2.28%	2	1	93	93	0.0018640795393290628	1	1	136	245	0	9	+T
G4_BC76_191109_LF_LIB_consensus_vsearch	634	C	C	391	6	1.47%	2	1	93	93	0.01533056561273411	1	1	146	245	0	6	+T
G4_BC76_191109_LF_LIB_consensus_vsearch	635	T	Y	368	11	2.72%	2	2	93	93	4.536430226559371E-4	1	1	135	233	2	9	C
G4_BC76_191109_LF_LIB_consensus_vsearch	636	A	R	373	16	4.03%	2	2	93	93	1.3036692196399446E-5	1	1	131	242	9	7	G
G4_BC76_191109_LF_LIB_consensus_vsearch	637	T	Y	376	13	3.3%	2	2	93	93	1.1024427063015114E-4	1	1	137	239	3	10	C
G4_BC76_191109_LF_LIB_consensus_vsearch	638	G	G	394	3	0.74%	2	1	93	93	0.1245271122321419	1	1	141	253	3	0	A
G4_BC76_191109_LF_LIB_consensus_vsearch	639	G	G	389	5	1.23%	2	1	93	93	0.030853681237272182	1	1	139	250	5	0	A
G4_BC76_191109_LF_LIB_consensus_vsearch	640	T	Y	362	9	2.26%	2	2	93	93	0.0018595784596105505	1	1	133	229	1	8	C
G4_BC76_191109_LF_LIB_consensus_vsearch	641	A	A	380	5	1.27%	2	2	93	93	0.030844422818352438	1	1	138	242	3	2	G
G4_BC76_191109_LF_LIB_consensus_vsearch	642	A	R	390	7	1.74%	2	1	93	93	0.007606917708857565	1	1	145	245	0	7	G
G4_BC76_191109_LF_LIB_consensus_vsearch	643	G	G	392	4	1%	2	2	93	93	0.06202621699451153	1	1	142	250	3	1	A
G4_BC76_191109_LF_LIB_consensus_vsearch	644	C	C	397	2	0.49%	2	1	93	93	0.24968632371350802	1	1	147	250	0	2	+G
G4_BC76_191109_LF_LIB_consensus_vsearch	645	A	A	403	1	0.25%	2	1	93	93	0.4999999999999138	1	1	145	258	1	0	+CA
G4_BC76_191109_LF_LIB_consensus_vsearch	646	T	T	394	6	1.47%	2	2	93	93	0.015332768266138878	1	1	141	253	4	2	-C
G4_BC76_191109_LF_LIB_consensus_vsearch	647	C	C	398	1	0.25%	2	1	93	93	0.4999999999999138	1	1	143	255	1	0	+A
G4_BC76_191109_LF_LIB_consensus_vsearch	648	C	*/-T	375	26	6.4%	2	2	93	93	9.804283000189345E-9	1	1	147	228	2	24	-T
G4_BC76_191109_LF_LIB_consensus_vsearch	649	T	T	372	2	0.53%	2	1	93	93	0.24966532797869725	1	1	147	225	0	2	C
G4_BC76_191109_LF_LIB_consensus_vsearch	650	T	T	389	3	0.75%	2	1	93	93	0.12452107279688855	1	1	144	245	3	0	+C
G4_BC76_191109_LF_LIB_consensus_vsearch	651	C	*/-G	316	48	12.06%	2	2	93	93	6.76217436237348E-16	1	1	133	183	9	39	-G
G4_BC76_191109_LF_LIB_consensus_vsearch	652	G	R	322	17	4.97%	2	2	93	93	6.211447452082619E-6	1	1	126	196	14	3	A
G4_BC76_191109_LF_LIB_consensus_vsearch	653	G	G	380	6	1.53%	2	1	93	93	0.015322197067995588	1	1	148	232	0	6	C
G4_BC76_191109_LF_LIB_consensus_vsearch	654	G	R	383	10	2.52%	2	2	93	93	9.215757570452482E-4	1	1	144	239	2	8	A
G4_BC76_191109_LF_LIB_consensus_vsearch	655	G	*/-TGG	395	7	1.72%	2	1	93	93	0.007609461804174083	1	1	148	247	0	7	-TGG
G4_BC76_191109_LF_LIB_consensus_vsearch	656	T	*/-G	361	19	4.75%	2	2	93	93	1.514486893723883E-6	1	1	148	213	1	18	-G
G4_BC76_191109_LF_LIB_consensus_vsearch	657	G	G	366	5	1.32%	2	1	93	93	0.03082912861416539	1	1	146	220	0	5	+CG
G4_BC76_191109_LF_LIB_consensus_vsearch	658	G	G	393	2	0.5%	2	1	93	93	0.24968314321918028	1	1	148	245	0	2	A
G4_BC76_191109_LF_LIB_consensus_vsearch	659	A	*/+T	374	19	4.68%	2	1	93	93	1.5263684541229892E-6	1	1	147	227	0	19	+T
G4_BC76_191109_LF_LIB_consensus_vsearch	660	C	*/-T	357	18	4.49%	2	2	93	93	3.0955569052562397E-6	1	1	136	221	8	10	-T
G4_BC76_191109_LF_LIB_consensus_vsearch	661	T	*/+C	343	25	6.48%	2	1	93	93	1.9547722588782718E-8	1	1	138	205	0	25	+C
G4_BC76_191109_LF_LIB_consensus_vsearch	662	G	R	374	8	2.02%	2	2	93	93	0.003764310420345661	1	1	135	239	5	3	A
G4_BC76_191109_LF_LIB_consensus_vsearch	663	C	Y	370	9	2.3%	2	2	93	93	0.00186152794791742	1	1	140	230	1	8	T
G4_BC76_191109_LF_LIB_consensus_vsearch	664	C	Y	369	16	3.98%	2	2	93	93	1.301495181198242E-5	1	1	141	228	2	14	T
G4_BC76_191109_LF_LIB_consensus_vsearch	665	G	G	378	6	1.52%	2	2	93	93	0.015320624140933634	1	1	139	239	5	1	A
G4_BC76_191109_LF_LIB_consensus_vsearch	666	G	G	392	6	1.48%	2	2	93	93	0.015331303510572384	1	1	141	251	1	5	A
G4_BC76_191109_LF_LIB_consensus_vsearch	667	C	Y	375	17	4.22%	2	1	93	93	6.390395927916272E-6	1	1	144	231	0	17	T
G4_BC76_191109_LF_LIB_consensus_vsearch	668	C	Y	376	24	5.88%	2	1	93	93	4.1772503633731856E-8	1	1	147	229	0	24	T
G4_BC76_191109_LF_LIB_consensus_vsearch	669	G	R	387	13	3.21%	2	2	93	93	1.1055857583867697E-4	1	1	136	251	12	1	A
G4_BC76_191109_LF_LIB_consensus_vsearch	670	G	G	400	2	0.49%	2	2	93	93	0.24968866749695368	1	1	145	255	1	1	-C
G4_BC76_191109_LF_LIB_consensus_vsearch	671	C	C	387	5	1.24%	2	2	93	93	0.030851660526274274	1	1	137	250	4	1	-G
G4_BC76_191109_LF_LIB_consensus_vsearch	672	G	*/-C	304	66	16.75%	2	2	93	93	5.606965236102011E-22	1	1	56	248	65	1	-C
G4_BC76_191109_LF_LIB_consensus_vsearch	673	C	C	321	6	1.8%	2	2	93	93	0.015267732793854377	1	1	73	248	2	4	T
G4_BC76_191109_LF_LIB_consensus_vsearch	674	C	M	389	7	1.73%	2	2	93	93	0.0076064012202881484	1	1	139	250	6	1	A
G4_BC76_191109_LF_LIB_consensus_vsearch	675	C	*/-T	386	15	3.68%	2	2	93	93	2.6707970567795604E-5	1	1	146	240	1	14	-T
G4_BC76_191109_LF_LIB_consensus_vsearch	676	T	Y	360	11	2.82%	2	1	93	93	4.5291345592755075E-4	1	1	141	219	0	11	C
G4_BC76_191109_LF_LIB_consensus_vsearch	677	A	M	378	12	3.06%	2	1	93	93	2.2404784900264377E-4	1	1	140	238	0	12	C
G4_BC76_191109_LF_LIB_consensus_vsearch	678	A	R	386	8	1.99%	2	2	93	93	0.003768597288121233	1	1	137	249	6	2	G
G4_BC76_191109_LF_LIB_consensus_vsearch	679	T	*/+C	377	11	2.76%	2	1	93	93	4.544286380884945E-4	1	1	143	234	0	11	+C
G4_BC76_191109_LF_LIB_consensus_vsearch	680	G	G	393	6	1.49%	2	2	93	93	0.015332037719180692	1	1	140	253	5	1	A
G4_BC76_191109_LF_LIB_consensus_vsearch	681	G	G	395	4	0.99%	2	2	93	93	0.06202978149183676	1	1	140	255	3	1	-C
G4_BC76_191109_LF_LIB_consensus_vsearch	682	C	C	398	3	0.74%	2	2	93	93	0.12453183520605009	1	1	144	254	1	2	T
G4_BC76_191109_LF_LIB_consensus_vsearch	683	C	Y	391	7	1.72%	2	1	93	93	0.007607431615374521	1	1	143	248	0	7	T
G4_BC76_191109_LF_LIB_consensus_vsearch	684	G	*/-TG	380	18	4.44%	2	2	93	93	3.134009125315532E-6	1	1	143	237	1	17	-TG
G4_BC76_191109_LF_LIB_consensus_vsearch	685	T	*/-G	364	13	3.36%	2	2	93	93	1.0988123554092724E-4	1	1	146	218	1	12	-G
G4_BC76_191109_LF_LIB_consensus_vsearch	686	G	G	367	4	1.07%	2	1	93	93	0.061994269529417605	1	1	142	225	4	0	A
G4_BC76_191109_LF_LIB_consensus_vsearch	687	G	G	398	4	0.99%	2	2	93	93	0.06203329275530562	1	1	144	254	3	1	A
G4_BC76_191109_LF_LIB_consensus_vsearch	688	G	G	393	4	0.98%	2	1	93	93	0.0620274111497499	1	1	145	248	0	4	-C
G4_BC76_191109_LF_LIB_consensus_vsearch	689	C	*/-T	372	17	4.24%	2	2	93	93	6.381477938656078E-6	1	1	142	230	5	12	-T
G4_BC76_191109_LF_LIB_consensus_vsearch	690	T	T	374	3	0.79%	2	1	93	93	0.12450199203194236	1	1	140	234	0	3	+C
G4_BC76_191109_LF_LIB_consensus_vsearch	691	T	*/-C	364	29	7.23%	2	2	93	93	1.0896949069747076E-9	1	1	139	225	3	26	-C
G4_BC76_191109_LF_LIB_consensus_vsearch	692	C	*/+T	343	13	3.49%	2	1	93	93	1.0918930528259452E-4	1	1	143	200	0	13	+T
G4_BC76_191109_LF_LIB_consensus_vsearch	693	G	G	395	2	0.5%	2	1	93	93	0.24968474148789518	1	1	148	247	0	2	A
G4_BC76_191109_LF_LIB_consensus_vsearch	694	G	G	388	5	1.23%	2	2	93	93	0.030852673450990298	1	1	143	245	2	3	A
G4_BC76_191109_LF_LIB_consensus_vsearch	695	C	*/-T	360	32	8%	2	1	93	93	1.2041966256890705E-10	1	1	144	216	0	32	-T
G4_BC76_191109_LF_LIB_consensus_vsearch	696	T	*/-C	345	20	5.38%	2	2	93	93	7.298736860370655E-7	1	1	123	222	18	2	-C
G4_BC76_191109_LF_LIB_consensus_vsearch	697	C	C	380	2	0.52%	2	1	93	93	0.2496723460023847	1	1	127	253	0	2	T
G4_BC76_191109_LF_LIB_consensus_vsearch	698	C	*/+G	383	8	1.98%	2	1	93	93	0.0037675500295774327	1	1	146	237	0	8	+G
G4_BC76_191109_LF_LIB_consensus_vsearch	699	G	R	391	8	2%	2	2	93	93	0.003770308015149166	1	1	140	251	5	3	A
G4_BC76_191109_LF_LIB_consensus_vsearch	700	G	G	400	3	0.74%	2	2	93	93	0.12453416149047736	1	1	144	256	2	1	A
G4_BC76_191109_LF_LIB_consensus_vsearch	701	T	T	401	3	0.74%	2	1	93	93	0.1245353159851805	1	1	144	257	3	0	-C
G4_BC76_191109_LF_LIB_consensus_vsearch	702	C	*/-A	392	9	2.22%	2	2	93	93	0.0018664928473143382	1	1	137	255	8	1	-A
G4_BC76_191109_LF_LIB_consensus_vsearch	703	A	A	390	4	1%	2	2	93	93	0.062023810487337606	1	1	136	254	3	1	G
G4_BC76_191109_LF_LIB_consensus_vsearch	704	C	Y	379	10	2.47%	2	2	93	93	9.21019917535404E-4	1	1	128	251	8	2	T
G4_BC76_191109_LF_LIB_consensus_vsearch	705	G	G	387	5	1.25%	2	2	93	93	0.030851660526274274	1	1	136	251	4	1	-A
G4_BC76_191109_LF_LIB_consensus_vsearch	706	A	A	392	6	1.5%	2	2	93	93	0.015331303510572384	1	1	135	257	5	1	G
G4_BC76_191109_LF_LIB_consensus_vsearch	707	A	R	396	7	1.72%	2	2	93	93	0.007609963086240239	1	1	138	258	6	1	G
G4_BC76_191109_LF_LIB_consensus_vsearch	708	T	T	395	6	1.47%	2	2	93	93	0.015333495178783761	1	1	142	253	3	3	C
G4_BC76_191109_LF_LIB_consensus_vsearch	709	A	*/-C	362	35	8.6%	2	2	93	93	1.3292373081448534E-11	1	1	141	221	1	34	-C
G4_BC76_191109_LF_LIB_consensus_vsearch	710	C	C	364	3	0.81%	2	2	93	93	0.1244884038198791	1	1	144	220	1	2	+A
G4_BC76_191109_LF_LIB_consensus_vsearch	711	C	*/-TC	358	22	5.42%	2	1	93	93	1.7437142008679426E-7	1	1	147	211	0	22	-TC
G4_BC76_191109_LF_LIB_consensus_vsearch	712	T	*/-C	336	29	7.84%	2	1	93	93	1.0440201861122694E-9	1	1	145	191	0	29	-C
G4_BC76_191109_LF_LIB_consensus_vsearch	713	C	*/+G	333	8	2.24%	2	1	93	93	0.003747409399187016	1	1	145	188	0	8	+G
G4_BC76_191109_LF_LIB_consensus_vsearch	714	G	G	400	2	0.49%	2	1	93	93	0.24968866749695368	1	1	145	255	0	2	A
G4_BC76_191109_LF_LIB_consensus_vsearch	715	A	A	401	2	0.49%	2	2	93	93	0.24968944099344345	1	1	144	257	1	1	T
G4_BC76_191109_LF_LIB_consensus_vsearch	716	A	A	389	5	1.23%	2	2	93	93	0.030853681237272182	1	1	141	248	1	4	+T
G4_BC76_191109_LF_LIB_consensus_vsearch	717	C	*/+A	377	11	2.72%	2	2	93	93	4.544286380884945E-4	1	1	146	231	1	10	+A
G4_BC76_191109_LF_LIB_consensus_vsearch	718	A	A	396	2	0.5%	2	1	93	93	0.24968553459123424	1	1	149	247	0	2	G
G4_BC76_191109_LF_LIB_consensus_vsearch	719	A	A	400	3	0.74%	2	1	93	93	0.12453416149047736	1	1	149	251	0	3	G
G4_BC76_191109_LF_LIB_consensus_vsearch	720	A	A	400	3	0.74%	2	2	93	93	0.12453416149047736	1	1	147	253	1	2	G
G4_BC76_191109_LF_LIB_consensus_vsearch	721	T	T	391	3	0.74%	2	1	93	93	0.12452350698836272	1	1	140	251	3	0	+A
G4_BC76_191109_LF_LIB_consensus_vsearch	722	G	*/+A	391	11	2.7%	2	1	93	93	4.5558231391399246E-4	1	1	135	256	11	0	+A
G4_BC76_191109_LF_LIB_consensus_vsearch	723	A	A	395	5	1.23%	2	2	93	93	0.030859622206549208	1	1	142	253	3	2	+G
G4_BC76_191109_LF_LIB_consensus_vsearch	724	G	*/-AG	358	20	4.94%	2	2	93	93	7.367991251368794E-7	1	1	113	245	9	11	-AG
G4_BC76_191109_LF_LIB_consensus_vsearch	725	A	A	362	5	1.34%	2	2	93	93	0.03082454467236996	1	1	119	243	4	1	+G
G4_BC76_191109_LF_LIB_consensus_vsearch	726	G	G	379	2	0.52%	2	2	93	93	0.24967148488839994	1	1	136	243	1	1	+AG
G4_BC76_191109_LF_LIB_consensus_vsearch	727	C	C	399	2	0.5%	2	1	93	93	0.24968789013733722	1	1	146	253	0	2	A
G4_BC76_191109_LF_LIB_consensus_vsearch	728	G	G	397	5	1.23%	2	2	93	93	0.03086156314569468	1	1	143	254	3	2	A
G4_BC76_191109_LF_LIB_consensus_vsearch	729	C	Y	383	12	2.96%	2	2	93	93	2.2429517467312504E-4	1	1	142	241	3	9	T
G4_BC76_191109_LF_LIB_consensus_vsearch	730	A	A	394	3	0.74%	2	2	93	93	0.1245271122321419	1	1	143	251	1	2	-T
G4_BC76_191109_LF_LIB_consensus_vsearch	731	T	T	382	6	1.49%	2	2	93	93	0.015323753822145654	1	1	140	242	5	1	+A
G4_BC76_191109_LF_LIB_consensus_vsearch	732	G	G	393	2	0.5%	2	1	93	93	0.24968314321918028	1	1	144	249	2	0	+A
G4_BC76_191109_LF_LIB_consensus_vsearch	733	A	R	386	9	2.23%	2	2	93	93	0.0018651929543866046	1	1	135	251	7	2	G
G4_BC76_191109_LF_LIB_consensus_vsearch	734	G	G	388	4	1%	2	1	93	93	0.0620213794085142	1	1	138	250	4	0	+A
G4_BC76_191109_LF_LIB_consensus_vsearch	735	G	G	398	3	0.74%	2	1	93	93	0.12453183520605009	1	1	145	253	3	0	A
G4_BC76_191109_LF_LIB_consensus_vsearch	736	C	C	396	3	0.74%	2	2	93	93	0.12452948557099502	1	1	146	250	2	1	-A
G4_BC76_191109_LF_LIB_consensus_vsearch	737	A	*/-G	381	8	1.99%	2	2	93	93	0.003766842960150322	1	1	138	243	2	6	-G
G4_BC76_191109_LF_LIB_consensus_vsearch	738	G	G	389	2	0.51%	2	1	93	93	0.24967989756723366	1	1	145	244	0	2	A
G4_BC76_191109_LF_LIB_consensus_vsearch	739	G	G	397	3	0.74%	2	2	93	93	0.12453066332921275	1	1	145	252	2	1	A
G4_BC76_191109_LF_LIB_consensus_vsearch	740	C	Y	380	9	2.24%	2	1	93	93	0.0018638534646934156	1	1	144	236	0	9	T
G4_BC76_191109_LF_LIB_consensus_vsearch	741	A	*/-CA	373	10	2.49%	2	2	93	93	9.201647694189105E-4	1	1	134	239	9	1	-CA
G4_BC76_191109_LF_LIB_consensus_vsearch	742	C	Y	368	11	2.84%	2	2	93	93	4.536430226559371E-4	1	1	134	234	3	8	T
G4_BC76_191109_LF_LIB_consensus_vsearch	743	A	A	385	6	1.52%	2	2	93	93	0.01532605917062568	1	1	134	251	3	3	G
G4_BC76_191109_LF_LIB_consensus_vsearch	744	T	Y	386	8	1.98%	2	2	93	93	0.003768597288121233	1	1	142	244	2	6	C
G4_BC76_191109_LF_LIB_consensus_vsearch	745	G	G	392	3	0.75%	2	2	93	93	0.12452471482865957	1	1	143	249	1	2	A
G4_BC76_191109_LF_LIB_consensus_vsearch	746	T	Y	386	12	3%	2	1	93	93	2.244406705806723E-4	1	1	147	239	0	12	C
G4_BC76_191109_LF_LIB_consensus_vsearch	747	T	T	398	2	0.49%	2	1	93	93	0.249687108886017	1	1	147	251	0	2	-GC
G4_BC76_191109_LF_LIB_consensus_vsearch	748	G	*/-C	380	9	2.23%	2	2	93	93	0.0018638534646934156	1	1	131	249	7	2	-C
G4_BC76_191109_LF_LIB_consensus_vsearch	749	C	C	391	1	0.26%	2	1	93	93	0.4999999999999138	1	1	139	252	0	1	T
G4_BC76_191109_LF_LIB_consensus_vsearch	750	C	*/-G	383	12	2.98%	2	2	93	93	2.2429517467312504E-4	1	1	142	241	3	9	-G
G4_BC76_191109_LF_LIB_consensus_vsearch	751	G	G	387	2	0.51%	2	1	93	93	0.24967824967779578	1	1	142	245	0	2	T
G4_BC76_191109_LF_LIB_consensus_vsearch	752	G	G	404	1	0.25%	2	1	93	93	0.4999999999999138	1	1	148	256	0	1	+A
G4_BC76_191109_LF_LIB_consensus_vsearch	753	A	A	407	0	0%	2	0	93	0	1.0	1	0	149	258	0	0	
G4_BC76_191109_LF_LIB_consensus_vsearch	754	A	A	402	4	0.98%	2	1	93	93	0.06203789367157223	1	1	149	253	0	4	+T
G4_BC76_191109_LF_LIB_consensus_vsearch	755	T	T	403	2	0.49%	2	2	93	93	0.24969097651407932	1	1	147	256	1	1	C
G4_BC76_191109_LF_LIB_consensus_vsearch	756	C	*/-T	395	10	2.45%	2	2	93	93	9.231784868029211E-4	1	1	147	248	1	9	-T
G4_BC76_191109_LF_LIB_consensus_vsearch	757	T	T	394	2	0.5%	2	1	93	93	0.24968394437400754	1	1	146	248	0	2	G
G4_BC76_191109_LF_LIB_consensus_vsearch	758	A	A	399	3	0.74%	2	2	93	93	0.12453300124551302	1	1	144	255	2	1	-T
G4_BC76_191109_LF_LIB_consensus_vsearch	759	T	T	396	5	1.24%	2	2	93	93	0.03086059509471206	1	1	143	253	3	2	A
G4_BC76_191109_LF_LIB_consensus_vsearch	760	T	T	402	2	0.49%	2	2	93	93	0.2496902106567468	1	1	145	257	1	1	+G
G4_BC76_191109_LF_LIB_consensus_vsearch	761	A	*/-G	392	7	1.72%	2	2	93	93	0.007607942959128091	1	1	142	250	2	5	-G
G4_BC76_191109_LF_LIB_consensus_vsearch	762	G	G	394	5	1.25%	2	2	93	93	0.030858644444955494	1	1	144	250	3	2	A
G4_BC76_191109_LF_LIB_consensus_vsearch	763	C	C	397	3	0.74%	2	1	93	93	0.12453066332921275	1	1	148	249	0	3	+A
G4_BC76_191109_LF_LIB_consensus_vsearch	764	A	A	403	1	0.25%	2	1	93	93	0.4999999999999138	1	1	149	254	0	1	+G
G4_BC76_191109_LF_LIB_consensus_vsearch	765	T	*/-G	386	11	2.71%	2	2	93	93	4.551794212032011E-4	1	1	147	239	1	10	-G
G4_BC76_191109_LF_LIB_consensus_vsearch	766	G	G	391	1	0.25%	2	1	93	93	0.4999999999999138	1	1	148	243	0	1	+CT
G4_BC76_191109_LF_LIB_consensus_vsearch	767	G	G	402	2	0.49%	2	1	93	93	0.2496902106567468	1	1	148	254	0	2	-AATAAC
G4_BC76_191109_LF_LIB_consensus_vsearch	768	A	A	399	3	0.74%	2	1	93	93	0.12453300124551302	1	1	145	254	3	0	+G
G4_BC76_191109_LF_LIB_consensus_vsearch	769	A	A	397	3	0.74%	2	1	93	93	0.12453066332921275	1	1	146	251	0	3	-TAA
G4_BC76_191109_LF_LIB_consensus_vsearch	770	T	*/-A	386	7	1.75%	2	2	93	93	0.0076048360660226225	1	1	147	239	1	6	-A
G4_BC76_191109_LF_LIB_consensus_vsearch	771	A	A	385	6	1.53%	2	2	93	93	0.01532605917062568	1	1	144	241	2	4	G
G4_BC76_191109_LF_LIB_consensus_vsearch	772	A	R	387	7	1.75%	2	2	93	93	0.007605360418658285	1	1	145	242	3	4	G
G4_BC76_191109_LF_LIB_consensus_vsearch	773	C	Y	377	13	3.25%	2	1	93	93	1.1027355068065241E-4	1	1	149	228	0	13	T
G4_BC76_191109_LF_LIB_consensus_vsearch	774	A	*/+T	366	13	3.23%	2	1	93	93	1.0994327994336431E-4	1	1	145	221	0	13	+T
G4_BC76_191109_LF_LIB_consensus_vsearch	775	C	Y	363	18	4.59%	2	1	93	93	3.105999102566561E-6	1	1	146	217	0	18	T
G4_BC76_191109_LF_LIB_consensus_vsearch	776	A	A	383	2	0.51%	2	2	93	93	0.24967490247067214	1	1	144	239	1	1	C
G4_BC76_191109_LF_LIB_consensus_vsearch	777	T	*/-G	357	24	5.94%	2	2	93	93	4.1015090927093485E-8	1	1	146	211	1	23	-G
G4_BC76_191109_LF_LIB_consensus_vsearch	778	G	G	373	6	1.57%	2	1	93	93	0.015316619391186111	1	1	148	225	0	6	T
G4_BC76_191109_LF_LIB_consensus_vsearch	779	G	G	404	2	0.49%	2	1	93	93	0.24969173859492816	1	1	147	257	2	0	A
G4_BC76_191109_LF_LIB_consensus_vsearch	780	A	*/-C	399	7	1.72%	2	1	93	93	0.007611452190916357	1	1	141	258	7	0	-C
G4_BC76_191109_LF_LIB_consensus_vsearch	781	C	C	397	3	0.75%	2	2	93	93	0.12453066332921275	1	1	140	257	1	2	T
G4_BC76_191109_LF_LIB_consensus_vsearch	782	C	Y	381	14	3.43%	2	2	93	93	5.4285201181963456E-5	1	1	140	241	3	11	T
G4_BC76_191109_LF_LIB_consensus_vsearch	783	G	G	391	6	1.49%	2	1	93	93	0.01533056561273411	1	1	139	252	6	0	A
G4_BC76_191109_LF_LIB_consensus_vsearch	784	C	C	385	6	1.49%	2	1	93	93	0.01532605917062568	1	1	142	243	0	6	+AA
G4_BC76_191109_LF_LIB_consensus_vsearch	785	A	A	391	5	1.25%	2	2	93	93	0.030855681550508444	1	1	141	250	2	3	G
G4_BC76_191109_LF_LIB_consensus_vsearch	786	G	G	396	3	0.75%	2	1	93	93	0.12452948557099502	1	1	145	251	0	3	-C
G4_BC76_191109_LF_LIB_consensus_vsearch	787	C	C	396	2	0.5%	2	1	93	93	0.24968553459123424	1	1	145	251	0	2	T
G4_BC76_191109_LF_LIB_consensus_vsearch	788	G	G	400	3	0.74%	2	1	93	93	0.12453416149047736	1	1	145	255	0	3	+CG
G4_BC76_191109_LF_LIB_consensus_vsearch	789	T	Y	396	7	1.72%	2	2	93	93	0.007609963086240239	1	1	144	252	3	4	C
G4_BC76_191109_LF_LIB_consensus_vsearch	790	C	C	395	5	1.23%	2	1	93	93	0.030859622206549208	1	1	147	248	0	5	-T
G4_BC76_191109_LF_LIB_consensus_vsearch	791	T	T	395	2	0.5%	2	1	93	93	0.24968474148789518	1	1	145	250	0	2	C
G4_BC76_191109_LF_LIB_consensus_vsearch	792	T	T	397	4	0.99%	2	2	93	93	0.062032128175275904	1	1	147	250	1	3	C
G4_BC76_191109_LF_LIB_consensus_vsearch	793	G	G	397	4	0.98%	2	2	93	93	0.062032128175275904	1	1	143	254	2	2	A
G4_BC76_191109_LF_LIB_consensus_vsearch	794	T	Y	392	12	2.95%	2	2	93	93	2.2472535825225005E-4	1	1	147	245	1	11	C
G4_BC76_191109_LF_LIB_consensus_vsearch	795	T	T	397	6	1.47%	2	2	93	93	0.015334938209013941	1	1	142	255	4	2	C
G4_BC76_191109_LF_LIB_consensus_vsearch	796	G	*/-TTG	385	15	3.69%	2	2	93	93	2.669890358265385E-5	1	1	130	255	13	2	-TTG
G4_BC76_191109_LF_LIB_consensus_vsearch	797	T	Y	373	15	3.85%	2	1	93	93	2.6586639991105327E-5	1	1	131	242	0	15	C
G4_BC76_191109_LF_LIB_consensus_vsearch	798	T	T	378	5	1.28%	2	1	93	93	0.030842306341483338	1	1	131	247	0	5	-G
G4_BC76_191109_LF_LIB_consensus_vsearch	799	G	R	361	20	5.17%	2	2	93	93	7.383372372820942E-7	1	1	114	247	18	2	A
G4_BC76_191109_LF_LIB_consensus_vsearch	800	G	G	399	2	0.49%	2	1	93	93	0.24968789013733722	1	1	147	252	0	2	-T
G4_BC76_191109_LF_LIB_consensus_vsearch	801	T	T	398	4	0.99%	2	1	93	93	0.06203329275530562	1	1	148	250	0	4	C
G4_BC76_191109_LF_LIB_consensus_vsearch	802	T	T	389	4	0.99%	2	2	93	93	0.06202259804292181	1	1	142	247	3	1	+A
G4_BC76_191109_LF_LIB_consensus_vsearch	803	A	A	398	1	0.25%	2	1	93	93	0.4999999999999138	1	1	146	252	0	1	+CA
G4_BC76_191109_LF_LIB_consensus_vsearch	804	A	A	402	2	0.49%	2	2	93	93	0.2496902106567468	1	1	147	255	1	1	C
G4_BC76_191109_LF_LIB_consensus_vsearch	805	A	A	404	3	0.74%	2	2	93	93	0.12453874538748007	1	1	148	256	1	2	G
G4_BC76_191109_LF_LIB_consensus_vsearch	806	G	G	405	1	0.25%	2	1	93	93	0.5000000000008233	1	1	147	258	1	0	+A
G4_BC76_191109_LF_LIB_consensus_vsearch	807	A	A	404	2	0.49%	2	1	93	93	0.24969173859492816	1	1	148	256	0	2	-CGA
G4_BC76_191109_LF_LIB_consensus_vsearch	808	C	C	400	4	0.99%	2	1	93	93	0.06203560460879861	1	1	143	257	4	0	-G
G4_BC76_191109_LF_LIB_consensus_vsearch	809	G	G	395	6	1.49%	2	1	93	93	0.015333495178783761	1	1	139	256	6	0	-A
G4_BC76_191109_LF_LIB_consensus_vsearch	810	A	A	392	3	0.75%	2	1	93	93	0.12452471482865957	1	1	137	255	3	0	G
G4_BC76_191109_LF_LIB_consensus_vsearch	811	T	T	394	6	1.48%	2	2	93	93	0.015332768266138878	1	1	144	250	1	5	C
G4_BC76_191109_LF_LIB_consensus_vsearch	812	G	*/-CA	379	19	4.69%	2	1	93	93	1.5307499583834213E-6	1	1	141	238	0	19	-CA
G4_BC76_191109_LF_LIB_consensus_vsearch	813	C	C	376	4	1.04%	2	2	93	93	0.06200625518874251	1	1	142	234	3	1	T
G4_BC76_191109_LF_LIB_consensus_vsearch	814	A	A	368	6	1.56%	2	2	93	93	0.01531250785611621	1	1	143	225	1	5	-GTA
G4_BC76_191109_LF_LIB_consensus_vsearch	815	G	G	394	4	1%	2	1	93	93	0.06202859930052086	1	1	147	247	0	4	-T
G4_BC76_191109_LF_LIB_consensus_vsearch	816	T	*/-A	363	14	3.53%	2	1	93	93	5.39767472832291E-5	1	1	144	219	0	14	-A
G4_BC76_191109_LF_LIB_consensus_vsearch	817	A	A	378	6	1.55%	2	2	93	93	0.015320624140933634	1	1	145	233	1	5	C
G4_BC76_191109_LF_LIB_consensus_vsearch	818	A	A	400	3	0.74%	2	2	93	93	0.12453416149047736	1	1	145	255	2	1	-T
G4_BC76_191109_LF_LIB_consensus_vsearch	819	T	Y	383	14	3.47%	2	1	93	93	5.4317819652484023E-5	1	1	145	238	0	14	C
G4_BC76_191109_LF_LIB_consensus_vsearch	820	G	G	402	2	0.49%	2	1	93	93	0.2496902106567468	1	1	145	257	2	0	-A
G4_BC76_191109_LF_LIB_consensus_vsearch	821	A	A	397	3	0.74%	2	2	93	93	0.12453066332921275	1	1	144	253	2	1	G
G4_BC76_191109_LF_LIB_consensus_vsearch	822	T	T	399	3	0.74%	2	2	93	93	0.12453300124551302	1	1	145	254	2	1	C
G4_BC76_191109_LF_LIB_consensus_vsearch	823	T	T	396	6	1.47%	2	2	93	93	0.015334218484153218	1	1	147	249	1	5	C
G4_BC76_191109_LF_LIB_consensus_vsearch	824	A	A	402	2	0.5%	2	2	93	93	0.2496902106567468	1	1	147	255	1	1	G
G4_BC76_191109_LF_LIB_consensus_vsearch	825	A	A	395	6	1.47%	2	2	93	93	0.015333495178783761	1	1	143	252	4	2	G
G4_BC76_191109_LF_LIB_consensus_vsearch	826	C	Y	386	7	1.72%	2	1	93	93	0.0076048360660226225	1	1	137	249	0	7	T
G4_BC76_191109_LF_LIB_consensus_vsearch	827	A	*/+G	112	235	58.17%	2	2	93	93	1.014027130087411E-98	1	1	55	57	80	155	+G
G4_BC76_191109_LF_LIB_consensus_vsearch	828	G	G	362	6	1.6%	2	1	93	93	0.015307426946136056	1	1	132	230	6	0	+A
G4_BC76_191109_LF_LIB_consensus_vsearch	829	G	R	390	8	1.99%	2	2	93	93	0.0037699692796093966	1	1	138	252	7	1	A
G4_BC76_191109_LF_LIB_consensus_vsearch	830	G	G	394	4	0.98%	2	1	93	93	0.06202859930052086	1	1	139	255	4	0	+AG
G4_BC76_191109_LF_LIB_consensus_vsearch	831	T	T	393	5	1.23%	2	2	93	93	0.03085766177318207	1	1	145	248	1	4	C
G4_BC76_191109_LF_LIB_consensus_vsearch	832	A	A	390	6	1.48%	2	2	93	93	0.015329823997787357	1	1	140	250	5	1	G
G4_BC76_191109_LF_LIB_consensus_vsearch	833	C	*/+T	370	16	3.97%	2	1	93	93	1.3020426605057041E-5	1	1	145	225	0	16	+T
G4_BC76_191109_LF_LIB_consensus_vsearch	834	T	*/-C	264	93	23.37%	2	2	93	93	1.008504122234177E-31	1	1	134	130	1	92	-C
G4_BC76_191109_LF_LIB_consensus_vsearch	835	C	*/-G	233	20	7.04%	2	2	93	93	6.452729203788659E-7	1	1	130	103	5	15	-G
G4_BC76_191109_LF_LIB_consensus_vsearch	836	G	R	322	20	5.8%	2	2	93	93	7.164812603389658E-7	1	1	123	199	19	1	A
G4_BC76_191109_LF_LIB_consensus_vsearch	837	G	R	362	17	4.45%	2	2	93	93	6.350804156561763E-6	1	1	133	229	14	3	A
G4_BC76_191109_LF_LIB_consensus_vsearch	838	G	R	385	18	4.47%	2	2	93	93	3.141832256242653E-6	1	1	148	237	1	17	A
G4_BC76_191109_LF_LIB_consensus_vsearch	839	G	R	387	13	3.19%	2	2	93	93	1.1055857583867697E-4	1	1	140	247	3	10	A
G4_BC76_191109_LF_LIB_consensus_vsearch	840	C	M	387	12	2.97%	2	2	93	93	2.2448869655710964E-4	1	1	144	243	1	11	A
G4_BC76_191109_LF_LIB_consensus_vsearch	841	C	Y	377	13	3.19%	2	2	93	93	1.1027355068065241E-4	1	1	142	235	4	9	T
G4_BC76_191109_LF_LIB_consensus_vsearch	842	A	A	400	3	0.74%	2	1	93	93	0.12453416149047736	1	1	147	253	0	3	G
G4_BC76_191109_LF_LIB_consensus_vsearch	843	A	R	382	9	2.21%	2	2	93	93	0.00186430447199865	1	1	135	247	8	1	G
G4_BC76_191109_LF_LIB_consensus_vsearch	844	C	C	399	3	0.74%	2	1	93	93	0.12453300124551302	1	1	145	254	0	3	+T
G4_BC76_191109_LF_LIB_consensus_vsearch	845	C	Y	381	15	3.69%	2	2	93	93	2.6662200580606564E-5	1	1	140	241	3	12	T
G4_BC76_191109_LF_LIB_consensus_vsearch	846	G	G	384	6	1.5%	2	2	93	93	0.015325294651568566	1	1	135	249	1	5	-TA
G4_BC76_191109_LF_LIB_consensus_vsearch	847	T	T	384	5	1.27%	2	2	93	93	0.030848590526024323	1	1	140	244	1	4	C
G4_BC76_191109_LF_LIB_consensus_vsearch	848	A	R	385	8	2%	2	2	93	93	0.0037682499633968467	1	1	140	245	7	1	G
G4_BC76_191109_LF_LIB_consensus_vsearch	849	C	*/-T	339	62	15.23%	2	2	93	93	1.6819506704373417E-20	1	1	146	193	1	61	-T
G4_BC76_191109_LF_LIB_consensus_vsearch	850	T	T	328	6	1.73%	2	1	93	93	0.015275197600068968	1	1	145	183	0	6	-CT
G4_BC76_191109_LF_LIB_consensus_vsearch	851	C	C	390	3	0.76%	2	2	93	93	0.12452229299364298	1	1	147	243	1	2	-T
G4_BC76_191109_LF_LIB_consensus_vsearch	852	T	*/+G	370	11	2.76%	2	2	93	93	4.5382073751055476E-4	1	1	142	228	1	10	+G
G4_BC76_191109_LF_LIB_consensus_vsearch	853	G	G	388	5	1.26%	2	1	93	93	0.030852673450990298	1	1	139	249	5	0	A
G4_BC76_191109_LF_LIB_consensus_vsearch	854	G	G	399	3	0.74%	2	2	93	93	0.12453300124551302	1	1	147	252	2	1	A
G4_BC76_191109_LF_LIB_consensus_vsearch	855	G	G	399	4	0.99%	2	2	93	93	0.06203445155203153	1	1	145	254	1	3	A
G4_BC76_191109_LF_LIB_consensus_vsearch	856	G	G	400	4	0.98%	2	2	93	93	0.06203560460879861	1	1	147	253	1	3	A
G4_BC76_191109_LF_LIB_consensus_vsearch	857	C	C	393	6	1.48%	2	1	93	93	0.015332037719180692	1	1	145	248	0	6	T
G4_BC76_191109_LF_LIB_consensus_vsearch	858	T	Y	384	9	2.22%	2	1	93	93	0.0018647509458963453	1	1	140	244	0	9	C
G4_BC76_191109_LF_LIB_consensus_vsearch	859	A	*/-G	191	129	32.17%	2	2	93	93	1.2067941499699468E-46	1	1	75	116	62	67	-G
G4_BC76_191109_LF_LIB_consensus_vsearch	860	G	R	208	8	3.65%	2	2	93	93	0.0036568954742723925	1	1	75	133	7	1	A
G4_BC76_191109_LF_LIB_consensus_vsearch	861	G	G	342	4	1.15%	2	2	93	93	0.06195770207455419	1	1	141	201	3	1	A
G4_BC76_191109_LF_LIB_consensus_vsearch	862	G	G	355	5	1.36%	2	2	93	93	0.030816277838216152	1	1	140	215	3	2	A
G4_BC76_191109_LF_LIB_consensus_vsearch	863	G	*/-T	389	8	1.97%	2	2	93	93	0.0037696288519149155	1	1	143	246	4	4	-T
G4_BC76_191109_LF_LIB_consensus_vsearch	864	T	T	379	5	1.27%	2	2	93	93	0.030843367333892417	1	1	141	238	1	4	C
G4_BC76_191109_LF_LIB_consensus_vsearch	865	G	+A/+A	59	326	81.7%	2	2	93	93	1.1208773988392947E-156	1	1	7	52	134	192	+A
G4_BC76_191109_LF_LIB_consensus_vsearch	866	A	A	400	4	0.99%	2	2	93	93	0.06203560460879861	1	1	145	255	1	3	+G
G4_BC76_191109_LF_LIB_consensus_vsearch	867	A	*/-T	388	10	2.46%	2	1	93	93	9.222551090526941E-4	1	1	146	242	0	10	-T
G4_BC76_191109_LF_LIB_consensus_vsearch	868	T	W	334	35	8.84%	2	1	93	93	1.2487895510157471E-11	1	1	131	203	0	35	A
G4_BC76_191109_LF_LIB_consensus_vsearch	869	C	C	373	5	1.31%	2	1	93	93	0.03083691723172624	1	1	133	240	0	5	A
G4_BC76_191109_LF_LIB_consensus_vsearch	870	C	*/-T	365	30	7.37%	2	2	93	93	5.255631458882903E-10	1	1	147	218	1	29	-T
G4_BC76_191109_LF_LIB_consensus_vsearch	871	T	Y	329	23	6.12%	2	2	93	93	8.223438578305512E-8	1	1	142	187	2	21	C
G4_BC76_191109_LF_LIB_consensus_vsearch	872	G	S	343	35	8.62%	2	1	93	93	1.275450934121292E-11	1	1	138	205	0	35	C
G4_BC76_191109_LF_LIB_consensus_vsearch	873	T	W	340	36	9.25%	2	1	93	93	6.038096214062909E-12	1	1	141	199	0	36	A
G4_BC76_191109_LF_LIB_consensus_vsearch	874	G	G	387	1	0.26%	2	1	93	93	0.4999999999999138	1	1	146	241	0	1	+A
G4_BC76_191109_LF_LIB_consensus_vsearch	875	A	*/+C	110	285	70.37%	2	2	93	93	2.0874883070681445E-123	1	1	12	98	134	151	+C
G4_BC76_191109_LF_LIB_consensus_vsearch	876	C	C	403	2	0.49%	2	1	93	93	0.24969097651407932	1	1	149	254	0	2	+T
G4_BC76_191109_LF_LIB_consensus_vsearch	877	C	C	395	5	1.23%	2	2	93	93	0.030859622206549208	1	1	144	251	1	4	-TC
G4_BC76_191109_LF_LIB_consensus_vsearch	878	T	Y	371	21	5.24%	2	2	93	93	3.6216250111330694E-7	1	1	138	233	3	18	C
G4_BC76_191109_LF_LIB_consensus_vsearch	879	C	*/-A	377	17	4.23%	2	2	93	93	6.396270971981517E-6	1	1	131	246	15	2	-A
G4_BC76_191109_LF_LIB_consensus_vsearch	880	A	A	377	4	1.03%	2	1	93	93	0.06200755195210619	1	1	129	248	0	4	+G
G4_BC76_191109_LF_LIB_consensus_vsearch	881	G	*/-A	391	11	2.72%	2	2	93	93	4.5558231391399246E-4	1	1	136	255	8	3	-A
G4_BC76_191109_LF_LIB_consensus_vsearch	882	A	A	390	3	0.76%	2	1	93	93	0.12452229299364298	1	1	136	254	3	0	+G
G4_BC76_191109_LF_LIB_consensus_vsearch	883	A	A	402	3	0.74%	2	2	93	93	0.1245364647713705	1	1	144	258	2	1	-G
G4_BC76_191109_LF_LIB_consensus_vsearch	884	G	G	400	1	0.25%	2	1	93	93	0.4999999999999138	1	1	143	257	1	0	+A
G4_BC76_191109_LF_LIB_consensus_vsearch	885	A	A	400	2	0.49%	2	2	93	93	0.24968866749695368	1	1	144	256	1	1	G
G4_BC76_191109_LF_LIB_consensus_vsearch	886	C	C	391	4	0.98%	2	1	93	93	0.06202501678889606	1	1	143	248	0	4	T
G4_BC76_191109_LF_LIB_consensus_vsearch	887	G	G	393	3	0.75%	2	2	93	93	0.12452591656124207	1	1	142	251	1	2	+A
G4_BC76_191109_LF_LIB_consensus_vsearch	888	A	A	379	6	1.49%	2	2	93	93	0.015321412641800121	1	1	131	248	5	1	+C
G4_BC76_191109_LF_LIB_consensus_vsearch	889	C	*/+T	380	10	2.51%	2	1	93	93	9.211599279939985E-4	1	1	139	241	0	10	+T
G4_BC76_191109_LF_LIB_consensus_vsearch	890	C	*/-T	386	14	3.45%	2	2	93	93	5.4366161181224727E-5	1	1	145	241	1	13	-T
G4_BC76_191109_LF_LIB_consensus_vsearch	891	T	*/-A	377	8	2.04%	2	2	93	93	0.003765406973524696	1	1	144	233	3	5	-A
G4_BC76_191109_LF_LIB_consensus_vsearch	892	A	A	392	5	1.25%	2	2	93	93	0.030856674154206513	1	1	143	249	1	4	C
G4_BC76_191109_LF_LIB_consensus_vsearch	893	A	A	399	6	1.47%	2	2	93	93	0.01533636702317035	1	1	144	255	3	3	G
G4_BC76_191109_LF_LIB_consensus_vsearch	894	T	T	396	4	0.98%	2	1	93	93	0.06203095776871511	1	1	144	252	0	4	C
G4_BC76_191109_LF_LIB_consensus_vsearch	895	G	G	393	3	0.75%	2	2	93	93	0.12452591656124207	1	1	139	254	1	2	-CG
G4_BC76_191109_LF_LIB_consensus_vsearch	896	C	C	378	6	1.5%	2	2	93	93	0.015320624140933634	1	1	133	245	1	5	-G
G4_BC76_191109_LF_LIB_consensus_vsearch	897	G	*/-A	365	9	2.28%	2	1	93	93	0.001860319163569236	1	1	130	235	9	0	-A
G4_BC76_191109_LF_LIB_consensus_vsearch	898	A	A	377	5	1.29%	2	2	93	93	0.03084123979791014	1	1	132	245	1	4	G
G4_BC76_191109_LF_LIB_consensus_vsearch	899	A	A	392	2	0.5%	2	1	93	93	0.24968233799211464	1	1	145	247	0	2	G
G4_BC76_191109_LF_LIB_consensus_vsearch	900	A	A	397	6	1.47%	2	2	93	93	0.015334938209013941	1	1	144	253	3	3	-G
G4_BC76_191109_LF_LIB_consensus_vsearch	901	G	G	393	4	1%	2	1	93	93	0.0620274111497499	1	1	145	248	0	4	-C
G4_BC76_191109_LF_LIB_consensus_vsearch	902	C	M	375	8	1.99%	2	1	93	93	0.003764677830168862	1	1	136	239	0	8	A
G4_BC76_191109_LF_LIB_consensus_vsearch	903	A	*/-G	382	11	2.71%	2	2	93	93	4.548498903980809E-4	1	1	137	245	6	5	-G
G4_BC76_191109_LF_LIB_consensus_vsearch	904	G	G	384	2	0.51%	2	1	93	93	0.24967574578483906	1	1	138	246	2	0	+A
G4_BC76_191109_LF_LIB_consensus_vsearch	905	T	Y	373	25	6.2%	2	1	93	93	2.0199709962030278E-8	1	1	147	226	0	25	C
G4_BC76_191109_LF_LIB_consensus_vsearch	906	T	*/-G	381	9	2.23%	2	2	93	93	0.0018640795393290628	1	1	148	233	1	8	-G
G4_BC76_191109_LF_LIB_consensus_vsearch	907	G	G	378	6	1.55%	2	2	93	93	0.015320624140933634	1	1	142	236	5	1	A
G4_BC76_191109_LF_LIB_consensus_vsearch	908	G	R	384	8	2.01%	2	2	93	93	0.0037679008816766993	1	1	146	238	1	7	A
G4_BC76_191109_LF_LIB_consensus_vsearch	909	C	Y	382	8	2.03%	2	2	93	93	0.0037671973936205536	1	1	147	235	1	7	T
G4_BC76_191109_LF_LIB_consensus_vsearch	910	T	*/+G	350	15	3.77%	2	2	93	93	2.635195227986554E-5	1	1	119	231	14	1	+G
G4_BC76_191109_LF_LIB_consensus_vsearch	911	A	*/-G	212	164	41.94%	2	2	93	93	4.32935782046914E-60	1	1	100	112	27	137	-G
G4_BC76_191109_LF_LIB_consensus_vsearch	912	G	G	218	6	2.61%	2	1	93	93	0.015104203282490625	1	1	104	114	6	0	+A
G4_BC76_191109_LF_LIB_consensus_vsearch	913	G	*/+A	347	27	6.68%	2	1	93	93	4.579987684166445E-9	1	1	94	253	27	0	+A
G4_BC76_191109_LF_LIB_consensus_vsearch	914	G	R	393	7	1.72%	2	2	93	93	0.007608451759263046	1	1	136	257	5	2	A
G4_BC76_191109_LF_LIB_consensus_vsearch	915	T	Y	393	9	2.22%	2	2	93	93	0.0018667057694086889	1	1	140	253	4	5	C
G4_BC76_191109_LF_LIB_consensus_vsearch	916	A	R	392	7	1.72%	2	2	93	93	0.007607942959128091	1	1	137	255	6	1	G
G4_BC76_191109_LF_LIB_consensus_vsearch	917	C	*/-T	375	13	3.19%	2	2	93	93	1.102148449959401E-4	1	1	144	231	1	12	-T
G4_BC76_191109_LF_LIB_consensus_vsearch	918	T	T	386	2	0.51%	2	2	93	93	0.24967741935460958	1	1	143	243	1	1	C
G4_BC76_191109_LF_LIB_consensus_vsearch	919	T	T	397	2	0.5%	2	2	93	93	0.24968632371350802	1	1	145	252	1	1	C
G4_BC76_191109_LF_LIB_consensus_vsearch	920	T	W	388	8	1.97%	2	1	93	93	0.0037692867193449852	1	1	146	242	0	8	A
G4_BC76_191109_LF_LIB_consensus_vsearch	921	C	C	381	6	1.49%	2	1	93	93	0.01532297745106865	1	1	145	236	0	6	-AT
G4_BC76_191109_LF_LIB_consensus_vsearch	922	A	A	389	1	0.25%	2	1	93	93	0.4999999999990043	1	1	145	244	0	1	+G
G4_BC76_191109_LF_LIB_consensus_vsearch	923	T	T	390	5	1.26%	2	1	93	93	0.030854683924238017	1	1	146	244	0	5	C
G4_BC76_191109_LF_LIB_consensus_vsearch	924	T	*/+G	386	10	2.47%	2	2	93	93	9.219853921161506E-4	1	1	145	241	1	9	+G
G4_BC76_191109_LF_LIB_consensus_vsearch	925	G	G	403	3	0.74%	2	1	93	93	0.12453760789147728	1	1	148	255	0	3	A
G4_BC76_191109_LF_LIB_consensus_vsearch	926	A	A	401	3	0.74%	2	1	93	93	0.1245353159851805	1	1	147	254	0	3	+C
G4_BC76_191109_LF_LIB_consensus_vsearch	927	T	T	401	2	0.49%	2	1	93	93	0.24968944099344345	1	1	147	254	0	2	-C
G4_BC76_191109_LF_LIB_consensus_vsearch	928	C	*/-A	375	27	6.67%	2	2	93	93	4.743417117774834E-9	1	1	147	228	1	26	-A
G4_BC76_191109_LF_LIB_consensus_vsearch	929	A	A	371	3	0.8%	2	2	93	93	0.1244979919678599	1	1	145	226	2	1	G
G4_BC76_191109_LF_LIB_consensus_vsearch	930	A	*/-G	371	28	6.93%	2	2	93	93	2.280626730498523E-9	1	1	146	225	2	26	-G
G4_BC76_191109_LF_LIB_consensus_vsearch	931	G	G	371	3	0.79%	2	1	93	93	0.1244979919678599	1	1	145	226	0	3	-C
G4_BC76_191109_LF_LIB_consensus_vsearch	932	C	C	385	5	1.24%	2	1	93	93	0.030849619103815673	1	1	142	243	0	5	+A
G4_BC76_191109_LF_LIB_consensus_vsearch	933	A	A	397	2	0.5%	2	2	93	93	0.24968632371350802	1	1	143	254	1	1	G
G4_BC76_191109_LF_LIB_consensus_vsearch	934	C	Y	382	15	3.69%	2	2	93	93	2.6671442214013996E-5	1	1	136	246	4	11	T
G4_BC76_191109_LF_LIB_consensus_vsearch	935	G	G	396	6	1.48%	2	2	93	93	0.015334218484153218	1	1	142	254	4	2	-A
G4_BC76_191109_LF_LIB_consensus_vsearch	936	A	A	389	4	1%	2	2	93	93	0.06202259804292181	1	1	138	251	1	3	G
G4_BC76_191109_LF_LIB_consensus_vsearch	937	A	*/-G	372	26	6.4%	2	2	93	93	9.772362925862572E-9	1	1	133	239	13	13	-G
G4_BC76_191109_LF_LIB_consensus_vsearch	938	G	G	368	4	1.05%	2	1	93	93	0.061995629927978635	1	1	126	242	4	0	+A
G4_BC76_191109_LF_LIB_consensus_vsearch	939	G	G	399	4	0.98%	2	2	93	93	0.06203445155203153	1	1	142	257	3	1	A
G4_BC76_191109_LF_LIB_consensus_vsearch	940	G	G	396	6	1.47%	2	1	93	93	0.015334218484153218	1	1	140	256	6	0	T
G4_BC76_191109_LF_LIB_consensus_vsearch	941	T	*/+G	371	18	4.46%	2	2	93	93	3.1194609634520567E-6	1	1	135	236	5	13	+G
G4_BC76_191109_LF_LIB_consensus_vsearch	942	G	G	395	3	0.75%	2	2	93	93	0.12452830188671389	1	1	144	251	2	1	+A
G4_BC76_191109_LF_LIB_consensus_vsearch	943	G	G	403	3	0.74%	2	1	93	93	0.12453760789147728	1	1	144	259	3	0	A
G4_BC76_191109_LF_LIB_consensus_vsearch	944	G	*/+A	374	29	7.13%	2	2	93	93	1.104833179604039E-9	1	1	119	255	27	2	+A
G4_BC76_191109_LF_LIB_consensus_vsearch	945	G	*/+A	222	166	40.79%	2	2	93	93	1.4580393325322848E-60	1	1	99	123	41	125	+A
G4_BC76_191109_LF_LIB_consensus_vsearch	946	G	*/+C	219	122	29.98%	2	2	93	93	3.2332783134694743E-43	1	1	74	145	39	83	+C
G4_BC76_191109_LF_LIB_consensus_vsearch	947	A	*/+GCA	183	122	30.73%	2	2	93	93	4.3952183505354966E-44	1	1	73	110	48	74	+GCA
G4_BC76_191109_LF_LIB_consensus_vsearch	948	A	M	389	8	1.96%	2	2	93	93	0.0037696288519149155	1	1	144	245	2	6	C
G4_BC76_191109_LF_LIB_consensus_vsearch	949	A	A	396	4	0.98%	2	1	93	93	0.06203095776871511	1	1	145	251	0	4	C
G4_BC76_191109_LF_LIB_consensus_vsearch	950	G	G	397	3	0.74%	2	2	93	93	0.12453066332921275	1	1	145	252	2	1	+A
G4_BC76_191109_LF_LIB_consensus_vsearch	951	A	A	401	2	0.49%	2	1	93	93	0.24968944099344345	1	1	145	256	0	2	-C
G4_BC76_191109_LF_LIB_consensus_vsearch	952	C	Y	394	7	1.72%	2	2	93	93	0.007608958034696689	1	1	145	249	1	6	T
G4_BC76_191109_LF_LIB_consensus_vsearch	953	G	*/-A	398	7	1.72%	2	1	93	93	0.007610958261497833	1	1	140	258	7	0	-A
G4_BC76_191109_LF_LIB_consensus_vsearch	954	A	R	388	7	1.75%	2	2	93	93	0.007605882130108492	1	1	136	252	4	3	G
G4_BC76_191109_LF_LIB_consensus_vsearch	955	T	T	401	1	0.25%	2	1	93	93	0.5000000000008233	1	1	147	254	1	0	+G
G4_BC76_191109_LF_LIB_consensus_vsearch	956	T	*/+G	379	19	4.67%	2	2	93	93	1.5307499583834213E-6	1	1	133	246	14	5	+G
G4_BC76_191109_LF_LIB_consensus_vsearch	957	A	*/-G	374	13	3.21%	2	1	93	93	1.1018527269038747E-4	1	1	129	245	13	0	-G
G4_BC76_191109_LF_LIB_consensus_vsearch	958	G	G	392	2	0.51%	2	1	93	93	0.24968233799211464	1	1	133	259	2	0	-A
G4_BC76_191109_LF_LIB_consensus_vsearch	959	A	A	397	2	0.49%	2	1	93	93	0.24968632371350802	1	1	142	255	2	0	+G
G4_BC76_191109_LF_LIB_consensus_vsearch	960	C	C	397	3	0.74%	2	2	93	93	0.12453066332921275	1	1	145	252	1	2	T
G4_BC76_191109_LF_LIB_consensus_vsearch	961	A	*/-C	380	15	3.7%	2	2	93	93	2.6652914497861675E-5	1	1	139	241	3	12	-C
G4_BC76_191109_LF_LIB_consensus_vsearch	962	C	C	382	3	0.77%	2	1	93	93	0.12451235370608407	1	1	144	238	0	3	+T
G4_BC76_191109_LF_LIB_consensus_vsearch	963	C	Y	365	29	7.14%	2	2	93	93	1.0912350581716082E-9	1	1	147	218	1	28	T
G4_BC76_191109_LF_LIB_consensus_vsearch	964	G	G	386	5	1.26%	2	2	93	93	0.030850642423789317	1	1	144	242	4	1	A
G4_BC76_191109_LF_LIB_consensus_vsearch	965	T	Y	366	29	7.3%	2	2	93	93	1.0927692732789675E-9	1	1	145	221	3	26	C
G4_BC76_191109_LF_LIB_consensus_vsearch	966	T	Y	387	7	1.73%	2	2	93	93	0.007605360418658285	1	1	142	245	3	4	C
G4_BC76_191109_LF_LIB_consensus_vsearch	967	G	*/+C	385	9	2.25%	2	1	93	93	0.001864972504119446	1	1	143	242	0	9	+C
G4_BC76_191109_LF_LIB_consensus_vsearch	968	T	Y	377	13	3.24%	2	1	93	93	1.1027355068065241E-4	1	1	144	233	0	13	C
G4_BC76_191109_LF_LIB_consensus_vsearch	969	A	A	391	4	1%	2	1	93	93	0.06202501678889606	1	1	147	244	0	4	G
G4_BC76_191109_LF_LIB_consensus_vsearch	970	G	G	398	4	0.99%	2	1	93	93	0.06203329275530562	1	1	149	249	0	4	A
G4_BC76_191109_LF_LIB_consensus_vsearch	971	T	*/-C	375	23	5.68%	2	2	93	93	8.594864968336328E-8	1	1	125	250	21	2	-C
G4_BC76_191109_LF_LIB_consensus_vsearch	972	C	C	380	1	0.26%	2	1	93	93	0.49999999999945904	1	1	125	255	1	0	+A
G4_BC76_191109_LF_LIB_consensus_vsearch	973	C	C	403	1	0.25%	2	1	93	93	0.4999999999999138	1	1	145	258	0	1	+T
G4_BC76_191109_LF_LIB_consensus_vsearch	974	C	C	396	6	1.47%	2	1	93	93	0.015334218484153218	1	1	142	254	6	0	-A
G4_BC76_191109_LF_LIB_consensus_vsearch	975	A	A	391	4	1%	2	2	93	93	0.06202501678889606	1	1	138	253	3	1	+C
G4_BC76_191109_LF_LIB_consensus_vsearch	976	C	C	393	5	1.23%	2	1	93	93	0.03085766177318207	1	1	141	252	5	0	G
G4_BC76_191109_LF_LIB_consensus_vsearch	977	C	C	397	3	0.74%	2	2	93	93	0.12453066332921275	1	1	143	254	1	2	T
G4_BC76_191109_LF_LIB_consensus_vsearch	978	A	R	388	11	2.71%	2	2	93	93	4.5534176337797E-4	1	1	137	251	10	1	G
G4_BC76_191109_LF_LIB_consensus_vsearch	979	G	G	400	3	0.74%	2	2	93	93	0.12453416149047736	1	1	145	255	1	2	-T
G4_BC76_191109_LF_LIB_consensus_vsearch	980	T	*/+A	372	13	3.23%	2	2	93	93	1.1012568366163888E-4	1	1	139	233	1	12	+A
G4_BC76_191109_LF_LIB_consensus_vsearch	981	A	A	397	1	0.25%	2	1	93	93	0.4999999999990043	1	1	144	253	1	0	+GCA
G4_BC76_191109_LF_LIB_consensus_vsearch	982	A	A	401	3	0.74%	2	2	93	93	0.1245353159851805	1	1	146	255	2	1	G
G4_BC76_191109_LF_LIB_consensus_vsearch	983	A	A	401	4	0.98%	2	2	93	93	0.06203675196794108	1	1	145	256	2	2	G
G4_BC76_191109_LF_LIB_consensus_vsearch	984	C	C	399	3	0.74%	2	1	93	93	0.12453300124551302	1	1	146	253	0	3	T
G4_BC76_191109_LF_LIB_consensus_vsearch	985	G	G	398	6	1.47%	2	1	93	93	0.015335654379945	1	1	141	257	6	0	-A
G4_BC76_191109_LF_LIB_consensus_vsearch	986	A	A	396	2	0.5%	2	2	93	93	0.24968553459123424	1	1	140	256	1	1	G
G4_BC76_191109_LF_LIB_consensus_vsearch	987	T	T	399	5	1.23%	2	2	93	93	0.030863484879977227	1	1	147	252	1	4	C
G4_BC76_191109_LF_LIB_consensus_vsearch	988	G	G	393	4	0.99%	2	1	93	93	0.0620274111497499	1	1	141	252	4	0	A
G4_BC76_191109_LF_LIB_consensus_vsearch	989	T	Y	391	7	1.74%	2	2	93	93	0.007607431615374521	1	1	143	248	1	6	C
G4_BC76_191109_LF_LIB_consensus_vsearch	990	C	C	393	3	0.75%	2	2	93	93	0.12452591656124207	1	1	141	252	2	1	+A
G4_BC76_191109_LF_LIB_consensus_vsearch	991	G	G	397	4	0.99%	2	2	93	93	0.062032128175275904	1	1	144	253	3	1	-A
G4_BC76_191109_LF_LIB_consensus_vsearch	992	A	A	399	4	0.99%	2	1	93	93	0.06203445155203153	1	1	142	257	4	0	G
G4_BC76_191109_LF_LIB_consensus_vsearch	993	C	C	403	3	0.74%	2	1	93	93	0.12453760789147728	1	1	148	255	0	3	T
G4_BC76_191109_LF_LIB_consensus_vsearch	994	G	*/-CG	387	10	2.46%	2	2	93	93	9.221205845541368E-4	1	1	140	247	7	3	-CG
G4_BC76_191109_LF_LIB_consensus_vsearch	995	C	C	384	6	1.52%	2	1	93	93	0.015325294651568566	1	1	141	243	0	6	T
G4_BC76_191109_LF_LIB_consensus_vsearch	996	G	G	389	4	1.01%	2	1	93	93	0.06202259804292181	1	1	137	252	0	4	+CG
G4_BC76_191109_LF_LIB_consensus_vsearch	997	A	A	400	2	0.5%	2	1	93	93	0.24968866749695368	1	1	144	256	0	2	+C
G4_BC76_191109_LF_LIB_consensus_vsearch	998	T	T	395	4	0.98%	2	2	93	93	0.06202978149183676	1	1	144	251	1	3	C
G4_BC76_191109_LF_LIB_consensus_vsearch	999	C	C	394	5	1.23%	2	1	93	93	0.030858644444955494	1	1	139	255	5	0	-AC
G4_BC76_191109_LF_LIB_consensus_vsearch	1000	A	A	389	3	0.75%	2	2	93	93	0.12452107279688855	1	1	136	253	2	1	G
G4_BC76_191109_LF_LIB_consensus_vsearch	1001	C	*/-G	359	21	5.24%	2	2	93	93	3.5894283967679816E-7	1	1	132	227	8	13	-G
G4_BC76_191109_LF_LIB_consensus_vsearch	1002	G	R	364	7	1.83%	2	1	93	93	0.007592589101619866	1	1	127	237	7	0	A
G4_BC76_191109_LF_LIB_consensus_vsearch	1003	G	R	376	11	2.72%	2	2	93	93	4.5434311102034934E-4	1	1	130	246	7	4	A
G4_BC76_191109_LF_LIB_consensus_vsearch	1004	G	G	397	4	0.98%	2	1	93	93	0.062032128175275904	1	1	147	250	0	4	A
G4_BC76_191109_LF_LIB_consensus_vsearch	1005	T	T	381	6	1.48%	2	1	93	93	0.01532297745106865	1	1	145	236	0	6	-G
G4_BC76_191109_LF_LIB_consensus_vsearch	1006	G	*/+T	362	24	6.03%	2	1	93	93	4.1220496412152925E-8	1	1	144	218	0	24	+T
G4_BC76_191109_LF_LIB_consensus_vsearch	1007	T	*/-C	384	8	1.99%	2	1	93	93	0.0037679008816766993	1	1	145	239	0	8	-C
G4_BC76_191109_LF_LIB_consensus_vsearch	1008	C	C	393	4	1.01%	2	1	93	93	0.0620274111497499	1	1	149	244	0	4	-T
G4_BC76_191109_LF_LIB_consensus_vsearch	1009	T	W	356	26	6.47%	2	2	93	93	9.595273565503464E-9	1	1	147	209	1	25	A
G4_BC76_191109_LF_LIB_consensus_vsearch	1010	G	*/-T	372	22	5.46%	2	1	93	93	1.7637609532244992E-7	1	1	148	224	0	22	-T
G4_BC76_191109_LF_LIB_consensus_vsearch	1011	T	W	354	11	2.87%	2	1	93	93	4.52345798270529E-4	1	1	146	208	0	11	A
G4_BC76_191109_LF_LIB_consensus_vsearch	1012	G	G	387	5	1.25%	2	1	93	93	0.030851660526274274	1	1	144	243	0	5	-T
G4_BC76_191109_LF_LIB_consensus_vsearch	1013	T	Y	380	9	2.28%	2	2	93	93	0.0018638534646934156	1	1	144	236	1	8	C
G4_BC76_191109_LF_LIB_consensus_vsearch	1014	T	Y	387	7	1.74%	2	1	93	93	0.007605360418658285	1	1	142	245	0	7	C
G4_BC76_191109_LF_LIB_consensus_vsearch	1015	A	A	390	4	1%	2	1	93	93	0.062023810487337606	1	1	142	248	0	4	+G
G4_BC76_191109_LF_LIB_consensus_vsearch	1016	G	G	395	3	0.75%	2	1	93	93	0.12452830188671389	1	1	141	254	3	0	A
G4_BC76_191109_LF_LIB_consensus_vsearch	1017	C	*/-AGC	388	9	2.23%	2	2	93	93	0.0018656305641170923	1	1	133	255	8	1	-AGC
G4_BC76_191109_LF_LIB_consensus_vsearch	1018	A	R	376	15	3.78%	2	2	93	93	2.6615319210402104E-5	1	1	126	250	9	6	G
G4_BC76_191109_LF_LIB_consensus_vsearch	1019	G	G	392	1	0.25%	2	1	93	93	0.4999999999990043	1	1	136	256	0	1	+AG
G4_BC76_191109_LF_LIB_consensus_vsearch	1020	C	C	386	5	1.26%	2	2	93	93	0.030850642423789317	1	1	136	250	2	3	-GC
G4_BC76_191109_LF_LIB_consensus_vsearch	1021	G	*/+C	381	13	3.26%	2	1	93	93	1.1038923642415208E-4	1	1	142	239	0	13	+C
G4_BC76_191109_LF_LIB_consensus_vsearch	1022	C	*/-T	384	12	2.99%	2	2	93	93	2.2434391137769687E-4	1	1	144	240	1	11	-T
G4_BC76_191109_LF_LIB_consensus_vsearch	1023	T	*/+C	370	11	2.78%	2	2	93	93	4.5382073751055476E-4	1	1	136	234	10	1	+C
G4_BC76_191109_LF_LIB_consensus_vsearch	1024	C	*/+G	345	24	6.02%	2	2	93	93	4.050315754047772E-8	1	1	140	205	2	22	+G
G4_BC76_191109_LF_LIB_consensus_vsearch	1025	G	G	368	6	1.56%	2	2	93	93	0.01531250785611621	1	1	137	231	4	2	A
G4_BC76_191109_LF_LIB_consensus_vsearch	1026	G	G	384	6	1.52%	2	2	93	93	0.015325294651568566	1	1	143	241	5	1	A
G4_BC76_191109_LF_LIB_consensus_vsearch	1027	G	*/-A	379	23	5.64%	2	2	93	93	8.623703234039144E-8	1	1	125	254	22	1	-A
G4_BC76_191109_LF_LIB_consensus_vsearch	1028	A	A	372	5	1.3%	2	1	93	93	0.03083582226799183	1	1	118	254	5	0	G
G4_BC76_191109_LF_LIB_consensus_vsearch	1029	G	G	395	3	0.75%	2	1	93	93	0.12452830188671389	1	1	145	250	0	3	-C
G4_BC76_191109_LF_LIB_consensus_vsearch	1030	C	Y	386	7	1.73%	2	2	93	93	0.0076048360660226225	1	1	145	241	1	6	T
G4_BC76_191109_LF_LIB_consensus_vsearch	1031	G	R	379	8	1.97%	2	2	93	93	0.0037661286454389806	1	1	142	237	6	2	A
G4_BC76_191109_LF_LIB_consensus_vsearch	1032	T	*/-A	364	23	5.76%	2	2	93	93	8.512923632334715E-8	1	1	134	230	11	12	-A
G4_BC76_191109_LF_LIB_consensus_vsearch	1033	A	+T/+T	14	353	92.89%	2	2	93	93	4.5983704629281386E-195	1	1	12	2	123	230	+T
G4_BC76_191109_LF_LIB_consensus_vsearch	1034	A	W	382	7	1.72%	2	1	93	93	0.0076027118384171	1	1	131	251	7	0	T
G4_BC76_191109_LF_LIB_consensus_vsearch	1035	G	*/-A	354	28	6.97%	2	2	93	93	2.2295225153050126E-9	1	1	109	245	23	5	-A
G4_BC76_191109_LF_LIB_consensus_vsearch	1036	A	A	360	5	1.35%	2	1	93	93	0.030822215052165283	1	1	109	251	5	0	T
G4_BC76_191109_LF_LIB_consensus_vsearch	1037	A	A	392	3	0.75%	2	1	93	93	0.12452471482865957	1	1	136	256	3	0	G
G4_BC76_191109_LF_LIB_consensus_vsearch	1038	A	*/-T	370	22	5.43%	2	2	93	93	1.7609736292660143E-7	1	1	117	253	21	1	-T
G4_BC76_191109_LF_LIB_consensus_vsearch	1039	T	K	346	26	6.82%	2	1	93	93	9.478377450788554E-9	1	1	91	255	26	0	G
G4_BC76_191109_LF_LIB_consensus_vsearch	1040	T	*/+C	363	7	1.73%	2	1	93	93	0.0075919980086515786	1	1	127	236	0	7	+C
G4_BC76_191109_LF_LIB_consensus_vsearch	1041	A	*/+G	273	50	12.56%	2	1	93	93	1.1365465767826324E-16	1	1	86	187	0	50	+G
G4_BC76_191109_LF_LIB_consensus_vsearch	1042	G	G	348	6	1.64%	2	1	93	93	0.015294903631575147	1	1	92	256	6	0	-A
G4_BC76_191109_LF_LIB_consensus_vsearch	1043	A	A	383	5	1.26%	2	1	93	93	0.030847556649813805	1	1	128	255	5	0	-G
G4_BC76_191109_LF_LIB_consensus_vsearch	1044	G	R	375	9	2.26%	2	2	93	93	0.001862705653908663	1	1	128	247	8	1	A
G4_BC76_191109_LF_LIB_consensus_vsearch	1045	T	T	396	3	0.75%	2	2	93	93	0.12452948557099502	1	1	146	250	1	2	C
G4_BC76_191109_LF_LIB_consensus_vsearch	1046	C	*/-T	333	55	13.55%	2	2	93	93	3.536947461648726E-18	1	1	143	190	2	53	-T
G4_BC76_191109_LF_LIB_consensus_vsearch	1047	T	T	332	3	0.88%	2	1	93	93	0.12443946188340989	1	1	144	188	0	3	+C
G4_BC76_191109_LF_LIB_consensus_vsearch	1048	T	T	383	5	1.27%	2	1	93	93	0.030847556649813805	1	1	144	239	0	5	C
G4_BC76_191109_LF_LIB_consensus_vsearch	1049	T	*/-G	327	76	18.63%	2	1	93	93	2.6565563145501537E-25	1	1	145	182	0	76	-G
G4_BC76_191109_LF_LIB_consensus_vsearch	1050	G	G	329	2	0.6%	2	1	93	93	0.24962178517399036	1	1	148	181	0	2	T
G4_BC76_191109_LF_LIB_consensus_vsearch	1051	G	G	404	1	0.25%	2	1	93	93	0.4999999999999138	1	1	146	258	1	0	+T
G4_BC76_191109_LF_LIB_consensus_vsearch	1052	A	A	403	1	0.25%	2	1	93	93	0.4999999999999138	1	1	146	257	1	0	+G
G4_BC76_191109_LF_LIB_consensus_vsearch	1053	C	*/-T	375	28	6.88%	2	1	93	93	2.2921605699551973E-9	1	1	146	229	0	28	-T
G4_BC76_191109_LF_LIB_consensus_vsearch	1054	T	*/-C	357	13	3.43%	2	1	93	93	1.0965899429487106E-4	1	1	146	211	0	13	-C
G4_BC76_191109_LF_LIB_consensus_vsearch	1055	C	C	383	4	1.02%	2	2	93	93	0.06201519170852023	1	1	146	237	2	2	T
G4_BC76_191109_LF_LIB_consensus_vsearch	1056	T	*/-G	253	87	21.64%	2	2	93	93	1.156473684243767E-29	1	1	105	148	26	61	-G
G4_BC76_191109_LF_LIB_consensus_vsearch	1057	G	G	305	2	0.65%	2	2	93	93	0.24959216965726613	1	1	120	185	1	1	C
G4_BC76_191109_LF_LIB_consensus_vsearch	1058	G	G	394	1	0.25%	2	1	93	93	0.4999999999999138	1	1	145	249	1	0	A
G4_BC76_191109_LF_LIB_consensus_vsearch	1059	G	G	407	0	0%	2	0	93	0	1.0	1	0	148	259	0	0	
G4_BC76_191109_LF_LIB_consensus_vsearch	1060	G	G	403	2	0.49%	2	1	93	93	0.24969097651407932	1	1	146	257	0	2	+A
G4_BC76_191109_LF_LIB_consensus_vsearch	1061	G	R	362	18	4.41%	2	1	93	93	3.1042797655903195E-6	1	1	107	255	18	0	A
G4_BC76_191109_LF_LIB_consensus_vsearch	1062	A	A	388	6	1.51%	2	2	93	93	0.015328329503561841	1	1	134	254	5	1	-G
G4_BC76_191109_LF_LIB_consensus_vsearch	1063	G	R	369	15	3.81%	2	2	93	93	2.6547739902969607E-5	1	1	118	251	14	1	A
G4_BC76_191109_LF_LIB_consensus_vsearch	1064	T	Y	387	8	1.98%	2	2	93	93	0.0037689428690762675	1	1	140	247	2	6	C
G4_BC76_191109_LF_LIB_consensus_vsearch	1065	A	A	401	2	0.5%	2	1	93	93	0.24968944099344345	1	1	144	257	2	0	G
G4_BC76_191109_LF_LIB_consensus_vsearch	1066	T	T	386	6	1.49%	2	1	93	93	0.015326819799317902	1	1	141	245	0	6	-G
G4_BC76_191109_LF_LIB_consensus_vsearch	1067	G	G	392	4	1%	2	1	93	93	0.06202621699451153	1	1	143	249	4	0	A
G4_BC76_191109_LF_LIB_consensus_vsearch	1068	G	G	397	6	1.48%	2	1	93	93	0.015334938209013941	1	1	147	250	0	6	A
G4_BC76_191109_LF_LIB_consensus_vsearch	1069	T	T	397	3	0.74%	2	2	93	93	0.12453066332921275	1	1	145	252	2	1	-C
G4_BC76_191109_LF_LIB_consensus_vsearch	1070	C	C	386	5	1.23%	2	2	93	93	0.030850642423789317	1	1	137	249	3	2	-GC
G4_BC76_191109_LF_LIB_consensus_vsearch	1071	G	G	386	4	1.01%	2	2	93	93	0.062018923379747036	1	1	138	248	3	1	A
G4_BC76_191109_LF_LIB_consensus_vsearch	1072	C	C	383	5	1.25%	2	2	93	93	0.030847556649813805	1	1	140	243	1	4	T
G4_BC76_191109_LF_LIB_consensus_vsearch	1073	A	A	397	2	0.5%	2	1	93	93	0.24968632371350802	1	1	142	255	2	0	G
G4_BC76_191109_LF_LIB_consensus_vsearch	1074	A	A	400	4	0.98%	2	2	93	93	0.06203560460879861	1	1	144	256	3	1	G
G4_BC76_191109_LF_LIB_consensus_vsearch	1075	G	G	401	2	0.49%	2	1	93	93	0.24968944099344345	1	1	147	254	2	0	+A
G4_BC76_191109_LF_LIB_consensus_vsearch	1076	T	T	400	2	0.49%	2	1	93	93	0.24968866749695368	1	1	147	253	2	0	+C
G4_BC76_191109_LF_LIB_consensus_vsearch	1077	C	C	401	3	0.74%	2	2	93	93	0.1245353159851805	1	1	147	254	1	2	-T
G4_BC76_191109_LF_LIB_consensus_vsearch	1078	T	*/+G	377	11	2.72%	2	2	93	93	4.544286380884945E-4	1	1	136	241	3	8	+G
G4_BC76_191109_LF_LIB_consensus_vsearch	1079	G	*/-A	383	10	2.46%	2	2	93	93	9.215757570452482E-4	1	1	134	249	6	4	-A
G4_BC76_191109_LF_LIB_consensus_vsearch	1080	A	A	394	2	0.51%	2	2	93	93	0.24968394437400754	1	1	140	254	1	1	G
G4_BC76_191109_LF_LIB_consensus_vsearch	1081	A	A	402	3	0.74%	2	1	93	93	0.1245364647713705	1	1	144	258	3	0	G
G4_BC76_191109_LF_LIB_consensus_vsearch	1082	A	R	385	17	4.17%	2	1	93	93	6.419225802716349E-6	1	1	130	255	17	0	G
G4_BC76_191109_LF_LIB_consensus_vsearch	1083	C	*/+T	377	10	2.46%	2	1	93	93	9.207377634483318E-4	1	1	132	245	0	10	+T
G4_BC76_191109_LF_LIB_consensus_vsearch	1084	T	Y	377	8	2.06%	2	2	93	93	0.003765406973524696	1	1	125	252	6	2	C
G4_BC76_191109_LF_LIB_consensus_vsearch	1085	T	*/-A	348	9	2.28%	2	2	93	93	0.001855959493097644	1	1	111	237	8	1	-A
G4_BC76_191109_LF_LIB_consensus_vsearch	1086	A	R	381	7	1.79%	2	1	93	93	0.007602173974125566	1	1	130	251	0	7	G
G4_BC76_191109_LF_LIB_consensus_vsearch	1087	A	A	405	1	0.25%	2	1	93	93	0.5000000000008233	1	1	146	259	1	0	G
G4_BC76_191109_LF_LIB_consensus_vsearch	1088	A	*/+G	383	9	2.21%	2	1	93	93	0.001864528271344425	1	1	134	249	9	0	+G
G4_BC76_191109_LF_LIB_consensus_vsearch	1089	G	G	397	1	0.25%	2	1	93	93	0.4999999999990043	1	1	145	252	0	1	+AA
G4_BC76_191109_LF_LIB_consensus_vsearch	1090	G	G	398	4	0.98%	2	1	93	93	0.06203329275530562	1	1	140	258	4	0	-A
G4_BC76_191109_LF_LIB_consensus_vsearch	1091	A	A	396	2	0.5%	2	1	93	93	0.24968553459123424	1	1	137	259	2	0	+G
G4_BC76_191109_LF_LIB_consensus_vsearch	1092	A	R	393	7	1.72%	2	1	93	93	0.007608451759263046	1	1	138	255	7	0	G
G4_BC76_191109_LF_LIB_consensus_vsearch	1093	T	T	392	5	1.24%	2	1	93	93	0.030856674154206513	1	1	139	253	5	0	G
G4_BC76_191109_LF_LIB_consensus_vsearch	1094	T	T	388	6	1.47%	2	1	93	93	0.015328329503561841	1	1	147	241	0	6	+G
G4_BC76_191109_LF_LIB_consensus_vsearch	1095	G	G	404	1	0.25%	2	1	93	93	0.4999999999999138	1	1	148	256	1	0	-A
G4_BC76_191109_LF_LIB_consensus_vsearch	1096	A	A	396	3	0.74%	2	1	93	93	0.12452948557099502	1	1	146	250	0	3	+T
G4_BC76_191109_LF_LIB_consensus_vsearch	1097	C	Y	387	7	1.72%	2	2	93	93	0.007605360418658285	1	1	144	243	2	5	T
G4_BC76_191109_LF_LIB_consensus_vsearch	1098	G	G	396	5	1.24%	2	1	93	93	0.03086059509471206	1	1	147	249	0	5	T
G4_BC76_191109_LF_LIB_consensus_vsearch	1099	G	*/+A	389	9	2.21%	2	2	93	93	0.0018658477399051397	1	1	141	248	6	3	+A
G4_BC76_191109_LF_LIB_consensus_vsearch	1100	A	A	399	3	0.75%	2	1	93	93	0.12453300124551302	1	1	148	251	0	3	C
G4_BC76_191109_LF_LIB_consensus_vsearch	1101	A	*/-G	366	24	5.94%	2	2	93	93	4.1381624104060524E-8	1	1	138	228	4	20	-G
G4_BC76_191109_LF_LIB_consensus_vsearch	1102	G	*/+A	349	11	2.91%	2	1	93	93	4.5185864877991805E-4	1	1	120	229	11	0	+A
G4_BC76_191109_LF_LIB_consensus_vsearch	1103	G	*/+A	389	8	1.99%	2	1	93	93	0.0037696288519149155	1	1	138	251	8	0	+A
G4_BC76_191109_LF_LIB_consensus_vsearch	1104	G	G	402	1	0.25%	2	1	93	93	0.4999999999999138	1	1	146	256	1	0	+AG
G4_BC76_191109_LF_LIB_consensus_vsearch	1105	C	*/+A	362	35	8.6%	2	1	93	93	1.3292373081448534E-11	1	1	143	219	0	35	+A
G4_BC76_191109_LF_LIB_consensus_vsearch	1106	A	A	397	6	1.47%	2	2	93	93	0.015334938209013941	1	1	144	253	4	2	G
G4_BC76_191109_LF_LIB_consensus_vsearch	1107	C	Y	343	39	9.61%	2	2	93	93	6.547100251732815E-13	1	1	143	200	3	36	T
G4_BC76_191109_LF_LIB_consensus_vsearch	1108	A	A	388	0	0%	2	0	93	0	1.0	1	0	146	242	0	0	
G4_BC76_191109_LF_LIB_consensus_vsearch	1109	A	R	385	13	3.19%	2	2	93	93	1.1050267709682812E-4	1	1	137	248	11	2	G
G4_BC76_191109_LF_LIB_consensus_vsearch	1110	C	C	394	4	0.99%	2	1	93	93	0.06202859930052086	1	1	144	250	4	0	G
G4_BC76_191109_LF_LIB_consensus_vsearch	1111	C	Y	374	29	7.11%	2	1	93	93	1.104833179604039E-9	1	1	146	228	0	29	T
G4_BC76_191109_LF_LIB_consensus_vsearch	1112	A	*/+G	377	9	2.22%	2	1	93	93	0.0018631683014264863	1	1	140	237	0	9	+G
G4_BC76_191109_LF_LIB_consensus_vsearch	1113	G	G	390	2	0.51%	2	1	93	93	0.24968071519789278	1	1	144	246	2	0	+A
G4_BC76_191109_LF_LIB_consensus_vsearch	1114	G	G	389	4	0.99%	2	1	93	93	0.06202259804292181	1	1	147	242	0	4	-CG
G4_BC76_191109_LF_LIB_consensus_vsearch	1115	C	C	388	2	0.51%	2	2	93	93	0.2496790757377846	1	1	146	242	1	1	A
G4_BC76_191109_LF_LIB_consensus_vsearch	1116	G	*/-TG	352	38	9.48%	2	1	93	93	1.4108953295604815E-12	1	1	145	207	0	38	-TG
G4_BC76_191109_LF_LIB_consensus_vsearch	1117	T	*/+G	337	7	1.94%	2	2	93	93	0.0075754305431544305	1	1	140	197	2	5	+G
G4_BC76_191109_LF_LIB_consensus_vsearch	1118	G	G	352	3	0.84%	2	1	93	93	0.12447108603676385	1	1	142	210	3	0	A
G4_BC76_191109_LF_LIB_consensus_vsearch	1119	G	G	394	5	1.24%	2	1	93	93	0.030858644444955494	1	1	141	253	5	0	-A
G4_BC76_191109_LF_LIB_consensus_vsearch	1120	A	A	395	5	1.24%	2	2	93	93	0.030859622206549208	1	1	137	258	4	1	-G
G4_BC76_191109_LF_LIB_consensus_vsearch	1121	G	G	388	5	1.24%	2	2	93	93	0.030852673450990298	1	1	138	250	3	2	-C
G4_BC76_191109_LF_LIB_consensus_vsearch	1122	C	C	396	4	0.99%	2	1	93	93	0.06203095776871511	1	1	145	251	0	4	T
G4_BC76_191109_LF_LIB_consensus_vsearch	1123	C	C	398	4	0.98%	2	2	93	93	0.06203329275530562	1	1	146	252	2	2	-T
G4_BC76_191109_LF_LIB_consensus_vsearch	1124	T	*/+G	380	11	2.74%	2	1	93	93	4.546826533185083E-4	1	1	146	234	0	11	+G
G4_BC76_191109_LF_LIB_consensus_vsearch	1125	G	G	396	2	0.49%	2	1	93	93	0.24968553459123424	1	1	144	252	2	0	+C
G4_BC76_191109_LF_LIB_consensus_vsearch	1126	C	Y	372	14	3.46%	2	2	93	93	5.413441518516823E-5	1	1	144	228	1	13	T
G4_BC76_191109_LF_LIB_consensus_vsearch	1127	G	R	391	8	1.99%	2	2	93	93	0.003770308015149166	1	1	141	250	5	3	A
G4_BC76_191109_LF_LIB_consensus_vsearch	1128	G	G	400	3	0.74%	2	2	93	93	0.12453416149047736	1	1	147	253	1	2	A
G4_BC76_191109_LF_LIB_consensus_vsearch	1129	C	*/-TT	314	58	14.22%	2	1	93	93	3.113951528607049E-19	1	1	84	230	58	0	-TT
G4_BC76_191109_LF_LIB_consensus_vsearch	1130	T	T	339	2	0.58%	2	1	93	93	0.24963289280493436	1	1	86	253	0	2	C
G4_BC76_191109_LF_LIB_consensus_vsearch	1131	T	*/-A	319	13	3.72%	2	2	93	93	1.0829578482007906E-4	1	1	77	242	6	7	-A
G4_BC76_191109_LF_LIB_consensus_vsearch	1132	A	A	382	3	0.77%	2	1	93	93	0.12451235370608407	1	1	137	245	0	3	C
G4_BC76_191109_LF_LIB_consensus_vsearch	1133	A	*/-T	373	17	4.23%	2	2	93	93	6.384464791951477E-6	1	1	129	244	14	3	-T
G4_BC76_191109_LF_LIB_consensus_vsearch	1134	T	K	373	8	2.05%	2	1	93	93	0.0037639410987491528	1	1	125	248	8	0	G
G4_BC76_191109_LF_LIB_consensus_vsearch	1135	T	K	386	10	2.46%	2	1	93	93	9.219853921161506E-4	1	1	138	248	10	0	G
G4_BC76_191109_LF_LIB_consensus_vsearch	1136	T	T	395	5	1.23%	2	2	93	93	0.030859622206549208	1	1	145	250	2	3	C
G4_BC76_191109_LF_LIB_consensus_vsearch	1137	G	G	401	3	0.74%	2	2	93	93	0.1245353159851805	1	1	146	255	1	2	C
G4_BC76_191109_LF_LIB_consensus_vsearch	1138	A	*/+C	387	11	2.71%	2	1	93	93	4.5526079174589983E-4	1	1	143	244	0	11	+C
G4_BC76_191109_LF_LIB_consensus_vsearch	1139	C	C	391	5	1.24%	2	2	93	93	0.030855681550508444	1	1	146	245	1	4	-T
G4_BC76_191109_LF_LIB_consensus_vsearch	1140	T	*/+C	372	12	2.99%	2	2	93	93	2.2374280247256466E-4	1	1	143	229	4	8	+C
G4_BC76_191109_LF_LIB_consensus_vsearch	1141	C	C	384	4	1.01%	2	1	93	93	0.06201644201482272	1	1	147	237	0	4	T
G4_BC76_191109_LF_LIB_consensus_vsearch	1142	A	A	404	1	0.25%	2	1	93	93	0.4999999999999138	1	1	148	256	0	1	G
G4_BC76_191109_LF_LIB_consensus_vsearch	1143	A	R	393	12	2.94%	2	2	93	93	2.247720086068572E-4	1	1	137	256	11	1	G
G4_BC76_191109_LF_LIB_consensus_vsearch	1144	C	C	402	2	0.49%	2	1	93	93	0.2496902106567468	1	1	144	258	2	0	+TT
G4_BC76_191109_LF_LIB_consensus_vsearch	1145	A	A	398	4	0.98%	2	1	93	93	0.06203329275530562	1	1	145	253	0	4	+T
G4_BC76_191109_LF_LIB_consensus_vsearch	1146	C	*/-G	286	89	21.92%	2	2	93	93	4.262224086917557E-30	1	1	84	202	44	45	-G
G4_BC76_191109_LF_LIB_consensus_vsearch	1147	G	R	296	8	2.58%	2	2	93	93	0.003728286891533163	1	1	91	205	7	1	A
G4_BC76_191109_LF_LIB_consensus_vsearch	1148	G	G	397	2	0.5%	2	2	93	93	0.24968632371350802	1	1	144	253	1	1	A
G4_BC76_191109_LF_LIB_consensus_vsearch	1149	G	G	402	4	0.98%	2	1	93	93	0.06203789367157223	1	1	147	255	0	4	T
G4_BC76_191109_LF_LIB_consensus_vsearch	1150	G	G	401	2	0.49%	2	1	93	93	0.24968944099344345	1	1	146	255	2	0	+A
G4_BC76_191109_LF_LIB_consensus_vsearch	1151	A	A	401	1	0.25%	2	1	93	93	0.5000000000008233	1	1	146	255	1	0	+G
G4_BC76_191109_LF_LIB_consensus_vsearch	1152	A	A	396	5	1.23%	2	1	93	93	0.03086059509471206	1	1	142	254	5	0	G
G4_BC76_191109_LF_LIB_consensus_vsearch	1153	G	*/+C	377	15	3.71%	2	1	93	93	2.662478633010287E-5	1	1	141	236	0	15	+C
G4_BC76_191109_LF_LIB_consensus_vsearch	1154	C	C	394	3	0.74%	2	2	93	93	0.1245271122321419	1	1	146	248	1	2	+T
G4_BC76_191109_LF_LIB_consensus_vsearch	1155	T	*/-C	383	11	2.72%	2	1	93	93	4.549328864195511E-4	1	1	146	237	0	11	-C
G4_BC76_191109_LF_LIB_consensus_vsearch	1156	C	C	382	4	1.01%	2	1	93	93	0.06201393491983747	1	1	143	239	0	4	+T
G4_BC76_191109_LF_LIB_consensus_vsearch	1157	A	*/+C	385	10	2.49%	2	1	93	93	9.218495267512253E-4	1	1	130	255	10	0	+C
G4_BC76_191109_LF_LIB_consensus_vsearch	1158	C	*/+T	376	14	3.46%	2	1	93	93	5.420225372441819E-5	1	1	140	236	0	14	+T
G4_BC76_191109_LF_LIB_consensus_vsearch	1159	C	Y	393	7	1.72%	2	1	93	93	0.007608451759263046	1	1	146	247	0	7	T
G4_BC76_191109_LF_LIB_consensus_vsearch	1160	A	*/-G	358	29	7.16%	2	2	93	93	1.0803274785134407E-9	1	1	141	217	1	28	-G
G4_BC76_191109_LF_LIB_consensus_vsearch	1161	G	G	373	2	0.53%	2	1	93	93	0.24966622162921065	1	1	146	227	2	0	+A
G4_BC76_191109_LF_LIB_consensus_vsearch	1162	G	G	398	3	0.74%	2	1	93	93	0.12453183520605009	1	1	145	253	3	0	+A
G4_BC76_191109_LF_LIB_consensus_vsearch	1163	G	G	399	5	1.23%	2	1	93	93	0.030863484879977227	1	1	147	252	0	5	-CA
G4_BC76_191109_LF_LIB_consensus_vsearch	1164	C	C	396	2	0.5%	2	2	93	93	0.24968553459123424	1	1	146	250	1	1	-A
G4_BC76_191109_LF_LIB_consensus_vsearch	1165	A	R	373	16	4.01%	2	2	93	93	1.3036692196399446E-5	1	1	135	238	11	5	G
G4_BC76_191109_LF_LIB_consensus_vsearch	1166	G	G	387	6	1.5%	2	1	93	93	0.015327576567173378	1	1	148	239	0	6	+T
G4_BC76_191109_LF_LIB_consensus_vsearch	1167	G	G	403	1	0.25%	2	1	93	93	0.4999999999999138	1	1	149	254	0	1	+A
G4_BC76_191109_LF_LIB_consensus_vsearch	1168	A	A	398	2	0.49%	2	2	93	93	0.249687108886017	1	1	146	252	1	1	+G
G4_BC76_191109_LF_LIB_consensus_vsearch	1169	C	C	399	2	0.49%	2	1	93	93	0.24968789013733722	1	1	146	253	0	2	T
G4_BC76_191109_LF_LIB_consensus_vsearch	1170	A	A	397	2	0.5%	2	1	93	93	0.24968632371350802	1	1	143	254	0	2	+G
G4_BC76_191109_LF_LIB_consensus_vsearch	1171	T	T	390	5	1.24%	2	2	93	93	0.030854683924238017	1	1	143	247	2	3	C
G4_BC76_191109_LF_LIB_consensus_vsearch	1172	G	G	400	2	0.49%	2	2	93	93	0.24968866749695368	1	1	147	253	1	1	C
G4_BC76_191109_LF_LIB_consensus_vsearch	1173	A	A	396	4	0.99%	2	1	93	93	0.06203095776871511	1	1	146	250	0	4	-T
G4_BC76_191109_LF_LIB_consensus_vsearch	1174	T	T	397	4	1%	2	1	93	93	0.062032128175275904	1	1	148	249	0	4	C
G4_BC76_191109_LF_LIB_consensus_vsearch	1175	T	T	396	6	1.47%	2	2	93	93	0.015334218484153218	1	1	144	252	2	4	C
G4_BC76_191109_LF_LIB_consensus_vsearch	1176	A	*/-G	301	65	16.05%	2	2	93	93	1.1957216815408826E-21	1	1	144	157	1	64	-G
G4_BC76_191109_LF_LIB_consensus_vsearch	1177	G	R	332	7	2.05%	2	2	93	93	0.007571954906961894	1	1	141	191	6	1	A
G4_BC76_191109_LF_LIB_consensus_vsearch	1178	G	*/-A	399	7	1.72%	2	2	93	93	0.007611452190916357	1	1	142	257	6	1	-A
G4_BC76_191109_LF_LIB_consensus_vsearch	1179	A	A	388	3	0.75%	2	1	93	93	0.12451984635071693	1	1	137	251	0	3	+T
G4_BC76_191109_LF_LIB_consensus_vsearch	1180	T	T	400	1	0.25%	2	1	93	93	0.4999999999999138	1	1	146	254	0	1	+A
G4_BC76_191109_LF_LIB_consensus_vsearch	1181	T	T	388	5	1.23%	2	2	93	93	0.030852673450990298	1	1	143	245	2	3	-G
G4_BC76_191109_LF_LIB_consensus_vsearch	1182	G	G	398	2	0.5%	2	1	93	93	0.249687108886017	1	1	145	253	0	2	-AC
G4_BC76_191109_LF_LIB_consensus_vsearch	1183	A	A	393	4	0.99%	2	1	93	93	0.0620274111497499	1	1	145	248	0	4	-C
G4_BC76_191109_LF_LIB_consensus_vsearch	1184	C	Y	386	8	2%	2	2	93	93	0.003768597288121233	1	1	143	243	2	6	T
G4_BC76_191109_LF_LIB_consensus_vsearch	1185	A	R	380	9	2.22%	2	2	93	93	0.0018638534646934156	1	1	137	243	6	3	G
G4_BC76_191109_LF_LIB_consensus_vsearch	1186	G	G	398	1	0.25%	2	1	93	93	0.4999999999999138	1	1	143	255	1	0	+A
G4_BC76_191109_LF_LIB_consensus_vsearch	1187	A	A	392	4	0.99%	2	2	93	93	0.06202621699451153	1	1	141	251	3	1	G
G4_BC76_191109_LF_LIB_consensus_vsearch	1188	C	C	392	3	0.75%	2	2	93	93	0.12452471482865957	1	1	141	251	2	1	-A
G4_BC76_191109_LF_LIB_consensus_vsearch	1189	A	A	387	6	1.5%	2	2	93	93	0.015327576567173378	1	1	137	250	5	1	G
G4_BC76_191109_LF_LIB_consensus_vsearch	1190	T	Y	386	9	2.23%	2	2	93	93	0.0018651929543866046	1	1	141	245	5	4	C
G4_BC76_191109_LF_LIB_consensus_vsearch	1191	G	G	399	1	0.25%	2	1	93	93	0.4999999999999138	1	1	148	251	0	1	+C
G4_BC76_191109_LF_LIB_consensus_vsearch	1192	A	A	394	4	0.99%	2	1	93	93	0.06202859930052086	1	1	143	251	4	0	+C
G4_BC76_191109_LF_LIB_consensus_vsearch	1193	C	C	398	3	0.74%	2	1	93	93	0.12453183520605009	1	1	148	250	0	3	T
G4_BC76_191109_LF_LIB_consensus_vsearch	1194	A	A	391	5	1.24%	2	1	93	93	0.030855681550508444	1	1	146	245	0	5	+G
G4_BC76_191109_LF_LIB_consensus_vsearch	1195	G	G	399	1	0.25%	2	1	93	93	0.4999999999999138	1	1	148	251	0	1	+C
G4_BC76_191109_LF_LIB_consensus_vsearch	1196	A	A	388	5	1.24%	2	2	93	93	0.030852673450990298	1	1	144	244	1	4	-T
G4_BC76_191109_LF_LIB_consensus_vsearch	1197	T	T	393	3	0.75%	2	1	93	93	0.12452591656124207	1	1	144	249	0	3	-C
G4_BC76_191109_LF_LIB_consensus_vsearch	1198	C	*/-T	356	39	9.68%	2	1	93	93	6.782915052865659E-13	1	1	148	208	0	39	-T
G4_BC76_191109_LF_LIB_consensus_vsearch	1199	T	T	358	6	1.64%	2	2	93	93	0.015303946878180787	1	1	148	210	1	5	C
G4_BC76_191109_LF_LIB_consensus_vsearch	1200	T	T	398	3	0.74%	2	1	93	93	0.12453183520605009	1	1	149	249	0	3	+C
G4_BC76_191109_LF_LIB_consensus_vsearch	1201	T	T	398	3	0.74%	2	1	93	93	0.12453183520605009	1	1	143	255	3	0	+C
G4_BC76_191109_LF_LIB_consensus_vsearch	1202	C	C	397	4	0.99%	2	2	93	93	0.062032128175275904	1	1	146	251	1	3	-A
G4_BC76_191109_LF_LIB_consensus_vsearch	1203	A	R	381	7	1.75%	2	2	93	93	0.007602173974125566	1	1	136	245	5	2	G
G4_BC76_191109_LF_LIB_consensus_vsearch	1204	T	T	385	6	1.5%	2	2	93	93	0.01532605917062568	1	1	142	243	3	3	C
G4_BC76_191109_LF_LIB_consensus_vsearch	1205	G	G	402	2	0.49%	2	1	93	93	0.2496902106567468	1	1	147	255	0	2	+CG
G4_BC76_191109_LF_LIB_consensus_vsearch	1206	A	A	397	5	1.23%	2	2	93	93	0.03086156314569468	1	1	144	253	3	2	G
G4_BC76_191109_LF_LIB_consensus_vsearch	1207	T	T	397	3	0.74%	2	1	93	93	0.12453066332921275	1	1	148	249	0	3	+C
G4_BC76_191109_LF_LIB_consensus_vsearch	1208	C	C	395	6	1.47%	2	1	93	93	0.015333495178783761	1	1	145	250	0	6	-T
G4_BC76_191109_LF_LIB_consensus_vsearch	1209	T	T	388	3	0.76%	2	1	93	93	0.12451984635071693	1	1	143	245	0	3	C
G4_BC76_191109_LF_LIB_consensus_vsearch	1210	C	C	384	5	1.24%	2	1	93	93	0.030848590526024323	1	1	143	241	0	5	-A
G4_BC76_191109_LF_LIB_consensus_vsearch	1211	A	A	387	2	0.51%	2	1	93	93	0.24967824967779578	1	1	147	240	0	2	-T
G4_BC76_191109_LF_LIB_consensus_vsearch	1212	T	*/-G	372	11	2.78%	2	2	93	93	4.539966388795655E-4	1	1	144	228	4	7	-G
G4_BC76_191109_LF_LIB_consensus_vsearch	1213	G	*/+C	380	7	1.79%	2	2	93	93	0.007601633344865528	1	1	142	238	1	6	+C
G4_BC76_191109_LF_LIB_consensus_vsearch	1214	G	*/+A	384	16	3.95%	2	1	93	93	1.309436672524504E-5	1	1	131	253	16	0	+A
G4_BC76_191109_LF_LIB_consensus_vsearch	1215	G	G	402	2	0.49%	2	1	93	93	0.2496902106567468	1	1	148	254	0	2	-T
G4_BC76_191109_LF_LIB_consensus_vsearch	1216	T	T	391	5	1.24%	2	1	93	93	0.030855681550508444	1	1	147	244	0	5	-G
G4_BC76_191109_LF_LIB_consensus_vsearch	1217	G	R	383	11	2.75%	2	2	93	93	4.549328864195511E-4	1	1	134	249	9	2	A
G4_BC76_191109_LF_LIB_consensus_vsearch	1218	G	G	400	2	0.49%	2	1	93	93	0.24968866749695368	1	1	147	253	0	2	-TG
G4_BC76_191109_LF_LIB_consensus_vsearch	1219	T	*/-GGT	375	10	2.48%	2	2	93	93	9.204527288502928E-4	1	1	146	229	2	8	-GGT
G4_BC76_191109_LF_LIB_consensus_vsearch	1220	G	G	378	6	1.54%	2	1	93	93	0.015320624140933634	1	1	138	240	6	0	A
G4_BC76_191109_LF_LIB_consensus_vsearch	1221	G	*/-TG	378	13	3.27%	2	1	93	93	1.1030268622449933E-4	1	1	147	231	0	13	-TG
G4_BC76_191109_LF_LIB_consensus_vsearch	1222	T	*/-GC	363	8	2.1%	2	1	93	93	0.003760139364613456	1	1	145	218	0	8	-GC
G4_BC76_191109_LF_LIB_consensus_vsearch	1223	G	R	372	7	1.82%	2	2	93	93	0.007597206160798333	1	1	145	227	2	5	A
G4_BC76_191109_LF_LIB_consensus_vsearch	1224	C	Y	372	11	2.77%	2	2	93	93	4.539966388795655E-4	1	1	143	229	2	9	T
G4_BC76_191109_LF_LIB_consensus_vsearch	1225	A	A	390	2	0.5%	2	1	93	93	0.24968071519789278	1	1	144	246	0	2	-T
G4_BC76_191109_LF_LIB_consensus_vsearch	1226	T	T	382	6	1.51%	2	1	93	93	0.015323753822145654	1	1	145	237	0	6	+G
G4_BC76_191109_LF_LIB_consensus_vsearch	1227	G	R	376	14	3.52%	2	2	93	93	5.420225372441819E-5	1	1	129	247	13	1	A
G4_BC76_191109_LF_LIB_consensus_vsearch	1228	G	G	393	5	1.24%	2	2	93	93	0.03085766177318207	1	1	141	252	4	1	A
G4_BC76_191109_LF_LIB_consensus_vsearch	1229	C	C	389	5	1.24%	2	2	93	93	0.030853681237272182	1	1	141	248	2	3	A
G4_BC76_191109_LF_LIB_consensus_vsearch	1230	C	Y	383	12	2.96%	2	2	93	93	2.2429517467312504E-4	1	1	143	240	1	11	T
G4_BC76_191109_LF_LIB_consensus_vsearch	1231	G	R	389	8	1.98%	2	2	93	93	0.0037696288519149155	1	1	140	249	5	3	A
G4_BC76_191109_LF_LIB_consensus_vsearch	1232	T	T	398	3	0.74%	2	1	93	93	0.12453183520605009	1	1	148	250	0	3	C
G4_BC76_191109_LF_LIB_consensus_vsearch	1233	T	T	401	2	0.49%	2	1	93	93	0.24968944099344345	1	1	149	252	0	2	C
G4_BC76_191109_LF_LIB_consensus_vsearch	1234	C	*/-T	377	19	4.7%	2	2	93	93	1.5290094520918881E-6	1	1	145	232	2	17	-T
G4_BC76_191109_LF_LIB_consensus_vsearch	1235	T	T	375	5	1.3%	2	2	93	93	0.030839089882184523	1	1	143	232	1	4	C
G4_BC76_191109_LF_LIB_consensus_vsearch	1236	T	T	395	2	0.49%	2	1	93	93	0.24968474148789518	1	1	148	247	0	2	+G
G4_BC76_191109_LF_LIB_consensus_vsearch	1237	A	R	385	13	3.21%	2	2	93	93	1.1050267709682812E-4	1	1	139	246	9	4	G
G4_BC76_191109_LF_LIB_consensus_vsearch	1238	G	G	396	2	0.5%	2	1	93	93	0.24968553459123424	1	1	147	249	0	2	-T
G4_BC76_191109_LF_LIB_consensus_vsearch	1239	T	*/+C	393	8	1.98%	2	1	93	93	0.003770980459969231	1	1	149	244	0	8	+C
G4_BC76_191109_LF_LIB_consensus_vsearch	1240	T	*/-C	392	12	2.96%	2	2	93	93	2.2472535825225005E-4	1	1	146	246	1	11	-C
G4_BC76_191109_LF_LIB_consensus_vsearch	1241	C	*/+A	380	10	2.53%	2	2	93	93	9.211599279939985E-4	1	1	137	243	9	1	+A
G4_BC76_191109_LF_LIB_consensus_vsearch	1242	G	K	387	9	2.22%	2	1	93	93	0.0018654123049784304	1	1	137	250	9	0	T
G4_BC76_191109_LF_LIB_consensus_vsearch	1243	T	*/-G	307	69	17.21%	2	2	93	93	5.442297840181198E-23	1	1	134	173	5	64	-G
G4_BC76_191109_LF_LIB_consensus_vsearch	1244	G	R	318	8	2.44%	2	1	93	93	0.0037401748205127794	1	1	134	184	8	0	A
G4_BC76_191109_LF_LIB_consensus_vsearch	1245	G	R	387	9	2.26%	2	2	93	93	0.0018654123049784304	1	1	142	245	6	3	A
G4_BC76_191109_LF_LIB_consensus_vsearch	1246	G	*/+A	387	8	1.98%	2	1	93	93	0.0037689428690762675	1	1	135	252	8	0	+A
G4_BC76_191109_LF_LIB_consensus_vsearch	1247	G	G	397	3	0.74%	2	1	93	93	0.12453066332921275	1	1	146	251	0	3	-T
G4_BC76_191109_LF_LIB_consensus_vsearch	1248	T	T	394	5	1.23%	2	2	93	93	0.030858644444955494	1	1	147	247	1	4	C
G4_BC76_191109_LF_LIB_consensus_vsearch	1249	G	G	399	3	0.74%	2	1	93	93	0.12453300124551302	1	1	147	252	0	3	C
G4_BC76_191109_LF_LIB_consensus_vsearch	1250	A	A	399	4	0.99%	2	2	93	93	0.06203445155203153	1	1	146	253	2	2	G
G4_BC76_191109_LF_LIB_consensus_vsearch	1251	C	*/-T	389	8	1.98%	2	1	93	93	0.0037696288519149155	1	1	148	241	0	8	-T
G4_BC76_191109_LF_LIB_consensus_vsearch	1252	T	T	391	2	0.5%	2	1	93	93	0.24968152866242077	1	1	147	244	0	2	+G
G4_BC76_191109_LF_LIB_consensus_vsearch	1253	T	T	387	6	1.48%	2	1	93	93	0.015327576567173378	1	1	145	242	0	6	G
G4_BC76_191109_LF_LIB_consensus_vsearch	1254	G	G	402	1	0.25%	2	1	93	93	0.4999999999999138	1	1	144	258	1	0	+C
G4_BC76_191109_LF_LIB_consensus_vsearch	1255	T	T	399	3	0.74%	2	1	93	93	0.12453300124551302	1	1	144	255	0	3	-C
G4_BC76_191109_LF_LIB_consensus_vsearch	1256	C	C	397	4	0.99%	2	1	93	93	0.062032128175275904	1	1	142	255	4	0	-T
G4_BC76_191109_LF_LIB_consensus_vsearch	1257	T	*/-G	387	10	2.48%	2	1	93	93	9.221205845541368E-4	1	1	142	245	0	10	-G
G4_BC76_191109_LF_LIB_consensus_vsearch	1258	G	G	393	3	0.75%	2	1	93	93	0.12452591656124207	1	1	145	248	3	0	A
G4_BC76_191109_LF_LIB_consensus_vsearch	1259	G	G	402	1	0.25%	2	1	93	93	0.4999999999999138	1	1	145	257	1	0	+A
G4_BC76_191109_LF_LIB_consensus_vsearch	1260	T	Y	388	16	3.93%	2	2	93	93	1.3114605407806796E-5	1	1	145	243	1	15	C
G4_BC76_191109_LF_LIB_consensus_vsearch	1261	T	T	394	4	0.98%	2	2	93	93	0.06202859930052086	1	1	140	254	2	2	+G
G4_BC76_191109_LF_LIB_consensus_vsearch	1262	G	G	403	3	0.74%	2	1	93	93	0.12453760789147728	1	1	145	258	3	0	-A
G4_BC76_191109_LF_LIB_consensus_vsearch	1263	A	A	395	4	0.99%	2	1	93	93	0.06202978149183676	1	1	144	251	0	4	-T
G4_BC76_191109_LF_LIB_consensus_vsearch	1264	T	*/+C	394	7	1.74%	2	1	93	93	0.007608958034696689	1	1	149	245	0	7	+C
G4_BC76_191109_LF_LIB_consensus_vsearch	1265	T	*/-C	380	20	4.93%	2	2	93	93	7.4759644062845E-7	1	1	140	240	9	11	-C
G4_BC76_191109_LF_LIB_consensus_vsearch	1266	C	C	384	3	0.77%	2	2	93	93	0.12451487710233766	1	1	139	245	1	2	T
G4_BC76_191109_LF_LIB_consensus_vsearch	1267	C	*/+G	363	14	3.43%	2	1	93	93	5.39767472832291E-5	1	1	146	217	0	14	+G
G4_BC76_191109_LF_LIB_consensus_vsearch	1268	G	G	408	0	0%	2	0	93	0	1.0	1	0	149	259	0	0	
G4_BC76_191109_LF_LIB_consensus_vsearch	1269	A	A	404	1	0.25%	2	1	93	93	0.4999999999999138	1	1	148	256	0	1	+C
G4_BC76_191109_LF_LIB_consensus_vsearch	1270	T	T	399	4	0.98%	2	1	93	93	0.06203445155203153	1	1	141	258	4	0	C
G4_BC76_191109_LF_LIB_consensus_vsearch	1271	A	A	404	0	0%	2	0	93	0	1.0	1	0	145	259	0	0	
G4_BC76_191109_LF_LIB_consensus_vsearch	1272	A	A	399	4	0.98%	2	1	93	93	0.06203445155203153	1	1	142	257	4	0	G
G4_BC76_191109_LF_LIB_consensus_vsearch	1273	C	C	385	6	1.48%	2	1	93	93	0.01532605917062568	1	1	133	252	6	0	+A
G4_BC76_191109_LF_LIB_consensus_vsearch	1274	G	*/-A	392	9	2.21%	2	2	93	93	0.0018664928473143382	1	1	135	257	8	1	-A
G4_BC76_191109_LF_LIB_consensus_vsearch	1275	A	A	388	6	1.51%	2	2	93	93	0.015328329503561841	1	1	138	250	1	5	-G
G4_BC76_191109_LF_LIB_consensus_vsearch	1276	G	G	395	3	0.75%	2	2	93	93	0.12452830188671389	1	1	145	250	2	1	A
G4_BC76_191109_LF_LIB_consensus_vsearch	1277	C	*/+A	376	8	1.97%	2	1	93	93	0.0037650433430064176	1	1	128	248	8	0	+A
G4_BC76_191109_LF_LIB_consensus_vsearch	1278	G	G	393	4	1%	2	2	93	93	0.0620274111497499	1	1	140	253	3	1	-A
G4_BC76_191109_LF_LIB_consensus_vsearch	1279	A	A	401	1	0.25%	2	1	93	93	0.5000000000008233	1	1	145	256	0	1	-G
G4_BC76_191109_LF_LIB_consensus_vsearch	1280	G	G	404	1	0.25%	2	1	93	93	0.4999999999999138	1	1	148	256	0	1	+C
G4_BC76_191109_LF_LIB_consensus_vsearch	1281	A	A	395	4	0.99%	2	1	93	93	0.06202978149183676	1	1	146	249	0	4	+C
G4_BC76_191109_LF_LIB_consensus_vsearch	1282	C	C	400	3	0.74%	2	1	93	93	0.12453416149047736	1	1	146	254	0	3	+T
G4_BC76_191109_LF_LIB_consensus_vsearch	1283	C	Y	355	29	7.11%	2	2	93	93	1.0755609030640925E-9	1	1	142	213	1	28	T
G4_BC76_191109_LF_LIB_consensus_vsearch	1284	G	G	399	4	0.99%	2	2	93	93	0.06203445155203153	1	1	143	256	3	1	-A
G4_BC76_191109_LF_LIB_consensus_vsearch	1285	A	A	391	6	1.49%	2	2	93	93	0.01533056561273411	1	1	138	253	5	1	G
G4_BC76_191109_LF_LIB_consensus_vsearch	1286	G	G	400	1	0.25%	2	1	93	93	0.4999999999999138	1	1	146	254	0	1	+A
G4_BC76_191109_LF_LIB_consensus_vsearch	1287	A	*/-C	351	39	9.68%	2	2	93	93	6.6931961725724E-13	1	1	122	229	15	24	-C
G4_BC76_191109_LF_LIB_consensus_vsearch	1288	C	C	349	6	1.65%	2	2	93	93	0.015295830816455393	1	1	122	227	1	5	+T
G4_BC76_191109_LF_LIB_consensus_vsearch	1289	C	C	390	6	1.49%	2	2	93	93	0.015329823997787357	1	1	140	250	2	4	T
G4_BC76_191109_LF_LIB_consensus_vsearch	1290	C	*/-A	332	21	5.15%	2	2	93	93	3.509991578913575E-7	1	1	130	202	15	6	-A
G4_BC76_191109_LF_LIB_consensus_vsearch	1291	A	R	336	15	4.21%	2	2	93	93	2.6194889808249706E-5	1	1	131	205	2	13	G
G4_BC76_191109_LF_LIB_consensus_vsearch	1292	A	R	348	10	2.65%	2	2	93	93	9.162988826076158E-4	1	1	142	206	3	7	G
G4_BC76_191109_LF_LIB_consensus_vsearch	1293	G	K	354	30	7.69%	2	1	93	93	5.166767531637126E-10	1	1	142	212	0	30	T
G4_BC76_191109_LF_LIB_consensus_vsearch	1294	G	G	398	2	0.49%	2	2	93	93	0.249687108886017	1	1	146	252	1	1	-TTG
G4_BC76_191109_LF_LIB_consensus_vsearch	1295	T	Y	382	19	4.73%	2	1	93	93	1.5333310267608091E-6	1	1	146	236	0	19	C
G4_BC76_191109_LF_LIB_consensus_vsearch	1296	T	*/-G	374	21	5.19%	2	2	93	93	3.6294031741071143E-7	1	1	143	231	1	20	-G
G4_BC76_191109_LF_LIB_consensus_vsearch	1297	G	R	373	8	2.09%	2	2	93	93	0.0037639410987491528	1	1	139	234	7	1	A
G4_BC76_191109_LF_LIB_consensus_vsearch	1298	G	R	384	19	4.67%	2	2	93	93	1.5350322571760348E-6	1	1	146	238	3	16	A
G4_BC76_191109_LF_LIB_consensus_vsearch	1299	C	C	389	5	1.23%	2	1	93	93	0.030853681237272182	1	1	143	246	0	5	T
G4_BC76_191109_LF_LIB_consensus_vsearch	1300	G	R	391	8	1.98%	2	2	93	93	0.003770308015149166	1	1	137	254	7	1	A
G4_BC76_191109_LF_LIB_consensus_vsearch	1301	C	C	396	2	0.5%	2	1	93	93	0.24968553459123424	1	1	144	252	0	2	+T
G4_BC76_191109_LF_LIB_consensus_vsearch	1302	C	Y	383	16	3.94%	2	2	93	93	1.3089247338748483E-5	1	1	144	239	1	15	T
G4_BC76_191109_LF_LIB_consensus_vsearch	1303	G	G	393	4	0.99%	2	2	93	93	0.0620274111497499	1	1	145	248	3	1	A
G4_BC76_191109_LF_LIB_consensus_vsearch	1304	T	T	394	2	0.5%	2	2	93	93	0.24968394437400754	1	1	147	247	1	1	A
G4_BC76_191109_LF_LIB_consensus_vsearch	1305	C	C	395	3	0.75%	2	2	93	93	0.12452830188671389	1	1	147	248	1	2	-T
G4_BC76_191109_LF_LIB_consensus_vsearch	1306	T	*/-C	237	130	32.91%	2	2	93	93	6.238444904969282E-46	1	1	126	111	20	110	-C
G4_BC76_191109_LF_LIB_consensus_vsearch	1307	C	C	256	1	0.39%	2	1	93	93	0.4999999999999138	1	1	126	130	1	0	+T
G4_BC76_191109_LF_LIB_consensus_vsearch	1308	C	C	385	5	1.27%	2	2	93	93	0.030849619103815673	1	1	145	240	2	3	+T
G4_BC76_191109_LF_LIB_consensus_vsearch	1309	C	*/-T	364	31	7.67%	2	2	93	93	2.524086161173689E-10	1	1	147	217	1	30	-T
G4_BC76_191109_LF_LIB_consensus_vsearch	1310	T	*/-C	347	8	2.17%	2	1	93	93	0.003753615277703552	1	1	146	201	0	8	-C
G4_BC76_191109_LF_LIB_consensus_vsearch	1311	C	C	375	5	1.27%	2	2	93	93	0.030839089882184523	1	1	138	237	3	2	-AT
G4_BC76_191109_LF_LIB_consensus_vsearch	1312	A	A	392	4	1%	2	1	93	93	0.06202621699451153	1	1	141	251	0	4	G
G4_BC76_191109_LF_LIB_consensus_vsearch	1313	T	T	387	6	1.5%	2	2	93	93	0.015327576567173378	1	1	140	247	2	4	C
G4_BC76_191109_LF_LIB_consensus_vsearch	1314	G	*/-TG	383	13	3.22%	2	2	93	93	1.104462332935663E-4	1	1	130	253	12	1	-TG
G4_BC76_191109_LF_LIB_consensus_vsearch	1315	T	T	380	2	0.51%	2	1	93	93	0.2496723460023847	1	1	127	253	2	0	-G
G4_BC76_191109_LF_LIB_consensus_vsearch	1316	G	G	383	3	0.77%	2	1	93	93	0.12451361867715198	1	1	127	256	3	0	C
G4_BC76_191109_LF_LIB_consensus_vsearch	1317	C	*/-T	358	21	5.19%	2	2	93	93	3.5866641692660115E-7	1	1	141	217	3	18	-T
G4_BC76_191109_LF_LIB_consensus_vsearch	1318	T	T	359	2	0.55%	2	2	93	93	0.24965325936195193	1	1	143	216	1	1	C
G4_BC76_191109_LF_LIB_consensus_vsearch	1319	T	T	383	2	0.52%	2	2	93	93	0.24967490247067214	1	1	146	237	1	1	C
G4_BC76_191109_LF_LIB_consensus_vsearch	1320	T	*/-CG	360	16	3.94%	2	1	93	93	1.2964449230219886E-5	1	1	136	224	0	16	-CG
G4_BC76_191109_LF_LIB_consensus_vsearch	1321	C	*/-G	330	20	5.32%	2	2	93	93	7.213162820643316E-7	1	1	146	184	2	18	-G
G4_BC76_191109_LF_LIB_consensus_vsearch	1322	G	R	336	14	3.9%	2	2	93	93	5.345740249078467E-5	1	1	132	204	13	1	A
G4_BC76_191109_LF_LIB_consensus_vsearch	1323	G	R	381	7	1.77%	2	2	93	93	0.007602173974125566	1	1	143	238	2	5	A
G4_BC76_191109_LF_LIB_consensus_vsearch	1324	G	*/-C	380	12	2.95%	2	2	93	93	2.2414751491838127E-4	1	1	146	234	1	11	-C
G4_BC76_191109_LF_LIB_consensus_vsearch	1325	C	Y	341	26	6.65%	2	2	93	93	9.418018589575704E-9	1	1	144	197	1	25	T
G4_BC76_191109_LF_LIB_consensus_vsearch	1326	T	T	371	5	1.3%	2	2	93	93	0.030834721484013016	1	1	144	227	1	4	C
G4_BC76_191109_LF_LIB_consensus_vsearch	1327	T	*/+GA	365	14	3.48%	2	1	93	93	5.401240330101599E-5	1	1	145	220	0	14	+GA
G4_BC76_191109_LF_LIB_consensus_vsearch	1328	C	S	342	28	6.93%	2	2	93	93	2.1912824638093567E-9	1	1	124	218	2	26	G
G4_BC76_191109_LF_LIB_consensus_vsearch	1329	G	*/+AGG	70	255	62.65%	2	2	93	93	4.923401912513137E-116	1	1	27	43	73	182	+AGG
G4_BC76_191109_LF_LIB_consensus_vsearch	1330	G	*/-C	363	32	7.84%	2	2	93	93	1.2104971840134513E-10	1	1	131	232	16	16	-C
G4_BC76_191109_LF_LIB_consensus_vsearch	1331	C	S	350	12	3.2%	2	2	93	93	2.2254044117729087E-4	1	1	128	222	3	9	G
G4_BC76_191109_LF_LIB_consensus_vsearch	1332	G	R	390	10	2.46%	2	2	93	93	9.225221739189795E-4	1	1	138	252	9	1	A
G4_BC76_191109_LF_LIB_consensus_vsearch	1333	G	G	406	1	0.25%	2	1	93	93	0.4999999999999138	1	1	148	258	0	1	+AG
G4_BC76_191109_LF_LIB_consensus_vsearch	1334	C	*/+G	382	13	3.19%	2	2	93	93	1.1041780449831012E-4	1	1	137	245	6	7	+G
G4_BC76_191109_LF_LIB_consensus_vsearch	1335	G	G	393	5	1.23%	2	2	93	93	0.03085766177318207	1	1	142	251	4	1	A
G4_BC76_191109_LF_LIB_consensus_vsearch	1336	C	*/-T	371	17	4.17%	2	1	93	93	6.378476759468224E-6	1	1	147	224	0	17	-T
G4_BC76_191109_LF_LIB_consensus_vsearch	1337	T	K	367	13	3.32%	2	2	93	93	1.0997406609837605E-4	1	1	145	222	3	10	G
G4_BC76_191109_LF_LIB_consensus_vsearch	1338	C	*/-T	365	26	6.42%	2	2	93	93	9.696334457173824E-9	1	1	146	219	1	25	-T
G4_BC76_191109_LF_LIB_consensus_vsearch	1339	T	T	373	2	0.53%	2	1	93	93	0.24966622162921065	1	1	145	228	0	2	+C
G4_BC76_191109_LF_LIB_consensus_vsearch	1340	T	T	391	3	0.74%	2	1	93	93	0.12452350698836272	1	1	145	246	0	3	+C
G4_BC76_191109_LF_LIB_consensus_vsearch	1341	C	*/-T	364	22	5.49%	2	2	93	93	1.752460710463997E-7	1	1	143	221	1	21	-T
G4_BC76_191109_LF_LIB_consensus_vsearch	1342	T	T	368	3	0.8%	2	1	93	93	0.12449392712559995	1	1	144	224	0	3	C
G4_BC76_191109_LF_LIB_consensus_vsearch	1343	T	T	389	5	1.24%	2	2	93	93	0.030853681237272182	1	1	135	254	4	1	C
G4_BC76_191109_LF_LIB_consensus_vsearch	1344	G	R	396	8	1.98%	2	2	93	93	0.0037719767465882576	1	1	140	256	6	2	A
G4_BC76_191109_LF_LIB_consensus_vsearch	1345	C	C	388	6	1.47%	2	2	93	93	0.015328329503561841	1	1	139	249	2	4	-GC
G4_BC76_191109_LF_LIB_consensus_vsearch	1346	G	*/-C	378	13	3.27%	2	2	93	93	1.1030268622449933E-4	1	1	129	249	9	4	-C
G4_BC76_191109_LF_LIB_consensus_vsearch	1347	C	*/+T	372	7	1.81%	2	1	93	93	0.007597206160798333	1	1	131	241	0	7	+T
G4_BC76_191109_LF_LIB_consensus_vsearch	1348	C	*/-T	361	20	4.91%	2	2	93	93	7.383372372820942E-7	1	1	128	233	4	16	-T
G4_BC76_191109_LF_LIB_consensus_vsearch	1349	T	Y	361	9	2.37%	2	2	93	93	0.0018593289243356043	1	1	124	237	5	4	C
G4_BC76_191109_LF_LIB_consensus_vsearch	1350	T	*/-GG	286	32	8%	2	2	93	93	1.0245538527602735E-10	1	1	113	173	3	29	-GG
G4_BC76_191109_LF_LIB_consensus_vsearch	1351	G	R	281	52	14.94%	2	2	93	93	2.5597504940654806E-17	1	1	106	175	22	30	A
G4_BC76_191109_LF_LIB_consensus_vsearch	1352	G	R	343	26	6.97%	2	2	93	93	9.442319188067389E-9	1	1	125	218	19	7	A
G4_BC76_191109_LF_LIB_consensus_vsearch	1353	G	R	370	35	8.62%	2	2	93	93	1.350918670682252E-11	1	1	146	224	2	33	A
G4_BC76_191109_LF_LIB_consensus_vsearch	1354	G	G	393	5	1.23%	2	2	93	93	0.03085766177318207	1	1	147	246	1	4	-A
G4_BC76_191109_LF_LIB_consensus_vsearch	1355	A	A	394	3	0.75%	2	1	93	93	0.1245271122321419	1	1	143	251	3	0	-C
G4_BC76_191109_LF_LIB_consensus_vsearch	1356	C	Y	393	7	1.74%	2	2	93	93	0.007608451759263046	1	1	142	251	1	6	T
G4_BC76_191109_LF_LIB_consensus_vsearch	1357	C	Y	387	8	1.97%	2	2	93	93	0.0037689428690762675	1	1	144	243	1	7	T
G4_BC76_191109_LF_LIB_consensus_vsearch	1358	G	R	396	8	1.98%	2	1	93	93	0.0037719767465882576	1	1	140	256	8	0	A
G4_BC76_191109_LF_LIB_consensus_vsearch	1359	G	G	403	3	0.74%	2	1	93	93	0.12453760789147728	1	1	145	258	3	0	A
G4_BC76_191109_LF_LIB_consensus_vsearch	1360	C	C	401	2	0.49%	2	1	93	93	0.24968944099344345	1	1	144	257	2	0	+AC
G4_BC76_191109_LF_LIB_consensus_vsearch	1361	G	*/-C	374	21	5.16%	2	2	93	93	3.6294031741071143E-7	1	1	121	253	18	3	-C
G4_BC76_191109_LF_LIB_consensus_vsearch	1362	C	C	370	2	0.53%	2	1	93	93	0.24966352624485505	1	1	120	250	2	0	+GC
G4_BC76_191109_LF_LIB_consensus_vsearch	1363	C	C	394	3	0.75%	2	1	93	93	0.1245271122321419	1	1	141	253	0	3	T
G4_BC76_191109_LF_LIB_consensus_vsearch	1364	C	*/-G	391	7	1.72%	2	2	93	93	0.007607431615374521	1	1	147	244	1	6	-G
G4_BC76_191109_LF_LIB_consensus_vsearch	1365	G	R	377	19	4.75%	2	1	93	93	1.5290094520918881E-6	1	1	127	250	19	0	A
G4_BC76_191109_LF_LIB_consensus_vsearch	1366	G	G	401	3	0.74%	2	2	93	93	0.1245353159851805	1	1	146	255	2	1	-T
G4_BC76_191109_LF_LIB_consensus_vsearch	1367	T	T	399	3	0.74%	2	1	93	93	0.12453300124551302	1	1	146	253	0	3	C
G4_BC76_191109_LF_LIB_consensus_vsearch	1368	T	*/-A	349	39	9.61%	2	2	93	93	6.656967776509024E-13	1	1	112	237	29	10	-A
G4_BC76_191109_LF_LIB_consensus_vsearch	1369	A	A	342	6	1.67%	2	2	93	93	0.015289228950998206	1	1	107	235	4	2	G
G4_BC76_191109_LF_LIB_consensus_vsearch	1370	A	R	345	15	3.76%	2	2	93	93	2.6297183451549872E-5	1	1	121	224	12	3	G
G4_BC76_191109_LF_LIB_consensus_vsearch	1371	G	G	362	6	1.57%	2	2	93	93	0.015307426946136056	1	1	124	238	4	2	A
G4_BC76_191109_LF_LIB_consensus_vsearch	1372	G	*/+A	372	15	3.77%	2	1	93	93	2.6576986497768562E-5	1	1	123	249	15	0	+A
G4_BC76_191109_LF_LIB_consensus_vsearch	1373	G	R	393	8	1.98%	2	1	93	93	0.003770980459969231	1	1	140	253	8	0	A
G4_BC76_191109_LF_LIB_consensus_vsearch	1374	C	C	397	2	0.5%	2	2	93	93	0.24968632371350802	1	1	146	251	1	1	+G
G4_BC76_191109_LF_LIB_consensus_vsearch	1375	G	*/-TG	372	22	5.41%	2	2	93	93	1.7637609532244992E-7	1	1	139	233	1	21	-TG
G4_BC76_191109_LF_LIB_consensus_vsearch	1376	T	*/-G	359	11	2.86%	2	2	93	93	4.5282009445977983E-4	1	1	141	218	3	8	-G
G4_BC76_191109_LF_LIB_consensus_vsearch	1377	G	G	372	1	0.27%	2	1	93	93	0.4999999999999138	1	1	143	229	1	0	+A
G4_BC76_191109_LF_LIB_consensus_vsearch	1378	G	G	397	3	0.74%	2	1	93	93	0.12453066332921275	1	1	139	258	3	0	-A
G4_BC76_191109_LF_LIB_consensus_vsearch	1379	A	*/-G	385	7	1.75%	2	2	93	93	0.007604309052101333	1	1	128	257	6	1	-G
G4_BC76_191109_LF_LIB_consensus_vsearch	1380	G	G	389	3	0.76%	2	1	93	93	0.12452107279688855	1	1	134	255	3	0	+AG
G4_BC76_191109_LF_LIB_consensus_vsearch	1381	G	G	399	5	1.23%	2	1	93	93	0.030863484879977227	1	1	145	254	0	5	-TG
G4_BC76_191109_LF_LIB_consensus_vsearch	1382	T	T	395	5	1.24%	2	1	93	93	0.030859622206549208	1	1	146	249	0	5	C
G4_BC76_191109_LF_LIB_consensus_vsearch	1383	G	*/-CT	369	16	3.98%	2	2	93	93	1.301495181198242E-5	1	1	123	246	15	1	-CT
G4_BC76_191109_LF_LIB_consensus_vsearch	1384	C	*/-T	340	20	5.25%	2	2	93	93	7.270916338558278E-7	1	1	108	232	17	3	-T
G4_BC76_191109_LF_LIB_consensus_vsearch	1385	T	T	356	6	1.64%	2	1	93	93	0.015302178085640468	1	1	102	254	6	0	C
G4_BC76_191109_LF_LIB_consensus_vsearch	1386	T	*/-G	363	12	2.99%	2	2	93	93	2.232674726173289E-4	1	1	128	235	3	9	-G
G4_BC76_191109_LF_LIB_consensus_vsearch	1387	G	R	351	33	8.51%	2	2	93	93	5.6772482962314925E-11	1	1	107	244	31	2	A
G4_BC76_191109_LF_LIB_consensus_vsearch	1388	G	R	389	12	2.96%	2	2	93	93	2.245840498305788E-4	1	1	139	250	7	5	A
G4_BC76_191109_LF_LIB_consensus_vsearch	1389	C	*/-A	360	31	7.67%	2	2	93	93	2.5076754199881873E-10	1	1	140	220	2	29	-A
G4_BC76_191109_LF_LIB_consensus_vsearch	1390	A	A	367	2	0.53%	2	1	93	93	0.24966078697405694	1	1	142	225	2	0	+G
G4_BC76_191109_LF_LIB_consensus_vsearch	1391	A	*/-TAA	378	9	2.22%	2	2	93	93	0.0018633978545959287	1	1	135	243	2	7	-TAA
G4_BC76_191109_LF_LIB_consensus_vsearch	1392	T	Y	357	28	7.2%	2	2	93	93	2.2387948053756232E-9	1	1	137	220	5	23	C
G4_BC76_191109_LF_LIB_consensus_vsearch	1393	A	M	380	8	2.03%	2	2	93	93	0.003766486715388715	1	1	136	244	1	7	C
G4_BC76_191109_LF_LIB_consensus_vsearch	1394	A	R	381	13	3.26%	2	2	93	93	1.1038923642415208E-4	1	1	133	248	12	1	G
G4_BC76_191109_LF_LIB_consensus_vsearch	1395	C	*/+T	389	7	1.72%	2	1	93	93	0.0076064012202881484	1	1	133	256	7	0	+T
G4_BC76_191109_LF_LIB_consensus_vsearch	1396	A	R	373	17	4.23%	2	2	93	93	6.384464791951477E-6	1	1	121	252	16	1	G
G4_BC76_191109_LF_LIB_consensus_vsearch	1397	G	G	400	1	0.25%	2	1	93	93	0.4999999999999138	1	1	146	254	0	1	A
G4_BC76_191109_LF_LIB_consensus_vsearch	1398	G	G	397	2	0.49%	2	1	93	93	0.24968632371350802	1	1	143	254	2	0	+AG
G4_BC76_191109_LF_LIB_consensus_vsearch	1399	T	*/-C	387	8	1.98%	2	1	93	93	0.0037689428690762675	1	1	145	242	0	8	-C
G4_BC76_191109_LF_LIB_consensus_vsearch	1400	C	C	395	1	0.25%	2	1	93	93	0.5000000000008233	1	1	147	248	1	0	+AC
G4_BC76_191109_LF_LIB_consensus_vsearch	1401	T	T	393	6	1.48%	2	2	93	93	0.015332037719180692	1	1	146	247	1	5	C
G4_BC76_191109_LF_LIB_consensus_vsearch	1402	G	S	387	11	2.7%	2	1	93	93	4.5526079174589983E-4	1	1	147	240	0	11	C
G4_BC76_191109_LF_LIB_consensus_vsearch	1403	T	W	382	11	2.74%	2	1	93	93	4.548498903980809E-4	1	1	147	235	0	11	A
G4_BC76_191109_LF_LIB_consensus_vsearch	1404	G	G	399	2	0.5%	2	1	93	93	0.24968789013733722	1	1	148	251	0	2	C
G4_BC76_191109_LF_LIB_consensus_vsearch	1405	A	A	403	3	0.74%	2	1	93	93	0.12453760789147728	1	1	149	254	0	3	G
G4_BC76_191109_LF_LIB_consensus_vsearch	1406	T	T	403	1	0.25%	2	1	93	93	0.4999999999999138	1	1	148	255	0	1	+G
G4_BC76_191109_LF_LIB_consensus_vsearch	1407	G	*/-C	385	13	3.22%	2	2	93	93	1.1050267709682812E-4	1	1	143	242	3	10	-C
G4_BC76_191109_LF_LIB_consensus_vsearch	1408	C	*/+T	378	10	2.56%	2	1	93	93	9.208791978192084E-4	1	1	143	235	0	10	+T
G4_BC76_191109_LF_LIB_consensus_vsearch	1409	C	C	399	5	1.23%	2	1	93	93	0.030863484879977227	1	1	146	253	0	5	T
G4_BC76_191109_LF_LIB_consensus_vsearch	1410	C	*/-T	367	18	4.44%	2	2	93	93	3.1127943336343686E-6	1	1	143	224	3	15	-T
G4_BC76_191109_LF_LIB_consensus_vsearch	1411	T	T	378	4	1.03%	2	2	93	93	0.062008841921801575	1	1	141	237	1	3	C
G4_BC76_191109_LF_LIB_consensus_vsearch	1412	T	Y	386	11	2.7%	2	2	93	93	4.551794212032011E-4	1	1	147	239	1	10	C
G4_BC76_191109_LF_LIB_consensus_vsearch	1413	A	A	387	5	1.25%	2	1	93	93	0.030851660526274274	1	1	145	242	0	5	+G
G4_BC76_191109_LF_LIB_consensus_vsearch	1414	G	G	400	2	0.49%	2	2	93	93	0.24968866749695368	1	1	148	252	1	1	-A
G4_BC76_191109_LF_LIB_consensus_vsearch	1415	A	A	401	1	0.25%	2	1	93	93	0.5000000000008233	1	1	147	254	0	1	C
G4_BC76_191109_LF_LIB_consensus_vsearch	1416	T	T	397	4	0.99%	2	1	93	93	0.062032128175275904	1	1	148	249	0	4	C
G4_BC76_191109_LF_LIB_consensus_vsearch	1417	G	G	399	2	0.49%	2	1	93	93	0.24968789013733722	1	1	146	253	0	2	+T
G4_BC76_191109_LF_LIB_consensus_vsearch	1418	T	*/-C	382	15	3.69%	2	2	93	93	2.6671442214013996E-5	1	1	131	251	13	2	-C
G4_BC76_191109_LF_LIB_consensus_vsearch	1419	C	C	390	1	0.26%	2	1	93	93	0.4999999999999138	1	1	135	255	0	1	+T
G4_BC76_191109_LF_LIB_consensus_vsearch	1420	C	C	397	4	0.98%	2	2	93	93	0.062032128175275904	1	1	145	252	1	3	-T
G4_BC76_191109_LF_LIB_consensus_vsearch	1421	T	*/-G	375	15	3.73%	2	2	93	93	2.6605806005741526E-5	1	1	145	230	1	14	-G
G4_BC76_191109_LF_LIB_consensus_vsearch	1422	G	G	378	6	1.55%	2	2	93	93	0.015320624140933634	1	1	141	237	5	1	A
G4_BC76_191109_LF_LIB_consensus_vsearch	1423	G	G	394	5	1.24%	2	1	93	93	0.030858644444955494	1	1	140	254	5	0	+A
G4_BC76_191109_LF_LIB_consensus_vsearch	1424	G	*/-C	395	8	1.96%	2	2	93	93	0.00377164628554966	1	1	141	254	7	1	-C
G4_BC76_191109_LF_LIB_consensus_vsearch	1425	C	Y	383	13	3.25%	2	1	93	93	1.104462332935663E-4	1	1	140	243	0	13	T
G4_BC76_191109_LF_LIB_consensus_vsearch	1426	C	Y	380	16	3.92%	2	2	93	93	1.3073743141806742E-5	1	1	142	238	2	14	T
G4_BC76_191109_LF_LIB_consensus_vsearch	1427	G	G	391	6	1.49%	2	2	93	93	0.01533056561273411	1	1	140	251	5	1	A
G4_BC76_191109_LF_LIB_consensus_vsearch	1428	C	Y	376	17	4.2%	2	1	93	93	6.393340411735821E-6	1	1	139	237	0	17	T
G4_BC76_191109_LF_LIB_consensus_vsearch	1429	A	*/+T	360	10	2.49%	2	1	93	93	9.182185248776328E-4	1	1	135	225	0	10	+T
G4_BC76_191109_LF_LIB_consensus_vsearch	1430	C	Y	371	7	1.76%	2	1	93	93	0.0075966396580781715	1	1	141	230	0	7	T
G4_BC76_191109_LF_LIB_consensus_vsearch	1431	G	G	393	4	1%	2	1	93	93	0.0620274111497499	1	1	144	249	0	4	A
G4_BC76_191109_LF_LIB_consensus_vsearch	1432	C	*/-GC	362	13	3.23%	2	2	93	93	1.0981855360452989E-4	1	1	129	233	11	2	-GC
G4_BC76_191109_LF_LIB_consensus_vsearch	1433	G	G	362	6	1.53%	2	1	93	93	0.015307426946136056	1	1	127	235	6	0	T
G4_BC76_191109_LF_LIB_consensus_vsearch	1434	C	*/+GC	194	143	36.39%	2	2	93	93	3.582845779553626E-52	1	1	74	120	49	94	+GC
G4_BC76_191109_LF_LIB_consensus_vsearch	1435	T	Y	365	27	6.72%	2	2	93	93	4.687180832740839E-9	1	1	144	221	2	25	C
G4_BC76_191109_LF_LIB_consensus_vsearch	1436	A	R	361	14	3.45%	2	2	93	93	5.3940727822064676E-5	1	1	131	230	10	4	G
G4_BC76_191109_LF_LIB_consensus_vsearch	1437	C	C	377	4	1.01%	2	2	93	93	0.06200755195210619	1	1	139	238	2	2	+T
G4_BC76_191109_LF_LIB_consensus_vsearch	1438	A	R	389	7	1.74%	2	2	93	93	0.0076064012202881484	1	1	138	251	4	3	G
G4_BC76_191109_LF_LIB_consensus_vsearch	1439	C	Y	377	13	3.24%	2	1	93	93	1.1027355068065241E-4	1	1	140	237	0	13	T
G4_BC76_191109_LF_LIB_consensus_vsearch	1440	T	*/+G	379	14	3.47%	2	1	93	93	5.425226475721076E-5	1	1	146	233	0	14	+G
G4_BC76_191109_LF_LIB_consensus_vsearch	1441	G	G	402	2	0.49%	2	1	93	93	0.2496902106567468	1	1	147	255	2	0	-A
G4_BC76_191109_LF_LIB_consensus_vsearch	1442	A	A	399	3	0.74%	2	2	93	93	0.12453300124551302	1	1	145	254	1	2	G
G4_BC76_191109_LF_LIB_consensus_vsearch	1443	T	*/+G	392	7	1.72%	2	1	93	93	0.007607942959128091	1	1	145	247	0	7	+G
G4_BC76_191109_LF_LIB_consensus_vsearch	1444	G	R	387	12	2.96%	2	2	93	93	2.2448869655710964E-4	1	1	132	255	11	1	A
G4_BC76_191109_LF_LIB_consensus_vsearch	1445	C	*/+G	393	7	1.73%	2	1	93	93	0.007608451759263046	1	1	139	254	7	0	+G
G4_BC76_191109_LF_LIB_consensus_vsearch	1446	A	*/-G	390	8	1.97%	2	1	93	93	0.0037699692796093966	1	1	136	254	8	0	-G
G4_BC76_191109_LF_LIB_consensus_vsearch	1447	G	G	391	3	0.75%	2	1	93	93	0.12452350698836272	1	1	138	253	0	3	-A
G4_BC76_191109_LF_LIB_consensus_vsearch	1448	A	A	394	4	0.99%	2	2	93	93	0.06202859930052086	1	1	141	253	3	1	G
G4_BC76_191109_LF_LIB_consensus_vsearch	1449	C	C	397	4	0.99%	2	2	93	93	0.062032128175275904	1	1	146	251	1	3	-A
G4_BC76_191109_LF_LIB_consensus_vsearch	1450	A	A	395	1	0.25%	2	1	93	93	0.5000000000008233	1	1	145	250	0	1	+C
G4_BC76_191109_LF_LIB_consensus_vsearch	1451	A	A	399	4	0.98%	2	2	93	93	0.06203445155203153	1	1	145	254	2	2	G
G4_BC76_191109_LF_LIB_consensus_vsearch	1452	T	*/-G	364	29	7.18%	2	2	93	93	1.0896949069747076E-9	1	1	143	221	3	26	-G
G4_BC76_191109_LF_LIB_consensus_vsearch	1453	G	G	367	3	0.8%	2	1	93	93	0.12449255751015709	1	1	144	223	0	3	+T
G4_BC76_191109_LF_LIB_consensus_vsearch	1454	G	G	404	1	0.25%	2	1	93	93	0.4999999999999138	1	1	147	257	0	1	A
G4_BC76_191109_LF_LIB_consensus_vsearch	1455	G	G	407	1	0.25%	2	1	93	93	0.5000000000008233	1	1	148	259	1	0	-CA
G4_BC76_191109_LF_LIB_consensus_vsearch	1456	C	C	404	1	0.25%	2	1	93	93	0.4999999999999138	1	1	147	257	0	1	-AT
G4_BC76_191109_LF_LIB_consensus_vsearch	1457	A	A	391	5	1.23%	2	1	93	93	0.030855681550508444	1	1	143	248	0	5	-T
G4_BC76_191109_LF_LIB_consensus_vsearch	1458	T	T	395	3	0.75%	2	1	93	93	0.12452830188671389	1	1	147	248	0	3	+C
G4_BC76_191109_LF_LIB_consensus_vsearch	1459	T	Y	394	7	1.72%	2	1	93	93	0.007608958034696689	1	1	145	249	0	7	C
G4_BC76_191109_LF_LIB_consensus_vsearch	1460	C	C	400	2	0.5%	2	1	93	93	0.24968866749695368	1	1	143	257	2	0	-AC
G4_BC76_191109_LF_LIB_consensus_vsearch	1461	A	A	388	6	1.49%	2	2	93	93	0.015328329503561841	1	1	137	251	2	4	G
G4_BC76_191109_LF_LIB_consensus_vsearch	1462	C	C	389	6	1.51%	2	1	93	93	0.015329078637527195	1	1	139	250	0	6	+T
G4_BC76_191109_LF_LIB_consensus_vsearch	1463	C	*/-T	389	14	3.46%	2	2	93	93	5.441381266881181E-5	1	1	146	243	1	13	-T
G4_BC76_191109_LF_LIB_consensus_vsearch	1464	T	Y	379	10	2.55%	2	2	93	93	9.21019917535404E-4	1	1	144	235	1	9	C
G4_BC76_191109_LF_LIB_consensus_vsearch	1465	A	A	397	4	0.99%	2	2	93	93	0.062032128175275904	1	1	142	255	3	1	G
G4_BC76_191109_LF_LIB_consensus_vsearch	1466	T	*/-C	377	14	3.44%	2	2	93	93	5.421900571236966E-5	1	1	124	253	13	1	-C
G4_BC76_191109_LF_LIB_consensus_vsearch	1467	C	C	383	0	0%	2	0	93	0	1.0	1	0	125	258	0	0	
G4_BC76_191109_LF_LIB_consensus_vsearch	1468	C	C	387	6	1.51%	2	1	93	93	0.015327576567173378	1	1	136	251	0	6	+T
G4_BC76_191109_LF_LIB_consensus_vsearch	1469	C	Y	335	25	6.14%	2	1	93	93	1.9358913764421943E-8	1	1	137	198	0	25	T
G4_BC76_191109_LF_LIB_consensus_vsearch	1470	G	*/-A	384	10	2.49%	2	2	93	93	9.217129834227815E-4	1	1	133	251	9	1	-A
G4_BC76_191109_LF_LIB_consensus_vsearch	1471	A	*/-G	370	17	4.3%	2	1	93	93	6.375461151373017E-6	1	1	120	250	17	0	-G
G4_BC76_191109_LF_LIB_consensus_vsearch	1472	G	*/-AG	345	24	6.19%	2	2	93	93	4.050315754047772E-8	1	1	107	238	8	16	-AG
G4_BC76_191109_LF_LIB_consensus_vsearch	1473	A	*/-G	346	15	4.07%	2	2	93	93	2.6308251910834233E-5	1	1	117	229	10	5	-G
G4_BC76_191109_LF_LIB_consensus_vsearch	1474	G	G	347	2	0.56%	2	1	93	93	0.24964131994254463	1	1	119	228	0	2	+AG
G4_BC76_191109_LF_LIB_consensus_vsearch	1475	G	*/+A	371	20	5.08%	2	2	93	93	7.433112408176003E-7	1	1	117	254	19	1	+A
G4_BC76_191109_LF_LIB_consensus_vsearch	1476	G	G	388	4	0.99%	2	2	93	93	0.0620213794085142	1	1	137	251	3	1	A
G4_BC76_191109_LF_LIB_consensus_vsearch	1477	C	C	397	3	0.74%	2	1	93	93	0.12453066332921275	1	1	145	252	0	3	T
G4_BC76_191109_LF_LIB_consensus_vsearch	1478	T	*/+G	376	8	1.98%	2	2	93	93	0.0037650433430064176	1	1	140	236	2	6	+G
G4_BC76_191109_LF_LIB_consensus_vsearch	1479	G	R	386	9	2.27%	2	2	93	93	0.0018651929543866046	1	1	139	247	7	2	A
G4_BC76_191109_LF_LIB_consensus_vsearch	1480	G	*/+A	372	9	2.25%	2	2	93	93	0.00186200269208392	1	1	124	248	8	1	+A
G4_BC76_191109_LF_LIB_consensus_vsearch	1481	G	G	400	4	0.98%	2	2	93	93	0.06203560460879861	1	1	145	255	1	3	-T
G4_BC76_191109_LF_LIB_consensus_vsearch	1482	T	Y	366	22	5.46%	2	2	93	93	1.7553238433432722E-7	1	1	135	231	4	18	C
G4_BC76_191109_LF_LIB_consensus_vsearch	1483	A	A	393	3	0.76%	2	2	93	93	0.12452591656124207	1	1	139	254	1	2	C
G4_BC76_191109_LF_LIB_consensus_vsearch	1484	A	A	395	5	1.23%	2	1	93	93	0.030859622206549208	1	1	147	248	0	5	-TC
G4_BC76_191109_LF_LIB_consensus_vsearch	1485	T	*/-C	375	11	2.76%	2	2	93	93	4.5425715087818366E-4	1	1	139	236	7	4	-C
G4_BC76_191109_LF_LIB_consensus_vsearch	1486	C	C	388	1	0.26%	2	1	93	93	0.4999999999999138	1	1	140	248	1	0	+A
G4_BC76_191109_LF_LIB_consensus_vsearch	1487	C	*/-T	392	8	1.97%	2	1	93	93	0.0037706450711110975	1	1	147	245	0	8	-T
G4_BC76_191109_LF_LIB_consensus_vsearch	1488	T	Y	357	14	3.54%	2	1	93	93	5.386757614476661E-5	1	1	145	212	0	14	C
G4_BC76_191109_LF_LIB_consensus_vsearch	1489	G	S	372	11	2.74%	2	1	93	93	4.539966388795655E-4	1	1	139	233	0	11	C
G4_BC76_191109_LF_LIB_consensus_vsearch	1490	T	W	371	12	3.07%	2	2	93	93	2.236910591562848E-4	1	1	136	235	1	11	A
G4_BC76_191109_LF_LIB_consensus_vsearch	1491	G	G	384	4	1.01%	2	2	93	93	0.06201644201482272	1	1	137	247	2	2	-A
G4_BC76_191109_LF_LIB_consensus_vsearch	1492	A	*/-G	373	16	3.98%	2	2	93	93	1.3036692196399446E-5	1	1	126	247	11	5	-G
G4_BC76_191109_LF_LIB_consensus_vsearch	1493	G	G	383	3	0.77%	2	1	93	93	0.12451361867715198	1	1	133	250	3	0	+A
G4_BC76_191109_LF_LIB_consensus_vsearch	1494	G	G	396	3	0.74%	2	2	93	93	0.12452948557099502	1	1	143	253	2	1	A
G4_BC76_191109_LF_LIB_consensus_vsearch	1495	C	C	398	3	0.74%	2	1	93	93	0.12453183520605009	1	1	145	253	0	3	T
G4_BC76_191109_LF_LIB_consensus_vsearch	1496	T	Y	390	9	2.22%	2	2	93	93	0.0018660638404102402	1	1	146	244	1	8	C
G4_BC76_191109_LF_LIB_consensus_vsearch	1497	G	G	398	3	0.74%	2	1	93	93	0.12453183520605009	1	1	144	254	3	0	A
G4_BC76_191109_LF_LIB_consensus_vsearch	1498	C	C	398	2	0.5%	2	1	93	93	0.249687108886017	1	1	147	251	0	2	T
G4_BC76_191109_LF_LIB_consensus_vsearch	1499	A	A	392	4	0.99%	2	1	93	93	0.06202621699451153	1	1	144	248	0	4	-T
G4_BC76_191109_LF_LIB_consensus_vsearch	1500	T	T	396	3	0.75%	2	2	93	93	0.12452948557099502	1	1	147	249	1	2	-C
G4_BC76_191109_LF_LIB_consensus_vsearch	1501	C	*/+A	384	8	1.99%	2	2	93	93	0.0037679008816766993	1	1	141	243	4	4	+A
G4_BC76_191109_LF_LIB_consensus_vsearch	1502	G	*/-TG	377	8	1.99%	2	1	93	93	0.003765406973524696	1	1	138	239	0	8	-TG
G4_BC76_191109_LF_LIB_consensus_vsearch	1503	T	Y	369	7	1.79%	2	2	93	93	0.007595497661975396	1	1	146	223	1	6	C
G4_BC76_191109_LF_LIB_consensus_vsearch	1504	G	*/-C	372	15	3.85%	2	1	93	93	2.6576986497768562E-5	1	1	146	226	0	15	-C
G4_BC76_191109_LF_LIB_consensus_vsearch	1505	C	Y	356	14	3.65%	2	1	93	93	5.384905221900327E-5	1	1	140	216	0	14	T
G4_BC76_191109_LF_LIB_consensus_vsearch	1506	T	*/-G	318	69	17.25%	2	2	93	93	6.060291346308443E-23	1	1	99	219	36	33	-G
G4_BC76_191109_LF_LIB_consensus_vsearch	1507	G	K	301	16	4.83%	2	2	93	93	1.2567545268824513E-5	1	1	96	205	1	15	T
G4_BC76_191109_LF_LIB_consensus_vsearch	1508	G	G	390	6	1.5%	2	1	93	93	0.015329823997787357	1	1	137	253	6	0	A
G4_BC76_191109_LF_LIB_consensus_vsearch	1509	G	R	364	36	8.93%	2	1	93	93	6.381215539906549E-12	1	1	108	256	36	0	A
G4_BC76_191109_LF_LIB_consensus_vsearch	1510	G	G	397	6	1.48%	2	2	93	93	0.015334938209013941	1	1	140	257	5	1	A
G4_BC76_191109_LF_LIB_consensus_vsearch	1511	A	*/+C	392	7	1.74%	2	1	93	93	0.007607942959128091	1	1	144	248	0	7	+C
G4_BC76_191109_LF_LIB_consensus_vsearch	1512	T	T	392	4	0.99%	2	1	93	93	0.06202621699451153	1	1	142	250	4	0	+CC
G4_BC76_191109_LF_LIB_consensus_vsearch	1513	C	*/+G	381	9	2.24%	2	1	93	93	0.0018640795393290628	1	1	143	238	0	9	+G
G4_BC76_191109_LF_LIB_consensus_vsearch	1514	G	*/-A	387	8	1.99%	2	2	93	93	0.0037689428690762675	1	1	135	252	7	1	-A
G4_BC76_191109_LF_LIB_consensus_vsearch	1515	A	R	382	7	1.77%	2	2	93	93	0.0076027118384171	1	1	134	248	3	4	G
G4_BC76_191109_LF_LIB_consensus_vsearch	1516	G	G	393	3	0.75%	2	1	93	93	0.12452591656124207	1	1	142	251	3	0	A
G4_BC76_191109_LF_LIB_consensus_vsearch	1517	C	C	393	4	0.99%	2	2	93	93	0.0620274111497499	1	1	142	251	1	3	T
G4_BC76_191109_LF_LIB_consensus_vsearch	1518	A	A	389	6	1.49%	2	1	93	93	0.015329078637527195	1	1	137	252	6	0	G
G4_BC76_191109_LF_LIB_consensus_vsearch	1519	C	C	393	3	0.75%	2	2	93	93	0.12452591656124207	1	1	142	251	2	1	-T
G4_BC76_191109_LF_LIB_consensus_vsearch	1520	T	*/-G	359	30	7.43%	2	1	93	93	5.207620028244116E-10	1	1	144	215	0	30	-G
G4_BC76_191109_LF_LIB_consensus_vsearch	1521	G	G	368	6	1.6%	2	1	93	93	0.01531250785611621	1	1	148	220	0	6	T
G4_BC76_191109_LF_LIB_consensus_vsearch	1522	G	G	396	6	1.48%	2	2	93	93	0.015334218484153218	1	1	145	251	4	2	-A
G4_BC76_191109_LF_LIB_consensus_vsearch	1523	A	A	391	4	1%	2	1	93	93	0.06202501678889606	1	1	139	252	4	0	+G
G4_BC76_191109_LF_LIB_consensus_vsearch	1524	A	A	397	2	0.49%	2	1	93	93	0.24968632371350802	1	1	147	250	0	2	+C
G4_BC76_191109_LF_LIB_consensus_vsearch	1525	C	C	398	3	0.74%	2	2	93	93	0.12453183520605009	1	1	146	252	1	2	-T
G4_BC76_191109_LF_LIB_consensus_vsearch	1526	T	Y	389	9	2.23%	2	2	93	93	0.0018658477399051397	1	1	147	242	1	8	C
G4_BC76_191109_LF_LIB_consensus_vsearch	1527	G	G	395	5	1.23%	2	1	93	93	0.030859622206549208	1	1	144	251	0	5	-TG
G4_BC76_191109_LF_LIB_consensus_vsearch	1528	T	T	396	3	0.75%	2	2	93	93	0.12452948557099502	1	1	146	250	2	1	-G
G4_BC76_191109_LF_LIB_consensus_vsearch	1529	G	*/-C	373	14	3.51%	2	1	93	93	5.415150063894175E-5	1	1	144	229	0	14	-C
G4_BC76_191109_LF_LIB_consensus_vsearch	1530	C	C	381	5	1.27%	2	2	93	93	0.03084547283766662	1	1	144	237	1	4	-T
G4_BC76_191109_LF_LIB_consensus_vsearch	1531	T	T	388	6	1.5%	2	2	93	93	0.015328329503561841	1	1	141	247	3	3	C
G4_BC76_191109_LF_LIB_consensus_vsearch	1532	C	*/-G	374	17	4.24%	2	1	93	93	6.387437421351367E-6	1	1	144	230	0	17	-G
G4_BC76_191109_LF_LIB_consensus_vsearch	1533	G	G	377	3	0.77%	2	1	93	93	0.124505928853663	1	1	146	231	0	3	-TG
G4_BC76_191109_LF_LIB_consensus_vsearch	1534	T	W	365	18	4.51%	2	1	93	93	3.109413023746024E-6	1	1	141	224	0	18	A
G4_BC76_191109_LF_LIB_consensus_vsearch	1535	G	G	387	6	1.5%	2	2	93	93	0.015327576567173378	1	1	140	247	5	1	-A
G4_BC76_191109_LF_LIB_consensus_vsearch	1536	A	A	396	1	0.25%	2	1	93	93	0.4999999999999138	1	1	140	256	1	0	+C
G4_BC76_191109_LF_LIB_consensus_vsearch	1537	A	A	397	6	1.48%	2	1	93	93	0.015334938209013941	1	1	141	256	6	0	G
G4_BC76_191109_LF_LIB_consensus_vsearch	1538	C	C	403	3	0.74%	2	2	93	93	0.12453760789147728	1	1	145	258	2	1	T
G4_BC76_191109_LF_LIB_consensus_vsearch	1539	A	A	396	3	0.74%	2	2	93	93	0.12452948557099502	1	1	142	254	1	2	-T
G4_BC76_191109_LF_LIB_consensus_vsearch	1540	T	*/-G	379	8	2%	2	2	93	93	0.0037661286454389806	1	1	129	250	4	4	-G
G4_BC76_191109_LF_LIB_consensus_vsearch	1541	G	G	384	4	1.01%	2	2	93	93	0.06201644201482272	1	1	133	251	3	1	A
G4_BC76_191109_LF_LIB_consensus_vsearch	1542	G	*/+A	388	8	1.98%	2	1	93	93	0.0037692867193449852	1	1	135	253	8	0	+A
G4_BC76_191109_LF_LIB_consensus_vsearch	1543	A	*/+G	389	7	1.75%	2	1	93	93	0.0076064012202881484	1	1	137	252	7	0	+G
G4_BC76_191109_LF_LIB_consensus_vsearch	1544	A	A	399	4	0.99%	2	1	93	93	0.06203445155203153	1	1	147	252	0	4	G
G4_BC76_191109_LF_LIB_consensus_vsearch	1545	T	T	388	5	1.24%	2	2	93	93	0.030852673450990298	1	1	142	246	1	4	C
G4_BC76_191109_LF_LIB_consensus_vsearch	1546	G	R	367	11	2.74%	2	2	93	93	4.5355347638701343E-4	1	1	131	236	10	1	A
G4_BC76_191109_LF_LIB_consensus_vsearch	1547	C	Y	377	7	1.77%	2	1	93	93	0.007599994652592844	1	1	143	234	0	7	T
G4_BC76_191109_LF_LIB_consensus_vsearch	1548	C	Y	365	18	4.44%	2	2	93	93	3.109413023746024E-6	1	1	145	220	1	17	T
G4_BC76_191109_LF_LIB_consensus_vsearch	1549	T	T	390	2	0.51%	2	1	93	93	0.24968071519789278	1	1	142	248	2	0	G
G4_BC76_191109_LF_LIB_consensus_vsearch	1550	T	T	392	5	1.23%	2	1	93	93	0.030856674154206513	1	1	143	249	0	5	+G
G4_BC76_191109_LF_LIB_consensus_vsearch	1551	G	G	392	6	1.5%	2	2	93	93	0.015331303510572384	1	1	141	251	1	5	-T
G4_BC76_191109_LF_LIB_consensus_vsearch	1552	T	Y	380	11	2.76%	2	1	93	93	4.546826533185083E-4	1	1	142	238	0	11	C
G4_BC76_191109_LF_LIB_consensus_vsearch	1553	A	A	397	4	1%	2	2	93	93	0.062032128175275904	1	1	145	252	1	3	C
G4_BC76_191109_LF_LIB_consensus_vsearch	1554	A	A	394	6	1.47%	2	2	93	93	0.015332768266138878	1	1	144	250	5	1	G
G4_BC76_191109_LF_LIB_consensus_vsearch	1555	T	T	397	5	1.24%	2	2	93	93	0.03086156314569468	1	1	148	249	1	4	C
G4_BC76_191109_LF_LIB_consensus_vsearch	1556	C	C	401	3	0.74%	2	1	93	93	0.1245353159851805	1	1	144	257	3	0	+G
G4_BC76_191109_LF_LIB_consensus_vsearch	1557	G	*/-TG	390	15	3.69%	2	1	93	93	2.674381262774065E-5	1	1	147	243	0	15	-TG
G4_BC76_191109_LF_LIB_consensus_vsearch	1558	T	*/-G	367	8	2.04%	2	2	93	93	0.0037616841729398503	1	1	133	234	5	3	-G
G4_BC76_191109_LF_LIB_consensus_vsearch	1559	G	*/-A	373	10	2.6%	2	1	93	93	9.201647694189105E-4	1	1	134	239	10	0	-A
G4_BC76_191109_LF_LIB_consensus_vsearch	1560	A	A	393	4	1.01%	2	2	93	93	0.0620274111497499	1	1	137	256	1	3	G
G4_BC76_191109_LF_LIB_consensus_vsearch	1561	G	G	404	2	0.49%	2	1	93	93	0.24969173859492816	1	1	148	256	0	2	+AG
G4_BC76_191109_LF_LIB_consensus_vsearch	1562	T	T	400	3	0.74%	2	1	93	93	0.12453416149047736	1	1	146	254	0	3	C
G4_BC76_191109_LF_LIB_consensus_vsearch	1563	C	C	404	1	0.25%	2	1	93	93	0.4999999999999138	1	1	145	259	1	0	+T
G4_BC76_191109_LF_LIB_consensus_vsearch	1564	A	A	401	5	1.23%	2	2	93	93	0.030865387693025832	1	1	144	257	4	1	G
G4_BC76_191109_LF_LIB_consensus_vsearch	1565	T	T	396	3	0.74%	2	2	93	93	0.12452948557099502	1	1	144	252	2	1	+C
G4_BC76_191109_LF_LIB_consensus_vsearch	1566	C	C	394	5	1.23%	2	1	93	93	0.030858644444955494	1	1	142	252	5	0	-A
G4_BC76_191109_LF_LIB_consensus_vsearch	1567	A	A	396	2	0.5%	2	2	93	93	0.24968553459123424	1	1	142	254	1	1	G
G4_BC76_191109_LF_LIB_consensus_vsearch	1568	A	R	386	13	3.21%	2	1	93	93	1.1053069410618301E-4	1	1	135	251	13	0	G
G4_BC76_191109_LF_LIB_consensus_vsearch	1569	C	*/-T	400	7	1.72%	2	1	93	93	0.007611943705349879	1	1	149	251	0	7	-T
G4_BC76_191109_LF_LIB_consensus_vsearch	1570	T	T	391	6	1.5%	2	2	93	93	0.01533056561273411	1	1	147	244	2	4	C
G4_BC76_191109_LF_LIB_consensus_vsearch	1571	C	C	399	4	0.98%	2	1	93	93	0.06203445155203153	1	1	144	255	4	0	+TC
G4_BC76_191109_LF_LIB_consensus_vsearch	1572	A	A	399	5	1.23%	2	2	93	93	0.030863484879977227	1	1	144	255	3	2	G
G4_BC76_191109_LF_LIB_consensus_vsearch	1573	C	C	401	5	1.23%	2	2	93	93	0.030865387693025832	1	1	147	254	1	4	T
G4_BC76_191109_LF_LIB_consensus_vsearch	1574	G	G	403	1	0.25%	2	1	93	93	0.4999999999999138	1	1	147	256	0	1	+TG
G4_BC76_191109_LF_LIB_consensus_vsearch	1575	A	A	403	3	0.74%	2	2	93	93	0.12453760789147728	1	1	146	257	1	2	-T
G4_BC76_191109_LF_LIB_consensus_vsearch	1576	T	*/+A	387	11	2.72%	2	1	93	93	4.5526079174589983E-4	1	1	131	256	11	0	+A
G4_BC76_191109_LF_LIB_consensus_vsearch	1577	G	*/-A	391	8	1.98%	2	1	93	93	0.003770308015149166	1	1	137	254	8	0	-A
G4_BC76_191109_LF_LIB_consensus_vsearch	1578	A	A	387	6	1.51%	2	2	93	93	0.015327576567173378	1	1	133	254	4	2	G
G4_BC76_191109_LF_LIB_consensus_vsearch	1579	A	M	388	9	2.22%	2	1	93	93	0.0018656305641170923	1	1	135	253	9	0	C
G4_BC76_191109_LF_LIB_consensus_vsearch	1580	T	Y	385	11	2.71%	2	2	93	93	4.550976487942495E-4	1	1	136	249	8	3	C
G4_BC76_191109_LF_LIB_consensus_vsearch	1581	A	R	380	11	2.73%	2	2	93	93	4.546826533185083E-4	1	1	125	255	10	1	G
G4_BC76_191109_LF_LIB_consensus_vsearch	1582	C	C	385	6	1.49%	2	1	93	93	0.01532605917062568	1	1	137	248	0	6	T
G4_BC76_191109_LF_LIB_consensus_vsearch	1583	G	R	374	19	4.69%	2	2	93	93	1.5263684541229892E-6	1	1	120	254	18	1	A
G4_BC76_191109_LF_LIB_consensus_vsearch	1584	T	*/-C	303	67	16.54%	2	2	93	93	2.5289576139099935E-22	1	1	71	232	60	7	-C
G4_BC76_191109_LF_LIB_consensus_vsearch	1585	C	C	337	1	0.3%	2	1	93	93	0.5000000000003686	1	1	86	251	0	1	+GT
G4_BC76_191109_LF_LIB_consensus_vsearch	1586	C	*/+T	392	8	1.98%	2	1	93	93	0.0037706450711110975	1	1	141	251	0	8	+T
G4_BC76_191109_LF_LIB_consensus_vsearch	1587	C	*/-T	381	18	4.42%	2	2	93	93	3.1355882207983647E-6	1	1	137	244	7	11	-T
G4_BC76_191109_LF_LIB_consensus_vsearch	1588	T	Y	356	24	6.2%	2	1	93	93	4.097346548042857E-8	1	1	139	217	0	24	C
G4_BC76_191109_LF_LIB_consensus_vsearch	1589	G	*/-C	365	15	3.7%	2	2	93	93	2.650806354364234E-5	1	1	130	235	6	9	-C
G4_BC76_191109_LF_LIB_consensus_vsearch	1590	C	*/+T	366	14	3.59%	2	1	93	93	5.403009673105009E-5	1	1	140	226	0	14	+T
G4_BC76_191109_LF_LIB_consensus_vsearch	1591	C	Y	387	13	3.2%	2	1	93	93	1.1055857583867697E-4	1	1	143	244	0	13	T
G4_BC76_191109_LF_LIB_consensus_vsearch	1592	C	*/-T	285	108	26.54%	2	2	93	93	5.953170302496012E-37	1	1	138	147	5	103	-T
G4_BC76_191109_LF_LIB_consensus_vsearch	1593	T	Y	264	10	3.5%	2	1	93	93	8.982685182237654E-4	1	1	135	129	0	10	C
G4_BC76_191109_LF_LIB_consensus_vsearch	1594	T	T	386	5	1.27%	2	2	93	93	0.030850642423789317	1	1	140	246	3	2	C
G4_BC76_191109_LF_LIB_consensus_vsearch	1595	T	T	393	4	0.99%	2	2	93	93	0.0620274111497499	1	1	142	251	1	3	C
G4_BC76_191109_LF_LIB_consensus_vsearch	1596	T	G	16	371	91.38%	2	2	93	93	6.006288750295858E-204	1	1	8	8	137	234	G
G4_BC76_191109_LF_LIB_consensus_vsearch	1597	T	*/-A	312	74	18.18%	2	2	93	93	1.0997995813312778E-24	1	1	102	210	39	35	-A
G4_BC76_191109_LF_LIB_consensus_vsearch	1598	A	+C/+C	5	307	92.19%	2	2	93	93	1.1626756399404523E-176	1	1	3	2	99	208	+C
G4_BC76_191109_LF_LIB_consensus_vsearch	1599	A	-C/-C	38	364	89.43%	2	2	93	93	3.474605951806974E-186	1	1	9	29	137	227	-C
G4_BC76_191109_LF_LIB_consensus_vsearch	1600	C	*/+A	13	24	54.55%	2	2	93	93	2.0322679520533668E-10	1	1	3	10	8	16	+A
G4_BC76_191109_LF_LIB_consensus_vsearch	1601	C	C	394	6	1.47%	2	2	93	93	0.015332768266138878	1	1	147	247	1	5	T
G4_BC76_191109_LF_LIB_consensus_vsearch	1602	A	A	389	4	0.99%	2	2	93	93	0.06202259804292181	1	1	146	243	1	3	-C
G4_BC76_191109_LF_LIB_consensus_vsearch	1603	C	*/+T	392	7	1.74%	2	1	93	93	0.007607942959128091	1	1	148	244	0	7	+T
G4_BC76_191109_LF_LIB_consensus_vsearch	1604	C	Y	354	48	11.76%	2	1	93	93	7.99038504352655E-16	1	1	147	207	0	48	T
G4_BC76_191109_LF_LIB_consensus_vsearch	1605	G	G	394	5	1.23%	2	2	93	93	0.030858644444955494	1	1	142	252	2	3	-C
G4_BC76_191109_LF_LIB_consensus_vsearch	1606	C	C	395	2	0.5%	2	1	93	93	0.24968474148789518	1	1	142	253	2	0	A
G4_BC76_191109_LF_LIB_consensus_vsearch	1607	C	C	399	3	0.74%	2	1	93	93	0.12453300124551302	1	1	147	252	0	3	+T
G4_BC76_191109_LF_LIB_consensus_vsearch	1608	C	Y	382	21	5.16%	2	2	93	93	3.6496416663752166E-7	1	1	146	236	1	20	T
G4_BC76_191109_LF_LIB_consensus_vsearch	1609	G	G	404	2	0.49%	2	2	93	93	0.24969173859492816	1	1	147	257	1	1	A
G4_BC76_191109_LF_LIB_consensus_vsearch	1610	T	Y	398	8	1.96%	2	1	93	93	0.003772632825065396	1	1	148	250	0	8	C
G4_BC76_191109_LF_LIB_consensus_vsearch	1611	C	C	400	3	0.74%	2	2	93	93	0.12453416149047736	1	1	144	256	1	2	+A
G4_BC76_191109_LF_LIB_consensus_vsearch	1612	G	G	398	2	0.49%	2	1	93	93	0.249687108886017	1	1	145	253	0	2	-T
G4_BC76_191109_LF_LIB_consensus_vsearch	1613	T	T	395	4	1%	2	1	93	93	0.06202978149183676	1	1	145	250	0	4	C
G4_BC76_191109_LF_LIB_consensus_vsearch	1614	T	T	393	5	1.23%	2	1	93	93	0.03085766177318207	1	1	143	250	0	5	C
G4_BC76_191109_LF_LIB_consensus_vsearch	1615	A	*/-T	377	9	2.21%	2	2	93	93	0.0018631683014264863	1	1	141	236	2	7	-T
G4_BC76_191109_LF_LIB_consensus_vsearch	1616	T	Y	381	9	2.28%	2	2	93	93	0.0018640795393290628	1	1	143	238	2	7	C
G4_BC76_191109_LF_LIB_consensus_vsearch	1617	T	Y	394	8	1.99%	2	2	93	93	0.0037713141940397903	1	1	147	247	1	7	C
G4_BC76_191109_LF_LIB_consensus_vsearch	1618	T	*/-C	378	16	3.93%	2	2	93	93	1.3063283572416325E-5	1	1	137	241	7	9	-C
G4_BC76_191109_LF_LIB_consensus_vsearch	1619	C	C	385	1	0.26%	2	1	93	93	0.4999999999999138	1	1	140	245	1	0	+A
G4_BC76_191109_LF_LIB_consensus_vsearch	1620	C	*/+G	364	13	3.21%	2	1	93	93	1.0988123554092724E-4	1	1	146	218	0	13	+G
G4_BC76_191109_LF_LIB_consensus_vsearch	1621	G	G	399	5	1.23%	2	1	93	93	0.030863484879977227	1	1	144	255	5	0	-A
G4_BC76_191109_LF_LIB_consensus_vsearch	1622	A	A	400	2	0.5%	2	1	93	93	0.24968866749695368	1	1	144	256	0	2	+C
G4_BC76_191109_LF_LIB_consensus_vsearch	1623	T	T	396	5	1.23%	2	1	93	93	0.03086059509471206	1	1	140	256	5	0	+C
G4_BC76_191109_LF_LIB_consensus_vsearch	1624	C	*/+A	393	10	2.47%	2	2	93	93	9.229178835087009E-4	1	1	139	254	9	1	+A
G4_BC76_191109_LF_LIB_consensus_vsearch	1625	G	*/-A	394	9	2.21%	2	2	93	93	0.0018669176476072253	1	1	139	255	8	1	-A
G4_BC76_191109_LF_LIB_consensus_vsearch	1626	A	A	395	1	0.25%	2	1	93	93	0.5000000000008233	1	1	138	257	1	0	+C
G4_BC76_191109_LF_LIB_consensus_vsearch	1627	A	A	400	3	0.74%	2	1	93	93	0.12453416149047736	1	1	147	253	0	3	-T
G4_BC76_191109_LF_LIB_consensus_vsearch	1628	T	Y	385	9	2.23%	2	2	93	93	0.001864972504119446	1	1	143	242	3	6	C
G4_BC76_191109_LF_LIB_consensus_vsearch	1629	G	G	397	2	0.5%	2	2	93	93	0.24968632371350802	1	1	146	251	1	1	+AA
G4_BC76_191109_LF_LIB_consensus_vsearch	1630	G	*/+C	375	13	3.2%	2	1	93	93	1.102148449959401E-4	1	1	144	231	0	13	+C
G4_BC76_191109_LF_LIB_consensus_vsearch	1631	C	C	388	4	1%	2	2	93	93	0.0620213794085142	1	1	143	245	1	3	+T
G4_BC76_191109_LF_LIB_consensus_vsearch	1632	T	*/-C	364	15	3.71%	2	1	93	93	2.6498020436636046E-5	1	1	131	233	0	15	-C
G4_BC76_191109_LF_LIB_consensus_vsearch	1633	C	C	376	5	1.28%	2	1	93	93	0.030840167659546065	1	1	147	229	0	5	+G
G4_BC76_191109_LF_LIB_consensus_vsearch	1634	G	G	395	3	0.74%	2	1	93	93	0.12452830188671389	1	1	149	246	0	3	+A
G4_BC76_191109_LF_LIB_consensus_vsearch	1635	G	G	401	3	0.74%	2	1	93	93	0.1245353159851805	1	1	148	253	0	3	-T
G4_BC76_191109_LF_LIB_consensus_vsearch	1636	T	T	380	6	1.48%	2	1	93	93	0.015322197067995588	1	1	138	242	0	6	A
G4_BC76_191109_LF_LIB_consensus_vsearch	1637	G	*/-A	389	7	1.74%	2	2	93	93	0.0076064012202881484	1	1	142	247	2	5	-A
G4_BC76_191109_LF_LIB_consensus_vsearch	1638	A	*/+GG	89	146	36.78%	2	2	93	93	2.3209815395412626E-59	1	1	66	23	22	124	+GG
G4_BC76_191109_LF_LIB_consensus_vsearch	1639	G	G	371	1	0.27%	2	1	93	93	0.4999999999999138	1	1	139	232	1	0	+A
G4_BC76_191109_LF_LIB_consensus_vsearch	1640	G	*/+A	395	7	1.73%	2	1	93	93	0.007609461804174083	1	1	139	256	7	0	+A
G4_BC76_191109_LF_LIB_consensus_vsearch	1641	G	*/+AG	389	10	2.45%	2	1	93	93	9.223889705434762E-4	1	1	138	251	10	0	+AG
G4_BC76_191109_LF_LIB_consensus_vsearch	1642	T	Y	365	15	3.75%	2	1	93	93	2.650806354364234E-5	1	1	141	224	0	15	C
G4_BC76_191109_LF_LIB_consensus_vsearch	1643	A	*/-G	379	7	1.77%	2	2	93	93	0.007601089929303789	1	1	143	236	2	5	-G
G4_BC76_191109_LF_LIB_consensus_vsearch	1644	G	G	380	5	1.27%	2	1	93	93	0.030844422818352438	1	1	138	242	5	0	A
G4_BC76_191109_LF_LIB_consensus_vsearch	1645	G	*/+A	38	293	73.07%	2	2	93	93	1.5788327602124634E-146	1	1	17	21	117	176	+A
G4_BC76_191109_LF_LIB_consensus_vsearch	1646	G	*/+AG	366	12	2.95%	2	2	93	93	2.234283568245827E-4	1	1	143	223	2	10	+AG
G4_BC76_191109_LF_LIB_consensus_vsearch	1647	C	*/-T	321	54	13.4%	2	1	93	93	7.099337706452484E-18	1	1	148	173	0	54	-T
G4_BC76_191109_LF_LIB_consensus_vsearch	1648	T	*/+C	332	9	2.55%	2	2	93	93	0.0018514648811998652	1	1	146	186	3	6	+C
G4_BC76_191109_LF_LIB_consensus_vsearch	1649	C	*/+G	366	13	3.21%	2	2	93	93	1.0994327994336431E-4	1	1	144	222	1	12	+G
G4_BC76_191109_LF_LIB_consensus_vsearch	1650	C	Y	381	7	1.72%	2	1	93	93	0.007602173974125566	1	1	149	232	0	7	T
G4_BC76_191109_LF_LIB_consensus_vsearch	1651	G	G	404	3	0.74%	2	1	93	93	0.12453874538748007	1	1	149	255	0	3	A
G4_BC76_191109_LF_LIB_consensus_vsearch	1652	C	C	398	6	1.47%	2	2	93	93	0.015335654379945	1	1	146	252	2	4	-G
G4_BC76_191109_LF_LIB_consensus_vsearch	1653	G	G	401	1	0.25%	2	1	93	93	0.5000000000008233	1	1	146	255	1	0	+C
G4_BC76_191109_LF_LIB_consensus_vsearch	1654	C	*/-G	374	29	7.11%	2	2	93	93	1.104833179604039E-9	1	1	129	245	17	12	-G
G4_BC76_191109_LF_LIB_consensus_vsearch	1655	G	*/+C	276	90	23.75%	2	2	93	93	1.5535310993217044E-30	1	1	94	182	34	56	+C
G4_BC76_191109_LF_LIB_consensus_vsearch	1656	C	C	391	5	1.24%	2	2	93	93	0.030855681550508444	1	1	142	249	1	4	+G
G4_BC76_191109_LF_LIB_consensus_vsearch	1657	G	*/-C	394	10	2.46%	2	2	93	93	9.230485023476184E-4	1	1	142	252	3	7	-C
G4_BC76_191109_LF_LIB_consensus_vsearch	1658	C	S	264	115	28.97%	2	2	93	93	8.589681749052472E-40	1	1	85	179	50	65	G
G4_BC76_191109_LF_LIB_consensus_vsearch	1659	C	*/+GGC	131	204	50%	2	2	93	93	4.4677382273743166E-82	1	1	62	69	75	129	+GGC
G4_BC76_191109_LF_LIB_consensus_vsearch	1660	T	T	400	2	0.5%	2	1	93	93	0.24968866749695368	1	1	142	258	2	0	G
G4_BC76_191109_LF_LIB_consensus_vsearch	1661	T	T	391	4	0.99%	2	2	93	93	0.06202501678889606	1	1	141	250	1	3	C
G4_BC76_191109_LF_LIB_consensus_vsearch	1662	G	G	402	2	0.49%	2	1	93	93	0.2496902106567468	1	1	147	255	0	2	A
G4_BC76_191109_LF_LIB_consensus_vsearch	1663	C	C	396	3	0.74%	2	1	93	93	0.12452948557099502	1	1	144	252	0	3	T
G4_BC76_191109_LF_LIB_consensus_vsearch	1664	T	T	399	4	0.99%	2	1	93	93	0.06203445155203153	1	1	147	252	0	4	-G
G4_BC76_191109_LF_LIB_consensus_vsearch	1665	G	G	396	2	0.5%	2	2	93	93	0.24968553459123424	1	1	145	251	1	1	+A
G4_BC76_191109_LF_LIB_consensus_vsearch	1666	G	G	400	2	0.49%	2	2	93	93	0.24968866749695368	1	1	145	255	1	1	-T
G4_BC76_191109_LF_LIB_consensus_vsearch	1667	T	T	398	4	0.99%	2	2	93	93	0.06203329275530562	1	1	142	256	3	1	-C
G4_BC76_191109_LF_LIB_consensus_vsearch	1668	C	C	401	1	0.25%	2	1	93	93	0.5000000000008233	1	1	144	257	1	0	+GGT
G4_BC76_191109_LF_LIB_consensus_vsearch	1669	G	G	400	6	1.47%	2	2	93	93	0.015337076164670276	1	1	146	254	2	4	A
G4_BC76_191109_LF_LIB_consensus_vsearch	1670	C	C	399	6	1.47%	2	1	93	93	0.01533636702317035	1	1	148	251	0	6	T
G4_BC76_191109_LF_LIB_consensus_vsearch	1671	G	*/-A	381	25	6.14%	2	1	93	93	2.0360009198932435E-8	1	1	123	258	25	0	-A
G4_BC76_191109_LF_LIB_consensus_vsearch	1672	A	A	379	1	0.26%	2	1	93	93	0.4999999999999138	1	1	123	256	0	1	-T
G4_BC76_191109_LF_LIB_consensus_vsearch	1673	T	T	404	2	0.49%	2	2	93	93	0.24969173859492816	1	1	148	256	1	1	C
G4_BC76_191109_LF_LIB_consensus_vsearch	1674	G	G	396	3	0.74%	2	1	93	93	0.12452948557099502	1	1	140	256	3	0	+CC
G4_BC76_191109_LF_LIB_consensus_vsearch	1675	C	*/-G	327	54	13.47%	2	2	93	93	7.351476729473221E-18	1	1	135	192	6	48	-G
G4_BC76_191109_LF_LIB_consensus_vsearch	1676	G	R	328	13	3.78%	2	2	93	93	1.0864499740310097E-4	1	1	126	202	12	1	A
G4_BC76_191109_LF_LIB_consensus_vsearch	1677	G	G	399	1	0.25%	2	1	93	93	0.4999999999999138	1	1	148	251	0	1	A
G4_BC76_191109_LF_LIB_consensus_vsearch	1678	G	R	373	15	3.7%	2	2	93	93	2.6586639991105327E-5	1	1	120	253	14	1	A
G4_BC76_191109_LF_LIB_consensus_vsearch	1679	G	R	388	13	3.19%	2	2	93	93	1.1058632327078025E-4	1	1	133	255	11	2	A
G4_BC76_191109_LF_LIB_consensus_vsearch	1680	C	*/+A	373	18	4.47%	2	1	93	93	3.122747183773151E-6	1	1	120	253	18	0	+A
G4_BC76_191109_LF_LIB_consensus_vsearch	1681	G	*/-A	367	15	3.72%	2	1	93	93	2.6528000199622014E-5	1	1	123	244	15	0	-A
G4_BC76_191109_LF_LIB_consensus_vsearch	1682	A	A	377	5	1.29%	2	2	93	93	0.03084123979791014	1	1	121	256	4	1	G
G4_BC76_191109_LF_LIB_consensus_vsearch	1683	A	R	386	12	2.96%	2	2	93	93	2.244406705806723E-4	1	1	132	254	11	1	G
G4_BC76_191109_LF_LIB_consensus_vsearch	1684	C	C	387	4	1%	2	1	93	93	0.062020154536760255	1	1	136	251	4	0	-A
G4_BC76_191109_LF_LIB_consensus_vsearch	1685	A	*/-C	363	17	4.25%	2	2	93	93	6.353939024329377E-6	1	1	124	239	4	13	-C
G4_BC76_191109_LF_LIB_consensus_vsearch	1686	C	C	372	6	1.55%	2	2	93	93	0.015315805762237024	1	1	134	238	2	4	T
G4_BC76_191109_LF_LIB_consensus_vsearch	1687	C	*/-T	346	42	10.34%	2	2	93	93	7.036844581598471E-14	1	1	133	213	6	36	-T
G4_BC76_191109_LF_LIB_consensus_vsearch	1688	T	T	344	3	0.84%	2	1	93	93	0.12445887445888035	1	1	130	214	3	0	A
G4_BC76_191109_LF_LIB_consensus_vsearch	1689	T	*/-C	370	19	4.75%	2	2	93	93	1.5227894966289487E-6	1	1	134	236	4	15	-C
G4_BC76_191109_LF_LIB_consensus_vsearch	1690	C	C	369	5	1.3%	2	2	93	93	0.03083250226854639	1	1	138	231	3	2	-G
G4_BC76_191109_LF_LIB_consensus_vsearch	1691	G	G	392	3	0.75%	2	2	93	93	0.12452471482865957	1	1	138	254	2	1	+A
G4_BC76_191109_LF_LIB_consensus_vsearch	1692	A	A	400	1	0.25%	2	1	93	93	0.4999999999999138	1	1	141	259	1	0	G
G4_BC76_191109_LF_LIB_consensus_vsearch	1693	A	A	391	5	1.24%	2	1	93	93	0.030855681550508444	1	1	140	251	0	5	+C
G4_BC76_191109_LF_LIB_consensus_vsearch	1694	C	*/-T	394	7	1.72%	2	2	93	93	0.007608958034696689	1	1	145	249	1	6	-T
G4_BC76_191109_LF_LIB_consensus_vsearch	1695	T	*/-C	380	10	2.51%	2	1	93	93	9.211599279939985E-4	1	1	143	237	0	10	-C
G4_BC76_191109_LF_LIB_consensus_vsearch	1696	C	C	383	4	1.01%	2	1	93	93	0.06201519170852023	1	1	147	236	0	4	-G
G4_BC76_191109_LF_LIB_consensus_vsearch	1697	G	G	391	5	1.25%	2	2	93	93	0.030855681550508444	1	1	143	248	3	2	A
G4_BC76_191109_LF_LIB_consensus_vsearch	1698	G	G	398	3	0.74%	2	2	93	93	0.12453183520605009	1	1	144	254	2	1	-C
G4_BC76_191109_LF_LIB_consensus_vsearch	1699	C	C	399	1	0.25%	2	1	93	93	0.4999999999999138	1	1	146	253	0	1	+AAGA
G4_BC76_191109_LF_LIB_consensus_vsearch	1700	C	C	401	1	0.25%	2	1	93	93	0.5000000000008233	1	1	145	256	1	0	+G
G4_BC76_191109_LF_LIB_consensus_vsearch	1701	A	*/-T	375	14	3.45%	2	2	93	93	5.41854192901933E-5	1	1	133	242	8	6	-T
G4_BC76_191109_LF_LIB_consensus_vsearch	1702	T	T	387	2	0.51%	2	1	93	93	0.24967824967779578	1	1	139	248	0	2	C
G4_BC76_191109_LF_LIB_consensus_vsearch	1703	T	T	401	1	0.25%	2	1	93	93	0.5000000000008233	1	1	147	254	0	1	+AA
G4_BC76_191109_LF_LIB_consensus_vsearch	1704	T	T	386	5	1.23%	2	1	93	93	0.030850642423789317	1	1	130	256	5	0	+A
G4_BC76_191109_LF_LIB_consensus_vsearch	1705	A	*/+G	365	19	4.8%	2	1	93	93	1.518220570262078E-6	1	1	129	236	0	19	+G
G4_BC76_191109_LF_LIB_consensus_vsearch	1706	G	G	383	4	1.01%	2	1	93	93	0.06201519170852023	1	1	129	254	4	0	+A
G4_BC76_191109_LF_LIB_consensus_vsearch	1707	A	*/-G	347	30	7.65%	2	2	93	93	5.108244232483581E-10	1	1	100	247	23	7	-G
G4_BC76_191109_LF_LIB_consensus_vsearch	1708	G	G	347	3	0.84%	2	1	93	93	0.12446351931328528	1	1	104	243	0	3	+T
G4_BC76_191109_LF_LIB_consensus_vsearch	1709	G	*/+A	363	16	4.05%	2	1	93	93	1.2981533565203076E-5	1	1	108	255	16	0	+A
G4_BC76_191109_LF_LIB_consensus_vsearch	1710	A	A	387	2	0.51%	2	1	93	93	0.24967824967779578	1	1	132	255	2	0	+GA
G4_BC76_191109_LF_LIB_consensus_vsearch	1711	A	*/-G	385	8	1.98%	2	1	93	93	0.0037682499633968467	1	1	134	251	8	0	-G
G4_BC76_191109_LF_LIB_consensus_vsearch	1712	G	R	356	18	4.53%	2	1	93	93	3.0937866668435775E-6	1	1	114	242	18	0	A
G4_BC76_191109_LF_LIB_consensus_vsearch	1713	T	Y	377	11	2.79%	2	2	93	93	4.544286380884945E-4	1	1	141	236	4	7	C
G4_BC76_191109_LF_LIB_consensus_vsearch	1714	A	R	373	8	2.04%	2	2	93	93	0.0037639410987491528	1	1	141	232	2	6	G
G4_BC76_191109_LF_LIB_consensus_vsearch	1715	C	*/-AA	374	7	1.75%	2	1	93	93	0.007598330292913895	1	1	139	235	0	7	-AA
G4_BC76_191109_LF_LIB_consensus_vsearch	1716	A	A	382	5	1.27%	2	2	93	93	0.030846517434254234	1	1	142	240	2	3	G
G4_BC76_191109_LF_LIB_consensus_vsearch	1717	A	W	376	11	2.75%	2	1	93	93	4.5434311102034934E-4	1	1	148	228	0	11	T
G4_BC76_191109_LF_LIB_consensus_vsearch	1718	G	R	390	10	2.47%	2	1	93	93	9.225221739189795E-4	1	1	135	255	10	0	A
G4_BC76_191109_LF_LIB_consensus_vsearch	1719	T	T	393	6	1.49%	2	2	93	93	0.015332037719180692	1	1	143	250	2	4	C
G4_BC76_191109_LF_LIB_consensus_vsearch	1720	C	C	383	5	1.25%	2	2	93	93	0.030847556649813805	1	1	138	245	1	4	-GT
G4_BC76_191109_LF_LIB_consensus_vsearch	1721	G	R	383	11	2.77%	2	2	93	93	4.549328864195511E-4	1	1	137	246	8	3	A
G4_BC76_191109_LF_LIB_consensus_vsearch	1722	T	*/+A	368	9	2.24%	2	1	93	93	0.0018610482319175187	1	1	139	229	0	9	+A
G4_BC76_191109_LF_LIB_consensus_vsearch	1723	A	A	389	4	1.01%	2	2	93	93	0.06202259804292181	1	1	141	248	1	3	G
G4_BC76_191109_LF_LIB_consensus_vsearch	1724	A	A	389	5	1.24%	2	2	93	93	0.030853681237272182	1	1	141	248	3	2	T
G4_BC76_191109_LF_LIB_consensus_vsearch	1725	C	Y	353	19	4.7%	2	1	93	93	1.5068014973452989E-6	1	1	128	225	0	19	T
G4_BC76_191109_LF_LIB_consensus_vsearch	1726	A	A	387	2	0.51%	2	2	93	93	0.24967824967779578	1	1	142	245	1	1	G
G4_BC76_191109_LF_LIB_consensus_vsearch	1727	A	A	385	3	0.76%	2	1	93	93	0.12451612903217696	1	1	142	243	3	0	-G
G4_BC76_191109_LF_LIB_consensus_vsearch	1728	G	G	390	2	0.5%	2	1	93	93	0.24968071519789278	1	1	143	247	0	2	C
G4_BC76_191109_LF_LIB_consensus_vsearch	1729	G	*/-T	389	9	2.22%	2	2	93	93	0.0018658477399051397	1	1	142	247	3	6	-T
G4_BC76_191109_LF_LIB_consensus_vsearch	1730	T	T	391	4	1%	2	1	93	93	0.06202501678889606	1	1	146	245	0	4	C
G4_BC76_191109_LF_LIB_consensus_vsearch	1731	T	T	402	4	0.98%	2	1	93	93	0.06203789367157223	1	1	149	253	0	4	C
G4_BC76_191109_LF_LIB_consensus_vsearch	1732	T	*/-C	374	29	7.11%	2	2	93	93	1.104833179604039E-9	1	1	139	235	8	21	-C
G4_BC76_191109_LF_LIB_consensus_vsearch	1733	C	C	373	3	0.79%	2	1	93	93	0.1245006657791147	1	1	140	233	0	3	+G
G4_BC76_191109_LF_LIB_consensus_vsearch	1734	C	C	388	6	1.47%	2	2	93	93	0.015328329503561841	1	1	143	245	1	5	T
G4_BC76_191109_LF_LIB_consensus_vsearch	1735	G	G	397	3	0.75%	2	1	93	93	0.12453066332921275	1	1	142	255	3	0	A
G4_BC76_191109_LF_LIB_consensus_vsearch	1736	T	Y	378	11	2.73%	2	1	93	93	4.5451373534606624E-4	1	1	139	239	0	11	C
G4_BC76_191109_LF_LIB_consensus_vsearch	1737	A	*/-G	375	10	2.52%	2	2	93	93	9.204527288502928E-4	1	1	137	238	2	8	-G
G4_BC76_191109_LF_LIB_consensus_vsearch	1738	G	G	383	5	1.28%	2	2	93	93	0.030847556649813805	1	1	137	246	3	2	A
G4_BC76_191109_LF_LIB_consensus_vsearch	1739	G	G	391	3	0.74%	2	2	93	93	0.12452350698836272	1	1	139	252	1	2	+C
G4_BC76_191109_LF_LIB_consensus_vsearch	1740	T	T	387	5	1.24%	2	2	93	93	0.030851660526274274	1	1	140	247	1	4	A
G4_BC76_191109_LF_LIB_consensus_vsearch	1741	G	*/+A	386	8	1.99%	2	2	93	93	0.003768597288121233	1	1	140	246	1	7	+A
G4_BC76_191109_LF_LIB_consensus_vsearch	1742	A	A	396	2	0.5%	2	1	93	93	0.24968553459123424	1	1	140	256	2	0	G
G4_BC76_191109_LF_LIB_consensus_vsearch	1743	A	*/-C	390	10	2.47%	2	2	93	93	9.225221739189795E-4	1	1	142	248	3	7	-C
G4_BC76_191109_LF_LIB_consensus_vsearch	1744	C	*/+T	384	8	2.03%	2	1	93	93	0.0037679008816766993	1	1	144	240	0	8	+T
G4_BC76_191109_LF_LIB_consensus_vsearch	1745	C	*/-T	393	7	1.72%	2	2	93	93	0.007608451759263046	1	1	147	246	2	5	-T
G4_BC76_191109_LF_LIB_consensus_vsearch	1746	T	T	383	6	1.51%	2	1	93	93	0.015324526212125619	1	1	147	236	0	6	+G
G4_BC76_191109_LF_LIB_consensus_vsearch	1747	G	G	393	3	0.74%	2	1	93	93	0.12452591656124207	1	1	143	250	0	3	-C
G4_BC76_191109_LF_LIB_consensus_vsearch	1748	C	*/-G	373	9	2.24%	2	1	93	93	0.0018622382238204073	1	1	147	226	0	9	-G
G4_BC76_191109_LF_LIB_consensus_vsearch	1749	G	G	386	4	1.02%	2	1	93	93	0.062018923379747036	1	1	148	238	0	4	+T
G4_BC76_191109_LF_LIB_consensus_vsearch	1750	G	G	394	6	1.48%	2	2	93	93	0.015332768266138878	1	1	145	249	2	4	-A
G4_BC76_191109_LF_LIB_consensus_vsearch	1751	A	A	396	2	0.5%	2	2	93	93	0.24968553459123424	1	1	145	251	1	1	G
G4_BC76_191109_LF_LIB_consensus_vsearch	1752	A	A	398	3	0.74%	2	1	93	93	0.12453183520605009	1	1	148	250	0	3	+G
G4_BC76_191109_LF_LIB_consensus_vsearch	1753	G	*/+C	391	8	1.98%	2	1	93	93	0.003770308015149166	1	1	149	242	0	8	+C
G4_BC76_191109_LF_LIB_consensus_vsearch	1754	G	G	405	1	0.25%	2	1	93	93	0.5000000000008233	1	1	149	256	0	1	+TC
G4_BC76_191109_LF_LIB_consensus_vsearch	1755	A	A	401	2	0.49%	2	1	93	93	0.24968944099344345	1	1	149	252	0	2	+T
G4_BC76_191109_LF_LIB_consensus_vsearch	1756	T	T	400	3	0.74%	2	1	93	93	0.12453416149047736	1	1	145	255	0	3	C
G4_BC76_191109_LF_LIB_consensus_vsearch	1757	C	C	396	5	1.23%	2	1	93	93	0.03086059509471206	1	1	143	253	5	0	-A
G4_BC76_191109_LF_LIB_consensus_vsearch	1758	A	A	388	3	0.74%	2	2	93	93	0.12451984635071693	1	1	138	250	1	2	G
G4_BC76_191109_LF_LIB_consensus_vsearch	1759	T	*/+CAT	380	7	1.73%	2	1	93	93	0.007601633344865528	1	1	137	243	0	7	+CAT
G4_BC76_191109_LF_LIB_consensus_vsearch	1760	A	*/-GTA	381	10	2.5%	2	2	93	93	9.212992345460898E-4	1	1	134	247	5	5	-GTA
G4_BC76_191109_LF_LIB_consensus_vsearch	1761	G	R	377	9	2.28%	2	1	93	93	0.0018631683014264863	1	1	129	248	9	0	A
G4_BC76_191109_LF_LIB_consensus_vsearch	1762	T	Y	352	22	5.61%	2	2	93	93	1.7347244644637046E-7	1	1	132	220	1	21	C
G4_BC76_191109_LF_LIB_consensus_vsearch	1763	A	M	377	7	1.82%	2	1	93	93	0.007599994652592844	1	1	132	245	0	7	C
G4_BC76_191109_LF_LIB_consensus_vsearch	1764	A	R	384	12	2.95%	2	2	93	93	2.2434391137769687E-4	1	1	137	247	11	1	G
G4_BC76_191109_LF_LIB_consensus_vsearch	1765	T	Y	385	9	2.26%	2	2	93	93	0.001864972504119446	1	1	145	240	1	8	C
G4_BC76_191109_LF_LIB_consensus_vsearch	1766	C	C	401	1	0.25%	2	1	93	93	0.5000000000008233	1	1	146	255	1	0	+TC
G4_BC76_191109_LF_LIB_consensus_vsearch	1767	G	*/-T	395	7	1.72%	2	1	93	93	0.007609461804174083	1	1	147	248	0	7	-T
G4_BC76_191109_LF_LIB_consensus_vsearch	1768	T	T	393	5	1.25%	2	2	93	93	0.03085766177318207	1	1	145	248	1	4	C
G4_BC76_191109_LF_LIB_consensus_vsearch	1769	C	*/-T	360	33	8.09%	2	2	93	93	5.775541777986772E-11	1	1	145	215	1	32	-T
G4_BC76_191109_LF_LIB_consensus_vsearch	1770	T	Y	355	9	2.44%	2	2	93	93	0.0018578033066990803	1	1	144	211	2	7	C
G4_BC76_191109_LF_LIB_consensus_vsearch	1771	T	Y	391	8	1.99%	2	1	93	93	0.003770308015149166	1	1	147	244	0	8	C
G4_BC76_191109_LF_LIB_consensus_vsearch	1772	T	Y	392	12	2.94%	2	2	93	93	2.2472535825225005E-4	1	1	147	245	1	11	C
G4_BC76_191109_LF_LIB_consensus_vsearch	1773	G	G	404	1	0.25%	2	1	93	93	0.4999999999999138	1	1	148	256	0	1	+A
G4_BC76_191109_LF_LIB_consensus_vsearch	1774	A	A	399	5	1.23%	2	2	93	93	0.030863484879977227	1	1	147	252	2	3	G
G4_BC76_191109_LF_LIB_consensus_vsearch	1775	C	C	399	5	1.23%	2	2	93	93	0.030863484879977227	1	1	147	252	1	4	T
G4_BC76_191109_LF_LIB_consensus_vsearch	1776	G	*/+T	384	10	2.47%	2	2	93	93	9.217129834227815E-4	1	1	135	249	7	3	+T
G4_BC76_191109_LF_LIB_consensus_vsearch	1777	T	T	399	3	0.74%	2	1	93	93	0.12453300124551302	1	1	149	250	0	3	C
G4_BC76_191109_LF_LIB_consensus_vsearch	1778	T	*/+C	392	9	2.21%	2	2	93	93	0.0018664928473143382	1	1	143	249	4	5	+C
G4_BC76_191109_LF_LIB_consensus_vsearch	1779	C	*/-T	393	9	2.22%	2	2	93	93	0.0018667057694086889	1	1	146	247	2	7	-T
G4_BC76_191109_LF_LIB_consensus_vsearch	1780	T	Y	380	10	2.51%	2	2	93	93	9.211599279939985E-4	1	1	143	237	1	9	C
G4_BC76_191109_LF_LIB_consensus_vsearch	1781	A	A	397	3	0.74%	2	1	93	93	0.12453066332921275	1	1	142	255	3	0	G
G4_BC76_191109_LF_LIB_consensus_vsearch	1782	T	*/-C	389	11	2.72%	2	2	93	93	4.554223390235558E-4	1	1	144	245	1	10	-C
G4_BC76_191109_LF_LIB_consensus_vsearch	1783	C	C	387	3	0.76%	2	2	93	93	0.12451861360729544	1	1	144	243	2	1	-T
G4_BC76_191109_LF_LIB_consensus_vsearch	1784	T	*/+C	381	10	2.51%	2	2	93	93	9.212992345460898E-4	1	1	132	249	9	1	+C
G4_BC76_191109_LF_LIB_consensus_vsearch	1785	C	C	398	1	0.25%	2	1	93	93	0.4999999999999138	1	1	144	254	1	0	+G
G4_BC76_191109_LF_LIB_consensus_vsearch	1786	C	C	402	2	0.49%	2	1	93	93	0.2496902106567468	1	1	148	254	0	2	-ATC
G4_BC76_191109_LF_LIB_consensus_vsearch	1787	A	A	397	4	0.99%	2	1	93	93	0.062032128175275904	1	1	147	250	0	4	-T
G4_BC76_191109_LF_LIB_consensus_vsearch	1788	T	T	398	2	0.5%	2	2	93	93	0.249687108886017	1	1	148	250	1	1	C
G4_BC76_191109_LF_LIB_consensus_vsearch	1789	C	C	399	2	0.5%	2	1	93	93	0.24968789013733722	1	1	145	254	2	0	-G
G4_BC76_191109_LF_LIB_consensus_vsearch	1790	G	G	403	1	0.25%	2	1	93	93	0.4999999999999138	1	1	145	258	0	1	-T
G4_BC76_191109_LF_LIB_consensus_vsearch	1791	T	T	399	4	0.99%	2	2	93	93	0.06203445155203153	1	1	146	253	1	3	-C
G4_BC76_191109_LF_LIB_consensus_vsearch	1792	C	C	398	2	0.5%	2	1	93	93	0.249687108886017	1	1	143	255	2	0	+A
G4_BC76_191109_LF_LIB_consensus_vsearch	1793	C	*/-T	390	13	3.19%	2	2	93	93	1.1064141909323187E-4	1	1	148	242	1	12	-T
G4_BC76_191109_LF_LIB_consensus_vsearch	1794	T	*/+C	363	14	3.57%	2	1	93	93	5.39767472832291E-5	1	1	125	238	14	0	+C
G4_BC76_191109_LF_LIB_consensus_vsearch	1795	C	*/-GG	337	44	10.89%	2	1	93	93	1.5223858059408667E-14	1	1	146	191	0	44	-GG
G4_BC76_191109_LF_LIB_consensus_vsearch	1796	G	R	310	29	8.45%	2	1	93	93	9.96706488622634E-10	1	1	119	191	29	0	A
G4_BC76_191109_LF_LIB_consensus_vsearch	1797	G	G	363	1	0.27%	2	1	93	93	0.4999999999999138	1	1	149	214	0	1	A
G4_BC76_191109_LF_LIB_consensus_vsearch	1798	G	G	406	2	0.49%	2	2	93	93	0.249693251533771	1	1	148	258	1	1	-A
G4_BC76_191109_LF_LIB_consensus_vsearch	1799	A	A	400	2	0.49%	2	1	93	93	0.24968866749695368	1	1	147	253	0	2	G
G4_BC76_191109_LF_LIB_consensus_vsearch	1800	C	C	400	6	1.47%	2	2	93	93	0.015337076164670276	1	1	148	252	1	5	T
G4_BC76_191109_LF_LIB_consensus_vsearch	1801	G	G	394	6	1.47%	2	2	93	93	0.015332768266138878	1	1	142	252	5	1	A
G4_BC76_191109_LF_LIB_consensus_vsearch	1802	T	T	398	4	1%	2	1	93	93	0.06203329275530562	1	1	148	250	0	4	C
G4_BC76_191109_LF_LIB_consensus_vsearch	1803	T	*/-A	375	15	3.71%	2	2	93	93	2.6605806005741526E-5	1	1	139	236	5	10	-A
G4_BC76_191109_LF_LIB_consensus_vsearch	1804	A	A	379	2	0.52%	2	1	93	93	0.24967148488839994	1	1	143	236	0	2	C
G4_BC76_191109_LF_LIB_consensus_vsearch	1805	A	*/-G	385	7	1.74%	2	1	93	93	0.007604309052101333	1	1	146	239	0	7	-G
G4_BC76_191109_LF_LIB_consensus_vsearch	1806	G	G	390	3	0.75%	2	1	93	93	0.12452229299364298	1	1	148	242	0	3	+C
G4_BC76_191109_LF_LIB_consensus_vsearch	1807	G	G	406	1	0.25%	2	1	93	93	0.4999999999999138	1	1	148	258	1	0	+C
G4_BC76_191109_LF_LIB_consensus_vsearch	1808	C	C	393	5	1.23%	2	1	93	93	0.03085766177318207	1	1	144	249	0	5	-GC
G4_BC76_191109_LF_LIB_consensus_vsearch	1809	G	G	388	3	0.75%	2	2	93	93	0.12451984635071693	1	1	143	245	1	2	+C
G4_BC76_191109_LF_LIB_consensus_vsearch	1810	C	*/-T	375	16	4%	2	2	93	93	1.3047405506016577E-5	1	1	141	234	1	15	-T
G4_BC76_191109_LF_LIB_consensus_vsearch	1811	T	T	377	5	1.28%	2	2	93	93	0.03084123979791014	1	1	143	234	1	4	C
G4_BC76_191109_LF_LIB_consensus_vsearch	1812	C	C	392	5	1.24%	2	2	93	93	0.030856674154206513	1	1	145	247	1	4	-T
G4_BC76_191109_LF_LIB_consensus_vsearch	1813	T	*/-G	381	17	4.24%	2	1	93	93	6.407855928137532E-6	1	1	146	235	0	17	-G
G4_BC76_191109_LF_LIB_consensus_vsearch	1814	G	G	381	5	1.28%	2	2	93	93	0.03084547283766662	1	1	147	234	2	3	A
G4_BC76_191109_LF_LIB_consensus_vsearch	1815	G	G	402	4	0.98%	2	2	93	93	0.06203789367157223	1	1	147	255	2	2	A
G4_BC76_191109_LF_LIB_consensus_vsearch	1816	T	T	400	4	0.98%	2	1	93	93	0.06203560460879861	1	1	149	251	0	4	C
G4_BC76_191109_LF_LIB_consensus_vsearch	1817	C	C	402	3	0.74%	2	2	93	93	0.1245364647713705	1	1	147	255	2	1	-G
G4_BC76_191109_LF_LIB_consensus_vsearch	1818	G	*/-AG	385	17	4.2%	2	1	93	93	6.419225802716349E-6	1	1	130	255	17	0	-AG
G4_BC76_191109_LF_LIB_consensus_vsearch	1819	A	*/-G	351	21	5.4%	2	2	93	93	3.5669485016956707E-7	1	1	114	237	11	10	-G
G4_BC76_191109_LF_LIB_consensus_vsearch	1820	G	G	358	3	0.82%	2	2	93	93	0.12447988904305424	1	1	117	241	1	2	+T
G4_BC76_191109_LF_LIB_consensus_vsearch	1821	G	G	394	3	0.75%	2	1	93	93	0.1245271122321419	1	1	143	251	3	0	-A
G4_BC76_191109_LF_LIB_consensus_vsearch	1822	A	A	390	4	1%	2	2	93	93	0.062023810487337606	1	1	143	247	1	3	G
G4_BC76_191109_LF_LIB_consensus_vsearch	1823	T	*/-A	353	31	7.67%	2	2	93	93	2.47836816557834E-10	1	1	143	210	3	28	-A
G4_BC76_191109_LF_LIB_consensus_vsearch	1824	A	A	363	3	0.8%	2	1	93	93	0.12448700410399625	1	1	140	223	3	0	G
G4_BC76_191109_LF_LIB_consensus_vsearch	1825	A	A	400	3	0.74%	2	1	93	93	0.12453416149047736	1	1	144	256	3	0	G
G4_BC76_191109_LF_LIB_consensus_vsearch	1826	A	R	388	11	2.7%	2	2	93	93	4.5534176337797E-4	1	1	135	253	10	1	G
G4_BC76_191109_LF_LIB_consensus_vsearch	1827	C	C	392	6	1.48%	2	2	93	93	0.015331303510572384	1	1	139	253	2	4	T
G4_BC76_191109_LF_LIB_consensus_vsearch	1828	G	*/-A	387	11	2.72%	2	1	93	93	4.5526079174589983E-4	1	1	133	254	11	0	-A
G4_BC76_191109_LF_LIB_consensus_vsearch	1829	A	*/-C	179	162	41.01%	2	2	93	93	1.4802208025006474E-60	1	1	100	79	11	151	-C
G4_BC76_191109_LF_LIB_consensus_vsearch	1830	C	S	211	9	4.04%	2	1	93	93	0.0017967787753331713	1	1	124	87	9	0	G
G4_BC76_191109_LF_LIB_consensus_vsearch	1831	C	C	382	2	0.52%	2	1	93	93	0.2496740547585969	1	1	144	238	0	2	T
G4_BC76_191109_LF_LIB_consensus_vsearch	1832	C	C	391	5	1.24%	2	1	93	93	0.030855681550508444	1	1	145	246	0	5	T
G4_BC76_191109_LF_LIB_consensus_vsearch	1833	C	*/-T	395	9	2.22%	2	2	93	93	0.0018671284895574335	1	1	147	248	1	8	-T
G4_BC76_191109_LF_LIB_consensus_vsearch	1834	T	*/-CT	375	17	4.27%	2	1	93	93	6.390395927916272E-6	1	1	146	229	0	17	-CT
G4_BC76_191109_LF_LIB_consensus_vsearch	1835	C	C	382	5	1.29%	2	2	93	93	0.030846517434254234	1	1	146	236	2	3	-T
G4_BC76_191109_LF_LIB_consensus_vsearch	1836	T	Y	368	9	2.34%	2	1	93	93	0.0018610482319175187	1	1	146	222	0	9	C
G4_BC76_191109_LF_LIB_consensus_vsearch	1837	G	G	404	1	0.25%	2	1	93	93	0.4999999999999138	1	1	148	256	0	1	+A
G4_BC76_191109_LF_LIB_consensus_vsearch	1838	A	A	397	3	0.74%	2	2	93	93	0.12453066332921275	1	1	143	254	2	1	-C
G4_BC76_191109_LF_LIB_consensus_vsearch	1839	C	C	399	4	0.99%	2	1	93	93	0.06203445155203153	1	1	146	253	0	4	T
G4_BC76_191109_LF_LIB_consensus_vsearch	1840	C	Y	388	9	2.21%	2	2	93	93	0.0018656305641170923	1	1	140	248	1	8	T
G4_BC76_191109_LF_LIB_consensus_vsearch	1841	G	*/-A	389	8	1.98%	2	2	93	93	0.0037696288519149155	1	1	140	249	4	4	-A
G4_BC76_191109_LF_LIB_consensus_vsearch	1842	A	*/-G	333	65	16.29%	2	2	93	93	1.5723217853853978E-21	1	1	82	251	62	3	-G
G4_BC76_191109_LF_LIB_consensus_vsearch	1843	G	G	328	3	0.88%	2	1	93	93	0.12443267776106595	1	1	81	247	3	0	+A
G4_BC76_191109_LF_LIB_consensus_vsearch	1844	G	G	396	3	0.74%	2	1	93	93	0.12452948557099502	1	1	145	251	3	0	+A
G4_BC76_191109_LF_LIB_consensus_vsearch	1845	T	Y	394	7	1.74%	2	1	93	93	0.007608958034696689	1	1	148	246	0	7	C
G4_BC76_191109_LF_LIB_consensus_vsearch	1846	T	*/-A	379	11	2.71%	2	2	93	93	4.5459840602315744E-4	1	1	144	235	2	9	-A
G4_BC76_191109_LF_LIB_consensus_vsearch	1847	A	A	383	4	1.02%	2	2	93	93	0.06201519170852023	1	1	142	241	2	2	G
G4_BC76_191109_LF_LIB_consensus_vsearch	1848	A	R	396	7	1.73%	2	2	93	93	0.007609963086240239	1	1	142	254	6	1	G
G4_BC76_191109_LF_LIB_consensus_vsearch	1849	A	A	393	6	1.48%	2	1	93	93	0.015332037719180692	1	1	143	250	6	0	G
G4_BC76_191109_LF_LIB_consensus_vsearch	1850	C	Y	385	10	2.48%	2	2	93	93	9.218495267512253E-4	1	1	143	242	1	9	T
G4_BC76_191109_LF_LIB_consensus_vsearch	1851	G	R	387	9	2.24%	2	1	93	93	0.0018654123049784304	1	1	139	248	9	0	A
G4_BC76_191109_LF_LIB_consensus_vsearch	1852	G	*/+T	386	7	1.72%	2	2	93	93	0.0076048360660226225	1	1	139	247	4	3	+T
G4_BC76_191109_LF_LIB_consensus_vsearch	1853	T	T	397	3	0.74%	2	2	93	93	0.12453066332921275	1	1	147	250	1	2	-C
G4_BC76_191109_LF_LIB_consensus_vsearch	1854	C	Y	244	154	38.31%	2	2	93	93	3.986045732421882E-55	1	1	91	153	57	97	T
G4_BC76_191109_LF_LIB_consensus_vsearch	1855	G	G	395	5	1.24%	2	2	93	93	0.030859622206549208	1	1	144	251	2	3	-C
G4_BC76_191109_LF_LIB_consensus_vsearch	1856	C	C	390	6	1.5%	2	2	93	93	0.015329823997787357	1	1	144	246	2	4	T
G4_BC76_191109_LF_LIB_consensus_vsearch	1857	C	Y	393	8	1.97%	2	2	93	93	0.003770980459969231	1	1	147	246	1	7	T
G4_BC76_191109_LF_LIB_consensus_vsearch	1858	A	A	393	6	1.49%	2	2	93	93	0.015332037719180692	1	1	143	250	5	1	G
G4_BC76_191109_LF_LIB_consensus_vsearch	1859	G	G	403	2	0.49%	2	1	93	93	0.24969097651407932	1	1	148	255	0	2	-TCT
G4_BC76_191109_LF_LIB_consensus_vsearch	1860	T	T	395	5	1.23%	2	2	93	93	0.030859622206549208	1	1	146	249	1	4	C
G4_BC76_191109_LF_LIB_consensus_vsearch	1861	C	C	394	6	1.49%	2	2	93	93	0.015332768266138878	1	1	142	252	5	1	-T
G4_BC76_191109_LF_LIB_consensus_vsearch	1862	T	T	383	5	1.25%	2	1	93	93	0.030847556649813805	1	1	140	243	0	5	C
G4_BC76_191109_LF_LIB_consensus_vsearch	1863	G	R	393	9	2.22%	2	2	93	93	0.0018667057694086889	1	1	140	253	8	1	A
G4_BC76_191109_LF_LIB_consensus_vsearch	1864	T	Y	369	16	3.93%	2	2	93	93	1.301495181198242E-5	1	1	133	236	1	15	C
G4_BC76_191109_LF_LIB_consensus_vsearch	1865	G	R	370	13	3.26%	2	1	93	93	1.1006549462483286E-4	1	1	119	251	13	0	A
G4_BC76_191109_LF_LIB_consensus_vsearch	1866	T	Y	384	14	3.51%	2	1	93	93	5.433401108852574E-5	1	1	143	241	0	14	C
G4_BC76_191109_LF_LIB_consensus_vsearch	1867	T	T	396	5	1.23%	2	1	93	93	0.03086059509471206	1	1	146	250	0	5	C
G4_BC76_191109_LF_LIB_consensus_vsearch	1868	A	*/-C	377	18	4.43%	2	2	93	93	3.129227623811749E-6	1	1	141	236	1	17	-C
G4_BC76_191109_LF_LIB_consensus_vsearch	1869	C	*/+T	366	15	3.88%	2	1	93	93	2.6518056674193244E-5	1	1	143	223	0	15	+T
G4_BC76_191109_LF_LIB_consensus_vsearch	1870	C	C	389	6	1.48%	2	1	93	93	0.015329078637527195	1	1	148	241	0	6	-TC
G4_BC76_191109_LF_LIB_consensus_vsearch	1871	T	*/-CCT	354	20	5.08%	2	2	93	93	7.347140179929136E-7	1	1	137	217	3	17	-CCT
G4_BC76_191109_LF_LIB_consensus_vsearch	1872	C	C	356	5	1.36%	2	1	93	93	0.030817478428780864	1	1	136	220	0	5	+TC
G4_BC76_191109_LF_LIB_consensus_vsearch	1873	C	*/-TC	365	8	2.08%	2	1	93	93	0.0037609158733080306	1	1	144	221	0	8	-TC
G4_BC76_191109_LF_LIB_consensus_vsearch	1874	T	*/+C	351	7	1.9%	2	1	93	93	0.0075846487975676224	1	1	132	219	7	0	+C
G4_BC76_191109_LF_LIB_consensus_vsearch	1875	C	*/-GG	313	40	10.15%	2	1	93	93	2.8200120191500097E-13	1	1	99	214	40	0	-GG
G4_BC76_191109_LF_LIB_consensus_vsearch	1876	G	G	319	5	1.52%	2	1	93	93	0.030768124797811377	1	1	96	223	5	0	A
G4_BC76_191109_LF_LIB_consensus_vsearch	1877	G	*/-A	351	7	1.91%	2	2	93	93	0.0075846487975676224	1	1	95	256	6	1	-A
G4_BC76_191109_LF_LIB_consensus_vsearch	1878	A	A	389	4	1%	2	2	93	93	0.06202259804292181	1	1	140	249	1	3	-G
G4_BC76_191109_LF_LIB_consensus_vsearch	1879	G	G	399	2	0.5%	2	1	93	93	0.24968789013733722	1	1	145	254	2	0	+A
G4_BC76_191109_LF_LIB_consensus_vsearch	1880	G	G	405	1	0.25%	2	1	93	93	0.5000000000008233	1	1	149	256	0	1	-C
G4_BC76_191109_LF_LIB_consensus_vsearch	1881	C	*/+A	388	9	2.22%	2	1	93	93	0.0018656305641170923	1	1	145	243	0	9	+A
G4_BC76_191109_LF_LIB_consensus_vsearch	1882	A	A	395	4	0.99%	2	1	93	93	0.06202978149183676	1	1	146	249	0	4	+T
G4_BC76_191109_LF_LIB_consensus_vsearch	1883	C	*/-AC	360	30	7.41%	2	2	93	93	5.215697744364693E-10	1	1	119	241	26	4	-AC
G4_BC76_191109_LF_LIB_consensus_vsearch	1884	A	*/+T	364	7	1.86%	2	1	93	93	0.007592589101619866	1	1	119	245	0	7	+T
G4_BC76_191109_LF_LIB_consensus_vsearch	1885	C	Y	361	7	1.86%	2	1	93	93	0.007590806239049772	1	1	121	240	0	7	T
G4_BC76_191109_LF_LIB_consensus_vsearch	1886	G	G	398	2	0.49%	2	1	93	93	0.249687108886017	1	1	144	254	2	0	A
G4_BC76_191109_LF_LIB_consensus_vsearch	1887	T	Y	392	9	2.22%	2	2	93	93	0.0018664928473143382	1	1	145	247	1	8	C
G4_BC76_191109_LF_LIB_consensus_vsearch	1888	T	*/-A	367	13	3.19%	2	1	93	93	1.0997406609837605E-4	1	1	120	247	13	0	-A
G4_BC76_191109_LF_LIB_consensus_vsearch	1889	A	A	383	2	0.52%	2	1	93	93	0.24967490247067214	1	1	127	256	2	0	G
G4_BC76_191109_LF_LIB_consensus_vsearch	1890	A	A	398	2	0.5%	2	2	93	93	0.249687108886017	1	1	141	257	1	1	G
G4_BC76_191109_LF_LIB_consensus_vsearch	1891	A	A	404	3	0.74%	2	2	93	93	0.12453874538748007	1	1	147	257	2	1	-GA
G4_BC76_191109_LF_LIB_consensus_vsearch	1892	G	G	402	2	0.49%	2	1	93	93	0.2496902106567468	1	1	144	258	2	0	-A
G4_BC76_191109_LF_LIB_consensus_vsearch	1893	A	A	395	5	1.24%	2	2	93	93	0.030859622206549208	1	1	141	254	3	2	G
G4_BC76_191109_LF_LIB_consensus_vsearch	1894	T	T	397	4	0.99%	2	2	93	93	0.062032128175275904	1	1	146	251	1	3	C
G4_BC76_191109_LF_LIB_consensus_vsearch	1895	C	C	400	1	0.25%	2	1	93	93	0.4999999999999138	1	1	148	252	0	1	+A
G4_BC76_191109_LF_LIB_consensus_vsearch	1896	G	G	400	3	0.74%	2	1	93	93	0.12453416149047736	1	1	148	252	0	3	-T
G4_BC76_191109_LF_LIB_consensus_vsearch	1897	T	Y	391	7	1.74%	2	2	93	93	0.007607431615374521	1	1	146	245	3	4	C
G4_BC76_191109_LF_LIB_consensus_vsearch	1898	T	*/-C	385	12	2.95%	2	2	93	93	2.2439240943114192E-4	1	1	140	245	5	7	-C
G4_BC76_191109_LF_LIB_consensus_vsearch	1899	C	C	389	2	0.51%	2	1	93	93	0.24967989756723366	1	1	141	248	0	2	+A
G4_BC76_191109_LF_LIB_consensus_vsearch	1900	C	*/+G	389	7	1.72%	2	1	93	93	0.0076064012202881484	1	1	147	242	0	7	+G
G4_BC76_191109_LF_LIB_consensus_vsearch	1901	G	R	380	17	4.2%	2	2	93	93	6.404980089016243E-6	1	1	141	239	5	12	A
G4_BC76_191109_LF_LIB_consensus_vsearch	1902	C	Y	378	12	3.01%	2	2	93	93	2.2404784900264377E-4	1	1	145	233	1	11	T
G4_BC76_191109_LF_LIB_consensus_vsearch	1903	G	G	381	4	1.01%	2	1	93	93	0.062012671598070994	1	1	144	237	0	4	-T
G4_BC76_191109_LF_LIB_consensus_vsearch	1904	T	T	390	3	0.76%	2	1	93	93	0.12452229299364298	1	1	147	243	0	3	C
G4_BC76_191109_LF_LIB_consensus_vsearch	1905	T	*/-G	377	9	2.24%	2	1	93	93	0.0018631683014264863	1	1	142	235	0	9	-G
G4_BC76_191109_LF_LIB_consensus_vsearch	1906	G	G	369	6	1.52%	2	1	93	93	0.015313338910416455	1	1	140	229	0	6	-TG
G4_BC76_191109_LF_LIB_consensus_vsearch	1907	T	W	348	19	4.79%	2	2	93	93	1.5018443455160622E-6	1	1	135	213	1	18	A
G4_BC76_191109_LF_LIB_consensus_vsearch	1908	G	*/-A	374	10	2.56%	2	2	93	93	9.203091175437465E-4	1	1	136	238	9	1	-A
G4_BC76_191109_LF_LIB_consensus_vsearch	1909	A	R	377	8	2.01%	2	2	93	93	0.003765406973524696	1	1	132	245	4	4	G
G4_BC76_191109_LF_LIB_consensus_vsearch	1910	G	G	383	6	1.5%	2	2	93	93	0.015324526212125619	1	1	141	242	2	4	-T
G4_BC76_191109_LF_LIB_consensus_vsearch	1911	T	T	391	3	0.75%	2	1	93	93	0.12452350698836272	1	1	142	249	3	0	+C
G4_BC76_191109_LF_LIB_consensus_vsearch	1912	C	C	395	5	1.23%	2	1	93	93	0.030859622206549208	1	1	147	248	0	5	-T
G4_BC76_191109_LF_LIB_consensus_vsearch	1913	T	T	387	6	1.5%	2	2	93	93	0.015327576567173378	1	1	147	240	1	5	C
G4_BC76_191109_LF_LIB_consensus_vsearch	1914	A	A	398	2	0.5%	2	2	93	93	0.249687108886017	1	1	145	253	1	1	G
G4_BC76_191109_LF_LIB_consensus_vsearch	1915	A	A	395	6	1.47%	2	2	93	93	0.015333495178783761	1	1	145	250	2	4	G
G4_BC76_191109_LF_LIB_consensus_vsearch	1916	C	C	401	2	0.49%	2	1	93	93	0.24968944099344345	1	1	145	256	2	0	-A
G4_BC76_191109_LF_LIB_consensus_vsearch	1917	A	A	392	3	0.74%	2	2	93	93	0.12452471482865957	1	1	138	254	2	1	-CCA
G4_BC76_191109_LF_LIB_consensus_vsearch	1918	C	C	394	3	0.75%	2	1	93	93	0.1245271122321419	1	1	144	250	0	3	A
G4_BC76_191109_LF_LIB_consensus_vsearch	1919	C	C	396	5	1.24%	2	1	93	93	0.03086059509471206	1	1	146	250	0	5	-A
G4_BC76_191109_LF_LIB_consensus_vsearch	1920	A	R	386	9	2.25%	2	2	93	93	0.0018651929543866046	1	1	141	245	6	3	G
G4_BC76_191109_LF_LIB_consensus_vsearch	1921	G	G	395	2	0.49%	2	1	93	93	0.24968474148789518	1	1	148	247	0	2	+CG
G4_BC76_191109_LF_LIB_consensus_vsearch	1922	T	Y	362	40	9.93%	2	1	93	93	3.277203199143782E-13	1	1	149	213	0	40	C
G4_BC76_191109_LF_LIB_consensus_vsearch	1923	T	T	394	5	1.23%	2	1	93	93	0.030858644444955494	1	1	145	249	0	5	C
G4_BC76_191109_LF_LIB_consensus_vsearch	1924	G	G	393	5	1.23%	2	2	93	93	0.03085766177318207	1	1	142	251	4	1	A
G4_BC76_191109_LF_LIB_consensus_vsearch	1925	T	*/-A	373	14	3.46%	2	2	93	93	5.415150063894175E-5	1	1	136	237	4	10	-A
G4_BC76_191109_LF_LIB_consensus_vsearch	1926	A	A	389	2	0.51%	2	1	93	93	0.24967989756723366	1	1	145	244	0	2	C
G4_BC76_191109_LF_LIB_consensus_vsearch	1927	A	A	401	5	1.23%	2	2	93	93	0.030865387693025832	1	1	146	255	2	3	G
G4_BC76_191109_LF_LIB_consensus_vsearch	1928	A	R	391	7	1.72%	2	2	93	93	0.007607431615374521	1	1	143	248	5	2	G
G4_BC76_191109_LF_LIB_consensus_vsearch	1929	C	*/-T	367	26	6.39%	2	2	93	93	9.718281636604173E-9	1	1	143	224	1	25	-T
G4_BC76_191109_LF_LIB_consensus_vsearch	1930	T	Y	370	10	2.62%	2	2	93	93	9.197272469938769E-4	1	1	147	223	1	9	C
G4_BC76_191109_LF_LIB_consensus_vsearch	1931	T	T	400	6	1.47%	2	2	93	93	0.015337076164670276	1	1	147	253	1	5	C
G4_BC76_191109_LF_LIB_consensus_vsearch	1932	T	T	398	4	0.98%	2	1	93	93	0.06203329275530562	1	1	148	250	0	4	+G
G4_BC76_191109_LF_LIB_consensus_vsearch	1933	A	A	397	6	1.47%	2	2	93	93	0.015334938209013941	1	1	148	249	1	5	G
G4_BC76_191109_LF_LIB_consensus_vsearch	1934	C	*/+A	387	15	3.69%	2	1	93	93	2.6716994663227938E-5	1	1	147	240	0	15	+A
G4_BC76_191109_LF_LIB_consensus_vsearch	1935	A	A	399	5	1.23%	2	1	93	93	0.030863484879977227	1	1	147	252	0	5	G
G4_BC76_191109_LF_LIB_consensus_vsearch	1936	A	R	389	10	2.46%	2	2	93	93	9.223889705434762E-4	1	1	140	249	7	3	G
G4_BC76_191109_LF_LIB_consensus_vsearch	1937	C	C	397	6	1.48%	2	1	93	93	0.015334938209013941	1	1	148	249	0	6	T
G4_BC76_191109_LF_LIB_consensus_vsearch	1938	C	Y	387	12	2.95%	2	2	93	93	2.2448869655710964E-4	1	1	145	242	1	11	T
G4_BC76_191109_LF_LIB_consensus_vsearch	1939	G	G	395	2	0.5%	2	1	93	93	0.24968474148789518	1	1	144	251	2	0	+A
G4_BC76_191109_LF_LIB_consensus_vsearch	1940	G	G	402	2	0.49%	2	2	93	93	0.2496902106567468	1	1	147	255	1	1	A
G4_BC76_191109_LF_LIB_consensus_vsearch	1941	C	C	393	5	1.23%	2	1	93	93	0.03085766177318207	1	1	142	251	0	5	+AA
G4_BC76_191109_LF_LIB_consensus_vsearch	1942	A	R	388	11	2.74%	2	2	93	93	4.5534176337797E-4	1	1	135	253	9	2	G
G4_BC76_191109_LF_LIB_consensus_vsearch	1943	G	G	393	4	0.99%	2	1	93	93	0.0620274111497499	1	1	144	249	0	4	-CGC
G4_BC76_191109_LF_LIB_consensus_vsearch	1944	C	C	388	5	1.25%	2	2	93	93	0.030852673450990298	1	1	145	243	2	3	-GC
G4_BC76_191109_LF_LIB_consensus_vsearch	1945	G	*/-C	374	21	5.29%	2	1	93	93	3.6294031741071143E-7	1	1	147	227	0	21	-C
G4_BC76_191109_LF_LIB_consensus_vsearch	1946	C	Y	346	17	4.51%	2	1	93	93	6.298471802440656E-6	1	1	141	205	0	17	T
G4_BC76_191109_LF_LIB_consensus_vsearch	1947	T	*/-G	374	18	4.49%	2	1	93	93	3.1243787131250986E-6	1	1	148	226	0	18	-G
G4_BC76_191109_LF_LIB_consensus_vsearch	1948	G	K	356	25	6.49%	2	1	93	93	1.984063341593292E-8	1	1	148	208	0	25	T
G4_BC76_191109_LF_LIB_consensus_vsearch	1949	G	R	398	7	1.72%	2	2	93	93	0.007610958261497833	1	1	142	256	6	1	A
G4_BC76_191109_LF_LIB_consensus_vsearch	1950	A	A	393	5	1.23%	2	2	93	93	0.03085766177318207	1	1	144	249	2	3	G
G4_BC76_191109_LF_LIB_consensus_vsearch	1951	T	*/-C	339	54	13.43%	2	2	93	93	7.855867966944029E-18	1	1	108	231	34	20	-C
G4_BC76_191109_LF_LIB_consensus_vsearch	1952	C	C	342	3	0.86%	2	1	93	93	0.12445573294627689	1	1	109	233	0	3	T
G4_BC76_191109_LF_LIB_consensus_vsearch	1953	C	*/+T	392	8	1.97%	2	1	93	93	0.0037706450711110975	1	1	144	248	0	8	+T
G4_BC76_191109_LF_LIB_consensus_vsearch	1954	C	*/+T	344	25	6.14%	2	1	93	93	1.9570853433407625E-8	1	1	140	204	0	25	+T
G4_BC76_191109_LF_LIB_consensus_vsearch	1955	T	T	377	5	1.3%	2	1	93	93	0.03084123979791014	1	1	136	241	5	0	A
G4_BC76_191109_LF_LIB_consensus_vsearch	1956	T	K	371	9	2.24%	2	1	93	93	0.0018617659366352362	1	1	140	231	0	9	G
G4_BC76_191109_LF_LIB_consensus_vsearch	1957	G	G	391	4	1.01%	2	2	93	93	0.06202501678889606	1	1	141	250	1	3	A
G4_BC76_191109_LF_LIB_consensus_vsearch	1958	G	G	399	3	0.74%	2	2	93	93	0.12453300124551302	1	1	144	255	1	2	T
G4_BC76_191109_LF_LIB_consensus_vsearch	1959	C	*/-AC	349	39	9.61%	2	2	93	93	6.656967776509024E-13	1	1	105	244	37	2	-AC
G4_BC76_191109_LF_LIB_consensus_vsearch	1960	A	A	358	3	0.82%	2	2	93	93	0.12447988904305424	1	1	105	253	1	2	-C
G4_BC76_191109_LF_LIB_consensus_vsearch	1961	C	C	360	3	0.82%	2	1	93	93	0.12448275862071713	1	1	109	251	0	3	T
G4_BC76_191109_LF_LIB_consensus_vsearch	1962	G	G	398	3	0.74%	2	1	93	93	0.12453183520605009	1	1	146	252	0	3	+C
G4_BC76_191109_LF_LIB_consensus_vsearch	1963	T	T	398	4	0.99%	2	1	93	93	0.06203329275530562	1	1	147	251	0	4	-C
G4_BC76_191109_LF_LIB_consensus_vsearch	1964	C	C	402	1	0.25%	2	1	93	93	0.4999999999999138	1	1	148	254	0	1	-AT
G4_BC76_191109_LF_LIB_consensus_vsearch	1965	A	A	401	4	0.99%	2	2	93	93	0.06203675196794108	1	1	144	257	3	1	G
G4_BC76_191109_LF_LIB_consensus_vsearch	1966	T	T	396	6	1.48%	2	1	93	93	0.015334218484153218	1	1	147	249	0	6	+C
G4_BC76_191109_LF_LIB_consensus_vsearch	1967	T	T	397	5	1.23%	2	1	93	93	0.03086156314569468	1	1	147	250	0	5	-C
G4_BC76_191109_LF_LIB_consensus_vsearch	1968	C	C	392	3	0.74%	2	1	93	93	0.12452471482865957	1	1	146	246	0	3	+G
G4_BC76_191109_LF_LIB_consensus_vsearch	1969	G	G	402	3	0.74%	2	2	93	93	0.1245364647713705	1	1	146	256	2	1	-A
G4_BC76_191109_LF_LIB_consensus_vsearch	1970	A	A	400	3	0.74%	2	1	93	93	0.12453416149047736	1	1	143	257	3	0	G
G4_BC76_191109_LF_LIB_consensus_vsearch	1971	T	T	404	2	0.49%	2	1	93	93	0.24969173859492816	1	1	147	257	0	2	C
G4_BC76_191109_LF_LIB_consensus_vsearch	1972	G	G	399	3	0.74%	2	1	93	93	0.12453300124551302	1	1	144	255	3	0	-A
G4_BC76_191109_LF_LIB_consensus_vsearch	1973	A	A	398	4	0.99%	2	2	93	93	0.06203329275530562	1	1	143	255	2	2	G
G4_BC76_191109_LF_LIB_consensus_vsearch	1974	A	A	398	6	1.47%	2	2	93	93	0.015335654379945	1	1	141	257	5	1	G
G4_BC76_191109_LF_LIB_consensus_vsearch	1975	G	G	399	3	0.74%	2	1	93	93	0.12453300124551302	1	1	145	254	0	3	+C
G4_BC76_191109_LF_LIB_consensus_vsearch	1976	A	A	391	4	0.99%	2	2	93	93	0.06202501678889606	1	1	141	250	1	3	+T
G4_BC76_191109_LF_LIB_consensus_vsearch	1977	C	C	399	2	0.49%	2	2	93	93	0.24968789013733722	1	1	148	251	1	1	A
G4_BC76_191109_LF_LIB_consensus_vsearch	1978	C	Y	342	51	12.5%	2	1	93	93	7.834695954742007E-17	1	1	148	194	0	51	T
G4_BC76_191109_LF_LIB_consensus_vsearch	1979	G	G	392	5	1.24%	2	1	93	93	0.030856674154206513	1	1	143	249	5	0	+T
G4_BC76_191109_LF_LIB_consensus_vsearch	1980	T	Y	379	21	5.19%	2	1	93	93	3.6421365056301974E-7	1	1	149	230	0	21	C
G4_BC76_191109_LF_LIB_consensus_vsearch	1981	T	T	395	4	0.98%	2	1	93	93	0.06202978149183676	1	1	148	247	0	4	G
G4_BC76_191109_LF_LIB_consensus_vsearch	1982	G	G	396	6	1.47%	2	1	93	93	0.015334218484153218	1	1	146	250	0	6	A
G4_BC76_191109_LF_LIB_consensus_vsearch	1983	C	*/-A	366	16	3.93%	2	2	93	93	1.2998365918939041E-5	1	1	142	224	3	13	-A
G4_BC76_191109_LF_LIB_consensus_vsearch	1984	A	A	384	2	0.51%	2	1	93	93	0.24967574578483906	1	1	145	239	0	2	+C
G4_BC76_191109_LF_LIB_consensus_vsearch	1985	A	A	399	2	0.49%	2	1	93	93	0.24968789013733722	1	1	147	252	0	2	C
G4_BC76_191109_LF_LIB_consensus_vsearch	1986	A	A	399	3	0.74%	2	1	93	93	0.12453300124551302	1	1	149	250	0	3	G
G4_BC76_191109_LF_LIB_consensus_vsearch	1987	T	T	394	6	1.48%	2	2	93	93	0.015332768266138878	1	1	144	250	1	5	C
G4_BC76_191109_LF_LIB_consensus_vsearch	1988	T	*/+G	389	11	2.71%	2	1	93	93	4.554223390235558E-4	1	1	149	240	0	11	+G
G4_BC76_191109_LF_LIB_consensus_vsearch	1989	G	G	400	6	1.47%	2	2	93	93	0.015337076164670276	1	1	147	253	2	4	A
G4_BC76_191109_LF_LIB_consensus_vsearch	1990	C	Y	382	21	5.16%	2	1	93	93	3.6496416663752166E-7	1	1	148	234	0	21	T
G4_BC76_191109_LF_LIB_consensus_vsearch	1991	G	G	404	2	0.49%	2	1	93	93	0.24969173859492816	1	1	147	257	2	0	-A
G4_BC76_191109_LF_LIB_consensus_vsearch	1992	A	A	404	1	0.25%	2	1	93	93	0.4999999999999138	1	1	147	257	0	1	+CA
G4_BC76_191109_LF_LIB_consensus_vsearch	1993	T	*/+A	380	9	2.21%	2	2	93	93	0.0018638534646934156	1	1	136	244	6	3	+A
G4_BC76_191109_LF_LIB_consensus_vsearch	1994	A	A	391	1	0.25%	2	1	93	93	0.4999999999999138	1	1	144	247	0	1	+CA
G4_BC76_191109_LF_LIB_consensus_vsearch	1995	A	A	397	2	0.5%	2	1	93	93	0.24968632371350802	1	1	146	251	2	0	+GA
G4_BC76_191109_LF_LIB_consensus_vsearch	1996	A	A	398	4	0.99%	2	1	93	93	0.06203329275530562	1	1	149	249	0	4	G
G4_BC76_191109_LF_LIB_consensus_vsearch	1997	G	G	396	4	0.99%	2	1	93	93	0.06203095776871511	1	1	145	251	0	4	-T
G4_BC76_191109_LF_LIB_consensus_vsearch	1998	T	Y	380	18	4.49%	2	1	93	93	3.134009125315532E-6	1	1	149	231	0	18	C
G4_BC76_191109_LF_LIB_consensus_vsearch	1999	G	G	396	3	0.74%	2	2	93	93	0.12452948557099502	1	1	147	249	2	1	-ATG
G4_BC76_191109_LF_LIB_consensus_vsearch	2000	A	A	400	1	0.25%	2	1	93	93	0.4999999999999138	1	1	147	253	0	1	+GA
G4_BC76_191109_LF_LIB_consensus_vsearch	2001	T	T	396	5	1.24%	2	2	93	93	0.03086059509471206	1	1	144	252	1	4	C
G4_BC76_191109_LF_LIB_consensus_vsearch	2002	G	*/-TG	362	29	7.2%	2	2	93	93	1.0865966641283314E-9	1	1	142	220	1	28	-TG
G4_BC76_191109_LF_LIB_consensus_vsearch	2003	T	T	361	5	1.34%	2	1	93	93	0.030823383042576463	1	1	146	215	0	5	+G
G4_BC76_191109_LF_LIB_consensus_vsearch	2004	G	G	374	1	0.27%	2	1	93	93	0.5000000000003686	1	1	147	227	1	0	+A
G4_BC76_191109_LF_LIB_consensus_vsearch	2005	A	A	400	4	0.98%	2	2	93	93	0.06203560460879861	1	1	146	254	2	2	G
G4_BC76_191109_LF_LIB_consensus_vsearch	2006	T	T	404	1	0.25%	2	1	93	93	0.4999999999999138	1	1	148	256	1	0	C
G4_BC76_191109_LF_LIB_consensus_vsearch	2007	G	G	400	3	0.74%	2	2	93	93	0.12453416149047736	1	1	148	252	1	2	A
G4_BC76_191109_LF_LIB_consensus_vsearch	2008	C	*/-G	371	7	1.72%	2	1	93	93	0.0075966396580781715	1	1	130	241	7	0	-G
G4_BC76_191109_LF_LIB_consensus_vsearch	2009	G	R	362	11	2.79%	2	2	93	93	4.530987124457782E-4	1	1	119	243	10	1	A
G4_BC76_191109_LF_LIB_consensus_vsearch	2010	C	Y	380	8	2.02%	2	2	93	93	0.003766486715388715	1	1	138	242	3	5	T
G4_BC76_191109_LF_LIB_consensus_vsearch	2011	A	A	391	6	1.51%	2	2	93	93	0.01533056561273411	1	1	142	249	3	3	G
G4_BC76_191109_LF_LIB_consensus_vsearch	2012	A	R	391	7	1.74%	2	2	93	93	0.007607431615374521	1	1	143	248	2	5	G
G4_BC76_191109_LF_LIB_consensus_vsearch	2013	G	G	399	1	0.25%	2	1	93	93	0.4999999999999138	1	1	146	253	0	1	+C
G4_BC76_191109_LF_LIB_consensus_vsearch	2014	T	*/-C	392	12	2.95%	2	2	93	93	2.2472535825225005E-4	1	1	137	255	11	1	-C
G4_BC76_191109_LF_LIB_consensus_vsearch	2015	C	C	392	1	0.25%	2	1	93	93	0.4999999999990043	1	1	137	255	0	1	+A
G4_BC76_191109_LF_LIB_consensus_vsearch	2016	C	C	401	3	0.74%	2	2	93	93	0.1245353159851805	1	1	145	256	1	2	T
G4_BC76_191109_LF_LIB_consensus_vsearch	2017	A	A	395	3	0.74%	2	1	93	93	0.12452830188671389	1	1	139	256	3	0	G
G4_BC76_191109_LF_LIB_consensus_vsearch	2018	C	C	401	2	0.5%	2	1	93	93	0.24968944099344345	1	1	144	257	2	0	G
G4_BC76_191109_LF_LIB_consensus_vsearch	2019	C	C	390	4	0.99%	2	2	93	93	0.062023810487337606	1	1	138	252	1	3	+A
G4_BC76_191109_LF_LIB_consensus_vsearch	2020	A	R	369	20	5%	2	2	93	93	7.423348007282038E-7	1	1	116	253	19	1	G
G4_BC76_191109_LF_LIB_consensus_vsearch	2021	C	*/-T	378	9	2.27%	2	2	93	93	0.0018633978545959287	1	1	130	248	7	2	-T
G4_BC76_191109_LF_LIB_consensus_vsearch	2022	T	Y	367	9	2.3%	2	1	93	93	0.001860806485014851	1	1	122	245	9	0	C
G4_BC76_191109_LF_LIB_consensus_vsearch	2023	T	Y	390	9	2.21%	2	2	93	93	0.0018660638404102402	1	1	138	252	7	2	C
G4_BC76_191109_LF_LIB_consensus_vsearch	2024	A	A	398	5	1.23%	2	2	93	93	0.030862526395586183	1	1	141	257	3	2	-TA
G4_BC76_191109_LF_LIB_consensus_vsearch	2025	T	T	397	3	0.75%	2	2	93	93	0.12453066332921275	1	1	143	254	1	2	C
G4_BC76_191109_LF_LIB_consensus_vsearch	2026	A	A	394	6	1.49%	2	2	93	93	0.015332768266138878	1	1	142	252	3	3	G
G4_BC76_191109_LF_LIB_consensus_vsearch	2027	C	C	402	2	0.49%	2	2	93	93	0.2496902106567468	1	1	147	255	1	1	+AC
G4_BC76_191109_LF_LIB_consensus_vsearch	2028	G	*/-TG	392	9	2.22%	2	2	93	93	0.0018664928473143382	1	1	146	246	1	8	-TG
G4_BC76_191109_LF_LIB_consensus_vsearch	2029	T	T	390	2	0.5%	2	1	93	93	0.24968071519789278	1	1	144	246	2	0	+A
G4_BC76_191109_LF_LIB_consensus_vsearch	2030	G	*/-A	386	7	1.76%	2	2	93	93	0.0076048360660226225	1	1	142	244	5	2	-A
G4_BC76_191109_LF_LIB_consensus_vsearch	2031	A	A	397	1	0.25%	2	1	93	93	0.4999999999990043	1	1	141	256	1	0	+G
G4_BC76_191109_LF_LIB_consensus_vsearch	2032	A	A	405	2	0.49%	2	1	93	93	0.2496924969251474	1	1	149	256	0	2	+T
G4_BC76_191109_LF_LIB_consensus_vsearch	2033	T	T	403	3	0.74%	2	1	93	93	0.12453760789147728	1	1	147	256	0	3	C
G4_BC76_191109_LF_LIB_consensus_vsearch	2034	C	C	403	2	0.49%	2	2	93	93	0.24969097651407932	1	1	147	256	1	1	-ATC
G4_BC76_191109_LF_LIB_consensus_vsearch	2035	A	A	401	3	0.74%	2	2	93	93	0.1245353159851805	1	1	145	256	2	1	G
G4_BC76_191109_LF_LIB_consensus_vsearch	2036	T	T	396	3	0.74%	2	1	93	93	0.12452948557099502	1	1	141	255	3	0	+CC
G4_BC76_191109_LF_LIB_consensus_vsearch	2037	C	C	390	5	1.24%	2	1	93	93	0.030854683924238017	1	1	138	252	5	0	-G
G4_BC76_191109_LF_LIB_consensus_vsearch	2038	G	G	385	6	1.49%	2	2	93	93	0.01532605917062568	1	1	132	253	4	2	-A
G4_BC76_191109_LF_LIB_consensus_vsearch	2039	A	A	396	3	0.75%	2	1	93	93	0.12452948557099502	1	1	141	255	3	0	+G
G4_BC76_191109_LF_LIB_consensus_vsearch	2040	G	G	398	2	0.49%	2	1	93	93	0.249687108886017	1	1	145	253	0	2	-T
G4_BC76_191109_LF_LIB_consensus_vsearch	2041	T	Y	396	9	2.22%	2	1	93	93	0.0018673383028544072	1	1	148	248	0	9	C
G4_BC76_191109_LF_LIB_consensus_vsearch	2042	T	T	398	3	0.74%	2	2	93	93	0.12453183520605009	1	1	145	253	1	2	C
G4_BC76_191109_LF_LIB_consensus_vsearch	2043	G	G	394	4	0.99%	2	2	93	93	0.06202859930052086	1	1	143	251	1	3	-T
G4_BC76_191109_LF_LIB_consensus_vsearch	2044	T	Y	391	9	2.24%	2	1	93	93	0.0018662788735768444	1	1	147	244	0	9	C
G4_BC76_191109_LF_LIB_consensus_vsearch	2045	T	T	395	2	0.49%	2	1	93	93	0.24968474148789518	1	1	145	250	2	0	+A
G4_BC76_191109_LF_LIB_consensus_vsearch	2046	G	G	398	4	0.99%	2	2	93	93	0.06203329275530562	1	1	145	253	3	1	-A
G4_BC76_191109_LF_LIB_consensus_vsearch	2047	A	A	399	1	0.25%	2	1	93	93	0.4999999999999138	1	1	143	256	1	0	+C
G4_BC76_191109_LF_LIB_consensus_vsearch	2048	A	A	389	6	1.47%	2	1	93	93	0.015329078637527195	1	1	146	243	0	6	+T
G4_BC76_191109_LF_LIB_consensus_vsearch	2049	C	Y	371	15	3.72%	2	2	93	93	2.656728555260812E-5	1	1	145	226	1	14	T
G4_BC76_191109_LF_LIB_consensus_vsearch	2050	G	G	391	3	0.74%	2	1	93	93	0.12452350698836272	1	1	141	250	0	3	+TG
G4_BC76_191109_LF_LIB_consensus_vsearch	2051	C	Y	388	7	1.74%	2	1	93	93	0.007605882130108492	1	1	140	248	0	7	T
G4_BC76_191109_LF_LIB_consensus_vsearch	2052	A	A	393	3	0.74%	2	2	93	93	0.12452591656124207	1	1	139	254	1	2	G
G4_BC76_191109_LF_LIB_consensus_vsearch	2053	T	T	394	6	1.49%	2	1	93	93	0.015332768266138878	1	1	144	250	0	6	C
G4_BC76_191109_LF_LIB_consensus_vsearch	2054	T	*/-GC	390	8	1.98%	2	1	93	93	0.0037699692796093966	1	1	137	253	8	0	-GC
G4_BC76_191109_LF_LIB_consensus_vsearch	2055	G	G	396	2	0.5%	2	2	93	93	0.24968553459123424	1	1	139	257	1	1	A
G4_BC76_191109_LF_LIB_consensus_vsearch	2056	C	C	386	6	1.5%	2	2	93	93	0.015326819799317902	1	1	136	250	1	5	T
G4_BC76_191109_LF_LIB_consensus_vsearch	2057	A	A	399	3	0.74%	2	2	93	93	0.12453300124551302	1	1	141	258	2	1	-C
G4_BC76_191109_LF_LIB_consensus_vsearch	2058	C	C	392	4	1%	2	1	93	93	0.06202621699451153	1	1	142	250	0	4	A
G4_BC76_191109_LF_LIB_consensus_vsearch	2059	C	Y	397	9	2.21%	2	2	93	93	0.0018675470949966115	1	1	146	251	2	7	T
G4_BC76_191109_LF_LIB_consensus_vsearch	2060	G	G	404	2	0.49%	2	1	93	93	0.24969173859492816	1	1	148	256	0	2	A
G4_BC76_191109_LF_LIB_consensus_vsearch	2061	C	C	396	5	1.23%	2	2	93	93	0.03086059509471206	1	1	144	252	1	4	T
G4_BC76_191109_LF_LIB_consensus_vsearch	2062	G	*/-C	332	56	13.86%	2	1	93	93	1.6335693546869968E-18	1	1	82	250	56	0	-C
G4_BC76_191109_LF_LIB_consensus_vsearch	2063	C	C	337	6	1.73%	2	1	93	93	0.015284348849175712	1	1	88	249	0	6	+T
G4_BC76_191109_LF_LIB_consensus_vsearch	2064	C	C	401	2	0.49%	2	2	93	93	0.24968944099344345	1	1	146	255	1	1	A
G4_BC76_191109_LF_LIB_consensus_vsearch	2065	C	C	394	6	1.47%	2	2	93	93	0.015332768266138878	1	1	142	252	2	4	-T
G4_BC76_191109_LF_LIB_consensus_vsearch	2066	T	*/+A	360	16	4.02%	2	2	93	93	1.2964449230219886E-5	1	1	138	222	1	15	+A
G4_BC76_191109_LF_LIB_consensus_vsearch	2067	A	A	394	1	0.25%	2	1	93	93	0.4999999999999138	1	1	141	253	1	0	+C
G4_BC76_191109_LF_LIB_consensus_vsearch	2068	A	A	400	2	0.5%	2	1	93	93	0.24968866749695368	1	1	145	255	2	0	G
G4_BC76_191109_LF_LIB_consensus_vsearch	2069	A	A	396	6	1.48%	2	2	93	93	0.015334218484153218	1	1	141	255	4	2	G
G4_BC76_191109_LF_LIB_consensus_vsearch	2070	C	C	403	1	0.25%	2	1	93	93	0.4999999999999138	1	1	145	258	1	0	A
G4_BC76_191109_LF_LIB_consensus_vsearch	2071	C	C	394	5	1.23%	2	2	93	93	0.030858644444955494	1	1	145	249	2	3	T
G4_BC76_191109_LF_LIB_consensus_vsearch	2072	G	G	398	2	0.5%	2	1	93	93	0.249687108886017	1	1	144	254	2	0	A
G4_BC76_191109_LF_LIB_consensus_vsearch	2073	G	G	400	3	0.74%	2	2	93	93	0.12453416149047736	1	1	144	256	2	1	A
G4_BC76_191109_LF_LIB_consensus_vsearch	2074	C	*/-T	390	7	1.72%	2	1	93	93	0.007606917708857565	1	1	139	251	7	0	-T
G4_BC76_191109_LF_LIB_consensus_vsearch	2075	T	T	390	5	1.25%	2	1	93	93	0.030854683924238017	1	1	138	252	0	5	+C
G4_BC76_191109_LF_LIB_consensus_vsearch	2076	G	G	395	3	0.74%	2	1	93	93	0.12452830188671389	1	1	144	251	0	3	-C
G4_BC76_191109_LF_LIB_consensus_vsearch	2077	C	S	374	10	2.51%	2	1	93	93	9.203091175437465E-4	1	1	144	230	0	10	G
G4_BC76_191109_LF_LIB_consensus_vsearch	2078	G	R	357	22	5.57%	2	2	93	93	1.7422330700087193E-7	1	1	120	237	21	1	A
G4_BC76_191109_LF_LIB_consensus_vsearch	2079	G	G	397	2	0.5%	2	1	93	93	0.24968632371350802	1	1	145	252	0	2	-T
G4_BC76_191109_LF_LIB_consensus_vsearch	2080	T	T	391	4	0.99%	2	2	93	93	0.06202501678889606	1	1	145	246	1	3	C
G4_BC76_191109_LF_LIB_consensus_vsearch	2081	A	A	397	1	0.25%	2	1	93	93	0.4999999999990043	1	1	144	253	1	0	+CG
G4_BC76_191109_LF_LIB_consensus_vsearch	2082	T	T	394	3	0.74%	2	2	93	93	0.1245271122321419	1	1	144	250	1	2	-G
G4_BC76_191109_LF_LIB_consensus_vsearch	2083	G	*/-C	286	62	15.46%	2	2	93	93	1.0959211319562908E-20	1	1	104	182	15	47	-C
G4_BC76_191109_LF_LIB_consensus_vsearch	2084	C	C	294	6	1.94%	2	1	93	93	0.015235687986651206	1	1	103	191	0	6	+T
G4_BC76_191109_LF_LIB_consensus_vsearch	2085	C	C	368	1	0.27%	2	1	93	93	0.4999999999999138	1	1	119	249	1	0	+T
G4_BC76_191109_LF_LIB_consensus_vsearch	2086	C	S	383	11	2.73%	2	1	93	93	4.549328864195511E-4	1	1	131	252	11	0	G
G4_BC76_191109_LF_LIB_consensus_vsearch	2087	C	*/-T	282	101	24.75%	2	2	93	93	1.9399166693297854E-34	1	1	117	165	11	90	-T
G4_BC76_191109_LF_LIB_consensus_vsearch	2088	T	T	278	6	2.09%	2	1	93	93	0.015213833742871467	1	1	119	159	0	6	C
G4_BC76_191109_LF_LIB_consensus_vsearch	2089	T	T	378	5	1.29%	2	2	93	93	0.030842306341483338	1	1	124	254	3	2	C
G4_BC76_191109_LF_LIB_consensus_vsearch	2090	T	T	395	5	1.23%	2	2	93	93	0.030859622206549208	1	1	139	256	4	1	C
G4_BC76_191109_LF_LIB_consensus_vsearch	2091	G	G	392	6	1.48%	2	2	93	93	0.015331303510572384	1	1	139	253	5	1	-A
G4_BC76_191109_LF_LIB_consensus_vsearch	2092	A	A	386	5	1.25%	2	2	93	93	0.030850642423789317	1	1	135	251	4	1	-G
G4_BC76_191109_LF_LIB_consensus_vsearch	2093	G	G	387	4	1%	2	1	93	93	0.062020154536760255	1	1	141	246	0	4	-CG
G4_BC76_191109_LF_LIB_consensus_vsearch	2094	C	Y	383	11	2.75%	2	2	93	93	4.549328864195511E-4	1	1	142	241	2	9	T
G4_BC76_191109_LF_LIB_consensus_vsearch	2095	G	G	385	5	1.25%	2	2	93	93	0.030849619103815673	1	1	140	245	3	2	-T
G4_BC76_191109_LF_LIB_consensus_vsearch	2096	T	T	389	5	1.24%	2	1	93	93	0.030853681237272182	1	1	142	247	0	5	-C
G4_BC76_191109_LF_LIB_consensus_vsearch	2097	C	C	394	5	1.25%	2	1	93	93	0.030858644444955494	1	1	141	253	5	0	-A
G4_BC76_191109_LF_LIB_consensus_vsearch	2098	A	A	390	3	0.75%	2	2	93	93	0.12452229299364298	1	1	141	249	1	2	G
G4_BC76_191109_LF_LIB_consensus_vsearch	2099	T	T	393	5	1.24%	2	1	93	93	0.03085766177318207	1	1	143	250	5	0	G
G4_BC76_191109_LF_LIB_consensus_vsearch	2100	T	*/-GT	389	8	1.97%	2	2	93	93	0.0037696288519149155	1	1	146	243	2	6	-GT
G4_BC76_191109_LF_LIB_consensus_vsearch	2101	G	G	384	5	1.26%	2	1	93	93	0.030848590526024323	1	1	142	242	0	5	-T
G4_BC76_191109_LF_LIB_consensus_vsearch	2102	T	Y	368	15	3.84%	2	2	93	93	2.6537894487866267E-5	1	1	141	227	1	14	C
G4_BC76_191109_LF_LIB_consensus_vsearch	2103	A	R	382	8	2%	2	2	93	93	0.0037671973936205536	1	1	141	241	2	6	G
G4_BC76_191109_LF_LIB_consensus_vsearch	2104	T	Y	381	11	2.75%	2	2	93	93	4.547664803982017E-4	1	1	144	237	3	8	C
G4_BC76_191109_LF_LIB_consensus_vsearch	2105	T	*/-C	370	20	4.94%	2	2	93	93	7.428241446984615E-7	1	1	144	226	3	17	-C
G4_BC76_191109_LF_LIB_consensus_vsearch	2106	C	*/+G	374	7	1.82%	2	1	93	93	0.007598330292913895	1	1	137	237	7	0	+G
G4_BC76_191109_LF_LIB_consensus_vsearch	2107	C	*/-T	388	8	1.98%	2	2	93	93	0.0037692867193449852	1	1	142	246	4	4	-T
G4_BC76_191109_LF_LIB_consensus_vsearch	2108	T	T	392	3	0.76%	2	1	93	93	0.12452471482865957	1	1	142	250	0	3	+CT
G4_BC76_191109_LF_LIB_consensus_vsearch	2109	T	T	392	6	1.48%	2	2	93	93	0.015331303510572384	1	1	136	256	5	1	+C
G4_BC76_191109_LF_LIB_consensus_vsearch	2110	C	*/-GG	314	36	8.96%	2	2	93	93	5.636089535632214E-12	1	1	109	205	2	34	-GG
G4_BC76_191109_LF_LIB_consensus_vsearch	2111	G	R	294	33	10%	2	1	93	93	4.976040875547274E-11	1	1	85	209	33	0	A
G4_BC76_191109_LF_LIB_consensus_vsearch	2112	G	G	357	6	1.65%	2	2	93	93	0.015303064911388683	1	1	138	219	3	3	A
G4_BC76_191109_LF_LIB_consensus_vsearch	2113	G	R	377	16	3.98%	2	2	93	93	1.3058016225586293E-5	1	1	126	251	15	1	A
G4_BC76_191109_LF_LIB_consensus_vsearch	2114	A	A	391	2	0.51%	2	2	93	93	0.24968152866242077	1	1	141	250	1	1	-G
G4_BC76_191109_LF_LIB_consensus_vsearch	2115	G	*/+T	378	12	3%	2	1	93	93	2.2404784900264377E-4	1	1	143	235	0	12	+T
G4_BC76_191109_LF_LIB_consensus_vsearch	2116	T	T	390	4	1%	2	2	93	93	0.062023810487337606	1	1	145	245	1	3	+C
G4_BC76_191109_LF_LIB_consensus_vsearch	2117	C	*/+T	64	285	71.43%	2	2	93	93	3.025422655799699E-133	1	1	9	55	136	149	+T
G4_BC76_191109_LF_LIB_consensus_vsearch	2118	T	T	395	1	0.25%	2	1	93	93	0.5000000000008233	1	1	146	249	0	1	+C
G4_BC76_191109_LF_LIB_consensus_vsearch	2119	T	*/-C	381	9	2.23%	2	1	93	93	0.0018640795393290628	1	1	145	236	0	9	-C
G4_BC76_191109_LF_LIB_consensus_vsearch	2120	C	Y	332	50	12.82%	2	2	93	93	1.5970268365110243E-16	1	1	140	192	5	45	T
G4_BC76_191109_LF_LIB_consensus_vsearch	2121	C	*/-T	299	72	18%	2	1	93	93	4.6464772080209724E-24	1	1	144	155	0	72	-T
G4_BC76_191109_LF_LIB_consensus_vsearch	2122	T	*/+C	287	7	2.24%	2	1	93	93	0.00753539154747985	1	1	142	145	0	7	+C
G4_BC76_191109_LF_LIB_consensus_vsearch	2123	T	Y	353	18	4.63%	2	2	93	93	3.088423482833563E-6	1	1	143	210	3	15	C
G4_BC76_191109_LF_LIB_consensus_vsearch	2124	G	G	388	3	0.75%	2	2	93	93	0.12451984635071693	1	1	145	243	1	2	A
G4_BC76_191109_LF_LIB_consensus_vsearch	2125	C	Y	376	14	3.48%	2	1	93	93	5.420225372441819E-5	1	1	147	229	0	14	T
G4_BC76_191109_LF_LIB_consensus_vsearch	2126	T	T	387	5	1.26%	2	2	93	93	0.030851660526274274	1	1	144	243	1	4	C
G4_BC76_191109_LF_LIB_consensus_vsearch	2127	G	*/-A	376	11	2.73%	2	2	93	93	4.5434311102034934E-4	1	1	129	247	10	1	-A
G4_BC76_191109_LF_LIB_consensus_vsearch	2128	A	A	383	2	0.52%	2	1	93	93	0.24967490247067214	1	1	132	251	0	2	G
G4_BC76_191109_LF_LIB_consensus_vsearch	2129	A	A	398	1	0.25%	2	1	93	93	0.4999999999999138	1	1	144	254	0	1	G
G4_BC76_191109_LF_LIB_consensus_vsearch	2130	A	A	397	4	0.99%	2	1	93	93	0.062032128175275904	1	1	141	256	4	0	G
G4_BC76_191109_LF_LIB_consensus_vsearch	2131	G	G	395	5	1.23%	2	1	93	93	0.030859622206549208	1	1	140	255	5	0	-A
G4_BC76_191109_LF_LIB_consensus_vsearch	2132	A	*/-C	372	15	3.76%	2	2	93	93	2.6576986497768562E-5	1	1	123	249	9	6	-C
G4_BC76_191109_LF_LIB_consensus_vsearch	2133	C	*/+T	349	32	8.23%	2	2	93	93	1.1805069326284918E-10	1	1	132	217	1	31	+T
G4_BC76_191109_LF_LIB_consensus_vsearch	2134	C	Y	393	7	1.72%	2	2	93	93	0.007608451759263046	1	1	145	248	2	5	T
G4_BC76_191109_LF_LIB_consensus_vsearch	2135	C	Y	307	76	18.67%	2	2	93	93	2.116442138603491E-25	1	1	138	169	1	75	T
G4_BC76_191109_LF_LIB_consensus_vsearch	2136	G	*/-A	389	9	2.23%	2	1	93	93	0.0018658477399051397	1	1	133	256	9	0	-A
G4_BC76_191109_LF_LIB_consensus_vsearch	2137	A	R	383	9	2.27%	2	1	93	93	0.001864528271344425	1	1	128	255	9	0	G
G4_BC76_191109_LF_LIB_consensus_vsearch	2138	G	*/+C	384	11	2.73%	2	1	93	93	4.5501547153779163E-4	1	1	145	239	0	11	+C
G4_BC76_191109_LF_LIB_consensus_vsearch	2139	C	*/-T	386	10	2.48%	2	2	93	93	9.219853921161506E-4	1	1	144	242	3	7	-T
G4_BC76_191109_LF_LIB_consensus_vsearch	2140	T	*/-C	367	10	2.54%	2	1	93	93	9.192828850276177E-4	1	1	134	233	0	10	-C
G4_BC76_191109_LF_LIB_consensus_vsearch	2141	C	*/-G	310	65	16.46%	2	2	93	93	1.2981593981673049E-21	1	1	102	208	33	32	-G
G4_BC76_191109_LF_LIB_consensus_vsearch	2142	G	R	304	21	6.23%	2	2	93	93	3.4155824062753555E-7	1	1	85	219	20	1	A
G4_BC76_191109_LF_LIB_consensus_vsearch	2143	G	*/+A	365	15	3.72%	2	1	93	93	2.650806354364234E-5	1	1	110	255	15	0	+A
G4_BC76_191109_LF_LIB_consensus_vsearch	2144	A	A	390	4	1.01%	2	1	93	93	0.062023810487337606	1	1	134	256	4	0	-G
G4_BC76_191109_LF_LIB_consensus_vsearch	2145	G	R	352	38	9.5%	2	2	93	93	1.4108953295604815E-12	1	1	100	252	37	1	A
G4_BC76_191109_LF_LIB_consensus_vsearch	2146	T	*/-C	379	11	2.74%	2	2	93	93	4.5459840602315744E-4	1	1	131	248	7	4	-C
G4_BC76_191109_LF_LIB_consensus_vsearch	2147	C	C	388	1	0.26%	2	1	93	93	0.4999999999999138	1	1	135	253	0	1	+T
G4_BC76_191109_LF_LIB_consensus_vsearch	2148	C	C	392	5	1.25%	2	1	93	93	0.030856674154206513	1	1	142	250	0	5	-T
G4_BC76_191109_LF_LIB_consensus_vsearch	2149	T	Y	376	9	2.27%	2	1	93	93	0.00186293757088788	1	1	136	240	0	9	C
G4_BC76_191109_LF_LIB_consensus_vsearch	2150	C	C	387	6	1.5%	2	1	93	93	0.015327576567173378	1	1	144	243	0	6	-G
G4_BC76_191109_LF_LIB_consensus_vsearch	2151	G	R	382	12	3%	2	2	93	93	2.2424619755304767E-4	1	1	135	247	10	2	A
G4_BC76_191109_LF_LIB_consensus_vsearch	2152	G	G	401	4	0.99%	2	2	93	93	0.06203675196794108	1	1	146	255	1	3	A
G4_BC76_191109_LF_LIB_consensus_vsearch	2153	T	*/+C	396	7	1.72%	2	2	93	93	0.007609963086240239	1	1	142	254	5	2	+C
G4_BC76_191109_LF_LIB_consensus_vsearch	2154	C	*/+G	373	29	7.16%	2	1	93	93	1.1033452924409622E-9	1	1	116	257	29	0	+G
G4_BC76_191109_LF_LIB_consensus_vsearch	2155	C	*/-T	346	31	7.62%	2	1	93	93	2.4482883268915226E-10	1	1	124	222	0	31	-T
G4_BC76_191109_LF_LIB_consensus_vsearch	2156	T	T	345	2	0.57%	2	1	93	93	0.24963924963931935	1	1	122	223	2	0	G
G4_BC76_191109_LF_LIB_consensus_vsearch	2157	T	T	373	5	1.32%	2	2	93	93	0.03083691723172624	1	1	122	251	3	2	C
G4_BC76_191109_LF_LIB_consensus_vsearch	2158	T	*/-G	293	106	26.17%	2	1	93	93	3.865102833117193E-36	1	1	146	147	0	106	-G
G4_BC76_191109_LF_LIB_consensus_vsearch	2159	G	G	294	5	1.67%	2	1	93	93	0.03072786903702899	1	1	148	146	0	5	T
G4_BC76_191109_LF_LIB_consensus_vsearch	2160	G	G	402	3	0.74%	2	1	93	93	0.1245364647713705	1	1	144	258	3	0	A
G4_BC76_191109_LF_LIB_consensus_vsearch	2161	A	A	400	2	0.49%	2	1	93	93	0.24968866749695368	1	1	147	253	0	2	+C
G4_BC76_191109_LF_LIB_consensus_vsearch	2162	T	T	396	3	0.74%	2	2	93	93	0.12452948557099502	1	1	143	253	1	2	-C
G4_BC76_191109_LF_LIB_consensus_vsearch	2163	C	C	398	4	0.99%	2	2	93	93	0.06203329275530562	1	1	145	253	1	3	+A
G4_BC76_191109_LF_LIB_consensus_vsearch	2164	G	G	395	5	1.23%	2	2	93	93	0.030859622206549208	1	1	143	252	4	1	A
G4_BC76_191109_LF_LIB_consensus_vsearch	2165	T	T	384	6	1.5%	2	2	93	93	0.015325294651568566	1	1	146	238	2	4	C
G4_BC76_191109_LF_LIB_consensus_vsearch	2166	G	G	388	6	1.5%	2	1	93	93	0.015328329503561841	1	1	148	240	0	6	-T
G4_BC76_191109_LF_LIB_consensus_vsearch	2167	T	T	387	4	1.02%	2	2	93	93	0.062020154536760255	1	1	148	239	1	3	C
G4_BC76_191109_LF_LIB_consensus_vsearch	2168	T	*/+C	387	7	1.73%	2	1	93	93	0.007605360418658285	1	1	149	238	0	7	+C
G4_BC76_191109_LF_LIB_consensus_vsearch	2169	C	C	395	4	0.99%	2	1	93	93	0.06202978149183676	1	1	148	247	0	4	+T
G4_BC76_191109_LF_LIB_consensus_vsearch	2170	T	*/-C	343	46	11.44%	2	1	93	93	3.4560542144781175E-15	1	1	145	198	0	46	-C
G4_BC76_191109_LF_LIB_consensus_vsearch	2171	C	*/-TC	333	15	4.18%	2	2	93	93	2.6159683280048882E-5	1	1	142	191	5	10	-TC
G4_BC76_191109_LF_LIB_consensus_vsearch	2172	T	Y	361	12	3.09%	2	2	93	93	2.2315882163969882E-4	1	1	132	229	1	11	C
G4_BC76_191109_LF_LIB_consensus_vsearch	2173	C	*/+G	366	12	3.09%	2	1	93	93	2.234283568245827E-4	1	1	128	238	12	0	+G
G4_BC76_191109_LF_LIB_consensus_vsearch	2174	A	*/-G	379	13	3.22%	2	1	93	93	1.1033167832753745E-4	1	1	134	245	13	0	-G
G4_BC76_191109_LF_LIB_consensus_vsearch	2175	G	G	391	2	0.51%	2	1	93	93	0.24968152866242077	1	1	132	259	2	0	-A
G4_BC76_191109_LF_LIB_consensus_vsearch	2176	A	A	397	4	0.99%	2	2	93	93	0.062032128175275904	1	1	143	254	3	1	-TG
G4_BC76_191109_LF_LIB_consensus_vsearch	2177	T	T	398	2	0.5%	2	1	93	93	0.249687108886017	1	1	143	255	0	2	C
G4_BC76_191109_LF_LIB_consensus_vsearch	2178	G	R	386	10	2.48%	2	1	93	93	9.219853921161506E-4	1	1	131	255	10	0	A
G4_BC76_191109_LF_LIB_consensus_vsearch	2179	C	Y	389	7	1.74%	2	2	93	93	0.0076064012202881484	1	1	142	247	1	6	T
G4_BC76_191109_LF_LIB_consensus_vsearch	2180	G	G	392	4	1%	2	2	93	93	0.06202621699451153	1	1	142	250	2	2	A
G4_BC76_191109_LF_LIB_consensus_vsearch	2181	T	T	395	5	1.24%	2	2	93	93	0.030859622206549208	1	1	142	253	2	3	C
G4_BC76_191109_LF_LIB_consensus_vsearch	2182	C	C	403	2	0.49%	2	2	93	93	0.24969097651407932	1	1	146	257	1	1	+A
G4_BC76_191109_LF_LIB_consensus_vsearch	2183	G	G	401	4	0.98%	2	2	93	93	0.06203675196794108	1	1	147	254	1	3	A
G4_BC76_191109_LF_LIB_consensus_vsearch	2184	C	*/-GC	388	11	2.71%	2	2	93	93	4.5534176337797E-4	1	1	137	251	10	1	-GC
G4_BC76_191109_LF_LIB_consensus_vsearch	2185	G	G	384	3	0.77%	2	1	93	93	0.12451487710233766	1	1	131	253	3	0	A
G4_BC76_191109_LF_LIB_consensus_vsearch	2186	C	C	391	2	0.51%	2	2	93	93	0.24968152866242077	1	1	136	255	1	1	T
G4_BC76_191109_LF_LIB_consensus_vsearch	2187	C	Y	392	8	1.98%	2	2	93	93	0.0037706450711110975	1	1	146	246	1	7	T
G4_BC76_191109_LF_LIB_consensus_vsearch	2188	G	G	404	1	0.25%	2	1	93	93	0.4999999999999138	1	1	148	256	0	1	A
G4_BC76_191109_LF_LIB_consensus_vsearch	2189	A	A	406	1	0.25%	2	1	93	93	0.4999999999999138	1	1	149	257	0	1	-T
G4_BC76_191109_LF_LIB_consensus_vsearch	2190	T	T	400	2	0.49%	2	1	93	93	0.24968866749695368	1	1	144	256	2	0	-C
G4_BC76_191109_LF_LIB_consensus_vsearch	2191	C	C	393	3	0.74%	2	1	93	93	0.12452591656124207	1	1	137	256	3	0	-GC
G4_BC76_191109_LF_LIB_consensus_vsearch	2192	G	*/-C	379	8	1.99%	2	2	93	93	0.0037661286454389806	1	1	127	252	7	1	-C
G4_BC76_191109_LF_LIB_consensus_vsearch	2193	C	C	386	3	0.76%	2	1	93	93	0.12451737451743523	1	1	130	256	3	0	T
G4_BC76_191109_LF_LIB_consensus_vsearch	2194	C	C	393	4	0.99%	2	2	93	93	0.0620274111497499	1	1	139	254	3	1	-T
G4_BC76_191109_LF_LIB_consensus_vsearch	2195	T	Y	388	7	1.74%	2	2	93	93	0.007605882130108492	1	1	142	246	2	5	C
G4_BC76_191109_LF_LIB_consensus_vsearch	2196	G	G	404	1	0.25%	2	1	93	93	0.4999999999999138	1	1	147	257	0	1	+CTG
G4_BC76_191109_LF_LIB_consensus_vsearch	2197	A	A	404	1	0.25%	2	1	93	93	0.4999999999999138	1	1	146	258	0	1	+GC
G4_BC76_191109_LF_LIB_consensus_vsearch	2198	T	*/-G	390	10	2.46%	2	2	93	93	9.225221739189795E-4	1	1	143	247	4	6	-G
G4_BC76_191109_LF_LIB_consensus_vsearch	2199	G	G	387	5	1.26%	2	2	93	93	0.030851660526274274	1	1	138	249	4	1	A
G4_BC76_191109_LF_LIB_consensus_vsearch	2200	G	G	400	4	0.99%	2	1	93	93	0.06203560460879861	1	1	143	257	4	0	+A
G4_BC76_191109_LF_LIB_consensus_vsearch	2201	G	G	397	3	0.74%	2	2	93	93	0.12453066332921275	1	1	141	256	2	1	-TA
G4_BC76_191109_LF_LIB_consensus_vsearch	2202	T	Y	381	16	3.98%	2	2	93	93	1.307893571981294E-5	1	1	142	239	3	13	C
G4_BC76_191109_LF_LIB_consensus_vsearch	2203	A	A	384	5	1.24%	2	1	93	93	0.030848590526024323	1	1	138	246	5	0	G
G4_BC76_191109_LF_LIB_consensus_vsearch	2204	C	*/+T	364	15	3.72%	2	1	93	93	2.6498020436636046E-5	1	1	144	220	0	15	+T
G4_BC76_191109_LF_LIB_consensus_vsearch	2205	T	*/+C	371	9	2.28%	2	1	93	93	0.0018617659366352362	1	1	137	234	9	0	+C
G4_BC76_191109_LF_LIB_consensus_vsearch	2206	C	*/-T	368	15	3.76%	2	2	93	93	2.6537894487866267E-5	1	1	141	227	2	13	-T
G4_BC76_191109_LF_LIB_consensus_vsearch	2207	T	*/-A	361	8	2.07%	2	2	93	93	0.0037593545145918465	1	1	140	221	2	6	-A
G4_BC76_191109_LF_LIB_consensus_vsearch	2208	A	A	384	6	1.53%	2	1	93	93	0.015325294651568566	1	1	143	241	0	6	C
G4_BC76_191109_LF_LIB_consensus_vsearch	2209	A	A	400	2	0.49%	2	1	93	93	0.24968866749695368	1	1	148	252	0	2	-T
G4_BC76_191109_LF_LIB_consensus_vsearch	2210	T	Y	390	9	2.23%	2	1	93	93	0.0018660638404102402	1	1	149	241	0	9	C
G4_BC76_191109_LF_LIB_consensus_vsearch	2211	G	G	392	4	0.99%	2	1	93	93	0.06202621699451153	1	1	145	247	0	4	+C
G4_BC76_191109_LF_LIB_consensus_vsearch	2212	C	C	400	2	0.5%	2	1	93	93	0.24968866749695368	1	1	145	255	0	2	+T
G4_BC76_191109_LF_LIB_consensus_vsearch	2213	C	C	402	1	0.25%	2	1	93	93	0.4999999999999138	1	1	148	254	0	1	+G
G4_BC76_191109_LF_LIB_consensus_vsearch	2214	T	Y	375	13	3.21%	2	1	93	93	1.102148449959401E-4	1	1	149	226	0	13	C
G4_BC76_191109_LF_LIB_consensus_vsearch	2215	G	G	400	5	1.23%	2	2	93	93	0.030864438634128317	1	1	145	255	3	2	-A
G4_BC76_191109_LF_LIB_consensus_vsearch	2216	A	A	391	5	1.25%	2	2	93	93	0.030855681550508444	1	1	140	251	3	2	-G
G4_BC76_191109_LF_LIB_consensus_vsearch	2217	G	G	396	1	0.25%	2	1	93	93	0.4999999999999138	1	1	143	253	1	0	+C
G4_BC76_191109_LF_LIB_consensus_vsearch	2218	C	C	393	4	0.99%	2	2	93	93	0.0620274111497499	1	1	143	250	1	3	T
G4_BC76_191109_LF_LIB_consensus_vsearch	2219	G	*/-TG	389	9	2.23%	2	1	93	93	0.0018658477399051397	1	1	144	245	0	9	-TG
G4_BC76_191109_LF_LIB_consensus_vsearch	2220	T	*/-G	367	15	3.77%	2	2	93	93	2.6528000199622014E-5	1	1	131	236	8	7	-G
G4_BC76_191109_LF_LIB_consensus_vsearch	2221	G	R	368	8	2.1%	2	1	93	93	0.003762065284927124	1	1	129	239	8	0	A
G4_BC76_191109_LF_LIB_consensus_vsearch	2222	G	*/-A	382	14	3.46%	2	2	93	93	5.430154987343997E-5	1	1	127	255	12	2	-A
G4_BC76_191109_LF_LIB_consensus_vsearch	2223	A	A	384	5	1.28%	2	2	93	93	0.030848590526024323	1	1	131	253	3	2	-G
G4_BC76_191109_LF_LIB_consensus_vsearch	2224	G	G	394	2	0.5%	2	1	93	93	0.24968394437400754	1	1	143	251	0	2	-T
G4_BC76_191109_LF_LIB_consensus_vsearch	2225	T	*/-C	315	80	19.85%	2	2	93	93	9.593886846317028E-27	1	1	105	210	43	37	-C
G4_BC76_191109_LF_LIB_consensus_vsearch	2226	C	C	322	2	0.62%	2	1	93	93	0.24961360123673174	1	1	105	217	0	2	T
G4_BC76_191109_LF_LIB_consensus_vsearch	2227	C	*/+T	385	13	3.21%	2	1	93	93	1.1050267709682812E-4	1	1	144	241	0	13	+T
G4_BC76_191109_LF_LIB_consensus_vsearch	2228	C	*/-T	366	21	5.17%	2	2	93	93	3.60842434638953E-7	1	1	147	219	1	20	-T
G4_BC76_191109_LF_LIB_consensus_vsearch	2229	T	T	374	5	1.31%	2	2	93	93	0.030838006421291704	1	1	146	228	1	4	C
G4_BC76_191109_LF_LIB_consensus_vsearch	2230	T	T	387	6	1.49%	2	1	93	93	0.015327576567173378	1	1	143	244	0	6	-C
G4_BC76_191109_LF_LIB_consensus_vsearch	2231	C	*/+G	369	13	3.24%	2	2	93	93	1.1003517226665928E-4	1	1	143	226	2	11	+G
G4_BC76_191109_LF_LIB_consensus_vsearch	2232	G	G	391	4	1%	2	2	93	93	0.06202501678889606	1	1	139	252	3	1	-A
G4_BC76_191109_LF_LIB_consensus_vsearch	2233	A	A	388	6	1.5%	2	2	93	93	0.015328329503561841	1	1	138	250	1	5	-G
G4_BC76_191109_LF_LIB_consensus_vsearch	2234	G	*/-T	375	7	1.76%	2	2	93	93	0.007598887968539548	1	1	131	244	5	2	-T
G4_BC76_191109_LF_LIB_consensus_vsearch	2235	T	Y	381	12	3.03%	2	1	93	93	2.2419697823514463E-4	1	1	139	242	0	12	C
G4_BC76_191109_LF_LIB_consensus_vsearch	2236	T	T	395	5	1.24%	2	1	93	93	0.030859622206549208	1	1	147	248	0	5	C
G4_BC76_191109_LF_LIB_consensus_vsearch	2237	T	Y	389	9	2.22%	2	2	93	93	0.0018658477399051397	1	1	143	246	3	6	C
G4_BC76_191109_LF_LIB_consensus_vsearch	2238	G	G	394	4	0.99%	2	1	93	93	0.06202859930052086	1	1	141	253	4	0	+A
G4_BC76_191109_LF_LIB_consensus_vsearch	2239	A	*/-G	361	39	9.65%	2	1	93	93	6.871429981672406E-13	1	1	107	254	39	0	-G
G4_BC76_191109_LF_LIB_consensus_vsearch	2240	G	G	358	4	1.09%	2	2	93	93	0.06198168749035562	1	1	103	255	2	2	-A
G4_BC76_191109_LF_LIB_consensus_vsearch	2241	A	*/+GA	386	11	2.72%	2	1	93	93	4.551794212032011E-4	1	1	146	240	0	11	+GA
G4_BC76_191109_LF_LIB_consensus_vsearch	2242	C	C	400	2	0.49%	2	2	93	93	0.24968866749695368	1	1	146	254	1	1	+T
G4_BC76_191109_LF_LIB_consensus_vsearch	2243	G	G	398	3	0.74%	2	2	93	93	0.12453183520605009	1	1	144	254	2	1	A
G4_BC76_191109_LF_LIB_consensus_vsearch	2244	C	*/-GC	368	25	6.16%	2	2	93	93	2.0096772623453192E-8	1	1	117	251	23	2	-GC
G4_BC76_191109_LF_LIB_consensus_vsearch	2245	G	G	368	3	0.8%	2	2	93	93	0.12449392712559995	1	1	112	256	2	1	T
G4_BC76_191109_LF_LIB_consensus_vsearch	2246	C	*/-T	341	21	5.56%	2	2	93	93	3.537623989695577E-7	1	1	109	232	8	13	-T
G4_BC76_191109_LF_LIB_consensus_vsearch	2247	T	T	371	3	0.79%	2	1	93	93	0.1244979919678599	1	1	129	242	3	0	C
G4_BC76_191109_LF_LIB_consensus_vsearch	2248	T	Y	384	7	1.74%	2	2	93	93	0.007603779356567615	1	1	141	243	4	3	C
G4_BC76_191109_LF_LIB_consensus_vsearch	2249	G	G	400	3	0.74%	2	1	93	93	0.12453416149047736	1	1	147	253	0	3	C
G4_BC76_191109_LF_LIB_consensus_vsearch	2250	A	A	390	6	1.48%	2	2	93	93	0.015329823997787357	1	1	143	247	1	5	-C
G4_BC76_191109_LF_LIB_consensus_vsearch	2251	C	Y	390	7	1.75%	2	2	93	93	0.007606917708857565	1	1	146	244	1	6	T
G4_BC76_191109_LF_LIB_consensus_vsearch	2252	C	Y	311	73	18.02%	2	1	93	93	2.4033189612629067E-24	1	1	144	167	0	73	T
G4_BC76_191109_LF_LIB_consensus_vsearch	2253	G	G	380	4	1.02%	2	1	93	93	0.06201140169241078	1	1	140	240	4	0	A
G4_BC76_191109_LF_LIB_consensus_vsearch	2254	G	G	387	5	1.23%	2	2	93	93	0.030851660526274274	1	1	137	250	4	1	-C
G4_BC76_191109_LF_LIB_consensus_vsearch	2255	C	C	387	5	1.25%	2	1	93	93	0.030851660526274274	1	1	139	248	0	5	T
G4_BC76_191109_LF_LIB_consensus_vsearch	2256	C	Y	370	27	6.65%	2	2	93	93	4.715581728157463E-9	1	1	144	226	1	26	T
G4_BC76_191109_LF_LIB_consensus_vsearch	2257	G	G	397	2	0.49%	2	1	93	93	0.24968632371350802	1	1	146	251	0	2	+CG
G4_BC76_191109_LF_LIB_consensus_vsearch	2258	T	Y	382	17	4.21%	2	1	93	93	6.410718325764792E-6	1	1	144	238	0	17	C
G4_BC76_191109_LF_LIB_consensus_vsearch	2259	T	*/-G	364	30	7.37%	2	2	93	93	5.247704825203226E-10	1	1	143	221	4	26	-G
G4_BC76_191109_LF_LIB_consensus_vsearch	2260	G	R	358	9	2.44%	2	2	93	93	0.0018585722679615095	1	1	134	224	8	1	A
G4_BC76_191109_LF_LIB_consensus_vsearch	2261	G	G	394	5	1.25%	2	2	93	93	0.030858644444955494	1	1	146	248	2	3	A
G4_BC76_191109_LF_LIB_consensus_vsearch	2262	G	*/+C	356	22	5.41%	2	1	93	93	1.7407451380387734E-7	1	1	144	212	0	22	+C
G4_BC76_191109_LF_LIB_consensus_vsearch	2263	C	C	382	6	1.5%	2	2	93	93	0.015323753822145654	1	1	146	236	1	5	T
G4_BC76_191109_LF_LIB_consensus_vsearch	2264	T	*/-C	354	38	9.43%	2	1	93	93	1.4180805182858033E-12	1	1	144	210	0	38	-C
G4_BC76_191109_LF_LIB_consensus_vsearch	2265	C	C	347	6	1.63%	2	2	93	93	0.015293971208790802	1	1	148	199	1	5	T
G4_BC76_191109_LF_LIB_consensus_vsearch	2266	G	R	382	16	3.94%	2	2	93	93	1.3084103727632285E-5	1	1	145	237	2	14	A
G4_BC76_191109_LF_LIB_consensus_vsearch	2267	C	Y	369	26	6.48%	2	2	93	93	9.740047923217663E-9	1	1	145	224	1	25	T
G4_BC76_191109_LF_LIB_consensus_vsearch	2268	G	G	380	4	1.01%	2	2	93	93	0.06201140169241078	1	1	142	238	3	1	A
G4_BC76_191109_LF_LIB_consensus_vsearch	2269	T	T	388	6	1.49%	2	2	93	93	0.015328329503561841	1	1	145	243	1	5	+GT
G4_BC76_191109_LF_LIB_consensus_vsearch	2270	C	*/-A	374	26	6.44%	2	2	93	93	9.79368641896108E-9	1	1	122	252	23	3	-A
G4_BC76_191109_LF_LIB_consensus_vsearch	2271	A	*/-C	347	15	3.95%	2	2	93	93	2.631926257505549E-5	1	1	119	228	4	11	-C
G4_BC76_191109_LF_LIB_consensus_vsearch	2272	C	S	346	22	5.68%	2	1	93	93	1.725481335683033E-7	1	1	121	225	22	0	G
G4_BC76_191109_LF_LIB_consensus_vsearch	2273	C	*/-A	371	15	3.72%	2	2	93	93	2.656728555260812E-5	1	1	140	231	7	8	-A
G4_BC76_191109_LF_LIB_consensus_vsearch	2274	A	A	370	4	1.05%	2	1	93	93	0.061998328885973654	1	1	134	236	4	0	+G
G4_BC76_191109_LF_LIB_consensus_vsearch	2275	A	A	392	6	1.5%	2	1	93	93	0.015331303510572384	1	1	147	245	0	6	T
G4_BC76_191109_LF_LIB_consensus_vsearch	2276	G	G	399	4	0.98%	2	1	93	93	0.06203445155203153	1	1	144	255	4	0	A
G4_BC76_191109_LF_LIB_consensus_vsearch	2277	T	*/-C	395	7	1.72%	2	1	93	93	0.007609461804174083	1	1	138	257	7	0	-C
G4_BC76_191109_LF_LIB_consensus_vsearch	2278	C	C	399	1	0.25%	2	1	93	93	0.4999999999999138	1	1	141	258	1	0	+G
G4_BC76_191109_LF_LIB_consensus_vsearch	2279	C	*/+G	389	9	2.21%	2	1	93	93	0.0018658477399051397	1	1	146	243	0	9	+G
G4_BC76_191109_LF_LIB_consensus_vsearch	2280	G	G	394	5	1.23%	2	2	93	93	0.030858644444955494	1	1	141	253	4	1	A
G4_BC76_191109_LF_LIB_consensus_vsearch	2281	C	C	401	1	0.25%	2	1	93	93	0.5000000000008233	1	1	146	255	0	1	+AAA
G4_BC76_191109_LF_LIB_consensus_vsearch	2282	G	R	389	8	1.98%	2	2	93	93	0.0037696288519149155	1	1	138	251	7	1	A
G4_BC76_191109_LF_LIB_consensus_vsearch	2283	T	*/-C	377	16	3.94%	2	1	93	93	1.3058016225586293E-5	1	1	124	253	16	0	-C
G4_BC76_191109_LF_LIB_consensus_vsearch	2284	C	C	386	2	0.52%	2	1	93	93	0.24967741935460958	1	1	127	259	2	0	+A
G4_BC76_191109_LF_LIB_consensus_vsearch	2285	C	*/-T	395	7	1.73%	2	1	93	93	0.007609461804174083	1	1	144	251	0	7	-T
G4_BC76_191109_LF_LIB_consensus_vsearch	2286	T	T	379	5	1.26%	2	2	93	93	0.030843367333892417	1	1	138	241	1	4	-CT
G4_BC76_191109_LF_LIB_consensus_vsearch	2287	C	*/-T	303	88	22.11%	2	2	93	93	1.2859074656249986E-29	1	1	139	164	4	84	-T
G4_BC76_191109_LF_LIB_consensus_vsearch	2288	T	T	303	5	1.62%	2	2	93	93	0.030743113303893718	1	1	138	165	1	4	C
G4_BC76_191109_LF_LIB_consensus_vsearch	2289	T	*/-G	304	88	21.84%	2	1	93	93	1.3065872640497488E-29	1	1	144	160	0	88	-G
G4_BC76_191109_LF_LIB_consensus_vsearch	2290	G	G	309	4	1.26%	2	1	93	93	0.06190048154092627	1	1	146	163	0	4	T
G4_BC76_191109_LF_LIB_consensus_vsearch	2291	G	G	402	2	0.49%	2	1	93	93	0.2496902106567468	1	1	146	256	2	0	-A
G4_BC76_191109_LF_LIB_consensus_vsearch	2292	A	A	403	1	0.25%	2	1	93	93	0.4999999999999138	1	1	147	256	0	1	+C
G4_BC76_191109_LF_LIB_consensus_vsearch	2293	C	C	403	2	0.49%	2	2	93	93	0.24969097651407932	1	1	147	256	1	1	T
G4_BC76_191109_LF_LIB_consensus_vsearch	2294	G	G	400	4	0.98%	2	2	93	93	0.06203560460879861	1	1	146	254	1	3	+C
G4_BC76_191109_LF_LIB_consensus_vsearch	2295	T	Y	395	7	1.72%	2	2	93	93	0.007609461804174083	1	1	145	250	2	5	C
G4_BC76_191109_LF_LIB_consensus_vsearch	2296	C	C	397	3	0.74%	2	1	93	93	0.12453066332921275	1	1	143	254	3	0	-G
G4_BC76_191109_LF_LIB_consensus_vsearch	2297	G	R	376	22	5.45%	2	1	93	93	1.7692620972051166E-7	1	1	121	255	22	0	A
G4_BC76_191109_LF_LIB_consensus_vsearch	2298	G	G	401	3	0.74%	2	1	93	93	0.1245353159851805	1	1	144	257	3	0	T
G4_BC76_191109_LF_LIB_consensus_vsearch	2299	T	T	398	5	1.23%	2	2	93	93	0.030862526395586183	1	1	145	253	1	4	C
G4_BC76_191109_LF_LIB_consensus_vsearch	2300	A	A	395	4	0.99%	2	2	93	93	0.06202978149183676	1	1	144	251	2	2	G
G4_BC76_191109_LF_LIB_consensus_vsearch	2301	C	C	382	6	1.47%	2	2	93	93	0.015323753822145654	1	1	142	240	2	4	-T
G4_BC76_191109_LF_LIB_consensus_vsearch	2302	T	Y	374	10	2.54%	2	2	93	93	9.203091175437465E-4	1	1	133	241	4	6	C
G4_BC76_191109_LF_LIB_consensus_vsearch	2303	A	R	375	8	2.03%	2	2	93	93	0.003764677830168862	1	1	129	246	7	1	G
G4_BC76_191109_LF_LIB_consensus_vsearch	2304	C	*/+A	370	15	3.78%	2	2	93	93	2.6557536805524368E-5	1	1	138	232	1	14	+A
G4_BC76_191109_LF_LIB_consensus_vsearch	2305	A	A	393	4	1%	2	1	93	93	0.0620274111497499	1	1	139	254	4	0	T
G4_BC76_191109_LF_LIB_consensus_vsearch	2306	A	A	397	6	1.48%	2	2	93	93	0.015334938209013941	1	1	141	256	5	1	G
G4_BC76_191109_LF_LIB_consensus_vsearch	2307	C	*/-GC	376	19	4.69%	2	2	93	93	1.5281331789884465E-6	1	1	120	256	18	1	-GC
G4_BC76_191109_LF_LIB_consensus_vsearch	2308	G	R	371	10	2.6%	2	1	93	93	9.198738399151659E-4	1	1	117	254	10	0	A
G4_BC76_191109_LF_LIB_consensus_vsearch	2309	C	C	377	4	1.04%	2	1	93	93	0.06200755195210619	1	1	128	249	0	4	T
G4_BC76_191109_LF_LIB_consensus_vsearch	2310	A	A	390	4	0.99%	2	2	93	93	0.062023810487337606	1	1	139	251	3	1	G
G4_BC76_191109_LF_LIB_consensus_vsearch	2311	T	Y	393	7	1.73%	2	2	93	93	0.007608451759263046	1	1	147	246	2	5	C
G4_BC76_191109_LF_LIB_consensus_vsearch	2312	G	G	397	5	1.23%	2	2	93	93	0.03086156314569468	1	1	147	250	1	4	A
G4_BC76_191109_LF_LIB_consensus_vsearch	2313	A	A	394	4	0.99%	2	2	93	93	0.06202859930052086	1	1	143	251	3	1	G
G4_BC76_191109_LF_LIB_consensus_vsearch	2314	C	C	395	4	0.99%	2	2	93	93	0.06202978149183676	1	1	143	252	1	3	T
G4_BC76_191109_LF_LIB_consensus_vsearch	2315	C	*/-TC	391	7	1.72%	2	1	93	93	0.007607431615374521	1	1	148	243	0	7	-TC
G4_BC76_191109_LF_LIB_consensus_vsearch	2316	T	T	393	4	1.01%	2	1	93	93	0.0620274111497499	1	1	148	245	0	4	C
G4_BC76_191109_LF_LIB_consensus_vsearch	2317	C	*/-A	382	9	2.26%	2	1	93	93	0.00186430447199865	1	1	137	245	9	0	-A
G4_BC76_191109_LF_LIB_consensus_vsearch	2318	A	A	386	5	1.27%	2	2	93	93	0.030850642423789317	1	1	134	252	3	2	G
G4_BC76_191109_LF_LIB_consensus_vsearch	2319	T	K	387	9	2.24%	2	1	93	93	0.0018654123049784304	1	1	136	251	9	0	G
G4_BC76_191109_LF_LIB_consensus_vsearch	2320	T	*/-G	304	61	15.17%	2	2	93	93	2.8083866635975303E-20	1	1	137	167	5	56	-G
G4_BC76_191109_LF_LIB_consensus_vsearch	2321	G	R	309	7	2.18%	2	2	93	93	0.007554559545842425	1	1	134	175	4	3	A
G4_BC76_191109_LF_LIB_consensus_vsearch	2322	G	R	359	13	3.4%	2	2	93	93	1.0972331368377564E-4	1	1	137	222	10	3	A
G4_BC76_191109_LF_LIB_consensus_vsearch	2323	G	R	363	18	4.52%	2	2	93	93	3.105999102566561E-6	1	1	136	227	1	17	A
G4_BC76_191109_LF_LIB_consensus_vsearch	2324	G	G	390	4	1%	2	2	93	93	0.062023810487337606	1	1	147	243	1	3	-TA
G4_BC76_191109_LF_LIB_consensus_vsearch	2325	T	Y	366	14	3.56%	2	2	93	93	5.403009673105009E-5	1	1	145	221	2	12	C
G4_BC76_191109_LF_LIB_consensus_vsearch	2326	A	*/+G	348	19	4.9%	2	1	93	93	1.5018443455160622E-6	1	1	144	204	0	19	+G
G4_BC76_191109_LF_LIB_consensus_vsearch	2327	G	G	371	4	1.04%	2	2	93	93	0.06199966756219321	1	1	145	226	3	1	A
G4_BC76_191109_LF_LIB_consensus_vsearch	2328	G	G	399	2	0.49%	2	1	93	93	0.24968789013733722	1	1	148	251	0	2	A
G4_BC76_191109_LF_LIB_consensus_vsearch	2329	A	A	401	2	0.49%	2	2	93	93	0.24968944099344345	1	1	146	255	1	1	G
G4_BC76_191109_LF_LIB_consensus_vsearch	2330	C	*/+A	381	12	2.96%	2	1	93	93	2.2419697823514463E-4	1	1	138	243	0	12	+A
G4_BC76_191109_LF_LIB_consensus_vsearch	2331	A	A	398	1	0.25%	2	1	93	93	0.4999999999999138	1	1	141	257	0	1	+GCTCC
G4_BC76_191109_LF_LIB_consensus_vsearch	2332	A	*/+C	368	13	3.23%	2	1	93	93	1.1000469648005649E-4	1	1	119	249	13	0	+C
G4_BC76_191109_LF_LIB_consensus_vsearch	2333	C	C	382	4	1.02%	2	2	93	93	0.06201393491983747	1	1	135	247	1	3	T
G4_BC76_191109_LF_LIB_consensus_vsearch	2334	C	C	398	4	0.99%	2	1	93	93	0.06203329275530562	1	1	147	251	0	4	T
G4_BC76_191109_LF_LIB_consensus_vsearch	2335	C	Y	373	23	5.65%	2	1	93	93	8.580257819947001E-8	1	1	147	226	0	23	T
G4_BC76_191109_LF_LIB_consensus_vsearch	2336	G	G	393	4	0.99%	2	2	93	93	0.0620274111497499	1	1	145	248	2	2	-C
G4_BC76_191109_LF_LIB_consensus_vsearch	2337	C	C	385	3	0.75%	2	2	93	93	0.12451612903217696	1	1	142	243	1	2	+G
G4_BC76_191109_LF_LIB_consensus_vsearch	2338	T	Y	310	71	17.66%	2	2	93	93	1.157336158259582E-23	1	1	139	171	1	70	C
G4_BC76_191109_LF_LIB_consensus_vsearch	2339	A	R	367	12	3.01%	2	2	93	93	2.2348143552523473E-4	1	1	131	236	10	2	G
G4_BC76_191109_LF_LIB_consensus_vsearch	2340	G	G	392	1	0.25%	2	1	93	93	0.4999999999990043	1	1	140	252	0	1	+A
G4_BC76_191109_LF_LIB_consensus_vsearch	2341	A	A	390	6	1.48%	2	2	93	93	0.015329823997787357	1	1	141	249	5	1	G
G4_BC76_191109_LF_LIB_consensus_vsearch	2342	C	C	383	6	1.49%	2	2	93	93	0.015324526212125619	1	1	140	243	4	2	-T
G4_BC76_191109_LF_LIB_consensus_vsearch	2343	T	T	392	2	0.51%	2	2	93	93	0.24968233799211464	1	1	139	253	1	1	C
G4_BC76_191109_LF_LIB_consensus_vsearch	2344	T	*/-A	376	10	2.49%	2	2	93	93	9.205956089622115E-4	1	1	138	238	1	9	-A
G4_BC76_191109_LF_LIB_consensus_vsearch	2345	A	A	388	2	0.51%	2	2	93	93	0.2496790757377846	1	1	145	243	1	1	C
G4_BC76_191109_LF_LIB_consensus_vsearch	2346	A	*/-G	389	8	1.98%	2	1	93	93	0.0037696288519149155	1	1	147	242	0	8	-G
G4_BC76_191109_LF_LIB_consensus_vsearch	2347	G	G	391	5	1.25%	2	2	93	93	0.030855681550508444	1	1	145	246	4	1	A
G4_BC76_191109_LF_LIB_consensus_vsearch	2348	C	C	399	4	0.99%	2	2	93	93	0.06203445155203153	1	1	147	252	2	2	T
G4_BC76_191109_LF_LIB_consensus_vsearch	2349	A	A	402	1	0.25%	2	1	93	93	0.4999999999999138	1	1	148	254	1	0	+CGCA
G4_BC76_191109_LF_LIB_consensus_vsearch	2350	T	T	400	4	0.98%	2	2	93	93	0.06203560460879861	1	1	147	253	1	3	C
G4_BC76_191109_LF_LIB_consensus_vsearch	2351	A	A	396	4	0.98%	2	2	93	93	0.06203095776871511	1	1	143	253	2	2	-T
G4_BC76_191109_LF_LIB_consensus_vsearch	2352	T	T	394	5	1.25%	2	2	93	93	0.030858644444955494	1	1	143	251	2	3	C
G4_BC76_191109_LF_LIB_consensus_vsearch	2353	T	T	400	2	0.49%	2	1	93	93	0.24968866749695368	1	1	146	254	2	0	-A
G4_BC76_191109_LF_LIB_consensus_vsearch	2354	A	A	399	2	0.5%	2	2	93	93	0.24968789013733722	1	1	144	255	1	1	G
G4_BC76_191109_LF_LIB_consensus_vsearch	2355	A	A	397	3	0.74%	2	1	93	93	0.12453066332921275	1	1	147	250	0	3	+C
G4_BC76_191109_LF_LIB_consensus_vsearch	2356	T	T	391	6	1.48%	2	2	93	93	0.01533056561273411	1	1	143	248	2	4	C
G4_BC76_191109_LF_LIB_consensus_vsearch	2357	C	C	387	5	1.24%	2	1	93	93	0.030851660526274274	1	1	141	246	5	0	-AGC
G4_BC76_191109_LF_LIB_consensus_vsearch	2358	A	*/-G	387	9	2.24%	2	1	93	93	0.0018654123049784304	1	1	141	246	0	9	-G
G4_BC76_191109_LF_LIB_consensus_vsearch	2359	G	G	387	1	0.26%	2	1	93	93	0.4999999999999138	1	1	143	244	0	1	+T
G4_BC76_191109_LF_LIB_consensus_vsearch	2360	C	*/+G	373	7	1.75%	2	2	93	93	0.007597769697997662	1	1	141	232	1	6	+G
G4_BC76_191109_LF_LIB_consensus_vsearch	2361	G	G	395	2	0.5%	2	1	93	93	0.24968474148789518	1	1	148	247	0	2	+C
G4_BC76_191109_LF_LIB_consensus_vsearch	2362	G	G	402	2	0.49%	2	1	93	93	0.2496902106567468	1	1	144	258	2	0	-A
G4_BC76_191109_LF_LIB_consensus_vsearch	2363	A	*/-G	379	16	3.97%	2	2	93	93	1.306852581830906E-5	1	1	127	252	14	2	-G
G4_BC76_191109_LF_LIB_consensus_vsearch	2364	G	G	379	5	1.29%	2	1	93	93	0.030843367333892417	1	1	130	249	0	5	+T
G4_BC76_191109_LF_LIB_consensus_vsearch	2365	G	*/-A	335	40	9.88%	2	2	93	93	3.032341121064343E-13	1	1	95	240	29	11	-A
G4_BC76_191109_LF_LIB_consensus_vsearch	2366	A	A	358	1	0.28%	2	1	93	93	0.4999999999999138	1	1	113	245	1	0	+GA
G4_BC76_191109_LF_LIB_consensus_vsearch	2367	A	A	401	1	0.25%	2	1	93	93	0.5000000000008233	1	1	144	257	1	0	G
G4_BC76_191109_LF_LIB_consensus_vsearch	2368	A	A	401	3	0.74%	2	2	93	93	0.1245353159851805	1	1	146	255	1	2	G
G4_BC76_191109_LF_LIB_consensus_vsearch	2369	A	*/-G	385	7	1.72%	2	1	93	93	0.007604309052101333	1	1	134	251	7	0	-G
G4_BC76_191109_LF_LIB_consensus_vsearch	2370	G	*/+A	363	12	3.04%	2	2	93	93	2.232674726173289E-4	1	1	124	239	1	11	+A
G4_BC76_191109_LF_LIB_consensus_vsearch	2371	A	A	384	0	0%	2	0	93	0	1.0	1	0	132	252	0	0	
G4_BC76_191109_LF_LIB_consensus_vsearch	2372	A	A	393	2	0.51%	2	1	93	93	0.24968314321918028	1	1	136	257	2	0	G
G4_BC76_191109_LF_LIB_consensus_vsearch	2373	A	R	372	19	4.73%	2	1	93	93	1.52458730307249E-6	1	1	118	254	19	0	G
G4_BC76_191109_LF_LIB_consensus_vsearch	2374	C	*/-T	385	9	2.24%	2	2	93	93	0.001864972504119446	1	1	130	255	7	2	-T
G4_BC76_191109_LF_LIB_consensus_vsearch	2375	T	Y	358	29	7.34%	2	2	93	93	1.0803274785134407E-9	1	1	136	222	1	28	C
G4_BC76_191109_LF_LIB_consensus_vsearch	2376	A	A	397	3	0.75%	2	2	93	93	0.12453066332921275	1	1	141	256	1	2	G
G4_BC76_191109_LF_LIB_consensus_vsearch	2377	A	*/-C	378	10	2.48%	2	1	93	93	9.208791978192084E-4	1	1	125	253	10	0	-C
G4_BC76_191109_LF_LIB_consensus_vsearch	2378	C	C	385	3	0.77%	2	1	93	93	0.12451612903217696	1	1	132	253	0	3	T
G4_BC76_191109_LF_LIB_consensus_vsearch	2379	C	C	399	3	0.74%	2	1	93	93	0.12453300124551302	1	1	145	254	0	3	T
G4_BC76_191109_LF_LIB_consensus_vsearch	2380	A	*/-G	353	44	10.86%	2	2	93	93	1.6104542507422574E-14	1	1	144	209	1	43	-G
G4_BC76_191109_LF_LIB_consensus_vsearch	2381	G	G	358	5	1.38%	2	1	93	93	0.030819859779619867	1	1	143	215	5	0	A
G4_BC76_191109_LF_LIB_consensus_vsearch	2382	G	G	401	6	1.47%	2	2	93	93	0.01533778183023708	1	1	144	257	5	1	-A
G4_BC76_191109_LF_LIB_consensus_vsearch	2383	A	*/-T	387	7	1.75%	2	1	93	93	0.007605360418658285	1	1	140	247	0	7	-T
G4_BC76_191109_LF_LIB_consensus_vsearch	2384	T	Y	392	7	1.75%	2	1	93	93	0.007607942959128091	1	1	149	243	0	7	C
G4_BC76_191109_LF_LIB_consensus_vsearch	2385	T	*/-C	176	196	48.16%	2	2	93	93	3.382626963326513E-75	1	1	71	105	63	133	-C
G4_BC76_191109_LF_LIB_consensus_vsearch	2386	C	C	189	2	1.05%	2	2	93	93	0.24934383202100482	1	1	75	114	1	1	T
G4_BC76_191109_LF_LIB_consensus_vsearch	2387	C	C	384	1	0.26%	2	1	93	93	0.4999999999999138	1	1	139	245	0	1	+T
G4_BC76_191109_LF_LIB_consensus_vsearch	2388	C	Y	389	8	2.01%	2	1	93	93	0.0037696288519149155	1	1	148	241	0	8	T
G4_BC76_191109_LF_LIB_consensus_vsearch	2389	C	*/-T	390	12	2.96%	2	1	93	93	2.2463138050531574E-4	1	1	148	242	0	12	-T
G4_BC76_191109_LF_LIB_consensus_vsearch	2390	T	T	385	4	1.01%	2	1	93	93	0.06201768588877767	1	1	147	238	0	4	C
G4_BC76_191109_LF_LIB_consensus_vsearch	2391	A	*/-G	391	9	2.22%	2	1	93	93	0.0018662788735768444	1	1	146	245	0	9	-G
G4_BC76_191109_LF_LIB_consensus_vsearch	2392	G	G	389	2	0.51%	2	1	93	93	0.24967989756723366	1	1	144	245	0	2	-T
G4_BC76_191109_LF_LIB_consensus_vsearch	2393	T	T	393	5	1.25%	2	2	93	93	0.03085766177318207	1	1	144	249	1	4	C
G4_BC76_191109_LF_LIB_consensus_vsearch	2394	A	A	396	3	0.75%	2	1	93	93	0.12452948557099502	1	1	142	254	3	0	G
G4_BC76_191109_LF_LIB_consensus_vsearch	2395	A	A	393	6	1.48%	2	2	93	93	0.015332037719180692	1	1	146	247	3	3	G
G4_BC76_191109_LF_LIB_consensus_vsearch	2396	C	C	392	5	1.23%	2	1	93	93	0.030856674154206513	1	1	143	249	5	0	+TT
G4_BC76_191109_LF_LIB_consensus_vsearch	2397	T	Y	384	17	4.2%	2	1	93	93	6.4164031706101775E-6	1	1	149	235	0	17	C
G4_BC76_191109_LF_LIB_consensus_vsearch	2398	G	G	400	3	0.74%	2	1	93	93	0.12453416149047736	1	1	147	253	0	3	-CG
G4_BC76_191109_LF_LIB_consensus_vsearch	2399	C	*/-G	359	17	4.23%	2	1	93	93	6.341306688682443E-6	1	1	116	243	17	0	-G
G4_BC76_191109_LF_LIB_consensus_vsearch	2400	G	G	372	4	1.04%	2	1	93	93	0.06200099911305842	1	1	124	248	0	4	+TG
G4_BC76_191109_LF_LIB_consensus_vsearch	2401	A	A	395	4	1%	2	2	93	93	0.06202978149183676	1	1	142	253	2	2	G
G4_BC76_191109_LF_LIB_consensus_vsearch	2402	G	*/-T	375	16	3.95%	2	2	93	93	1.3047405506016577E-5	1	1	146	229	1	15	-T
G4_BC76_191109_LF_LIB_consensus_vsearch	2403	T	Y	365	10	2.61%	2	2	93	93	9.189827643807342E-4	1	1	143	222	1	9	C
G4_BC76_191109_LF_LIB_consensus_vsearch	2404	G	G	394	2	0.5%	2	1	93	93	0.24968394437400754	1	1	147	247	0	2	A
G4_BC76_191109_LF_LIB_consensus_vsearch	2405	A	A	395	6	1.48%	2	2	93	93	0.015333495178783761	1	1	142	253	4	2	G
G4_BC76_191109_LF_LIB_consensus_vsearch	2406	A	R	396	8	1.97%	2	2	93	93	0.0037719767465882576	1	1	143	253	3	5	G
G4_BC76_191109_LF_LIB_consensus_vsearch	2407	G	*/-CG	355	30	7.39%	2	1	93	93	5.175000443872132E-10	1	1	141	214	0	30	-CG
G4_BC76_191109_LF_LIB_consensus_vsearch	2408	C	*/-G	275	63	17.45%	2	2	93	93	4.468771809521167E-21	1	1	140	135	4	59	-G
G4_BC76_191109_LF_LIB_consensus_vsearch	2409	G	R	264	21	7.12%	2	2	93	93	3.253563722721416E-7	1	1	125	139	19	2	A
G4_BC76_191109_LF_LIB_consensus_vsearch	2410	G	K	376	9	2.32%	2	1	93	93	0.00186293757088788	1	1	148	228	0	9	T
G4_BC76_191109_LF_LIB_consensus_vsearch	2411	G	G	395	4	0.99%	2	1	93	93	0.06202978149183676	1	1	147	248	0	4	A
G4_BC76_191109_LF_LIB_consensus_vsearch	2412	A	A	390	5	1.24%	2	2	93	93	0.030854683924238017	1	1	140	250	4	1	-C
G4_BC76_191109_LF_LIB_consensus_vsearch	2413	C	Y	391	7	1.75%	2	2	93	93	0.007607431615374521	1	1	140	251	2	5	T
G4_BC76_191109_LF_LIB_consensus_vsearch	2414	C	*/-G	369	19	4.68%	2	2	93	93	1.5218842748442643E-6	1	1	141	228	3	16	-G
G4_BC76_191109_LF_LIB_consensus_vsearch	2415	G	G	379	5	1.29%	2	2	93	93	0.030843367333892417	1	1	143	236	3	2	A
G4_BC76_191109_LF_LIB_consensus_vsearch	2416	G	G	386	6	1.47%	2	1	93	93	0.015326819799317902	1	1	144	242	0	6	-C
G4_BC76_191109_LF_LIB_consensus_vsearch	2417	C	*/-T	385	8	2%	2	2	93	93	0.0037682499633968467	1	1	143	242	3	5	-T
G4_BC76_191109_LF_LIB_consensus_vsearch	2418	T	*/+C	374	13	3.27%	2	2	93	93	1.1018527269038747E-4	1	1	131	243	11	2	+C
G4_BC76_191109_LF_LIB_consensus_vsearch	2419	C	*/-A	380	8	2%	2	1	93	93	0.003766486715388715	1	1	145	235	0	8	-A
G4_BC76_191109_LF_LIB_consensus_vsearch	2420	A	R	385	7	1.77%	2	2	93	93	0.007604309052101333	1	1	148	237	1	6	G
G4_BC76_191109_LF_LIB_consensus_vsearch	2421	A	A	391	6	1.49%	2	2	93	93	0.01533056561273411	1	1	148	243	1	5	G
G4_BC76_191109_LF_LIB_consensus_vsearch	2422	T	Y	380	14	3.49%	2	2	93	93	5.426877300342222E-5	1	1	145	235	2	12	C
G4_BC76_191109_LF_LIB_consensus_vsearch	2423	G	G	392	4	0.99%	2	2	93	93	0.06202621699451153	1	1	142	250	2	2	-TGTG
G4_BC76_191109_LF_LIB_consensus_vsearch	2424	T	T	377	6	1.52%	2	2	93	93	0.01531983153360656	1	1	142	235	1	5	C
G4_BC76_191109_LF_LIB_consensus_vsearch	2425	G	*/-TG	342	47	11.87%	2	2	93	93	1.6194352398455574E-15	1	1	116	226	24	23	-TG
G4_BC76_191109_LF_LIB_consensus_vsearch	2426	T	T	335	4	1.15%	2	1	93	93	0.06194649597906977	1	1	113	222	0	4	-G
G4_BC76_191109_LF_LIB_consensus_vsearch	2427	G	*/-A	334	8	2.29%	2	2	93	93	0.003747869361231707	1	1	113	221	7	1	-A
G4_BC76_191109_LF_LIB_consensus_vsearch	2428	A	A	395	2	0.5%	2	1	93	93	0.24968474148789518	1	1	139	256	2	0	+G
G4_BC76_191109_LF_LIB_consensus_vsearch	2429	A	*/+T	391	8	1.98%	2	1	93	93	0.003770308015149166	1	1	142	249	0	8	+T
G4_BC76_191109_LF_LIB_consensus_vsearch	2430	T	T	396	4	0.99%	2	2	93	93	0.06203095776871511	1	1	142	254	3	1	+C
G4_BC76_191109_LF_LIB_consensus_vsearch	2431	C	*/-T	390	14	3.45%	2	2	93	93	5.442954570018379E-5	1	1	142	248	5	9	-T
G4_BC76_191109_LF_LIB_consensus_vsearch	2432	T	T	388	2	0.51%	2	1	93	93	0.2496790757377846	1	1	142	246	0	2	+G
G4_BC76_191109_LF_LIB_consensus_vsearch	2433	G	G	403	1	0.25%	2	1	93	93	0.4999999999999138	1	1	147	256	1	0	+CTG
G4_BC76_191109_LF_LIB_consensus_vsearch	2434	A	A	392	6	1.48%	2	2	93	93	0.015331303510572384	1	1	144	248	4	2	G
G4_BC76_191109_LF_LIB_consensus_vsearch	2435	C	*/-T	372	11	2.72%	2	2	93	93	4.539966388795655E-4	1	1	135	237	3	8	-T
G4_BC76_191109_LF_LIB_consensus_vsearch	2436	T	T	372	6	1.57%	2	2	93	93	0.015315805762237024	1	1	132	240	3	3	C
G4_BC76_191109_LF_LIB_consensus_vsearch	2437	T	*/-G	301	62	15.66%	2	2	93	93	1.2545203164742292E-20	1	1	116	185	6	56	-G
G4_BC76_191109_LF_LIB_consensus_vsearch	2438	G	R	293	32	9.67%	2	2	93	93	1.04378605910745E-10	1	1	108	185	31	1	A
G4_BC76_191109_LF_LIB_consensus_vsearch	2439	G	R	381	9	2.27%	2	2	93	93	0.0018640795393290628	1	1	140	241	7	2	A
G4_BC76_191109_LF_LIB_consensus_vsearch	2440	G	R	377	14	3.5%	2	2	93	93	5.421900571236966E-5	1	1	134	243	7	7	A
G4_BC76_191109_LF_LIB_consensus_vsearch	2441	G	G	391	6	1.48%	2	2	93	93	0.01533056561273411	1	1	146	245	2	4	-T
G4_BC76_191109_LF_LIB_consensus_vsearch	2442	T	*/+A	351	30	7.5%	2	2	93	93	5.141878840814134E-10	1	1	141	210	2	28	+A
G4_BC76_191109_LF_LIB_consensus_vsearch	2443	A	A	394	2	0.5%	2	2	93	93	0.24968394437400754	1	1	140	254	1	1	C
G4_BC76_191109_LF_LIB_consensus_vsearch	2444	A	A	404	3	0.74%	2	2	93	93	0.12453874538748007	1	1	148	256	1	2	G
G4_BC76_191109_LF_LIB_consensus_vsearch	2445	A	*/-C	383	9	2.21%	2	2	93	93	0.001864528271344425	1	1	129	254	6	3	-C
G4_BC76_191109_LF_LIB_consensus_vsearch	2446	C	*/+T	361	28	7.05%	2	1	93	93	2.2509853423028136E-9	1	1	136	225	0	28	+T
G4_BC76_191109_LF_LIB_consensus_vsearch	2447	C	C	401	2	0.49%	2	1	93	93	0.24968944099344345	1	1	146	255	0	2	+T
G4_BC76_191109_LF_LIB_consensus_vsearch	2448	C	Y	377	16	3.93%	2	2	93	93	1.3058016225586293E-5	1	1	147	230	1	15	T
G4_BC76_191109_LF_LIB_consensus_vsearch	2449	G	G	395	3	0.75%	2	1	93	93	0.12452830188671389	1	1	148	247	0	3	A
G4_BC76_191109_LF_LIB_consensus_vsearch	2450	T	T	391	5	1.23%	2	1	93	93	0.030855681550508444	1	1	148	243	0	5	A
G4_BC76_191109_LF_LIB_consensus_vsearch	2451	G	R	395	7	1.74%	2	2	93	93	0.007609461804174083	1	1	146	249	3	4	A
G4_BC76_191109_LF_LIB_consensus_vsearch	2452	T	*/-C	364	31	7.69%	2	1	93	93	2.524086161173689E-10	1	1	117	247	31	0	-C
G4_BC76_191109_LF_LIB_consensus_vsearch	2453	C	C	373	1	0.27%	2	1	93	93	0.5000000000003686	1	1	116	257	1	0	+G
G4_BC76_191109_LF_LIB_consensus_vsearch	2454	C	*/+G	360	29	7.14%	2	2	93	93	1.08347427809576E-9	1	1	136	224	1	28	+G
G4_BC76_191109_LF_LIB_consensus_vsearch	2455	G	*/+A	384	9	2.26%	2	2	93	93	0.0018647509458963453	1	1	131	253	7	2	+A
G4_BC76_191109_LF_LIB_consensus_vsearch	2456	A	A	394	5	1.24%	2	2	93	93	0.030858644444955494	1	1	139	255	4	1	G
G4_BC76_191109_LF_LIB_consensus_vsearch	2457	G	G	395	3	0.74%	2	1	93	93	0.12452830188671389	1	1	143	252	3	0	+A
G4_BC76_191109_LF_LIB_consensus_vsearch	2458	T	T	395	4	1%	2	1	93	93	0.06202978149183676	1	1	147	248	0	4	C
G4_BC76_191109_LF_LIB_consensus_vsearch	2459	T	T	392	6	1.48%	2	1	93	93	0.015331303510572384	1	1	141	251	6	0	+A
G4_BC76_191109_LF_LIB_consensus_vsearch	2460	G	K	387	7	1.73%	2	1	93	93	0.007605360418658285	1	1	141	246	7	0	T
G4_BC76_191109_LF_LIB_consensus_vsearch	2461	T	Y	381	10	2.5%	2	2	93	93	9.212992345460898E-4	1	1	141	240	3	7	C
G4_BC76_191109_LF_LIB_consensus_vsearch	2462	G	R	386	7	1.75%	2	2	93	93	0.0076048360660226225	1	1	137	249	4	3	A
G4_BC76_191109_LF_LIB_consensus_vsearch	2463	C	*/+A	385	11	2.74%	2	1	93	93	4.550976487942495E-4	1	1	143	242	0	11	+A
G4_BC76_191109_LF_LIB_consensus_vsearch	2464	A	A	395	5	1.23%	2	1	93	93	0.030859622206549208	1	1	145	250	0	5	+T
G4_BC76_191109_LF_LIB_consensus_vsearch	2465	C	Y	380	17	4.18%	2	2	93	93	6.404980089016243E-6	1	1	145	235	1	16	T
G4_BC76_191109_LF_LIB_consensus_vsearch	2466	T	Y	384	11	2.72%	2	2	93	93	4.5501547153779163E-4	1	1	146	238	1	10	C
G4_BC76_191109_LF_LIB_consensus_vsearch	2467	A	A	393	5	1.24%	2	2	93	93	0.03085766177318207	1	1	147	246	1	4	G
G4_BC76_191109_LF_LIB_consensus_vsearch	2468	T	T	394	6	1.49%	2	2	93	93	0.015332768266138878	1	1	147	247	1	5	C
G4_BC76_191109_LF_LIB_consensus_vsearch	2469	G	G	401	2	0.49%	2	1	93	93	0.24968944099344345	1	1	148	253	0	2	+T
G4_BC76_191109_LF_LIB_consensus_vsearch	2470	G	G	403	3	0.74%	2	2	93	93	0.12453760789147728	1	1	146	257	1	2	A
G4_BC76_191109_LF_LIB_consensus_vsearch	2471	A	A	402	1	0.25%	2	1	93	93	0.4999999999999138	1	1	145	257	0	1	+C
G4_BC76_191109_LF_LIB_consensus_vsearch	2472	C	C	398	4	0.99%	2	2	93	93	0.06203329275530562	1	1	141	257	2	2	T
G4_BC76_191109_LF_LIB_consensus_vsearch	2473	G	*/-T	383	9	2.23%	2	2	93	93	0.001864528271344425	1	1	130	253	8	1	-T
G4_BC76_191109_LF_LIB_consensus_vsearch	2474	T	T	385	4	1.01%	2	2	93	93	0.06201768588877767	1	1	134	251	1	3	C
G4_BC76_191109_LF_LIB_consensus_vsearch	2475	T	*/+C	390	7	1.72%	2	1	93	93	0.007606917708857565	1	1	145	245	0	7	+C
G4_BC76_191109_LF_LIB_consensus_vsearch	2476	T	*/-C	382	13	3.19%	2	2	93	93	1.1041780449831012E-4	1	1	143	239	1	12	-C
G4_BC76_191109_LF_LIB_consensus_vsearch	2477	C	*/+T	361	15	3.81%	2	1	93	93	2.646758748659218E-5	1	1	147	214	0	15	+T
G4_BC76_191109_LF_LIB_consensus_vsearch	2478	G	G	387	5	1.23%	2	1	93	93	0.030851660526274274	1	1	146	241	0	5	+T
G4_BC76_191109_LF_LIB_consensus_vsearch	2479	T	T	397	4	0.99%	2	1	93	93	0.062032128175275904	1	1	149	248	0	4	C
G4_BC76_191109_LF_LIB_consensus_vsearch	2480	C	*/-T	394	8	1.98%	2	2	93	93	0.0037713141940397903	1	1	148	246	1	7	-T
G4_BC76_191109_LF_LIB_consensus_vsearch	2481	T	T	382	5	1.26%	2	1	93	93	0.030846517434254234	1	1	147	235	0	5	+G
G4_BC76_191109_LF_LIB_consensus_vsearch	2482	G	G	394	5	1.23%	2	1	93	93	0.030858644444955494	1	1	147	247	0	5	-C
G4_BC76_191109_LF_LIB_consensus_vsearch	2483	C	Y	383	7	1.75%	2	1	93	93	0.007603246958909687	1	1	144	239	0	7	T
G4_BC76_191109_LF_LIB_consensus_vsearch	2484	G	G	394	3	0.75%	2	2	93	93	0.1245271122321419	1	1	144	250	1	2	-T
G4_BC76_191109_LF_LIB_consensus_vsearch	2485	T	Y	372	14	3.5%	2	2	93	93	5.413441518516823E-5	1	1	142	230	1	13	C
G4_BC76_191109_LF_LIB_consensus_vsearch	2486	A	R	386	7	1.73%	2	2	93	93	0.0076048360660226225	1	1	141	245	1	6	G
G4_BC76_191109_LF_LIB_consensus_vsearch	2487	T	Y	375	16	3.98%	2	2	93	93	1.3047405506016577E-5	1	1	140	235	4	12	C
G4_BC76_191109_LF_LIB_consensus_vsearch	2488	G	G	389	4	1%	2	2	93	93	0.06202259804292181	1	1	143	246	1	3	A
G4_BC76_191109_LF_LIB_consensus_vsearch	2489	T	Y	386	8	2%	2	2	93	93	0.003768597288121233	1	1	144	242	4	4	C
G4_BC76_191109_LF_LIB_consensus_vsearch	2490	A	A	400	4	0.99%	2	2	93	93	0.06203560460879861	1	1	146	254	1	3	G
G4_BC76_191109_LF_LIB_consensus_vsearch	2491	A	A	399	4	0.99%	2	2	93	93	0.06203445155203153	1	1	146	253	2	2	G
G4_BC76_191109_LF_LIB_consensus_vsearch	2492	C	C	401	3	0.74%	2	1	93	93	0.1245353159851805	1	1	149	252	0	3	T
G4_BC76_191109_LF_LIB_consensus_vsearch	2493	G	G	400	3	0.74%	2	1	93	93	0.12453416149047736	1	1	145	255	3	0	A
G4_BC76_191109_LF_LIB_consensus_vsearch	2494	G	G	402	3	0.74%	2	1	93	93	0.1245364647713705	1	1	146	256	3	0	-CGG
G4_BC76_191109_LF_LIB_consensus_vsearch	2495	C	C	392	3	0.74%	2	1	93	93	0.12452471482865957	1	1	145	247	0	3	+G
G4_BC76_191109_LF_LIB_consensus_vsearch	2496	G	R	386	12	3%	2	1	93	93	2.244406705806723E-4	1	1	133	253	12	0	A
G4_BC76_191109_LF_LIB_consensus_vsearch	2497	G	G	396	4	0.99%	2	1	93	93	0.06203095776871511	1	1	145	251	0	4	-TGG
G4_BC76_191109_LF_LIB_consensus_vsearch	2498	T	*/-G	366	16	3.99%	2	2	93	93	1.2998365918939041E-5	1	1	135	231	9	7	-G
G4_BC76_191109_LF_LIB_consensus_vsearch	2499	G	G	372	4	1.06%	2	1	93	93	0.06200099911305842	1	1	139	233	0	4	A
G4_BC76_191109_LF_LIB_consensus_vsearch	2500	G	*/-A	372	11	2.79%	2	2	93	93	4.539966388795655E-4	1	1	139	233	6	5	-A
G4_BC76_191109_LF_LIB_consensus_vsearch	2501	A	A	377	4	1.04%	2	2	93	93	0.06200755195210619	1	1	138	239	2	2	G
G4_BC76_191109_LF_LIB_consensus_vsearch	2502	A	*/-G	384	11	2.73%	2	2	93	93	4.5501547153779163E-4	1	1	141	243	7	4	-G
G4_BC76_191109_LF_LIB_consensus_vsearch	2503	G	G	385	2	0.51%	2	1	93	93	0.24967658473511495	1	1	139	246	0	2	-T
G4_BC76_191109_LF_LIB_consensus_vsearch	2504	T	*/-C	386	8	1.98%	2	1	93	93	0.003768597288121233	1	1	137	249	8	0	-C
G4_BC76_191109_LF_LIB_consensus_vsearch	2505	C	C	394	2	0.5%	2	1	93	93	0.24968394437400754	1	1	138	256	2	0	A
G4_BC76_191109_LF_LIB_consensus_vsearch	2506	C	C	399	3	0.74%	2	1	93	93	0.12453300124551302	1	1	148	251	0	3	+T
G4_BC76_191109_LF_LIB_consensus_vsearch	2507	G	G	390	6	1.47%	2	2	93	93	0.015329823997787357	1	1	143	247	1	5	-T
G4_BC76_191109_LF_LIB_consensus_vsearch	2508	T	Y	387	11	2.75%	2	2	93	93	4.5526079174589983E-4	1	1	146	241	1	10	C
G4_BC76_191109_LF_LIB_consensus_vsearch	2509	T	Y	383	10	2.46%	2	2	93	93	9.215757570452482E-4	1	1	143	240	2	8	C
G4_BC76_191109_LF_LIB_consensus_vsearch	2510	G	*/-A	380	12	2.97%	2	2	93	93	2.2414751491838127E-4	1	1	141	239	5	7	-A
G4_BC76_191109_LF_LIB_consensus_vsearch	2511	A	R	381	7	1.79%	2	2	93	93	0.007602173974125566	1	1	138	243	2	5	G
G4_BC76_191109_LF_LIB_consensus_vsearch	2512	A	A	394	6	1.49%	2	2	93	93	0.015332768266138878	1	1	143	251	3	3	T
G4_BC76_191109_LF_LIB_consensus_vsearch	2513	A	R	389	8	1.97%	2	2	93	93	0.0037696288519149155	1	1	138	251	6	2	G
G4_BC76_191109_LF_LIB_consensus_vsearch	2514	C	C	392	4	0.99%	2	2	93	93	0.06202621699451153	1	1	140	252	2	2	+G
G4_BC76_191109_LF_LIB_consensus_vsearch	2515	A	A	396	4	1%	2	1	93	93	0.06203095776871511	1	1	141	255	4	0	G
G4_BC76_191109_LF_LIB_consensus_vsearch	2516	C	C	391	4	0.99%	2	2	93	93	0.06202501678889606	1	1	140	251	2	2	-G
G4_BC76_191109_LF_LIB_consensus_vsearch	2517	G	R	392	8	1.99%	2	2	93	93	0.0037706450711110975	1	1	139	253	6	2	A
G4_BC76_191109_LF_LIB_consensus_vsearch	2518	G	G	398	3	0.74%	2	1	93	93	0.12453183520605009	1	1	143	255	3	0	A
G4_BC76_191109_LF_LIB_consensus_vsearch	2519	C	C	392	4	0.99%	2	1	93	93	0.06202621699451153	1	1	142	250	0	4	T
G4_BC76_191109_LF_LIB_consensus_vsearch	2520	A	*/+C	386	8	1.97%	2	1	93	93	0.003768597288121233	1	1	147	239	0	8	+C
G4_BC76_191109_LF_LIB_consensus_vsearch	2521	C	C	396	1	0.25%	2	1	93	93	0.4999999999999138	1	1	148	248	0	1	+T
G4_BC76_191109_LF_LIB_consensus_vsearch	2522	C	*/-TC	377	20	4.9%	2	1	93	93	7.461874627489505E-7	1	1	149	228	0	20	-TC
G4_BC76_191109_LF_LIB_consensus_vsearch	2523	T	T	375	6	1.56%	2	2	93	93	0.015318233870525945	1	1	145	230	2	4	C
G4_BC76_191109_LF_LIB_consensus_vsearch	2524	C	C	378	2	0.52%	2	1	93	93	0.24967061923567593	1	1	145	233	0	2	+T
G4_BC76_191109_LF_LIB_consensus_vsearch	2525	A	A	393	4	0.99%	2	2	93	93	0.0620274111497499	1	1	143	250	2	2	G
G4_BC76_191109_LF_LIB_consensus_vsearch	2526	G	*/-AG	391	9	2.22%	2	2	93	93	0.0018662788735768444	1	1	136	255	8	1	-AG
G4_BC76_191109_LF_LIB_consensus_vsearch	2527	A	*/-G	329	64	16.2%	2	2	93	93	3.316646228229835E-21	1	1	92	237	46	18	-G
G4_BC76_191109_LF_LIB_consensus_vsearch	2528	G	G	323	4	1.21%	2	1	93	93	0.06192616848150559	1	1	91	232	0	4	+T
G4_BC76_191109_LF_LIB_consensus_vsearch	2529	G	G	401	2	0.49%	2	1	93	93	0.24968944099344345	1	1	145	256	2	0	A
G4_BC76_191109_LF_LIB_consensus_vsearch	2530	G	G	400	4	0.98%	2	2	93	93	0.06203560460879861	1	1	146	254	1	3	-T
G4_BC76_191109_LF_LIB_consensus_vsearch	2531	T	T	396	4	0.99%	2	2	93	93	0.06203095776871511	1	1	144	252	1	3	C
G4_BC76_191109_LF_LIB_consensus_vsearch	2532	C	C	395	4	0.99%	2	1	93	93	0.06202978149183676	1	1	141	254	4	0	-A
G4_BC76_191109_LF_LIB_consensus_vsearch	2533	A	W	353	26	6.44%	2	2	93	93	9.560726489103875E-9	1	1	114	239	23	3	T
G4_BC76_191109_LF_LIB_consensus_vsearch	2534	C	S	366	25	6.19%	2	2	93	93	2.0054986841706538E-8	1	1	119	247	23	2	G
G4_BC76_191109_LF_LIB_consensus_vsearch	2535	A	*/-G	375	22	5.42%	2	2	93	93	1.7678958990507014E-7	1	1	123	252	21	1	-G
G4_BC76_191109_LF_LIB_consensus_vsearch	2536	G	G	382	1	0.26%	2	1	93	93	0.5000000000003686	1	1	127	255	1	0	+A
G4_BC76_191109_LF_LIB_consensus_vsearch	2537	T	*/-C	387	15	3.68%	2	2	93	93	2.6716994663227938E-5	1	1	132	255	14	1	-C
G4_BC76_191109_LF_LIB_consensus_vsearch	2538	C	C	391	1	0.25%	2	1	93	93	0.4999999999999138	1	1	134	257	1	0	+T
G4_BC76_191109_LF_LIB_consensus_vsearch	2539	C	C	395	6	1.47%	2	2	93	93	0.015333495178783761	1	1	144	251	3	3	-T
G4_BC76_191109_LF_LIB_consensus_vsearch	2540	T	Y	366	24	6.03%	2	2	93	93	4.1381624104060524E-8	1	1	140	226	2	22	C
G4_BC76_191109_LF_LIB_consensus_vsearch	2541	G	G	387	3	0.75%	2	1	93	93	0.12451861360729544	1	1	136	251	3	0	+C
G4_BC76_191109_LF_LIB_consensus_vsearch	2542	T	Y	381	12	2.99%	2	2	93	93	2.2419697823514463E-4	1	1	138	243	5	7	C
G4_BC76_191109_LF_LIB_consensus_vsearch	2543	A	A	394	2	0.5%	2	1	93	93	0.24968394437400754	1	1	138	256	2	0	-C
G4_BC76_191109_LF_LIB_consensus_vsearch	2544	C	M	388	9	2.22%	2	1	93	93	0.0018656305641170923	1	1	145	243	0	9	A
G4_BC76_191109_LF_LIB_consensus_vsearch	2545	C	C	396	4	0.98%	2	2	93	93	0.06203095776871511	1	1	143	253	3	1	-ACC
G4_BC76_191109_LF_LIB_consensus_vsearch	2546	A	A	382	5	1.25%	2	2	93	93	0.030846517434254234	1	1	138	244	3	2	G
G4_BC76_191109_LF_LIB_consensus_vsearch	2547	C	C	385	6	1.5%	2	1	93	93	0.01532605917062568	1	1	142	243	0	6	+T
G4_BC76_191109_LF_LIB_consensus_vsearch	2548	C	*/-T	393	8	1.99%	2	2	93	93	0.003770980459969231	1	1	142	251	3	5	-T
G4_BC76_191109_LF_LIB_consensus_vsearch	2549	T	Y	306	82	20.55%	2	2	93	93	1.7140140028614285E-27	1	1	143	163	1	81	C
G4_BC76_191109_LF_LIB_consensus_vsearch	2550	G	G	393	5	1.23%	2	1	93	93	0.03085766177318207	1	1	137	256	5	0	-CCTG
G4_BC76_191109_LF_LIB_consensus_vsearch	2551	C	C	394	3	0.75%	2	1	93	93	0.1245271122321419	1	1	137	257	3	0	+A
G4_BC76_191109_LF_LIB_consensus_vsearch	2552	C	C	400	1	0.25%	2	1	93	93	0.4999999999999138	1	1	142	258	0	1	-T
G4_BC76_191109_LF_LIB_consensus_vsearch	2553	T	Y	341	53	13.25%	2	2	93	93	1.7023291083358726E-17	1	1	138	203	2	51	C
G4_BC76_191109_LF_LIB_consensus_vsearch	2554	G	G	395	2	0.5%	2	2	93	93	0.24968474148789518	1	1	137	258	1	1	A
G4_BC76_191109_LF_LIB_consensus_vsearch	2555	C	C	394	5	1.24%	2	2	93	93	0.030858644444955494	1	1	140	254	4	1	-A
G4_BC76_191109_LF_LIB_consensus_vsearch	2556	A	A	393	4	1%	2	1	93	93	0.0620274111497499	1	1	141	252	0	4	+C
G4_BC76_191109_LF_LIB_consensus_vsearch	2557	C	*/-T	390	8	1.98%	2	1	93	93	0.0037699692796093966	1	1	146	244	0	8	-T
G4_BC76_191109_LF_LIB_consensus_vsearch	2558	T	*/-C	381	10	2.51%	2	1	93	93	9.212992345460898E-4	1	1	146	235	0	10	-C
G4_BC76_191109_LF_LIB_consensus_vsearch	2559	C	C	385	5	1.26%	2	2	93	93	0.030849619103815673	1	1	146	239	1	4	+TC
G4_BC76_191109_LF_LIB_consensus_vsearch	2560	G	G	399	3	0.74%	2	2	93	93	0.12453300124551302	1	1	147	252	2	1	T
G4_BC76_191109_LF_LIB_consensus_vsearch	2561	C	Y	389	7	1.72%	2	1	93	93	0.0076064012202881484	1	1	143	246	0	7	T
G4_BC76_191109_LF_LIB_consensus_vsearch	2562	G	*/-C	387	7	1.76%	2	2	93	93	0.007605360418658285	1	1	140	247	3	4	-C
G4_BC76_191109_LF_LIB_consensus_vsearch	2563	C	C	381	5	1.27%	2	1	93	93	0.03084547283766662	1	1	139	242	0	5	T
G4_BC76_191109_LF_LIB_consensus_vsearch	2564	C	*/-A	261	132	32.51%	2	2	93	93	3.0742730749391745E-46	1	1	146	115	2	130	-A
G4_BC76_191109_LF_LIB_consensus_vsearch	2565	A	*/+C	241	13	4.74%	2	1	93	93	1.0428879711659624E-4	1	1	145	96	0	13	+C
G4_BC76_191109_LF_LIB_consensus_vsearch	2566	A	M	382	10	2.46%	2	2	93	93	9.214378424824657E-4	1	1	143	239	2	8	C
G4_BC76_191109_LF_LIB_consensus_vsearch	2567	T	Y	247	101	25%	2	2	93	93	7.858770162252241E-35	1	1	144	103	3	98	C
G4_BC76_191109_LF_LIB_consensus_vsearch	2568	G	G	397	3	0.74%	2	1	93	93	0.12453066332921275	1	1	147	250	0	3	T
G4_BC76_191109_LF_LIB_consensus_vsearch	2569	A	A	393	4	0.99%	2	2	93	93	0.0620274111497499	1	1	144	249	1	3	G
G4_BC76_191109_LF_LIB_consensus_vsearch	2570	C	C	383	5	1.24%	2	2	93	93	0.030847556649813805	1	1	142	241	4	1	T
G4_BC76_191109_LF_LIB_consensus_vsearch	2571	A	A	388	5	1.25%	2	2	93	93	0.030852673450990298	1	1	144	244	2	3	G
G4_BC76_191109_LF_LIB_consensus_vsearch	2572	A	A	386	6	1.49%	2	2	93	93	0.015326819799317902	1	1	143	243	4	2	G
G4_BC76_191109_LF_LIB_consensus_vsearch	2573	G	*/-C	388	9	2.23%	2	1	93	93	0.0018656305641170923	1	1	146	242	0	9	-C
G4_BC76_191109_LF_LIB_consensus_vsearch	2574	C	C	394	1	0.25%	2	1	93	93	0.4999999999999138	1	1	149	245	0	1	+G
G4_BC76_191109_LF_LIB_consensus_vsearch	2575	G	G	402	4	0.99%	2	1	93	93	0.06203789367157223	1	1	149	253	0	4	+C
G4_BC76_191109_LF_LIB_consensus_vsearch	2576	C	*/-T	318	48	11.79%	2	1	93	93	6.828155108600473E-16	1	1	147	171	0	48	-T
G4_BC76_191109_LF_LIB_consensus_vsearch	2577	T	T	307	5	1.55%	2	2	93	93	0.030749606470160035	1	1	145	162	1	4	-CCT
G4_BC76_191109_LF_LIB_consensus_vsearch	2578	C	C	359	2	0.55%	2	1	93	93	0.24965325936195193	1	1	144	215	2	0	+AC
G4_BC76_191109_LF_LIB_consensus_vsearch	2579	C	*/-TC	379	17	4.23%	2	1	93	93	6.402090713768902E-6	1	1	147	232	0	17	-TC
G4_BC76_191109_LF_LIB_consensus_vsearch	2580	T	T	375	3	0.78%	2	1	93	93	0.1245033112582789	1	1	142	233	3	0	+C
G4_BC76_191109_LF_LIB_consensus_vsearch	2581	C	*/+G	372	7	1.79%	2	2	93	93	0.007597206160798333	1	1	136	236	3	4	+G
G4_BC76_191109_LF_LIB_consensus_vsearch	2582	G	G	391	5	1.23%	2	1	93	93	0.030855681550508444	1	1	134	257	5	0	+A
G4_BC76_191109_LF_LIB_consensus_vsearch	2583	A	A	390	6	1.49%	2	1	93	93	0.015329823997787357	1	1	138	252	6	0	+G
G4_BC76_191109_LF_LIB_consensus_vsearch	2584	G	G	400	1	0.25%	2	1	93	93	0.4999999999999138	1	1	147	253	0	1	+A
G4_BC76_191109_LF_LIB_consensus_vsearch	2585	T	T	396	4	0.99%	2	2	93	93	0.06203095776871511	1	1	142	254	3	1	-C
G4_BC76_191109_LF_LIB_consensus_vsearch	2586	C	C	399	2	0.5%	2	1	93	93	0.24968789013733722	1	1	144	255	0	2	+A
G4_BC76_191109_LF_LIB_consensus_vsearch	2587	G	G	402	2	0.49%	2	2	93	93	0.2496902106567468	1	1	146	256	1	1	A
G4_BC76_191109_LF_LIB_consensus_vsearch	2588	C	C	399	2	0.49%	2	2	93	93	0.24968789013733722	1	1	145	254	1	1	T
G4_BC76_191109_LF_LIB_consensus_vsearch	2589	G	G	398	4	0.99%	2	2	93	93	0.06203329275530562	1	1	144	254	1	3	-TA
G4_BC76_191109_LF_LIB_consensus_vsearch	2590	T	T	386	6	1.49%	2	2	93	93	0.015326819799317902	1	1	144	242	1	5	-A
G4_BC76_191109_LF_LIB_consensus_vsearch	2591	A	A	387	3	0.76%	2	1	93	93	0.12451861360729544	1	1	144	243	0	3	+G
G4_BC76_191109_LF_LIB_consensus_vsearch	2592	G	*/+T	355	27	6.67%	2	2	93	93	4.6286143486725934E-9	1	1	114	241	24	3	+T
G4_BC76_191109_LF_LIB_consensus_vsearch	2593	T	T	382	3	0.77%	2	2	93	93	0.12451235370608407	1	1	140	242	1	2	C
G4_BC76_191109_LF_LIB_consensus_vsearch	2594	T	T	402	3	0.74%	2	2	93	93	0.1245364647713705	1	1	147	255	2	1	C
G4_BC76_191109_LF_LIB_consensus_vsearch	2595	T	T	404	2	0.49%	2	1	93	93	0.24969173859492816	1	1	148	256	0	2	C
G4_BC76_191109_LF_LIB_consensus_vsearch	2596	T	*/-GT	383	7	1.72%	2	1	93	93	0.007603246958909687	1	1	138	245	0	7	-GT
G4_BC76_191109_LF_LIB_consensus_vsearch	2597	G	G	383	5	1.28%	2	1	93	93	0.030847556649813805	1	1	138	245	5	0	A
G4_BC76_191109_LF_LIB_consensus_vsearch	2598	T	*/-A	369	18	4.56%	2	2	93	93	3.116143495392193E-6	1	1	135	234	7	11	-A
G4_BC76_191109_LF_LIB_consensus_vsearch	2599	A	A	379	4	1.04%	2	2	93	93	0.06201012515103793	1	1	136	243	1	3	G
G4_BC76_191109_LF_LIB_consensus_vsearch	2600	A	A	396	6	1.47%	2	2	93	93	0.015334218484153218	1	1	141	255	3	3	G
G4_BC76_191109_LF_LIB_consensus_vsearch	2601	T	*/+C	385	10	2.47%	2	2	93	93	9.218495267512253E-4	1	1	144	241	1	9	+C
G4_BC76_191109_LF_LIB_consensus_vsearch	2602	G	G	390	6	1.48%	2	2	93	93	0.015329823997787357	1	1	138	252	5	1	A
G4_BC76_191109_LF_LIB_consensus_vsearch	2603	C	Y	387	8	1.97%	2	2	93	93	0.0037689428690762675	1	1	143	244	1	7	T
G4_BC76_191109_LF_LIB_consensus_vsearch	2604	T	T	390	3	0.75%	2	1	93	93	0.12452229299364298	1	1	142	248	0	3	C
G4_BC76_191109_LF_LIB_consensus_vsearch	2605	G	G	398	3	0.75%	2	2	93	93	0.12453183520605009	1	1	146	252	1	2	A
G4_BC76_191109_LF_LIB_consensus_vsearch	2606	C	*/-GC	388	7	1.73%	2	2	93	93	0.007605882130108492	1	1	142	246	4	3	-GC
G4_BC76_191109_LF_LIB_consensus_vsearch	2607	G	G	393	2	0.5%	2	2	93	93	0.24968314321918028	1	1	140	253	1	1	-C
G4_BC76_191109_LF_LIB_consensus_vsearch	2608	C	C	394	1	0.25%	2	1	93	93	0.4999999999999138	1	1	140	254	1	0	+AT
G4_BC76_191109_LF_LIB_consensus_vsearch	2609	C	*/-A	381	11	2.71%	2	2	93	93	4.547664803982017E-4	1	1	142	239	1	10	-A
G4_BC76_191109_LF_LIB_consensus_vsearch	2610	A	A	381	4	1.02%	2	2	93	93	0.062012671598070994	1	1	140	241	2	2	G
G4_BC76_191109_LF_LIB_consensus_vsearch	2611	A	*/-G	392	8	1.98%	2	1	93	93	0.0037706450711110975	1	1	147	245	0	8	-G
G4_BC76_191109_LF_LIB_consensus_vsearch	2612	G	*/-T	382	8	2%	2	1	93	93	0.0037671973936205536	1	1	147	235	0	8	-T
G4_BC76_191109_LF_LIB_consensus_vsearch	2613	T	*/-G	332	21	5.34%	2	2	93	93	3.509991578913575E-7	1	1	137	195	4	17	-G
G4_BC76_191109_LF_LIB_consensus_vsearch	2614	G	G	360	2	0.55%	2	1	93	93	0.24965421853373454	1	1	140	220	2	0	A
G4_BC76_191109_LF_LIB_consensus_vsearch	2615	G	G	391	1	0.25%	2	1	93	93	0.4999999999999138	1	1	144	247	1	0	+AG
G4_BC76_191109_LF_LIB_consensus_vsearch	2616	G	G	394	5	1.23%	2	2	93	93	0.030858644444955494	1	1	140	254	2	3	-A
G4_BC76_191109_LF_LIB_consensus_vsearch	2617	A	*/-G	384	10	2.53%	2	2	93	93	9.217129834227815E-4	1	1	133	251	8	2	-G
G4_BC76_191109_LF_LIB_consensus_vsearch	2618	G	*/+T	365	7	1.79%	2	1	93	93	0.007593177034187656	1	1	130	235	0	7	+T
G4_BC76_191109_LF_LIB_consensus_vsearch	2619	G	G	400	1	0.25%	2	1	93	93	0.4999999999999138	1	1	144	256	1	0	+CA
G4_BC76_191109_LF_LIB_consensus_vsearch	2620	T	Y	377	20	4.91%	2	2	93	93	7.461874627489505E-7	1	1	140	237	4	16	C
G4_BC76_191109_LF_LIB_consensus_vsearch	2621	A	A	401	2	0.49%	2	1	93	93	0.24968944099344345	1	1	147	254	0	2	G
G4_BC76_191109_LF_LIB_consensus_vsearch	2622	G	G	398	4	0.98%	2	2	93	93	0.06203329275530562	1	1	143	255	2	2	-A
G4_BC76_191109_LF_LIB_consensus_vsearch	2623	A	A	387	4	0.99%	2	1	93	93	0.062020154536760255	1	1	140	247	0	4	-GA
G4_BC76_191109_LF_LIB_consensus_vsearch	2624	G	G	396	3	0.75%	2	2	93	93	0.12452948557099502	1	1	144	252	2	1	-A
G4_BC76_191109_LF_LIB_consensus_vsearch	2625	A	*/-C	376	10	2.51%	2	2	93	93	9.205956089622115E-4	1	1	133	243	5	5	-C
G4_BC76_191109_LF_LIB_consensus_vsearch	2626	C	C	389	4	1.01%	2	1	93	93	0.06202259804292181	1	1	141	248	0	4	T
G4_BC76_191109_LF_LIB_consensus_vsearch	2627	C	*/-T	366	28	6.9%	2	2	93	93	2.265952579810639E-9	1	1	143	223	3	25	-T
G4_BC76_191109_LF_LIB_consensus_vsearch	2628	T	T	362	3	0.81%	2	2	93	93	0.12448559670790355	1	1	141	221	1	2	C
G4_BC76_191109_LF_LIB_consensus_vsearch	2629	T	T	383	6	1.5%	2	1	93	93	0.015324526212125619	1	1	136	247	6	0	+C
G4_BC76_191109_LF_LIB_consensus_vsearch	2630	C	*/-T	373	22	5.45%	2	2	93	93	1.7651453668610844E-7	1	1	145	228	1	21	-T
G4_BC76_191109_LF_LIB_consensus_vsearch	2631	T	*/-A	344	15	3.95%	2	2	93	93	2.6286056741937496E-5	1	1	134	210	5	10	-A
G4_BC76_191109_LF_LIB_consensus_vsearch	2632	A	A	373	5	1.3%	2	2	93	93	0.03083691723172624	1	1	140	233	3	2	G
G4_BC76_191109_LF_LIB_consensus_vsearch	2633	A	R	376	7	1.74%	2	2	93	93	0.007599442747600996	1	1	145	231	2	5	G
G4_BC76_191109_LF_LIB_consensus_vsearch	2634	G	G	385	1	0.26%	2	1	93	93	0.4999999999999138	1	1	146	239	1	0	+AA
G4_BC76_191109_LF_LIB_consensus_vsearch	2635	G	G	394	3	0.75%	2	2	93	93	0.1245271122321419	1	1	148	246	1	2	-C
G4_BC76_191109_LF_LIB_consensus_vsearch	2636	C	Y	378	14	3.49%	2	1	93	93	5.423567585746075E-5	1	1	147	231	0	14	T
G4_BC76_191109_LF_LIB_consensus_vsearch	2637	T	T	380	6	1.5%	2	2	93	93	0.015322197067995588	1	1	145	235	1	5	-A
G4_BC76_191109_LF_LIB_consensus_vsearch	2638	A	A	386	5	1.26%	2	1	93	93	0.030850642423789317	1	1	147	239	0	5	C
G4_BC76_191109_LF_LIB_consensus_vsearch	2639	A	A	398	3	0.74%	2	2	93	93	0.12453183520605009	1	1	146	252	2	1	G
G4_BC76_191109_LF_LIB_consensus_vsearch	2640	A	A	404	2	0.49%	2	2	93	93	0.24969173859492816	1	1	148	256	1	1	G
G4_BC76_191109_LF_LIB_consensus_vsearch	2641	T	Y	383	16	3.94%	2	1	93	93	1.3089247338748483E-5	1	1	148	235	0	16	C
G4_BC76_191109_LF_LIB_consensus_vsearch	2642	A	A	399	3	0.74%	2	1	93	93	0.12453300124551302	1	1	147	252	0	3	G
G4_BC76_191109_LF_LIB_consensus_vsearch	2643	T	T	399	3	0.74%	2	1	93	93	0.12453300124551302	1	1	147	252	0	3	C
G4_BC76_191109_LF_LIB_consensus_vsearch	2644	G	G	406	1	0.25%	2	1	93	93	0.4999999999999138	1	1	149	257	0	1	+AAG
G4_BC76_191109_LF_LIB_consensus_vsearch	2645	A	A	398	6	1.47%	2	2	93	93	0.015335654379945	1	1	143	255	4	2	-TGA
G4_BC76_191109_LF_LIB_consensus_vsearch	2646	T	Y	392	7	1.74%	2	2	93	93	0.007607942959128091	1	1	144	248	1	6	C
G4_BC76_191109_LF_LIB_consensus_vsearch	2647	G	G	399	1	0.25%	2	1	93	93	0.4999999999999138	1	1	145	254	0	1	-A
G4_BC76_191109_LF_LIB_consensus_vsearch	2648	A	A	395	2	0.5%	2	1	93	93	0.24968474148789518	1	1	143	252	2	0	G
G4_BC76_191109_LF_LIB_consensus_vsearch	2649	C	C	400	4	0.99%	2	1	93	93	0.06203560460879861	1	1	148	252	0	4	T
G4_BC76_191109_LF_LIB_consensus_vsearch	2650	G	*/-TG	379	22	5.42%	2	2	93	93	1.773324890376511E-7	1	1	146	233	2	20	-TG
G4_BC76_191109_LF_LIB_consensus_vsearch	2651	T	Y	372	7	1.82%	2	2	93	93	0.007597206160798333	1	1	144	228	1	6	C
G4_BC76_191109_LF_LIB_consensus_vsearch	2652	G	G	376	2	0.52%	2	1	93	93	0.2496688741720519	1	1	144	232	2	0	-A
G4_BC76_191109_LF_LIB_consensus_vsearch	2653	A	A	394	4	0.99%	2	2	93	93	0.06202859930052086	1	1	140	254	3	1	-C
G4_BC76_191109_LF_LIB_consensus_vsearch	2654	C	C	395	6	1.49%	2	2	93	93	0.015333495178783761	1	1	143	252	2	4	T
G4_BC76_191109_LF_LIB_consensus_vsearch	2655	C	Y	378	16	3.93%	2	2	93	93	1.3063283572416325E-5	1	1	141	237	7	9	T
G4_BC76_191109_LF_LIB_consensus_vsearch	2656	G	G	402	2	0.49%	2	1	93	93	0.2496902106567468	1	1	147	255	0	2	T
G4_BC76_191109_LF_LIB_consensus_vsearch	2657	A	A	399	3	0.74%	2	2	93	93	0.12453300124551302	1	1	145	254	1	2	G
G4_BC76_191109_LF_LIB_consensus_vsearch	2658	T	T	392	3	0.74%	2	1	93	93	0.12452471482865957	1	1	144	248	0	3	+AA
G4_BC76_191109_LF_LIB_consensus_vsearch	2659	A	A	390	4	1%	2	1	93	93	0.062023810487337606	1	1	140	250	4	0	G
G4_BC76_191109_LF_LIB_consensus_vsearch	2660	G	G	397	1	0.25%	2	1	93	93	0.4999999999990043	1	1	146	251	0	1	+TA
G4_BC76_191109_LF_LIB_consensus_vsearch	2661	C	*/+A	376	16	3.98%	2	1	93	93	1.3052723597432312E-5	1	1	142	234	0	16	+A
G4_BC76_191109_LF_LIB_consensus_vsearch	2662	A	A	394	2	0.5%	2	1	93	93	0.24968394437400754	1	1	142	252	0	2	-C
G4_BC76_191109_LF_LIB_consensus_vsearch	2663	C	Y	373	18	4.49%	2	2	93	93	3.122747183773151E-6	1	1	139	234	2	16	T
G4_BC76_191109_LF_LIB_consensus_vsearch	2664	A	*/-CA	349	34	8.54%	2	2	93	93	2.7055217861798467E-11	1	1	133	216	4	30	-CA
G4_BC76_191109_LF_LIB_consensus_vsearch	2665	C	C	347	6	1.65%	2	2	93	93	0.015293971208790802	1	1	130	217	4	2	+A
G4_BC76_191109_LF_LIB_consensus_vsearch	2666	A	A	351	6	1.65%	2	2	93	93	0.015297669648122982	1	1	134	217	1	5	+CA
G4_BC76_191109_LF_LIB_consensus_vsearch	2667	A	A	389	4	1%	2	1	93	93	0.06202259804292181	1	1	141	248	0	4	-G
G4_BC76_191109_LF_LIB_consensus_vsearch	2668	G	G	387	4	1%	2	1	93	93	0.062020154536760255	1	1	138	249	4	0	T
G4_BC76_191109_LF_LIB_consensus_vsearch	2669	T	Y	380	10	2.48%	2	2	93	93	9.211599279939985E-4	1	1	146	234	1	9	C
G4_BC76_191109_LF_LIB_consensus_vsearch	2670	A	R	384	11	2.74%	2	2	93	93	4.5501547153779163E-4	1	1	138	246	5	6	G
G4_BC76_191109_LF_LIB_consensus_vsearch	2671	C	C	386	5	1.25%	2	1	93	93	0.030850642423789317	1	1	144	242	0	5	+A
G4_BC76_191109_LF_LIB_consensus_vsearch	2672	C	M	380	7	1.72%	2	1	93	93	0.007601633344865528	1	1	148	232	0	7	A
G4_BC76_191109_LF_LIB_consensus_vsearch	2673	G	R	385	13	3.21%	2	2	93	93	1.1050267709682812E-4	1	1	145	240	3	10	A
G4_BC76_191109_LF_LIB_consensus_vsearch	2674	C	Y	373	18	4.47%	2	2	93	93	3.122747183773151E-6	1	1	142	231	2	16	T
G4_BC76_191109_LF_LIB_consensus_vsearch	2675	G	G	394	4	0.99%	2	1	93	93	0.06202859930052086	1	1	142	252	4	0	-A
G4_BC76_191109_LF_LIB_consensus_vsearch	2676	A	*/+G	345	21	5.21%	2	2	93	93	3.5495225087012497E-7	1	1	99	246	15	6	+G
G4_BC76_191109_LF_LIB_consensus_vsearch	2677	G	G	368	4	1.07%	2	1	93	93	0.061995629927978635	1	1	119	249	0	4	+T
G4_BC76_191109_LF_LIB_consensus_vsearch	2678	G	G	391	2	0.51%	2	2	93	93	0.24968152866242077	1	1	135	256	1	1	+A
G4_BC76_191109_LF_LIB_consensus_vsearch	2679	G	*/+A	44	254	62.87%	2	2	93	93	7.741090499034875E-123	1	1	31	13	63	191	+A
G4_BC76_191109_LF_LIB_consensus_vsearch	2680	A	A	398	0	0%	2	0	93	0	1.0	1	0	145	253	0	0	
G4_BC76_191109_LF_LIB_consensus_vsearch	2681	A	A	395	4	0.99%	2	1	93	93	0.06202978149183676	1	1	147	248	0	4	+G
G4_BC76_191109_LF_LIB_consensus_vsearch	2682	G	G	398	3	0.74%	2	1	93	93	0.12453183520605009	1	1	145	253	0	3	A
G4_BC76_191109_LF_LIB_consensus_vsearch	2683	G	G	398	2	0.49%	2	2	93	93	0.249687108886017	1	1	144	254	1	1	-T
G4_BC76_191109_LF_LIB_consensus_vsearch	2684	T	T	394	4	0.99%	2	2	93	93	0.06202859930052086	1	1	144	250	1	3	C
G4_BC76_191109_LF_LIB_consensus_vsearch	2685	G	*/-A	343	37	9.16%	2	2	93	93	2.8969540342692684E-12	1	1	134	209	10	27	-A
G4_BC76_191109_LF_LIB_consensus_vsearch	2686	A	A	359	2	0.55%	2	1	93	93	0.24965325936195193	1	1	132	227	2	0	+G
G4_BC76_191109_LF_LIB_consensus_vsearch	2687	A	A	397	3	0.75%	2	2	93	93	0.12453066332921275	1	1	144	253	2	1	G
G4_BC76_191109_LF_LIB_consensus_vsearch	2688	A	A	400	4	0.99%	2	2	93	93	0.06203560460879861	1	1	146	254	1	3	G
G4_BC76_191109_LF_LIB_consensus_vsearch	2689	A	A	400	3	0.74%	2	1	93	93	0.12453416149047736	1	1	144	256	3	0	-G
G4_BC76_191109_LF_LIB_consensus_vsearch	2690	G	G	394	4	0.99%	2	1	93	93	0.06202859930052086	1	1	142	252	4	0	A
G4_BC76_191109_LF_LIB_consensus_vsearch	2691	C	*/+A	385	19	4.69%	2	1	93	93	1.5358771066795427E-6	1	1	149	236	0	19	+A
G4_BC76_191109_LF_LIB_consensus_vsearch	2692	A	A	406	1	0.25%	2	1	93	93	0.4999999999999138	1	1	148	258	1	0	G
G4_BC76_191109_LF_LIB_consensus_vsearch	2693	A	R	391	10	2.46%	2	2	93	93	9.226547240173711E-4	1	1	139	252	7	3	G
G4_BC76_191109_LF_LIB_consensus_vsearch	2694	C	C	400	2	0.5%	2	2	93	93	0.24968866749695368	1	1	145	255	1	1	T
G4_BC76_191109_LF_LIB_consensus_vsearch	2695	C	Y	389	15	3.69%	2	2	93	93	2.6734915394337705E-5	1	1	144	245	2	13	T
G4_BC76_191109_LF_LIB_consensus_vsearch	2696	A	A	394	3	0.74%	2	2	93	93	0.1245271122321419	1	1	143	251	1	2	-T
G4_BC76_191109_LF_LIB_consensus_vsearch	2697	T	T	395	5	1.24%	2	2	93	93	0.030859622206549208	1	1	144	251	1	4	C
G4_BC76_191109_LF_LIB_consensus_vsearch	2698	G	*/-A	215	175	43.1%	2	2	93	93	1.7507364438771652E-64	1	1	130	85	16	159	-A
G4_BC76_191109_LF_LIB_consensus_vsearch	2699	A	A	226	3	1.3%	2	1	93	93	0.12417943107231426	1	1	132	94	0	3	G
G4_BC76_191109_LF_LIB_consensus_vsearch	2700	A	A	403	1	0.25%	2	1	93	93	0.4999999999999138	1	1	149	254	0	1	C
G4_BC76_191109_LF_LIB_consensus_vsearch	2701	A	A	403	4	0.98%	2	2	93	93	0.062039029761584305	1	1	146	257	3	1	G
G4_BC76_191109_LF_LIB_consensus_vsearch	2702	A	A	401	1	0.25%	2	1	93	93	0.5000000000008233	1	1	145	256	0	1	+C
G4_BC76_191109_LF_LIB_consensus_vsearch	2703	A	A	396	3	0.74%	2	2	93	93	0.12452948557099502	1	1	144	252	2	1	-T
G4_BC76_191109_LF_LIB_consensus_vsearch	2704	T	-G/-G	27	363	90.75%	2	2	93	93	1.1857248335100116E-191	1	1	24	3	118	245	-G
G4_BC76_191109_LF_LIB_consensus_vsearch	2705	G	G	24	3	9.68%	2	1	93	93	0.11792452830187919	1	1	22	2	3	0	A
G4_BC76_191109_LF_LIB_consensus_vsearch	2706	G	R	382	8	2.03%	2	1	93	93	0.0037671973936205536	1	1	134	248	8	0	A
G4_BC76_191109_LF_LIB_consensus_vsearch	2707	G	R	381	23	5.68%	2	1	93	93	8.637937525117628E-8	1	1	126	255	23	0	A
G4_BC76_191109_LF_LIB_consensus_vsearch	2708	G	G	397	6	1.48%	2	1	93	93	0.015334938209013941	1	1	143	254	6	0	T
G4_BC76_191109_LF_LIB_consensus_vsearch	2709	T	Y	389	15	3.7%	2	1	93	93	2.6734915394337705E-5	1	1	149	240	0	15	C
G4_BC76_191109_LF_LIB_consensus_vsearch	2710	T	T	388	6	1.48%	2	2	93	93	0.015328329503561841	1	1	138	250	5	1	+G
G4_BC76_191109_LF_LIB_consensus_vsearch	2711	G	*/+A	388	8	1.97%	2	1	93	93	0.0037692867193449852	1	1	148	240	0	8	+A
G4_BC76_191109_LF_LIB_consensus_vsearch	2712	A	A	395	1	0.25%	2	1	93	93	0.5000000000008233	1	1	147	248	0	1	+C
G4_BC76_191109_LF_LIB_consensus_vsearch	2713	A	A	401	1	0.25%	2	1	93	93	0.5000000000008233	1	1	148	253	0	1	G
G4_BC76_191109_LF_LIB_consensus_vsearch	2714	A	A	397	4	0.99%	2	2	93	93	0.062032128175275904	1	1	146	251	2	2	G
G4_BC76_191109_LF_LIB_consensus_vsearch	2715	C	C	394	3	0.74%	2	1	93	93	0.1245271122321419	1	1	145	249	3	0	+G
G4_BC76_191109_LF_LIB_consensus_vsearch	2716	A	A	391	4	0.99%	2	1	93	93	0.06202501678889606	1	1	142	249	4	0	G
G4_BC76_191109_LF_LIB_consensus_vsearch	2717	G	G	392	3	0.75%	2	2	93	93	0.12452471482865957	1	1	146	246	1	2	-T
G4_BC76_191109_LF_LIB_consensus_vsearch	2718	T	Y	371	14	3.5%	2	1	93	93	5.4117244811276506E-5	1	1	141	230	0	14	C
G4_BC76_191109_LF_LIB_consensus_vsearch	2719	A	A	391	3	0.75%	2	2	93	93	0.12452350698836272	1	1	145	246	1	2	G
G4_BC76_191109_LF_LIB_consensus_vsearch	2720	G	G	377	6	1.5%	2	1	93	93	0.01531983153360656	1	1	142	235	0	6	-TG
G4_BC76_191109_LF_LIB_consensus_vsearch	2721	T	*/-GA	368	7	1.81%	2	1	93	93	0.007594922120899784	1	1	139	229	7	0	-GA
G4_BC76_191109_LF_LIB_consensus_vsearch	2722	G	*/-AAA	353	12	3.1%	2	2	93	93	2.2271267397471224E-4	1	1	121	232	11	1	-AAA
G4_BC76_191109_LF_LIB_consensus_vsearch	2723	A	A	369	2	0.54%	2	1	93	93	0.24966261808374654	1	1	124	245	2	0	+GA
G4_BC76_191109_LF_LIB_consensus_vsearch	2724	A	A	380	2	0.52%	2	1	93	93	0.2496723460023847	1	1	133	247	0	2	C
G4_BC76_191109_LF_LIB_consensus_vsearch	2725	A	A	385	3	0.76%	2	1	93	93	0.12451612903217696	1	1	132	253	3	0	-G
G4_BC76_191109_LF_LIB_consensus_vsearch	2726	G	*/-C	389	9	2.23%	2	1	93	93	0.0018658477399051397	1	1	144	245	0	9	-C
G4_BC76_191109_LF_LIB_consensus_vsearch	2727	C	C	384	4	1.01%	2	1	93	93	0.06201644201482272	1	1	142	242	4	0	-G
G4_BC76_191109_LF_LIB_consensus_vsearch	2728	G	G	391	2	0.5%	2	1	93	93	0.24968152866242077	1	1	142	249	0	2	+T
G4_BC76_191109_LF_LIB_consensus_vsearch	2729	C	*/-T	373	12	2.99%	2	2	93	93	2.2379428476008937E-4	1	1	136	237	6	6	-T
G4_BC76_191109_LF_LIB_consensus_vsearch	2730	T	Y	380	8	2.05%	2	2	93	93	0.003766486715388715	1	1	141	239	1	7	C
G4_BC76_191109_LF_LIB_consensus_vsearch	2731	T	*/-C	353	26	6.45%	2	2	93	93	9.560726489103875E-9	1	1	118	235	19	7	-C
G4_BC76_191109_LF_LIB_consensus_vsearch	2732	C	C	368	1	0.27%	2	1	93	93	0.4999999999999138	1	1	125	243	0	1	+TC
G4_BC76_191109_LF_LIB_consensus_vsearch	2733	C	*/-G	345	40	10.08%	2	1	93	93	3.1250079521913753E-13	1	1	145	200	0	40	-G
G4_BC76_191109_LF_LIB_consensus_vsearch	2734	G	R	326	20	5.65%	2	2	93	93	7.1892347744872E-7	1	1	129	197	19	1	A
G4_BC76_191109_LF_LIB_consensus_vsearch	2735	G	G	393	3	0.75%	2	2	93	93	0.12452591656124207	1	1	147	246	1	2	A
G4_BC76_191109_LF_LIB_consensus_vsearch	2736	G	G	402	1	0.25%	2	1	93	93	0.4999999999999138	1	1	148	254	0	1	-A
G4_BC76_191109_LF_LIB_consensus_vsearch	2737	A	A	400	2	0.49%	2	2	93	93	0.24968866749695368	1	1	148	252	1	1	G
G4_BC76_191109_LF_LIB_consensus_vsearch	2738	T	*/-A	378	13	3.21%	2	2	93	93	1.1030268622449933E-4	1	1	136	242	5	8	-A
G4_BC76_191109_LF_LIB_consensus_vsearch	2739	A	*/+T	374	7	1.79%	2	1	93	93	0.007598330292913895	1	1	139	235	0	7	+T
G4_BC76_191109_LF_LIB_consensus_vsearch	2740	A	*/+G	343	19	4.7%	2	1	93	93	1.4967636255307876E-6	1	1	143	200	0	19	+G
G4_BC76_191109_LF_LIB_consensus_vsearch	2741	G	G	377	3	0.77%	2	1	93	93	0.124505928853663	1	1	141	236	3	0	+A
G4_BC76_191109_LF_LIB_consensus_vsearch	2742	G	G	393	2	0.5%	2	1	93	93	0.24968314321918028	1	1	145	248	2	0	+A
G4_BC76_191109_LF_LIB_consensus_vsearch	2743	G	G	389	5	1.24%	2	2	93	93	0.030853681237272182	1	1	144	245	3	2	A
G4_BC76_191109_LF_LIB_consensus_vsearch	2744	C	*/+T	376	9	2.23%	2	1	93	93	0.00186293757088788	1	1	146	230	0	9	+T
G4_BC76_191109_LF_LIB_consensus_vsearch	2745	T	Y	367	16	4.01%	2	2	93	93	1.3003921666510645E-5	1	1	146	221	1	15	C
G4_BC76_191109_LF_LIB_consensus_vsearch	2746	A	R	387	11	2.72%	2	2	93	93	4.5526079174589983E-4	1	1	141	246	7	4	G
G4_BC76_191109_LF_LIB_consensus_vsearch	2747	T	*/-C	379	11	2.73%	2	2	93	93	4.5459840602315744E-4	1	1	136	243	1	10	-C
G4_BC76_191109_LF_LIB_consensus_vsearch	2748	C	*/-G	367	11	2.78%	2	2	93	93	4.5355347638701343E-4	1	1	136	231	4	7	-G
G4_BC76_191109_LF_LIB_consensus_vsearch	2749	G	R	362	15	3.85%	2	2	93	93	2.647778278892089E-5	1	1	127	235	13	2	A
G4_BC76_191109_LF_LIB_consensus_vsearch	2750	G	R	374	12	2.99%	2	2	93	93	2.2384550798854884E-4	1	1	140	234	7	5	A
G4_BC76_191109_LF_LIB_consensus_vsearch	2751	G	*/-TG	378	12	2.96%	2	1	93	93	2.2404784900264377E-4	1	1	140	238	0	12	-TG
G4_BC76_191109_LF_LIB_consensus_vsearch	2752	T	T	383	6	1.52%	2	1	93	93	0.015324526212125619	1	1	149	234	0	6	C
G4_BC76_191109_LF_LIB_consensus_vsearch	2753	G	G	385	4	1.02%	2	1	93	93	0.06201768588877767	1	1	146	239	0	4	-C
G4_BC76_191109_LF_LIB_consensus_vsearch	2754	C	C	392	3	0.75%	2	1	93	93	0.12452471482865957	1	1	149	243	0	3	-T
G4_BC76_191109_LF_LIB_consensus_vsearch	2755	T	*/-G	370	14	3.5%	2	2	93	93	5.409998888327447E-5	1	1	143	227	1	13	-G
G4_BC76_191109_LF_LIB_consensus_vsearch	2756	G	G	376	2	0.52%	2	1	93	93	0.2496688741720519	1	1	146	230	2	0	A
G4_BC76_191109_LF_LIB_consensus_vsearch	2757	G	G	389	5	1.25%	2	1	93	93	0.030853681237272182	1	1	149	240	0	5	C
G4_BC76_191109_LF_LIB_consensus_vsearch	2758	G	R	384	12	2.96%	2	1	93	93	2.2434391137769687E-4	1	1	142	242	0	12	A
G4_BC76_191109_LF_LIB_consensus_vsearch	2759	G	G	387	6	1.47%	2	2	93	93	0.015327576567173378	1	1	145	242	2	4	A
G4_BC76_191109_LF_LIB_consensus_vsearch	2760	C	*/-T	375	15	3.71%	2	1	93	93	2.6605806005741526E-5	1	1	145	230	0	15	-T
G4_BC76_191109_LF_LIB_consensus_vsearch	2761	T	*/-C	369	8	2.04%	2	1	93	93	0.0037624443929833353	1	1	142	227	0	8	-C
G4_BC76_191109_LF_LIB_consensus_vsearch	2762	C	*/-T	307	66	16.62%	2	1	93	93	5.767166090127936E-22	1	1	146	161	0	66	-T
G4_BC76_191109_LF_LIB_consensus_vsearch	2763	T	T	327	2	0.61%	2	1	93	93	0.24961948249601232	1	1	148	179	0	2	C
G4_BC76_191109_LF_LIB_consensus_vsearch	2764	T	T	397	1	0.25%	2	1	93	93	0.4999999999990043	1	1	149	248	0	1	+G
G4_BC76_191109_LF_LIB_consensus_vsearch	2765	T	*/-G	377	13	3.19%	2	2	93	93	1.1027355068065241E-4	1	1	138	239	3	10	-G
G4_BC76_191109_LF_LIB_consensus_vsearch	2766	G	R	378	11	2.79%	2	2	93	93	4.5451373534606624E-4	1	1	135	243	10	1	A
G4_BC76_191109_LF_LIB_consensus_vsearch	2767	G	S	364	23	5.65%	2	1	93	93	8.512923632334715E-8	1	1	137	227	0	23	C
G4_BC76_191109_LF_LIB_consensus_vsearch	2768	G	G	397	4	0.98%	2	1	93	93	0.062032128175275904	1	1	146	251	0	4	-T
G4_BC76_191109_LF_LIB_consensus_vsearch	2769	T	Y	387	7	1.73%	2	1	93	93	0.007605360418658285	1	1	147	240	0	7	C
G4_BC76_191109_LF_LIB_consensus_vsearch	2770	G	*/+C	369	23	5.65%	2	2	93	93	8.550659354703449E-8	1	1	147	222	1	22	+C
G4_BC76_191109_LF_LIB_consensus_vsearch	2771	T	*/-GC	349	29	7.16%	2	2	93	93	1.0658573227161048E-9	1	1	144	205	1	28	-GC
G4_BC76_191109_LF_LIB_consensus_vsearch	2772	G	G	350	5	1.36%	2	1	93	93	0.030810173501717365	1	1	142	208	0	5	T
G4_BC76_191109_LF_LIB_consensus_vsearch	2773	C	*/+T	46	272	71.77%	2	2	93	93	6.68603043972323E-132	1	1	15	31	115	157	+T
G4_BC76_191109_LF_LIB_consensus_vsearch	2774	T	T	378	4	1.04%	2	2	93	93	0.062008841921801575	1	1	130	248	1	3	+C
G4_BC76_191109_LF_LIB_consensus_vsearch	2775	T	*/+G	371	9	2.21%	2	2	93	93	0.0018617659366352362	1	1	129	242	7	2	+G
G4_BC76_191109_LF_LIB_consensus_vsearch	2776	A	A	389	6	1.48%	2	2	93	93	0.015329078637527195	1	1	140	249	1	5	-G
G4_BC76_191109_LF_LIB_consensus_vsearch	2777	G	G	389	4	1%	2	1	93	93	0.06202259804292181	1	1	142	247	4	0	T
G4_BC76_191109_LF_LIB_consensus_vsearch	2778	T	T	391	5	1.24%	2	1	93	93	0.030855681550508444	1	1	146	245	0	5	C
G4_BC76_191109_LF_LIB_consensus_vsearch	2779	G	G	394	4	1%	2	2	93	93	0.06202859930052086	1	1	143	251	3	1	A
G4_BC76_191109_LF_LIB_consensus_vsearch	2780	C	C	392	4	0.99%	2	1	93	93	0.06202621699451153	1	1	142	250	4	0	+TT
G4_BC76_191109_LF_LIB_consensus_vsearch	2781	T	Y	390	9	2.22%	2	2	93	93	0.0018660638404102402	1	1	141	249	3	6	C
G4_BC76_191109_LF_LIB_consensus_vsearch	2782	A	*/-C	375	15	3.7%	2	2	93	93	2.6605806005741526E-5	1	1	138	237	4	11	-C
G4_BC76_191109_LF_LIB_consensus_vsearch	2783	C	*/+T	378	12	3.08%	2	2	93	93	2.2404784900264377E-4	1	1	143	235	1	11	+T
G4_BC76_191109_LF_LIB_consensus_vsearch	2784	C	C	395	6	1.47%	2	1	93	93	0.015333495178783761	1	1	140	255	6	0	+G
G4_BC76_191109_LF_LIB_consensus_vsearch	2785	C	*/-T	370	23	5.64%	2	2	93	93	8.558107510380592E-8	1	1	139	231	3	20	-T
G4_BC76_191109_LF_LIB_consensus_vsearch	2786	T	T	364	6	1.58%	2	2	93	93	0.015309138841624766	1	1	132	232	5	1	A
G4_BC76_191109_LF_LIB_consensus_vsearch	2787	T	*/-G	364	13	3.23%	2	1	93	93	1.0988123554092724E-4	1	1	126	238	0	13	-G
G4_BC76_191109_LF_LIB_consensus_vsearch	2788	G	*/+A	313	65	16.46%	2	1	93	93	1.3329458302209781E-21	1	1	143	170	0	65	+A
G4_BC76_191109_LF_LIB_consensus_vsearch	2789	G	G	400	3	0.74%	2	1	93	93	0.12453416149047736	1	1	143	257	3	0	+A
G4_BC76_191109_LF_LIB_consensus_vsearch	2790	A	*/+C	305	73	17.94%	2	2	93	93	2.2482271518844688E-24	1	1	119	186	5	68	+C
G4_BC76_191109_LF_LIB_consensus_vsearch	2791	G	*/+C	379	15	3.68%	2	2	93	93	2.6643583645111762E-5	1	1	123	256	14	1	+C
G4_BC76_191109_LF_LIB_consensus_vsearch	2792	A	R	297	83	20.54%	2	2	93	93	6.724812312179041E-28	1	1	119	178	11	72	G
G4_BC76_191109_LF_LIB_consensus_vsearch	2793	C	*/+GGC	96	199	49.63%	2	2	93	93	1.556310653092406E-83	1	1	28	68	68	131	+GGC
G4_BC76_191109_LF_LIB_consensus_vsearch	2794	C	*/+T	389	7	1.72%	2	2	93	93	0.0076064012202881484	1	1	141	248	1	6	+T
G4_BC76_191109_LF_LIB_consensus_vsearch	2795	C	*/-G	366	17	4.17%	2	2	93	93	6.36325233547173E-6	1	1	142	224	3	14	-G
G4_BC76_191109_LF_LIB_consensus_vsearch	2796	G	G	383	3	0.77%	2	1	93	93	0.12451361867715198	1	1	144	239	0	3	A
G4_BC76_191109_LF_LIB_consensus_vsearch	2797	C	C	395	4	0.99%	2	1	93	93	0.06202978149183676	1	1	147	248	0	4	T
G4_BC76_191109_LF_LIB_consensus_vsearch	2798	G	G	395	4	0.99%	2	2	93	93	0.06202978149183676	1	1	143	252	1	3	C
G4_BC76_191109_LF_LIB_consensus_vsearch	2799	C	*/-G	370	24	5.91%	2	2	93	93	4.1539988169801786E-8	1	1	145	225	3	21	-G
G4_BC76_191109_LF_LIB_consensus_vsearch	2800	G	R	362	8	2.11%	2	2	93	93	0.003759747990644719	1	1	139	223	5	3	A
G4_BC76_191109_LF_LIB_consensus_vsearch	2801	G	*/+A	384	14	3.46%	2	1	93	93	5.433401108852574E-5	1	1	133	251	14	0	+A
G4_BC76_191109_LF_LIB_consensus_vsearch	2802	G	G	396	3	0.74%	2	1	93	93	0.12452948557099502	1	1	140	256	3	0	A
G4_BC76_191109_LF_LIB_consensus_vsearch	2803	T	Y	388	16	3.95%	2	1	93	93	1.3114605407806796E-5	1	1	145	243	0	16	C
G4_BC76_191109_LF_LIB_consensus_vsearch	2804	T	T	393	6	1.48%	2	2	93	93	0.015332037719180692	1	1	145	248	2	4	C
G4_BC76_191109_LF_LIB_consensus_vsearch	2805	G	G	403	1	0.25%	2	1	93	93	0.4999999999999138	1	1	147	256	1	0	-A
G4_BC76_191109_LF_LIB_consensus_vsearch	2806	A	A	404	1	0.25%	2	1	93	93	0.4999999999999138	1	1	146	258	1	0	-T
G4_BC76_191109_LF_LIB_consensus_vsearch	2807	T	T	396	3	0.74%	2	1	93	93	0.12452948557099502	1	1	147	249	0	3	-GTTGG
G4_BC76_191109_LF_LIB_consensus_vsearch	2808	G	G	397	3	0.74%	2	1	93	93	0.12453066332921275	1	1	149	248	0	3	+CG
G4_BC76_191109_LF_LIB_consensus_vsearch	2809	T	T	396	3	0.74%	2	1	93	93	0.12452948557099502	1	1	149	247	0	3	A
G4_BC76_191109_LF_LIB_consensus_vsearch	2810	T	*/-G	317	54	13.37%	2	2	93	93	6.931367636007888E-18	1	1	142	175	2	52	-G
G4_BC76_191109_LF_LIB_consensus_vsearch	2811	G	R	311	10	3.03%	2	2	93	93	9.09495348801856E-4	1	1	138	173	8	2	A
G4_BC76_191109_LF_LIB_consensus_vsearch	2812	G	R	371	12	3.12%	2	2	93	93	2.236910591562848E-4	1	1	147	224	1	11	A
G4_BC76_191109_LF_LIB_consensus_vsearch	2813	G	R	371	30	7.37%	2	2	93	93	5.30257233806281E-10	1	1	143	228	3	27	A
G4_BC76_191109_LF_LIB_consensus_vsearch	2814	G	G	397	5	1.23%	2	2	93	93	0.03086156314569468	1	1	146	251	1	4	A
G4_BC76_191109_LF_LIB_consensus_vsearch	2815	C	Y	394	7	1.73%	2	2	93	93	0.007608958034696689	1	1	145	249	1	6	T
G4_BC76_191109_LF_LIB_consensus_vsearch	2816	G	G	402	1	0.25%	2	1	93	93	0.4999999999999138	1	1	146	256	0	1	+CG
G4_BC76_191109_LF_LIB_consensus_vsearch	2817	A	A	403	2	0.49%	2	2	93	93	0.24969097651407932	1	1	147	256	1	1	G
G4_BC76_191109_LF_LIB_consensus_vsearch	2818	T	T	397	4	0.98%	2	1	93	93	0.062032128175275904	1	1	146	251	0	4	-A
G4_BC76_191109_LF_LIB_consensus_vsearch	2819	A	*/+G	377	16	3.97%	2	1	93	93	1.3058016225586293E-5	1	1	142	235	0	16	+G
G4_BC76_191109_LF_LIB_consensus_vsearch	2820	G	G	398	3	0.74%	2	1	93	93	0.12453183520605009	1	1	144	254	0	3	-AC
G4_BC76_191109_LF_LIB_consensus_vsearch	2821	A	A	391	6	1.49%	2	1	93	93	0.01533056561273411	1	1	139	252	6	0	G
G4_BC76_191109_LF_LIB_consensus_vsearch	2822	C	C	395	4	1%	2	2	93	93	0.06202978149183676	1	1	146	249	2	2	T
G4_BC76_191109_LF_LIB_consensus_vsearch	2823	G	G	401	2	0.49%	2	1	93	93	0.24968944099344345	1	1	148	253	0	2	T
G4_BC76_191109_LF_LIB_consensus_vsearch	2824	C	*/-GC	368	34	8.4%	2	2	93	93	2.809773954312077E-11	1	1	142	226	6	28	-GC
G4_BC76_191109_LF_LIB_consensus_vsearch	2825	G	G	366	1	0.27%	2	1	93	93	0.4999999999999138	1	1	142	224	0	1	-CCG
G4_BC76_191109_LF_LIB_consensus_vsearch	2826	C	C	366	3	0.81%	2	2	93	93	0.12449118046122318	1	1	141	225	1	2	+GC
G4_BC76_191109_LF_LIB_consensus_vsearch	2827	C	Y	396	9	2.22%	2	1	93	93	0.0018673383028544072	1	1	148	248	0	9	T
G4_BC76_191109_LF_LIB_consensus_vsearch	2828	G	G	402	1	0.25%	2	1	93	93	0.4999999999999138	1	1	146	256	1	0	+A
G4_BC76_191109_LF_LIB_consensus_vsearch	2829	T	Y	391	13	3.19%	2	1	93	93	1.1066876939038198E-4	1	1	147	244	0	13	C
G4_BC76_191109_LF_LIB_consensus_vsearch	2830	T	*/-G	369	31	7.6%	2	2	93	93	2.544265000862745E-10	1	1	141	228	3	28	-G
G4_BC76_191109_LF_LIB_consensus_vsearch	2831	G	G	375	1	0.27%	2	1	93	93	0.5000000000003686	1	1	145	230	1	0	A
G4_BC76_191109_LF_LIB_consensus_vsearch	2832	G	*/+A	384	8	1.97%	2	1	93	93	0.0037679008816766993	1	1	136	248	8	0	+A
G4_BC76_191109_LF_LIB_consensus_vsearch	2833	A	A	388	4	1.02%	2	1	93	93	0.0620213794085142	1	1	138	250	4	0	G
G4_BC76_191109_LF_LIB_consensus_vsearch	2834	A	A	390	5	1.25%	2	2	93	93	0.030854683924238017	1	1	144	246	2	3	G
G4_BC76_191109_LF_LIB_consensus_vsearch	2835	T	*/+C	389	7	1.74%	2	2	93	93	0.0076064012202881484	1	1	145	244	1	6	+C
G4_BC76_191109_LF_LIB_consensus_vsearch	2836	T	*/-C	374	18	4.41%	2	2	93	93	3.1243787131250986E-6	1	1	144	230	1	17	-C
G4_BC76_191109_LF_LIB_consensus_vsearch	2837	C	*/-G	377	7	1.8%	2	2	93	93	0.007599994652592844	1	1	144	233	3	4	-G
G4_BC76_191109_LF_LIB_consensus_vsearch	2838	G	R	385	11	2.75%	2	2	93	93	4.550976487942495E-4	1	1	135	250	10	1	A
G4_BC76_191109_LF_LIB_consensus_vsearch	2839	G	G	401	2	0.49%	2	1	93	93	0.24968944099344345	1	1	145	256	2	0	+C
G4_BC76_191109_LF_LIB_consensus_vsearch	2840	C	C	392	5	1.23%	2	2	93	93	0.030856674154206513	1	1	138	254	3	2	+T
G4_BC76_191109_LF_LIB_consensus_vsearch	2841	T	Y	392	8	1.98%	2	2	93	93	0.0037706450711110975	1	1	144	248	2	6	C
G4_BC76_191109_LF_LIB_consensus_vsearch	2842	G	*/-T	389	7	1.73%	2	1	93	93	0.0076064012202881484	1	1	146	243	0	7	-T
G4_BC76_191109_LF_LIB_consensus_vsearch	2843	T	*/-CT	365	28	7.04%	2	1	93	93	2.262982847908866E-9	1	1	146	219	0	28	-CT
G4_BC76_191109_LF_LIB_consensus_vsearch	2844	C	*/-T	335	32	8.49%	2	1	93	93	1.148957441815799E-10	1	1	148	187	0	32	-T
G4_BC76_191109_LF_LIB_consensus_vsearch	2845	T	T	338	4	1.17%	2	1	93	93	0.06195135480287766	1	1	148	190	0	4	C
G4_BC76_191109_LF_LIB_consensus_vsearch	2846	T	*/-CG	366	14	3.48%	2	1	93	93	5.403009673105009E-5	1	1	136	230	0	14	-CG
G4_BC76_191109_LF_LIB_consensus_vsearch	2847	C	*/-G	342	29	7.51%	2	2	93	93	1.0542404836015714E-9	1	1	145	197	1	28	-G
G4_BC76_191109_LF_LIB_consensus_vsearch	2848	G	R	331	13	3.67%	2	2	93	93	1.0875750416273054E-4	1	1	137	194	11	2	A
G4_BC76_191109_LF_LIB_consensus_vsearch	2849	G	R	386	7	1.76%	2	2	93	93	0.0076048360660226225	1	1	143	243	3	4	A
G4_BC76_191109_LF_LIB_consensus_vsearch	2850	G	G	396	4	0.99%	2	2	93	93	0.06203095776871511	1	1	146	250	1	3	A
G4_BC76_191109_LF_LIB_consensus_vsearch	2851	C	C	395	2	0.5%	2	1	93	93	0.24968474148789518	1	1	145	250	0	2	A
G4_BC76_191109_LF_LIB_consensus_vsearch	2852	A	R	391	7	1.74%	2	2	93	93	0.007607431615374521	1	1	139	252	6	1	G
G4_BC76_191109_LF_LIB_consensus_vsearch	2853	G	G	398	1	0.25%	2	1	93	93	0.4999999999999138	1	1	146	252	1	0	+T
G4_BC76_191109_LF_LIB_consensus_vsearch	2854	T	Y	390	8	1.98%	2	2	93	93	0.0037699692796093966	1	1	146	244	2	6	C
G4_BC76_191109_LF_LIB_consensus_vsearch	2855	G	G	386	6	1.49%	2	1	93	93	0.015326819799317902	1	1	145	241	0	6	+C
G4_BC76_191109_LF_LIB_consensus_vsearch	2856	T	Y	381	17	4.24%	2	1	93	93	6.407855928137532E-6	1	1	148	233	0	17	C
G4_BC76_191109_LF_LIB_consensus_vsearch	2857	T	*/-GT	380	8	1.99%	2	2	93	93	0.003766486715388715	1	1	134	246	6	2	-GT
G4_BC76_191109_LF_LIB_consensus_vsearch	2858	G	G	370	6	1.52%	2	1	93	93	0.015314165556293042	1	1	121	249	6	0	+C
G4_BC76_191109_LF_LIB_consensus_vsearch	2859	T	Y	359	24	6.14%	2	2	93	93	4.109779394937169E-8	1	1	119	240	15	9	C
G4_BC76_191109_LF_LIB_consensus_vsearch	2860	A	R	386	7	1.76%	2	2	93	93	0.0076048360660226225	1	1	139	247	4	3	G
G4_BC76_191109_LF_LIB_consensus_vsearch	2861	G	R	378	9	2.24%	2	1	93	93	0.0018633978545959287	1	1	133	245	9	0	A
G4_BC76_191109_LF_LIB_consensus_vsearch	2862	C	*/+T	384	8	2.03%	2	1	93	93	0.0037679008816766993	1	1	146	238	0	8	+T
G4_BC76_191109_LF_LIB_consensus_vsearch	2863	C	*/-T	366	31	7.64%	2	1	93	93	2.5322018519396876E-10	1	1	147	219	0	31	-T
G4_BC76_191109_LF_LIB_consensus_vsearch	2864	T	T	364	5	1.34%	2	1	93	93	0.03082684905710192	1	1	146	218	0	5	+C
G4_BC76_191109_LF_LIB_consensus_vsearch	2865	T	T	391	5	1.23%	2	2	93	93	0.030855681550508444	1	1	141	250	4	1	+C
G4_BC76_191109_LF_LIB_consensus_vsearch	2866	C	*/-G	378	9	2.25%	2	1	93	93	0.0018633978545959287	1	1	144	234	0	9	-G
G4_BC76_191109_LF_LIB_consensus_vsearch	2867	G	R	383	9	2.27%	2	2	93	93	0.001864528271344425	1	1	139	244	7	2	A
G4_BC76_191109_LF_LIB_consensus_vsearch	2868	G	G	383	6	1.48%	2	1	93	93	0.015324526212125619	1	1	137	246	0	6	+C
G4_BC76_191109_LF_LIB_consensus_vsearch	2869	T	Y	367	31	7.69%	2	2	93	93	2.536237544568906E-10	1	1	144	223	2	29	C
G4_BC76_191109_LF_LIB_consensus_vsearch	2870	T	T	393	5	1.23%	2	1	93	93	0.03085766177318207	1	1	147	246	0	5	C
G4_BC76_191109_LF_LIB_consensus_vsearch	2871	G	G	394	6	1.49%	2	1	93	93	0.015332768266138878	1	1	144	250	0	6	-CTG
G4_BC76_191109_LF_LIB_consensus_vsearch	2872	C	Y	376	16	3.99%	2	1	93	93	1.3052723597432312E-5	1	1	144	232	0	16	T
G4_BC76_191109_LF_LIB_consensus_vsearch	2873	T	Y	379	10	2.5%	2	2	93	93	9.21019917535404E-4	1	1	144	235	3	7	C
G4_BC76_191109_LF_LIB_consensus_vsearch	2874	G	G	401	0	0%	2	0	93	0	1.0	1	0	148	253	0	0	
G4_BC76_191109_LF_LIB_consensus_vsearch	2875	A	A	402	3	0.74%	2	1	93	93	0.1245364647713705	1	1	147	255	0	3	-T
G4_BC76_191109_LF_LIB_consensus_vsearch	2876	T	*/-C	386	9	2.23%	2	2	93	93	0.0018651929543866046	1	1	139	247	8	1	-C
G4_BC76_191109_LF_LIB_consensus_vsearch	2877	C	C	391	2	0.5%	2	1	93	93	0.24968152866242077	1	1	138	253	2	0	+A
G4_BC76_191109_LF_LIB_consensus_vsearch	2878	C	C	400	2	0.49%	2	1	93	93	0.24968866749695368	1	1	148	252	0	2	-T
G4_BC76_191109_LF_LIB_consensus_vsearch	2879	T	*/-C	386	7	1.73%	2	2	93	93	0.0076048360660226225	1	1	141	245	4	3	-C
G4_BC76_191109_LF_LIB_consensus_vsearch	2880	C	C	394	2	0.5%	2	1	93	93	0.24968394437400754	1	1	143	251	2	0	+A
G4_BC76_191109_LF_LIB_consensus_vsearch	2881	C	C	395	5	1.23%	2	2	93	93	0.030859622206549208	1	1	147	248	1	4	-TG
G4_BC76_191109_LF_LIB_consensus_vsearch	2882	T	Y	373	14	3.53%	2	2	93	93	5.415150063894175E-5	1	1	145	228	1	13	C
G4_BC76_191109_LF_LIB_consensus_vsearch	2883	G	G	397	3	0.74%	2	2	93	93	0.12453066332921275	1	1	145	252	1	2	A
G4_BC76_191109_LF_LIB_consensus_vsearch	2884	C	Y	386	9	2.22%	2	1	93	93	0.0018651929543866046	1	1	148	238	0	9	T
G4_BC76_191109_LF_LIB_consensus_vsearch	2885	G	G	401	1	0.25%	2	1	93	93	0.5000000000008233	1	1	148	253	0	1	+TG
G4_BC76_191109_LF_LIB_consensus_vsearch	2886	A	A	399	6	1.47%	2	2	93	93	0.01533636702317035	1	1	146	253	2	4	-C
G4_BC76_191109_LF_LIB_consensus_vsearch	2887	C	C	397	2	0.5%	2	1	93	93	0.24968632371350802	1	1	145	252	0	2	T
G4_BC76_191109_LF_LIB_consensus_vsearch	2888	C	*/+T	381	15	3.68%	2	2	93	93	2.6662200580606564E-5	1	1	145	236	1	14	+T
G4_BC76_191109_LF_LIB_consensus_vsearch	2889	T	T	392	3	0.76%	2	1	93	93	0.12452471482865957	1	1	145	247	0	3	C
G4_BC76_191109_LF_LIB_consensus_vsearch	2890	T	T	394	3	0.74%	2	2	93	93	0.1245271122321419	1	1	142	252	2	1	-G
G4_BC76_191109_LF_LIB_consensus_vsearch	2891	G	G	397	2	0.5%	2	1	93	93	0.24968632371350802	1	1	146	251	0	2	C
G4_BC76_191109_LF_LIB_consensus_vsearch	2892	T	T	391	5	1.23%	2	1	93	93	0.030855681550508444	1	1	146	245	0	5	C
G4_BC76_191109_LF_LIB_consensus_vsearch	2893	G	*/-TG	368	27	6.65%	2	2	93	93	4.7042901618677225E-9	1	1	130	238	16	11	-TG
G4_BC76_191109_LF_LIB_consensus_vsearch	2894	T	T	365	4	1.07%	2	2	93	93	0.06199152659703387	1	1	125	240	2	2	C
G4_BC76_191109_LF_LIB_consensus_vsearch	2895	G	G	366	4	1.06%	2	2	93	93	0.061992901772438824	1	1	125	241	3	1	-A
G4_BC76_191109_LF_LIB_consensus_vsearch	2896	A	A	398	4	1%	2	2	93	93	0.06203329275530562	1	1	143	255	1	3	G
G4_BC76_191109_LF_LIB_consensus_vsearch	2897	A	A	401	4	0.98%	2	2	93	93	0.06203675196794108	1	1	144	257	3	1	G
G4_BC76_191109_LF_LIB_consensus_vsearch	2898	T	T	404	2	0.49%	2	2	93	93	0.24969173859492816	1	1	147	257	1	1	C
G4_BC76_191109_LF_LIB_consensus_vsearch	2899	G	G	388	5	1.23%	2	1	93	93	0.030852673450990298	1	1	134	254	5	0	+CC
G4_BC76_191109_LF_LIB_consensus_vsearch	2900	C	*/-G	368	25	6.23%	2	2	93	93	2.0096772623453192E-8	1	1	141	227	1	24	-G
G4_BC76_191109_LF_LIB_consensus_vsearch	2901	G	R	331	40	10.61%	2	1	93	93	2.994608669172783E-13	1	1	104	227	40	0	A
G4_BC76_191109_LF_LIB_consensus_vsearch	2902	G	G	401	2	0.5%	2	2	93	93	0.24968944099344345	1	1	146	255	1	1	A
G4_BC76_191109_LF_LIB_consensus_vsearch	2903	G	G	399	3	0.74%	2	2	93	93	0.12453300124551302	1	1	146	253	2	1	A
G4_BC76_191109_LF_LIB_consensus_vsearch	2904	T	T	397	3	0.74%	2	1	93	93	0.12453066332921275	1	1	145	252	3	0	+G
G4_BC76_191109_LF_LIB_consensus_vsearch	2905	C	*/-T	395	9	2.22%	2	1	93	93	0.0018671284895574335	1	1	149	246	0	9	-T
G4_BC76_191109_LF_LIB_consensus_vsearch	2906	T	T	391	5	1.26%	2	2	93	93	0.030855681550508444	1	1	146	245	3	2	C
G4_BC76_191109_LF_LIB_consensus_vsearch	2907	T	*/-G	389	13	3.19%	2	2	93	93	1.1061393736967548E-4	1	1	146	243	1	12	-G
G4_BC76_191109_LF_LIB_consensus_vsearch	2908	G	G	381	5	1.27%	2	1	93	93	0.03084547283766662	1	1	145	236	0	5	C
G4_BC76_191109_LF_LIB_consensus_vsearch	2909	T	W	373	19	4.71%	2	2	93	93	1.5254799460974752E-6	1	1	144	229	1	18	A
G4_BC76_191109_LF_LIB_consensus_vsearch	2910	G	G	400	2	0.5%	2	1	93	93	0.24968866749695368	1	1	146	254	2	0	-A
G4_BC76_191109_LF_LIB_consensus_vsearch	2911	A	A	402	2	0.5%	2	1	93	93	0.2496902106567468	1	1	146	256	0	2	-C
G4_BC76_191109_LF_LIB_consensus_vsearch	2912	C	C	398	2	0.49%	2	1	93	93	0.249687108886017	1	1	147	251	0	2	T
G4_BC76_191109_LF_LIB_consensus_vsearch	2913	C	Y	375	26	6.37%	2	2	93	93	9.804283000189345E-9	1	1	146	229	1	25	T
G4_BC76_191109_LF_LIB_consensus_vsearch	2914	G	G	403	1	0.25%	2	1	93	93	0.4999999999999138	1	1	147	256	0	1	+CG
G4_BC76_191109_LF_LIB_consensus_vsearch	2915	T	T	398	6	1.48%	2	1	93	93	0.015335654379945	1	1	146	252	0	6	C
G4_BC76_191109_LF_LIB_consensus_vsearch	2916	T	T	396	5	1.23%	2	2	93	93	0.03086059509471206	1	1	143	253	2	3	C
G4_BC76_191109_LF_LIB_consensus_vsearch	2917	A	*/-G	392	8	1.96%	2	2	93	93	0.0037706450711110975	1	1	143	249	2	6	-G
G4_BC76_191109_LF_LIB_consensus_vsearch	2918	G	G	386	4	1.01%	2	2	93	93	0.062018923379747036	1	1	137	249	3	1	A
G4_BC76_191109_LF_LIB_consensus_vsearch	2919	C	C	393	5	1.24%	2	1	93	93	0.03085766177318207	1	1	142	251	0	5	T
G4_BC76_191109_LF_LIB_consensus_vsearch	2920	C	C	395	6	1.47%	2	2	93	93	0.015333495178783761	1	1	146	249	1	5	-GCC
G4_BC76_191109_LF_LIB_consensus_vsearch	2921	G	*/-C	383	10	2.49%	2	1	93	93	9.215757570452482E-4	1	1	132	251	10	0	-C
G4_BC76_191109_LF_LIB_consensus_vsearch	2922	C	*/+T	383	7	1.79%	2	2	93	93	0.007603246958909687	1	1	136	247	1	6	+T
G4_BC76_191109_LF_LIB_consensus_vsearch	2923	C	C	398	3	0.75%	2	2	93	93	0.12453183520605009	1	1	146	252	2	1	A
G4_BC76_191109_LF_LIB_consensus_vsearch	2924	C	Y	394	11	2.7%	2	2	93	93	4.5581937785957034E-4	1	1	146	248	2	9	T
G4_BC76_191109_LF_LIB_consensus_vsearch	2925	G	G	399	3	0.74%	2	1	93	93	0.12453300124551302	1	1	145	254	3	0	A
G4_BC76_191109_LF_LIB_consensus_vsearch	2926	T	T	403	2	0.49%	2	1	93	93	0.24969097651407932	1	1	149	254	0	2	-C
G4_BC76_191109_LF_LIB_consensus_vsearch	2927	C	*/-T	390	11	2.72%	2	1	93	93	4.555025215794059E-4	1	1	147	243	0	11	-T
G4_BC76_191109_LF_LIB_consensus_vsearch	2928	T	T	388	3	0.76%	2	1	93	93	0.12451984635071693	1	1	147	241	0	3	C
G4_BC76_191109_LF_LIB_consensus_vsearch	2929	T	*/+G	384	11	2.7%	2	1	93	93	4.5501547153779163E-4	1	1	144	240	0	11	+G
G4_BC76_191109_LF_LIB_consensus_vsearch	2930	G	G	393	6	1.48%	2	1	93	93	0.015332037719180692	1	1	148	245	0	6	+A
G4_BC76_191109_LF_LIB_consensus_vsearch	2931	A	A	395	4	1%	2	2	93	93	0.06202978149183676	1	1	145	250	2	2	G
G4_BC76_191109_LF_LIB_consensus_vsearch	2932	A	A	402	2	0.49%	2	1	93	93	0.2496902106567468	1	1	146	256	2	0	C
G4_BC76_191109_LF_LIB_consensus_vsearch	2933	A	A	395	5	1.23%	2	1	93	93	0.030859622206549208	1	1	143	252	5	0	G
G4_BC76_191109_LF_LIB_consensus_vsearch	2934	C	C	398	2	0.5%	2	1	93	93	0.249687108886017	1	1	146	252	0	2	+G
G4_BC76_191109_LF_LIB_consensus_vsearch	2935	A	A	398	4	0.99%	2	2	93	93	0.06203329275530562	1	1	146	252	1	3	G
G4_BC76_191109_LF_LIB_consensus_vsearch	2936	C	*/-G	388	7	1.73%	2	1	93	93	0.007605882130108492	1	1	142	246	0	7	-G
G4_BC76_191109_LF_LIB_consensus_vsearch	2937	G	G	396	3	0.75%	2	1	93	93	0.12452948557099502	1	1	149	247	0	3	T
G4_BC76_191109_LF_LIB_consensus_vsearch	2938	G	G	405	1	0.25%	2	1	93	93	0.5000000000008233	1	1	149	256	0	1	+T
G4_BC76_191109_LF_LIB_consensus_vsearch	2939	A	*/-C	393	7	1.72%	2	1	93	93	0.007608451759263046	1	1	140	253	7	0	-C
G4_BC76_191109_LF_LIB_consensus_vsearch	2940	C	C	394	3	0.75%	2	2	93	93	0.1245271122321419	1	1	140	254	2	1	T
G4_BC76_191109_LF_LIB_consensus_vsearch	2941	C	*/-A	375	18	4.43%	2	2	93	93	3.1260025940381716E-6	1	1	128	247	14	4	-A
G4_BC76_191109_LF_LIB_consensus_vsearch	2942	A	R	377	7	1.82%	2	2	93	93	0.007599994652592844	1	1	131	246	1	6	G
G4_BC76_191109_LF_LIB_consensus_vsearch	2943	A	*/-G	369	8	1.99%	2	2	93	93	0.0037624443929833353	1	1	125	244	4	4	-G
G4_BC76_191109_LF_LIB_consensus_vsearch	2944	G	K	366	7	1.84%	2	1	93	93	0.007593761831616585	1	1	123	243	0	7	T
G4_BC76_191109_LF_LIB_consensus_vsearch	2945	G	G	370	6	1.54%	2	1	93	93	0.015314165556293042	1	1	113	257	6	0	A
G4_BC76_191109_LF_LIB_consensus_vsearch	2946	A	A	384	1	0.26%	2	1	93	93	0.4999999999999138	1	1	128	256	1	0	+G
G4_BC76_191109_LF_LIB_consensus_vsearch	2947	G	*/-T	375	15	3.75%	2	1	93	93	2.6605806005741526E-5	1	1	135	240	0	15	-T
G4_BC76_191109_LF_LIB_consensus_vsearch	2948	T	Y	372	8	2.06%	2	2	93	93	0.003763569850402068	1	1	140	232	1	7	C
G4_BC76_191109_LF_LIB_consensus_vsearch	2949	G	G	388	4	1.01%	2	1	93	93	0.0620213794085142	1	1	138	250	4	0	A
G4_BC76_191109_LF_LIB_consensus_vsearch	2950	C	C	389	4	1.01%	2	1	93	93	0.06202259804292181	1	1	137	252	4	0	-AC
G4_BC76_191109_LF_LIB_consensus_vsearch	2951	A	*/-C	389	8	2%	2	2	93	93	0.0037696288519149155	1	1	136	253	5	3	-C
G4_BC76_191109_LF_LIB_consensus_vsearch	2952	C	C	386	4	1.02%	2	1	93	93	0.062018923379747036	1	1	136	250	0	4	+T
G4_BC76_191109_LF_LIB_consensus_vsearch	2953	C	*/-T	347	44	10.84%	2	2	93	93	1.57774927801518E-14	1	1	140	207	6	38	-T
G4_BC76_191109_LF_LIB_consensus_vsearch	2954	T	T	358	1	0.28%	2	1	93	93	0.4999999999999138	1	1	140	218	0	1	+GGG
G4_BC76_191109_LF_LIB_consensus_vsearch	2955	T	T	397	5	1.24%	2	2	93	93	0.03086156314569468	1	1	146	251	1	4	C
G4_BC76_191109_LF_LIB_consensus_vsearch	2956	G	G	397	3	0.74%	2	2	93	93	0.12453066332921275	1	1	141	256	2	1	+C
G4_BC76_191109_LF_LIB_consensus_vsearch	2957	C	Y	389	10	2.48%	2	1	93	93	9.223889705434762E-4	1	1	144	245	0	10	T
G4_BC76_191109_LF_LIB_consensus_vsearch	2958	A	A	389	6	1.5%	2	2	93	93	0.015329078637527195	1	1	140	249	4	2	G
G4_BC76_191109_LF_LIB_consensus_vsearch	2959	T	T	393	6	1.49%	2	2	93	93	0.015332037719180692	1	1	144	249	2	4	C
G4_BC76_191109_LF_LIB_consensus_vsearch	2960	G	*/-CG	390	8	1.98%	2	1	93	93	0.0037699692796093966	1	1	143	247	0	8	-CG
G4_BC76_191109_LF_LIB_consensus_vsearch	2961	C	*/-G	377	9	2.26%	2	1	93	93	0.0018631683014264863	1	1	132	245	9	0	-G
G4_BC76_191109_LF_LIB_consensus_vsearch	2962	G	G	378	6	1.53%	2	1	93	93	0.015320624140933634	1	1	133	245	6	0	+A
G4_BC76_191109_LF_LIB_consensus_vsearch	2963	A	A	401	2	0.49%	2	2	93	93	0.24968944099344345	1	1	146	255	1	1	G
G4_BC76_191109_LF_LIB_consensus_vsearch	2964	G	G	397	4	0.99%	2	2	93	93	0.062032128175275904	1	1	146	251	1	3	+AG
G4_BC76_191109_LF_LIB_consensus_vsearch	2965	T	T	401	3	0.74%	2	1	93	93	0.1245353159851805	1	1	148	253	0	3	C
G4_BC76_191109_LF_LIB_consensus_vsearch	2966	C	*/-G	394	10	2.46%	2	2	93	93	9.230485023476184E-4	1	1	142	252	4	6	-G
G4_BC76_191109_LF_LIB_consensus_vsearch	2967	G	G	389	2	0.51%	2	1	93	93	0.24967989756723366	1	1	139	250	0	2	-A
G4_BC76_191109_LF_LIB_consensus_vsearch	2968	A	-GA/-GA	18	370	92.27%	2	2	93	93	8.4123145671793E-202	1	1	14	4	125	245	-GA
G4_BC76_191109_LF_LIB_consensus_vsearch	2969	G	*/-A	11	6	25%	2	2	93	93	0.009202143796136892	1	1	5	6	5	1	-A
G4_BC76_191109_LF_LIB_consensus_vsearch	2970	A	A	19	0	0%	2	0	93	0	1.0	1	0	9	10	0	0	
G4_BC76_191109_LF_LIB_consensus_vsearch	2971	A	*/-G	245	143	35.93%	2	2	93	93	8.559167273667522E-51	1	1	85	160	51	92	-G
G4_BC76_191109_LF_LIB_consensus_vsearch	2972	G	G	250	3	1.17%	2	1	93	93	0.12425742574263329	1	1	87	163	3	0	+A
G4_BC76_191109_LF_LIB_consensus_vsearch	2973	G	G	396	3	0.75%	2	1	93	93	0.12452948557099502	1	1	140	256	0	3	C
G4_BC76_191109_LF_LIB_consensus_vsearch	2974	G	*/-AAT	352	33	8.15%	2	1	93	93	5.6883222526000494E-11	1	1	95	257	33	0	-AAT
G4_BC76_191109_LF_LIB_consensus_vsearch	2975	A	A	354	1	0.28%	2	1	93	93	0.4999999999999138	1	1	98	256	0	1	G
G4_BC76_191109_LF_LIB_consensus_vsearch	2976	A	A	355	4	1.1%	2	2	93	93	0.061977353190804614	1	1	102	253	1	3	-T
G4_BC76_191109_LF_LIB_consensus_vsearch	2977	T	K	354	13	3.5%	2	1	93	93	1.0956125007602598E-4	1	1	102	252	13	0	G
G4_BC76_191109_LF_LIB_consensus_vsearch	2978	T	T	395	4	0.98%	2	1	93	93	0.06202978149183676	1	1	143	252	4	0	+G
G4_BC76_191109_LF_LIB_consensus_vsearch	2979	G	*/+A	367	21	5.17%	2	1	93	93	3.611088560552585E-7	1	1	145	222	0	21	+A
G4_BC76_191109_LF_LIB_consensus_vsearch	2980	A	A	391	3	0.76%	2	1	93	93	0.12452350698836272	1	1	145	246	3	0	G
G4_BC76_191109_LF_LIB_consensus_vsearch	2981	A	A	404	2	0.49%	2	2	93	93	0.24969173859492816	1	1	147	257	1	1	G
G4_BC76_191109_LF_LIB_consensus_vsearch	2982	A	*/-C	377	17	4.17%	2	1	93	93	6.396270971981517E-6	1	1	144	233	0	17	-C
G4_BC76_191109_LF_LIB_consensus_vsearch	2983	C	*/+T	375	12	3.08%	2	1	93	93	2.2389647410688774E-4	1	1	149	226	0	12	+T
G4_BC76_191109_LF_LIB_consensus_vsearch	2984	C	*/-T	381	20	4.91%	2	1	93	93	7.480618802321155E-7	1	1	149	232	0	20	-T
G4_BC76_191109_LF_LIB_consensus_vsearch	2985	T	*/-G	279	76	19.64%	2	2	93	93	1.4667645231289512E-25	1	1	148	131	1	75	-G
G4_BC76_191109_LF_LIB_consensus_vsearch	2986	G	S	305	20	6.04%	2	1	93	93	7.05513742935678E-7	1	1	148	157	0	20	C
G4_BC76_191109_LF_LIB_consensus_vsearch	2987	G	G	397	4	0.98%	2	1	93	93	0.062032128175275904	1	1	146	251	0	4	-A
G4_BC76_191109_LF_LIB_consensus_vsearch	2988	A	A	392	4	1%	2	2	93	93	0.06202621699451153	1	1	141	251	1	3	G
G4_BC76_191109_LF_LIB_consensus_vsearch	2989	G	*/+AG	386	9	2.23%	2	1	93	93	0.0018651929543866046	1	1	133	253	9	0	+AG
G4_BC76_191109_LF_LIB_consensus_vsearch	2990	G	G	401	3	0.74%	2	1	93	93	0.1245353159851805	1	1	147	254	0	3	-CG
G4_BC76_191109_LF_LIB_consensus_vsearch	2991	C	C	399	3	0.74%	2	1	93	93	0.12453300124551302	1	1	149	250	0	3	+G
G4_BC76_191109_LF_LIB_consensus_vsearch	2992	G	G	395	2	0.49%	2	1	93	93	0.24968474148789518	1	1	142	253	2	0	+CG
G4_BC76_191109_LF_LIB_consensus_vsearch	2993	T	Y	376	11	2.71%	2	2	93	93	4.5434311102034934E-4	1	1	142	234	4	7	C
G4_BC76_191109_LF_LIB_consensus_vsearch	2994	A	A	395	4	0.98%	2	1	93	93	0.06202978149183676	1	1	145	250	0	4	-G
G4_BC76_191109_LF_LIB_consensus_vsearch	2995	G	*/-CG	388	7	1.74%	2	2	93	93	0.007605882130108492	1	1	146	242	2	5	-CG
G4_BC76_191109_LF_LIB_consensus_vsearch	2996	C	*/+G	365	10	2.51%	2	2	93	93	9.189827643807342E-4	1	1	133	232	7	3	+G
G4_BC76_191109_LF_LIB_consensus_vsearch	2997	G	*/-A	373	7	1.76%	2	1	93	93	0.007597769697997662	1	1	137	236	7	0	-A
G4_BC76_191109_LF_LIB_consensus_vsearch	2998	A	R	388	7	1.76%	2	2	93	93	0.007605882130108492	1	1	133	255	6	1	G
G4_BC76_191109_LF_LIB_consensus_vsearch	2999	A	*/-C	387	8	1.97%	2	2	93	93	0.0037689428690762675	1	1	133	254	7	1	-C
G4_BC76_191109_LF_LIB_consensus_vsearch	3000	C	C	389	5	1.25%	2	2	93	93	0.030853681237272182	1	1	137	252	3	2	G
G4_BC76_191109_LF_LIB_consensus_vsearch	3001	G	G	390	6	1.47%	2	1	93	93	0.015329823997787357	1	1	143	247	0	6	+TG
G4_BC76_191109_LF_LIB_consensus_vsearch	3002	C	C	398	1	0.25%	2	1	93	93	0.4999999999999138	1	1	146	252	0	1	+G
G4_BC76_191109_LF_LIB_consensus_vsearch	3003	G	G	400	1	0.25%	2	1	93	93	0.4999999999999138	1	1	145	255	1	0	-A
G4_BC76_191109_LF_LIB_consensus_vsearch	3004	A	A	401	1	0.25%	2	1	93	93	0.5000000000008233	1	1	147	254	0	1	+GA
G4_BC76_191109_LF_LIB_consensus_vsearch	3005	C	C	400	3	0.74%	2	1	93	93	0.12453416149047736	1	1	148	252	0	3	T
G4_BC76_191109_LF_LIB_consensus_vsearch	3006	G	G	402	2	0.49%	2	2	93	93	0.2496902106567468	1	1	148	254	1	1	-A
G4_BC76_191109_LF_LIB_consensus_vsearch	3007	A	A	401	2	0.5%	2	1	93	93	0.24968944099344345	1	1	148	253	0	2	+GA
G4_BC76_191109_LF_LIB_consensus_vsearch	3008	T	*/-G	325	53	13.02%	2	2	93	93	1.562906833551754E-17	1	1	107	218	23	30	-G
G4_BC76_191109_LF_LIB_consensus_vsearch	3009	G	G	336	6	1.73%	2	1	93	93	0.015283355757130674	1	1	114	222	6	0	A
G4_BC76_191109_LF_LIB_consensus_vsearch	3010	G	G	395	3	0.75%	2	1	93	93	0.12452830188671389	1	1	144	251	0	3	T
G4_BC76_191109_LF_LIB_consensus_vsearch	3011	G	G	398	6	1.48%	2	2	93	93	0.015335654379945	1	1	145	253	3	3	A
G4_BC76_191109_LF_LIB_consensus_vsearch	3012	G	G	402	2	0.49%	2	1	93	93	0.2496902106567468	1	1	147	255	0	2	+A
G4_BC76_191109_LF_LIB_consensus_vsearch	3013	A	A	401	2	0.49%	2	2	93	93	0.24968944099344345	1	1	145	256	1	1	G
G4_BC76_191109_LF_LIB_consensus_vsearch	3014	A	A	401	4	0.98%	2	1	93	93	0.06203675196794108	1	1	143	258	4	0	G
G4_BC76_191109_LF_LIB_consensus_vsearch	3015	T	T	393	5	1.23%	2	2	93	93	0.03085766177318207	1	1	142	251	1	4	C
G4_BC76_191109_LF_LIB_consensus_vsearch	3016	G	G	399	5	1.23%	2	1	93	93	0.030863484879977227	1	1	142	257	5	0	A
G4_BC76_191109_LF_LIB_consensus_vsearch	3017	T	*/-C	389	9	2.21%	2	2	93	93	0.0018658477399051397	1	1	139	250	3	6	-C
G4_BC76_191109_LF_LIB_consensus_vsearch	3018	C	*/+G	387	9	2.26%	2	1	93	93	0.0018654123049784304	1	1	136	251	9	0	+G
G4_BC76_191109_LF_LIB_consensus_vsearch	3019	C	*/-T	319	55	13.51%	2	2	93	93	3.2541018736409713E-18	1	1	139	180	2	53	-T
G4_BC76_191109_LF_LIB_consensus_vsearch	3020	T	Y	331	11	3.18%	2	2	93	93	4.499900004081131E-4	1	1	140	191	4	7	C
G4_BC76_191109_LF_LIB_consensus_vsearch	3021	T	W	375	9	2.24%	2	1	93	93	0.001862705653908663	1	1	142	233	0	9	A
G4_BC76_191109_LF_LIB_consensus_vsearch	3022	G	*/-TG	367	13	3.27%	2	2	93	93	1.0997406609837605E-4	1	1	135	232	6	7	-TG
G4_BC76_191109_LF_LIB_consensus_vsearch	3023	T	Y	353	10	2.6%	2	2	93	93	9.171138727297223E-4	1	1	134	219	3	7	C
G4_BC76_191109_LF_LIB_consensus_vsearch	3024	G	R	364	9	2.37%	2	2	93	93	0.0018600735687751945	1	1	131	233	4	5	A
G4_BC76_191109_LF_LIB_consensus_vsearch	3025	G	*/-C	382	9	2.28%	2	2	93	93	0.00186430447199865	1	1	144	238	3	6	-C
G4_BC76_191109_LF_LIB_consensus_vsearch	3026	C	*/+G	364	17	4.35%	2	1	93	93	6.357058602775765E-6	1	1	122	242	17	0	+G
G4_BC76_191109_LF_LIB_consensus_vsearch	3027	A	*/-G	370	21	5.26%	2	1	93	93	3.619008797151079E-7	1	1	120	250	21	0	-G
G4_BC76_191109_LF_LIB_consensus_vsearch	3028	G	G	383	1	0.26%	2	1	93	93	0.4999999999999138	1	1	126	257	1	0	+A
G4_BC76_191109_LF_LIB_consensus_vsearch	3029	A	A	397	5	1.23%	2	2	93	93	0.03086156314569468	1	1	143	254	4	1	-C
G4_BC76_191109_LF_LIB_consensus_vsearch	3030	C	C	392	4	0.99%	2	1	93	93	0.06202621699451153	1	1	142	250	0	4	+A
G4_BC76_191109_LF_LIB_consensus_vsearch	3031	A	*/-C	360	34	8.4%	2	2	93	93	2.7666826560318824E-11	1	1	119	241	20	14	-C
G4_BC76_191109_LF_LIB_consensus_vsearch	3032	C	C	361	4	1.08%	2	1	93	93	0.061985950492774826	1	1	123	238	0	4	T
G4_BC76_191109_LF_LIB_consensus_vsearch	3033	C	C	396	4	0.99%	2	1	93	93	0.06203095776871511	1	1	144	252	0	4	T
G4_BC76_191109_LF_LIB_consensus_vsearch	3034	C	Y	381	16	3.93%	2	1	93	93	1.307893571981294E-5	1	1	144	237	0	16	T
G4_BC76_191109_LF_LIB_consensus_vsearch	3035	G	G	394	3	0.76%	2	2	93	93	0.1245271122321419	1	1	142	252	2	1	A
G4_BC76_191109_LF_LIB_consensus_vsearch	3036	C	C	390	4	1%	2	1	93	93	0.062023810487337606	1	1	140	250	0	4	+A
G4_BC76_191109_LF_LIB_consensus_vsearch	3037	A	*/-C	367	28	6.95%	2	2	93	93	2.2689105892084044E-9	1	1	116	251	22	6	-C
G4_BC76_191109_LF_LIB_consensus_vsearch	3038	C	C	367	2	0.53%	2	1	93	93	0.24966078697405694	1	1	119	248	0	2	+T
G4_BC76_191109_LF_LIB_consensus_vsearch	3039	C	C	400	5	1.23%	2	2	93	93	0.030864438634128317	1	1	146	254	1	4	T
G4_BC76_191109_LF_LIB_consensus_vsearch	3040	C	Y	389	12	2.96%	2	1	93	93	2.245840498305788E-4	1	1	144	245	0	12	T
G4_BC76_191109_LF_LIB_consensus_vsearch	3041	G	G	403	2	0.49%	2	2	93	93	0.24969097651407932	1	1	146	257	1	1	+C
G4_BC76_191109_LF_LIB_consensus_vsearch	3042	C	C	401	2	0.49%	2	1	93	93	0.24968944099344345	1	1	144	257	2	0	+GC
G4_BC76_191109_LF_LIB_consensus_vsearch	3043	C	C	393	6	1.47%	2	2	93	93	0.015332037719180692	1	1	144	249	2	4	+T
G4_BC76_191109_LF_LIB_consensus_vsearch	3044	T	Y	391	10	2.48%	2	2	93	93	9.226547240173711E-4	1	1	143	248	4	6	C
G4_BC76_191109_LF_LIB_consensus_vsearch	3045	T	T	392	6	1.47%	2	2	93	93	0.015331303510572384	1	1	142	250	5	1	+A
G4_BC76_191109_LF_LIB_consensus_vsearch	3046	G	G	392	5	1.23%	2	2	93	93	0.030856674154206513	1	1	141	251	2	3	-TG
G4_BC76_191109_LF_LIB_consensus_vsearch	3047	T	T	397	4	1%	2	1	93	93	0.062032128175275904	1	1	146	251	0	4	A
G4_BC76_191109_LF_LIB_consensus_vsearch	3048	G	G	394	3	0.74%	2	1	93	93	0.1245271122321419	1	1	142	252	3	0	A
G4_BC76_191109_LF_LIB_consensus_vsearch	3049	C	*/-G	386	9	2.22%	2	1	93	93	0.0018651929543866046	1	1	137	249	9	0	-G
G4_BC76_191109_LF_LIB_consensus_vsearch	3050	G	*/-AG	376	8	2.02%	2	1	93	93	0.0037650433430064176	1	1	126	250	8	0	-AG
G4_BC76_191109_LF_LIB_consensus_vsearch	3051	A	*/-G	351	29	7.38%	2	2	93	93	1.069117431109715E-9	1	1	102	249	28	1	-G
G4_BC76_191109_LF_LIB_consensus_vsearch	3052	G	G	357	5	1.36%	2	1	93	93	0.030818672390969276	1	1	108	249	0	5	+AG
G4_BC76_191109_LF_LIB_consensus_vsearch	3053	G	G	398	4	0.99%	2	2	93	93	0.06203329275530562	1	1	144	254	2	2	-T
G4_BC76_191109_LF_LIB_consensus_vsearch	3054	T	*/+A	386	8	1.99%	2	1	93	93	0.003768597288121233	1	1	135	251	8	0	+A
G4_BC76_191109_LF_LIB_consensus_vsearch	3055	A	A	393	4	1%	2	2	93	93	0.0620274111497499	1	1	142	251	2	2	G
G4_BC76_191109_LF_LIB_consensus_vsearch	3056	G	G	400	2	0.49%	2	1	93	93	0.24968866749695368	1	1	148	252	0	2	+AA
G4_BC76_191109_LF_LIB_consensus_vsearch	3057	A	A	394	6	1.49%	2	2	93	93	0.015332768266138878	1	1	144	250	4	2	-G
G4_BC76_191109_LF_LIB_consensus_vsearch	3058	G	G	386	4	1%	2	2	93	93	0.062018923379747036	1	1	141	245	3	1	A
G4_BC76_191109_LF_LIB_consensus_vsearch	3059	C	Y	385	12	2.97%	2	2	93	93	2.2439240943114192E-4	1	1	145	240	2	10	T
G4_BC76_191109_LF_LIB_consensus_vsearch	3060	A	A	393	4	0.99%	2	2	93	93	0.0620274111497499	1	1	147	246	1	3	G
G4_BC76_191109_LF_LIB_consensus_vsearch	3061	T	Y	381	12	2.97%	2	2	93	93	2.2419697823514463E-4	1	1	144	237	2	10	C
G4_BC76_191109_LF_LIB_consensus_vsearch	3062	G	G	391	3	0.75%	2	2	93	93	0.12452350698836272	1	1	140	251	2	1	-TA
G4_BC76_191109_LF_LIB_consensus_vsearch	3063	T	Y	378	10	2.51%	2	2	93	93	9.208791978192084E-4	1	1	142	236	3	7	C
G4_BC76_191109_LF_LIB_consensus_vsearch	3064	A	R	386	7	1.74%	2	2	93	93	0.0076048360660226225	1	1	135	251	5	2	G
G4_BC76_191109_LF_LIB_consensus_vsearch	3065	C	Y	377	13	3.23%	2	2	93	93	1.1027355068065241E-4	1	1	140	237	1	12	T
G4_BC76_191109_LF_LIB_consensus_vsearch	3066	G	R	366	26	6.52%	2	2	93	93	9.70733079567718E-9	1	1	118	248	25	1	A
G4_BC76_191109_LF_LIB_consensus_vsearch	3067	G	G	392	6	1.47%	2	1	93	93	0.015331303510572384	1	1	143	249	6	0	T
G4_BC76_191109_LF_LIB_consensus_vsearch	3068	T	T	395	6	1.49%	2	2	93	93	0.015333495178783761	1	1	148	247	1	5	A
G4_BC76_191109_LF_LIB_consensus_vsearch	3069	G	R	394	7	1.72%	2	2	93	93	0.007608958034696689	1	1	143	251	5	2	A
G4_BC76_191109_LF_LIB_consensus_vsearch	3070	C	C	392	5	1.23%	2	1	93	93	0.030856674154206513	1	1	148	244	0	5	T
G4_BC76_191109_LF_LIB_consensus_vsearch	3071	G	G	399	1	0.25%	2	1	93	93	0.4999999999999138	1	1	148	251	1	0	-A
G4_BC76_191109_LF_LIB_consensus_vsearch	3072	A	*/-C	385	11	2.7%	2	2	93	93	4.550976487942495E-4	1	1	135	250	5	6	-C
G4_BC76_191109_LF_LIB_consensus_vsearch	3073	C	C	387	2	0.51%	2	1	93	93	0.24967824967779578	1	1	139	248	0	2	T
G4_BC76_191109_LF_LIB_consensus_vsearch	3074	C	*/+T	392	7	1.74%	2	1	93	93	0.007607942959128091	1	1	142	250	0	7	+T
G4_BC76_191109_LF_LIB_consensus_vsearch	3075	C	Y	346	35	8.58%	2	2	93	93	1.2841652684323611E-11	1	1	144	202	1	34	T
G4_BC76_191109_LF_LIB_consensus_vsearch	3076	G	*/-A	362	36	8.89%	2	2	93	93	6.353587133281144E-12	1	1	113	249	34	2	-A
G4_BC76_191109_LF_LIB_consensus_vsearch	3077	A	A	361	4	1.09%	2	2	93	93	0.061985950492774826	1	1	111	250	1	3	G
G4_BC76_191109_LF_LIB_consensus_vsearch	3078	A	A	402	1	0.25%	2	1	93	93	0.4999999999999138	1	1	147	255	1	0	+GA
G4_BC76_191109_LF_LIB_consensus_vsearch	3079	A	A	403	3	0.74%	2	2	93	93	0.12453760789147728	1	1	147	256	2	1	G
G4_BC76_191109_LF_LIB_consensus_vsearch	3080	G	G	406	0	0%	2	0	93	0	1.0	1	0	149	257	0	0	
G4_BC76_191109_LF_LIB_consensus_vsearch	3081	A	A	404	2	0.49%	2	1	93	93	0.24969173859492816	1	1	149	255	0	2	-T
G4_BC76_191109_LF_LIB_consensus_vsearch	3082	T	T	398	3	0.74%	2	1	93	93	0.12453183520605009	1	1	143	255	3	0	-GGT
G4_BC76_191109_LF_LIB_consensus_vsearch	3083	G	*/+A	390	7	1.74%	2	1	93	93	0.007606917708857565	1	1	136	254	7	0	+A
G4_BC76_191109_LF_LIB_consensus_vsearch	3084	G	G	393	5	1.23%	2	2	93	93	0.03085766177318207	1	1	140	253	3	2	A
G4_BC76_191109_LF_LIB_consensus_vsearch	3085	T	T	389	4	0.99%	2	2	93	93	0.06202259804292181	1	1	137	252	2	2	-G
G4_BC76_191109_LF_LIB_consensus_vsearch	3086	G	G	396	3	0.74%	2	1	93	93	0.12452948557099502	1	1	143	253	3	0	-A
G4_BC76_191109_LF_LIB_consensus_vsearch	3087	A	A	400	4	0.99%	2	2	93	93	0.06203560460879861	1	1	144	256	1	3	G
G4_BC76_191109_LF_LIB_consensus_vsearch	3088	A	A	399	4	0.98%	2	1	93	93	0.06203445155203153	1	1	143	256	4	0	-C
G4_BC76_191109_LF_LIB_consensus_vsearch	3089	C	C	396	2	0.5%	2	1	93	93	0.24968553459123424	1	1	141	255	0	2	-T
G4_BC76_191109_LF_LIB_consensus_vsearch	3090	T	T	397	5	1.23%	2	1	93	93	0.03086156314569468	1	1	149	248	0	5	C
G4_BC76_191109_LF_LIB_consensus_vsearch	3091	A	A	398	5	1.23%	2	2	93	93	0.030862526395586183	1	1	147	251	1	4	G
G4_BC76_191109_LF_LIB_consensus_vsearch	3092	T	T	397	6	1.47%	2	2	93	93	0.015334938209013941	1	1	147	250	1	5	C
G4_BC76_191109_LF_LIB_consensus_vsearch	3093	G	*/-C	375	24	5.9%	2	2	93	93	4.173416239328845E-8	1	1	135	240	6	18	-C
G4_BC76_191109_LF_LIB_consensus_vsearch	3094	C	C	370	5	1.32%	2	1	93	93	0.03083361483319147	1	1	137	233	0	5	+T
G4_BC76_191109_LF_LIB_consensus_vsearch	3095	C	C	395	5	1.24%	2	2	93	93	0.030859622206549208	1	1	142	253	1	4	T
G4_BC76_191109_LF_LIB_consensus_vsearch	3096	C	*/-G	323	41	10.05%	2	2	93	93	1.3787185252470273E-13	1	1	143	180	1	40	-G
G4_BC76_191109_LF_LIB_consensus_vsearch	3097	G	R	329	12	3.47%	2	2	93	93	2.212527302735519E-4	1	1	136	193	11	1	A
G4_BC76_191109_LF_LIB_consensus_vsearch	3098	G	K	359	14	3.62%	2	2	93	93	5.390433933988049E-5	1	1	135	224	1	13	T
G4_BC76_191109_LF_LIB_consensus_vsearch	3099	G	G	398	6	1.47%	2	1	93	93	0.015335654379945	1	1	147	251	0	6	-T
G4_BC76_191109_LF_LIB_consensus_vsearch	3100	T	Y	306	33	8.29%	2	2	93	93	5.135941276725105E-11	1	1	98	208	1	32	C
G4_BC76_191109_LF_LIB_consensus_vsearch	3101	A	A	363	6	1.6%	2	1	93	93	0.015308285207060264	1	1	125	238	0	6	C
G4_BC76_191109_LF_LIB_consensus_vsearch	3102	A	*/-G	375	12	2.98%	2	2	93	93	2.2389647410688774E-4	1	1	140	235	8	4	-G
G4_BC76_191109_LF_LIB_consensus_vsearch	3103	G	*/+A	355	24	6.14%	2	2	93	93	4.0931655821778274E-8	1	1	115	240	23	1	+A
G4_BC76_191109_LF_LIB_consensus_vsearch	3104	G	G	387	5	1.24%	2	1	93	93	0.030851660526274274	1	1	142	245	0	5	-TG
G4_BC76_191109_LF_LIB_consensus_vsearch	3105	T	T	380	6	1.51%	2	2	93	93	0.015322197067995588	1	1	143	237	4	2	+G
G4_BC76_191109_LF_LIB_consensus_vsearch	3106	G	*/-AA	383	9	2.26%	2	1	93	93	0.001864528271344425	1	1	147	236	0	9	-AA
G4_BC76_191109_LF_LIB_consensus_vsearch	3107	A	R	378	8	2.03%	2	2	93	93	0.00376576873622069	1	1	145	233	2	6	G
G4_BC76_191109_LF_LIB_consensus_vsearch	3108	A	A	383	5	1.26%	2	2	93	93	0.030847556649813805	1	1	143	240	3	2	G
G4_BC76_191109_LF_LIB_consensus_vsearch	3109	G	*/-C	389	7	1.75%	2	2	93	93	0.0076064012202881484	1	1	142	247	1	6	-C
G4_BC76_191109_LF_LIB_consensus_vsearch	3110	C	C	387	3	0.76%	2	2	93	93	0.12451861360729544	1	1	146	241	2	1	T
G4_BC76_191109_LF_LIB_consensus_vsearch	3111	C	Y	388	9	2.21%	2	2	93	93	0.0018656305641170923	1	1	142	246	1	8	T
G4_BC76_191109_LF_LIB_consensus_vsearch	3112	A	R	386	7	1.73%	2	2	93	93	0.0076048360660226225	1	1	143	243	5	2	G
G4_BC76_191109_LF_LIB_consensus_vsearch	3113	G	G	399	3	0.74%	2	1	93	93	0.12453300124551302	1	1	149	250	0	3	-TG
G4_BC76_191109_LF_LIB_consensus_vsearch	3114	T	Y	379	10	2.49%	2	1	93	93	9.21019917535404E-4	1	1	145	234	0	10	C
G4_BC76_191109_LF_LIB_consensus_vsearch	3115	G	G	391	4	1.01%	2	2	93	93	0.06202501678889606	1	1	146	245	1	3	+CG
G4_BC76_191109_LF_LIB_consensus_vsearch	3116	G	*/-A	382	10	2.46%	2	2	93	93	9.214378424824657E-4	1	1	146	236	2	8	-A
G4_BC76_191109_LF_LIB_consensus_vsearch	3117	A	A	390	3	0.76%	2	2	93	93	0.12452229299364298	1	1	146	244	1	2	G
G4_BC76_191109_LF_LIB_consensus_vsearch	3118	A	A	401	3	0.74%	2	1	93	93	0.1245353159851805	1	1	149	252	0	3	G
G4_BC76_191109_LF_LIB_consensus_vsearch	3119	A	A	396	4	0.99%	2	2	93	93	0.06203095776871511	1	1	144	252	3	1	G
G4_BC76_191109_LF_LIB_consensus_vsearch	3120	C	C	398	2	0.5%	2	1	93	93	0.249687108886017	1	1	144	254	2	0	-GC
G4_BC76_191109_LF_LIB_consensus_vsearch	3121	G	G	394	3	0.74%	2	2	93	93	0.1245271122321419	1	1	141	253	2	1	A
G4_BC76_191109_LF_LIB_consensus_vsearch	3122	C	C	396	2	0.5%	2	2	93	93	0.24968553459123424	1	1	142	254	1	1	A
G4_BC76_191109_LF_LIB_consensus_vsearch	3123	T	T	393	4	0.99%	2	2	93	93	0.0620274111497499	1	1	143	250	1	3	-G
G4_BC76_191109_LF_LIB_consensus_vsearch	3124	G	R	383	8	2%	2	2	93	93	0.0037675500295774327	1	1	136	247	4	4	A
G4_BC76_191109_LF_LIB_consensus_vsearch	3125	G	G	397	4	0.99%	2	1	93	93	0.062032128175275904	1	1	148	249	0	4	-TG
G4_BC76_191109_LF_LIB_consensus_vsearch	3126	T	*/-G	377	9	2.25%	2	2	93	93	0.0018631683014264863	1	1	144	233	2	7	-G
G4_BC76_191109_LF_LIB_consensus_vsearch	3127	G	G	387	2	0.51%	2	1	93	93	0.24967824967779578	1	1	145	242	0	2	+TG
G4_BC76_191109_LF_LIB_consensus_vsearch	3128	G	G	396	3	0.74%	2	2	93	93	0.12452948557099502	1	1	141	255	2	1	+A
G4_BC76_191109_LF_LIB_consensus_vsearch	3129	A	A	388	6	1.49%	2	2	93	93	0.015328329503561841	1	1	137	251	2	4	+G
G4_BC76_191109_LF_LIB_consensus_vsearch	3130	G	G	392	5	1.25%	2	2	93	93	0.030856674154206513	1	1	143	249	1	4	+T
G4_BC76_191109_LF_LIB_consensus_vsearch	3131	G	*/-C	393	8	1.97%	2	2	93	93	0.003770980459969231	1	1	141	252	6	2	-C
G4_BC76_191109_LF_LIB_consensus_vsearch	3132	C	*/+T	387	8	2%	2	1	93	93	0.0037689428690762675	1	1	141	246	0	8	+T
G4_BC76_191109_LF_LIB_consensus_vsearch	3133	C	*/-T	394	7	1.72%	2	2	93	93	0.007608958034696689	1	1	143	251	3	4	-T
G4_BC76_191109_LF_LIB_consensus_vsearch	3134	T	Y	372	9	2.26%	2	1	93	93	0.00186200269208392	1	1	141	231	0	9	C
G4_BC76_191109_LF_LIB_consensus_vsearch	3135	G	G	382	5	1.26%	2	2	93	93	0.030846517434254234	1	1	135	247	4	1	-TA
G4_BC76_191109_LF_LIB_consensus_vsearch	3136	T	Y	364	18	4.51%	2	2	93	93	3.1077101688596113E-6	1	1	134	230	3	15	C
G4_BC76_191109_LF_LIB_consensus_vsearch	3137	A	R	366	16	4.03%	2	2	93	93	1.2998365918939041E-5	1	1	130	236	8	8	G
G4_BC76_191109_LF_LIB_consensus_vsearch	3138	G	G	385	3	0.76%	2	2	93	93	0.12451612903217696	1	1	142	243	1	2	-C
G4_BC76_191109_LF_LIB_consensus_vsearch	3139	C	Y	378	12	3.01%	2	2	93	93	2.2404784900264377E-4	1	1	136	242	2	10	T
G4_BC76_191109_LF_LIB_consensus_vsearch	3140	G	*/-A	383	7	1.78%	2	2	93	93	0.007603246958909687	1	1	133	250	5	2	-A
G4_BC76_191109_LF_LIB_consensus_vsearch	3141	A	A	390	2	0.5%	2	1	93	93	0.24968071519789278	1	1	141	249	0	2	-TT
G4_BC76_191109_LF_LIB_consensus_vsearch	3142	T	Y	376	18	4.47%	2	2	93	93	3.127618879946835E-6	1	1	144	232	2	16	C
G4_BC76_191109_LF_LIB_consensus_vsearch	3143	T	*/-C	383	10	2.48%	2	1	93	93	9.215757570452482E-4	1	1	147	236	0	10	-C
G4_BC76_191109_LF_LIB_consensus_vsearch	3144	C	C	391	2	0.5%	2	1	93	93	0.24968152866242077	1	1	147	244	0	2	+T
G4_BC76_191109_LF_LIB_consensus_vsearch	3145	T	*/+G	380	16	3.94%	2	1	93	93	1.3073743141806742E-5	1	1	145	235	0	16	+G
G4_BC76_191109_LF_LIB_consensus_vsearch	3146	G	G	403	2	0.49%	2	2	93	93	0.24969097651407932	1	1	147	256	1	1	C
G4_BC76_191109_LF_LIB_consensus_vsearch	3147	A	A	399	3	0.74%	2	2	93	93	0.12453300124551302	1	1	145	254	2	1	G
G4_BC76_191109_LF_LIB_consensus_vsearch	3148	C	C	397	4	0.99%	2	1	93	93	0.062032128175275904	1	1	146	251	0	4	T
G4_BC76_191109_LF_LIB_consensus_vsearch	3149	G	*/-TG	337	59	14.53%	2	1	93	93	1.67917648089902E-19	1	1	142	195	0	59	-TG
G4_BC76_191109_LF_LIB_consensus_vsearch	3150	T	Y	331	8	2.29%	2	1	93	93	0.0037464814144769596	1	1	144	187	0	8	C
G4_BC76_191109_LF_LIB_consensus_vsearch	3151	G	G	330	3	0.87%	2	1	93	93	0.12443609022563339	1	1	138	192	3	0	+C
G4_BC76_191109_LF_LIB_consensus_vsearch	3152	C	*/-A	343	47	11.72%	2	2	93	93	1.6259869956432957E-15	1	1	139	204	3	44	-A
G4_BC76_191109_LF_LIB_consensus_vsearch	3153	A	A	352	1	0.28%	2	1	93	93	0.4999999999999138	1	1	144	208	0	1	+GTA
G4_BC76_191109_LF_LIB_consensus_vsearch	3154	A	A	397	3	0.74%	2	2	93	93	0.12453066332921275	1	1	144	253	2	1	G
G4_BC76_191109_LF_LIB_consensus_vsearch	3155	A	A	395	5	1.23%	2	2	93	93	0.030859622206549208	1	1	145	250	4	1	G
G4_BC76_191109_LF_LIB_consensus_vsearch	3156	T	Y	364	32	7.94%	2	2	93	93	1.2125824794487306E-10	1	1	145	219	2	30	C
G4_BC76_191109_LF_LIB_consensus_vsearch	3157	C	C	391	4	1%	2	1	93	93	0.06202501678889606	1	1	146	245	0	4	+G
G4_BC76_191109_LF_LIB_consensus_vsearch	3158	G	G	404	2	0.49%	2	1	93	93	0.24969173859492816	1	1	147	257	2	0	-A
G4_BC76_191109_LF_LIB_consensus_vsearch	3159	A	A	398	4	0.99%	2	1	93	93	0.06203329275530562	1	1	147	251	0	4	-T
G4_BC76_191109_LF_LIB_consensus_vsearch	3160	T	T	396	3	0.74%	2	1	93	93	0.12452948557099502	1	1	145	251	0	3	C
G4_BC76_191109_LF_LIB_consensus_vsearch	3161	C	C	396	3	0.74%	2	2	93	93	0.12452948557099502	1	1	143	253	2	1	+A
G4_BC76_191109_LF_LIB_consensus_vsearch	3162	G	*/-CG	380	12	2.98%	2	2	93	93	2.2414751491838127E-4	1	1	130	250	11	1	-CG
G4_BC76_191109_LF_LIB_consensus_vsearch	3163	C	*/-GT	372	11	2.8%	2	2	93	93	4.539966388795655E-4	1	1	134	238	1	10	-GT
G4_BC76_191109_LF_LIB_consensus_vsearch	3164	G	G	374	6	1.57%	2	2	93	93	0.015317428749418825	1	1	131	243	4	2	+CG
G4_BC76_191109_LF_LIB_consensus_vsearch	3165	T	*/-A	380	8	2.04%	2	2	93	93	0.003766486715388715	1	1	145	235	1	7	-A
G4_BC76_191109_LF_LIB_consensus_vsearch	3166	A	A	394	3	0.75%	2	1	93	93	0.1245271122321419	1	1	147	247	0	3	C
G4_BC76_191109_LF_LIB_consensus_vsearch	3167	A	A	395	4	0.98%	2	2	93	93	0.06202978149183676	1	1	143	252	2	2	+C
G4_BC76_191109_LF_LIB_consensus_vsearch	3168	C	C	401	1	0.25%	2	1	93	93	0.5000000000008233	1	1	147	254	1	0	+GAC
G4_BC76_191109_LF_LIB_consensus_vsearch	3169	C	C	400	3	0.74%	2	2	93	93	0.12453416149047736	1	1	148	252	1	2	+T
G4_BC76_191109_LF_LIB_consensus_vsearch	3170	T	*/-GG	360	19	4.71%	2	1	93	93	1.513542307305528E-6	1	1	142	218	0	19	-GG
G4_BC76_191109_LF_LIB_consensus_vsearch	3171	G	G	370	3	0.8%	2	2	93	93	0.12449664429518993	1	1	144	226	1	2	+C
G4_BC76_191109_LF_LIB_consensus_vsearch	3172	G	G	379	4	1.03%	2	1	93	93	0.06201012515103793	1	1	144	235	4	0	+A
G4_BC76_191109_LF_LIB_consensus_vsearch	3173	G	G	398	5	1.23%	2	1	93	93	0.030862526395586183	1	1	147	251	0	5	-T
G4_BC76_191109_LF_LIB_consensus_vsearch	3174	T	Y	365	35	8.68%	2	2	93	93	1.3374328460372275E-11	1	1	146	219	1	34	C
G4_BC76_191109_LF_LIB_consensus_vsearch	3175	A	A	393	4	0.98%	2	1	93	93	0.0620274111497499	1	1	145	248	0	4	-T
G4_BC76_191109_LF_LIB_consensus_vsearch	3176	T	*/+G	382	8	2.01%	2	2	93	93	0.0037671973936205536	1	1	138	244	7	1	+G
G4_BC76_191109_LF_LIB_consensus_vsearch	3177	A	*/-G	266	109	27.25%	2	2	93	93	1.5265157473400941E-37	1	1	117	149	24	85	-G
G4_BC76_191109_LF_LIB_consensus_vsearch	3178	G	G	290	1	0.34%	2	1	93	93	0.5000000000003686	1	1	125	165	0	1	+A
G4_BC76_191109_LF_LIB_consensus_vsearch	3179	G	R	390	7	1.74%	2	2	93	93	0.007606917708857565	1	1	147	243	2	5	A
G4_BC76_191109_LF_LIB_consensus_vsearch	3180	G	G	394	6	1.49%	2	1	93	93	0.015332768266138878	1	1	149	245	0	6	A
G4_BC76_191109_LF_LIB_consensus_vsearch	3181	G	G	397	4	0.98%	2	1	93	93	0.062032128175275904	1	1	149	248	0	4	-CG
G4_BC76_191109_LF_LIB_consensus_vsearch	3182	C	C	387	4	1%	2	2	93	93	0.062020154536760255	1	1	143	244	1	3	T
G4_BC76_191109_LF_LIB_consensus_vsearch	3183	G	*/-A	352	22	5.49%	2	2	93	93	1.7347244644637046E-7	1	1	111	241	20	2	-A
G4_BC76_191109_LF_LIB_consensus_vsearch	3184	A	A	376	2	0.53%	2	2	93	93	0.2496688741720519	1	1	122	254	1	1	+GA
G4_BC76_191109_LF_LIB_consensus_vsearch	3185	A	*/+G	383	15	3.74%	2	1	93	93	2.6680639716138052E-5	1	1	127	256	15	0	+G
G4_BC76_191109_LF_LIB_consensus_vsearch	3186	A	*/-G	380	15	3.69%	2	1	93	93	2.6652914497861675E-5	1	1	125	255	15	0	-G
G4_BC76_191109_LF_LIB_consensus_vsearch	3187	G	G	375	4	1.04%	2	2	93	93	0.06200495157771849	1	1	120	255	3	1	+A
G4_BC76_191109_LF_LIB_consensus_vsearch	3188	A	*/+C	384	9	2.26%	2	2	93	93	0.0018647509458963453	1	1	131	253	8	1	+C
G4_BC76_191109_LF_LIB_consensus_vsearch	3189	C	C	399	4	0.98%	2	2	93	93	0.06203445155203153	1	1	147	252	1	3	+T
G4_BC76_191109_LF_LIB_consensus_vsearch	3190	C	*/-T	386	11	2.7%	2	2	93	93	4.551794212032011E-4	1	1	145	241	1	10	-T
G4_BC76_191109_LF_LIB_consensus_vsearch	3191	T	Y	380	11	2.79%	2	2	93	93	4.546826533185083E-4	1	1	144	236	2	9	C
G4_BC76_191109_LF_LIB_consensus_vsearch	3192	A	A	401	2	0.49%	2	2	93	93	0.24968944099344345	1	1	146	255	1	1	G
G4_BC76_191109_LF_LIB_consensus_vsearch	3193	T	T	393	6	1.49%	2	1	93	93	0.015332037719180692	1	1	139	254	6	0	+C
G4_BC76_191109_LF_LIB_consensus_vsearch	3194	C	*/+A	384	11	2.74%	2	1	93	93	4.5501547153779163E-4	1	1	135	249	11	0	+A
G4_BC76_191109_LF_LIB_consensus_vsearch	3195	G	*/-A	390	11	2.7%	2	2	93	93	4.555025215794059E-4	1	1	138	252	9	2	-A
G4_BC76_191109_LF_LIB_consensus_vsearch	3196	A	A	390	4	1.01%	2	2	93	93	0.062023810487337606	1	1	134	256	3	1	G
G4_BC76_191109_LF_LIB_consensus_vsearch	3197	A	A	397	5	1.23%	2	2	93	93	0.03086156314569468	1	1	143	254	2	3	-C
G4_BC76_191109_LF_LIB_consensus_vsearch	3198	C	C	395	3	0.75%	2	2	93	93	0.12452830188671389	1	1	142	253	1	2	T
G4_BC76_191109_LF_LIB_consensus_vsearch	3199	C	Y	379	20	4.93%	2	1	93	93	7.47128900641539E-7	1	1	145	234	0	20	T
G4_BC76_191109_LF_LIB_consensus_vsearch	3200	G	*/+T	372	21	5.15%	2	1	93	93	3.6242294260751566E-7	1	1	140	232	0	21	+T
G4_BC76_191109_LF_LIB_consensus_vsearch	3201	T	T	397	4	0.99%	2	2	93	93	0.062032128175275904	1	1	146	251	1	3	C
G4_BC76_191109_LF_LIB_consensus_vsearch	3202	C	*/-T	376	24	5.91%	2	2	93	93	4.1772503633731856E-8	1	1	143	233	3	21	-T
G4_BC76_191109_LF_LIB_consensus_vsearch	3203	T	*/-A	358	8	2.09%	2	2	93	93	0.003758161303215178	1	1	140	218	2	6	-A
G4_BC76_191109_LF_LIB_consensus_vsearch	3204	A	A	393	3	0.75%	2	1	93	93	0.12452591656124207	1	1	145	248	0	3	C
G4_BC76_191109_LF_LIB_consensus_vsearch	3205	A	A	394	6	1.47%	2	2	93	93	0.015332768266138878	1	1	144	250	1	5	C
G4_BC76_191109_LF_LIB_consensus_vsearch	3206	T	Y	385	13	3.19%	2	2	93	93	1.1050267709682812E-4	1	1	144	241	1	12	C
G4_BC76_191109_LF_LIB_consensus_vsearch	3207	G	G	399	2	0.5%	2	2	93	93	0.24968789013733722	1	1	145	254	1	1	A
G4_BC76_191109_LF_LIB_consensus_vsearch	3208	G	G	391	5	1.23%	2	2	93	93	0.030855681550508444	1	1	141	250	1	4	A
G4_BC76_191109_LF_LIB_consensus_vsearch	3209	C	Y	385	7	1.75%	2	2	93	93	0.007604309052101333	1	1	139	246	1	6	T
G4_BC76_191109_LF_LIB_consensus_vsearch	3210	T	T	392	5	1.24%	2	1	93	93	0.030856674154206513	1	1	144	248	0	5	-G
G4_BC76_191109_LF_LIB_consensus_vsearch	3211	G	G	393	3	0.75%	2	2	93	93	0.12452591656124207	1	1	145	248	2	1	A
G4_BC76_191109_LF_LIB_consensus_vsearch	3212	G	G	385	6	1.49%	2	1	93	93	0.01532605917062568	1	1	142	243	0	6	-T
G4_BC76_191109_LF_LIB_consensus_vsearch	3213	T	T	396	3	0.75%	2	2	93	93	0.12452948557099502	1	1	147	249	2	1	C
G4_BC76_191109_LF_LIB_consensus_vsearch	3214	T	*/-C	250	133	32.76%	2	2	93	93	7.954551053687292E-47	1	1	107	143	40	93	-C
G4_BC76_191109_LF_LIB_consensus_vsearch	3215	C	C	258	3	1.15%	2	1	93	93	0.12428023032618613	1	1	105	153	3	0	T
G4_BC76_191109_LF_LIB_consensus_vsearch	3216	C	C	377	6	1.52%	2	1	93	93	0.01531983153360656	1	1	142	235	6	0	+A
G4_BC76_191109_LF_LIB_consensus_vsearch	3217	C	C	397	5	1.23%	2	1	93	93	0.03086156314569468	1	1	149	248	0	5	+T
G4_BC76_191109_LF_LIB_consensus_vsearch	3218	T	*/-C	348	55	13.61%	2	2	93	93	3.840697834941114E-18	1	1	95	253	54	1	-C
G4_BC76_191109_LF_LIB_consensus_vsearch	3219	C	C	343	6	1.71%	2	1	93	93	0.015290188241060826	1	1	94	249	0	6	+TC
G4_BC76_191109_LF_LIB_consensus_vsearch	3220	C	*/+G	355	21	5.16%	2	1	93	93	3.578293770447646E-7	1	1	134	221	0	21	+G
G4_BC76_191109_LF_LIB_consensus_vsearch	3221	G	*/-AA	378	7	1.79%	2	2	93	93	0.007600543705812317	1	1	129	249	3	4	-AA
G4_BC76_191109_LF_LIB_consensus_vsearch	3222	A	A	379	4	1.04%	2	2	93	93	0.06201012515103793	1	1	132	247	1	3	G
G4_BC76_191109_LF_LIB_consensus_vsearch	3223	A	A	396	3	0.75%	2	2	93	93	0.12452948557099502	1	1	145	251	1	2	G
G4_BC76_191109_LF_LIB_consensus_vsearch	3224	G	*/+T	157	234	57.35%	2	2	93	93	1.8609689672848452E-93	1	1	40	117	106	128	+T
G4_BC76_191109_LF_LIB_consensus_vsearch	3225	T	T	402	3	0.74%	2	1	93	93	0.1245364647713705	1	1	149	253	0	3	+C
G4_BC76_191109_LF_LIB_consensus_vsearch	3226	T	*/-CCC	345	23	5.67%	2	1	93	93	8.361576220545492E-8	1	1	144	201	0	23	-CCC
G4_BC76_191109_LF_LIB_consensus_vsearch	3227	C	Y	247	119	32.43%	2	2	93	93	1.4994019283131345E-41	1	1	108	139	40	79	T
G4_BC76_191109_LF_LIB_consensus_vsearch	3228	C	Y	361	13	3.39%	2	1	93	93	1.0978697048549478E-4	1	1	148	213	0	13	T
G4_BC76_191109_LF_LIB_consensus_vsearch	3229	C	*/-T	360	10	2.6%	2	1	93	93	9.182185248776328E-4	1	1	149	211	0	10	-T
G4_BC76_191109_LF_LIB_consensus_vsearch	3230	T	Y	380	10	2.53%	2	1	93	93	9.211599279939985E-4	1	1	146	234	0	10	C
G4_BC76_191109_LF_LIB_consensus_vsearch	3231	C	C	393	3	0.74%	2	2	93	93	0.12452591656124207	1	1	146	247	1	2	+T
G4_BC76_191109_LF_LIB_consensus_vsearch	3232	A	*/-G	363	32	7.94%	2	1	93	93	1.2104971840134513E-10	1	1	144	219	0	32	-G
G4_BC76_191109_LF_LIB_consensus_vsearch	3233	G	G	371	2	0.54%	2	2	93	93	0.24966442953001958	1	1	148	223	1	1	+T
G4_BC76_191109_LF_LIB_consensus_vsearch	3234	G	G	405	2	0.49%	2	1	93	93	0.2496924969251474	1	1	149	256	0	2	C
G4_BC76_191109_LF_LIB_consensus_vsearch	3235	A	A	403	1	0.25%	2	1	93	93	0.4999999999999138	1	1	148	255	1	0	+C
G4_BC76_191109_LF_LIB_consensus_vsearch	3236	T	T	395	3	0.74%	2	1	93	93	0.12452830188671389	1	1	144	251	0	3	+AA
G4_BC76_191109_LF_LIB_consensus_vsearch	3237	A	*/-G	384	7	1.73%	2	2	93	93	0.007603779356567615	1	1	139	245	1	6	-G
G4_BC76_191109_LF_LIB_consensus_vsearch	3238	G	G	389	2	0.51%	2	1	93	93	0.24967989756723366	1	1	142	247	0	2	+C
G4_BC76_191109_LF_LIB_consensus_vsearch	3239	C	Y	388	7	1.74%	2	2	93	93	0.007605882130108492	1	1	143	245	1	6	T
G4_BC76_191109_LF_LIB_consensus_vsearch	3240	T	T	380	6	1.48%	2	2	93	93	0.015322197067995588	1	1	146	234	1	5	C
G4_BC76_191109_LF_LIB_consensus_vsearch	3241	G	R	392	7	1.72%	2	1	93	93	0.007607942959128091	1	1	146	246	0	7	A
G4_BC76_191109_LF_LIB_consensus_vsearch	3242	C	S	339	41	10.2%	2	1	93	93	1.4539580303922012E-13	1	1	146	193	0	41	G
G4_BC76_191109_LF_LIB_consensus_vsearch	3243	G	*/-T	384	12	2.97%	2	1	93	93	2.2434391137769687E-4	1	1	143	241	0	12	-T
G4_BC76_191109_LF_LIB_consensus_vsearch	3244	T	*/+GT	344	34	8.59%	2	1	93	93	2.67696387917156E-11	1	1	148	196	0	34	+GT
G4_BC76_191109_LF_LIB_consensus_vsearch	3245	T	*/-C	372	29	7.11%	2	2	93	93	1.1018517250849488E-9	1	1	134	238	12	17	-C
G4_BC76_191109_LF_LIB_consensus_vsearch	3246	C	Y	366	12	3.17%	2	2	93	93	2.234283568245827E-4	1	1	130	236	7	5	T
G4_BC76_191109_LF_LIB_consensus_vsearch	3247	C	Y	385	16	3.93%	2	1	93	93	1.3099462057416885E-5	1	1	149	236	0	16	T
G4_BC76_191109_LF_LIB_consensus_vsearch	3248	T	T	394	4	0.99%	2	2	93	93	0.06202859930052086	1	1	143	251	1	3	C
G4_BC76_191109_LF_LIB_consensus_vsearch	3249	A	A	389	5	1.24%	2	2	93	93	0.030853681237272182	1	1	139	250	4	1	G
G4_BC76_191109_LF_LIB_consensus_vsearch	3250	T	T	394	4	0.99%	2	1	93	93	0.06202859930052086	1	1	140	254	4	0	G
G4_BC76_191109_LF_LIB_consensus_vsearch	3251	T	*/+G	389	9	2.22%	2	1	93	93	0.0018658477399051397	1	1	144	245	0	9	+G
G4_BC76_191109_LF_LIB_consensus_vsearch	3252	G	G	402	2	0.49%	2	2	93	93	0.2496902106567468	1	1	145	257	1	1	+A
G4_BC76_191109_LF_LIB_consensus_vsearch	3253	A	*/-G	373	26	6.37%	2	2	93	93	9.783046480984443E-9	1	1	119	254	25	1	-G
G4_BC76_191109_LF_LIB_consensus_vsearch	3254	G	*/-AG	360	16	4.2%	2	2	93	93	1.2964449230219886E-5	1	1	108	252	13	3	-AG
G4_BC76_191109_LF_LIB_consensus_vsearch	3255	A	A	386	2	0.51%	2	2	93	93	0.24967741935460958	1	1	132	254	1	1	G
G4_BC76_191109_LF_LIB_consensus_vsearch	3256	G	G	382	4	1.03%	2	1	93	93	0.06201393491983747	1	1	132	250	0	4	+AG
G4_BC76_191109_LF_LIB_consensus_vsearch	3257	T	T	401	3	0.74%	2	2	93	93	0.1245353159851805	1	1	146	255	1	2	C
G4_BC76_191109_LF_LIB_consensus_vsearch	3258	C	C	398	3	0.74%	2	1	93	93	0.12453183520605009	1	1	143	255	3	0	-A
G4_BC76_191109_LF_LIB_consensus_vsearch	3259	A	R	388	8	1.98%	2	2	93	93	0.0037692867193449852	1	1	138	250	6	2	G
G4_BC76_191109_LF_LIB_consensus_vsearch	3260	G	G	391	5	1.24%	2	1	93	93	0.030855681550508444	1	1	137	254	5	0	-T
G4_BC76_191109_LF_LIB_consensus_vsearch	3261	T	Y	389	7	1.75%	2	1	93	93	0.0076064012202881484	1	1	141	248	0	7	C
G4_BC76_191109_LF_LIB_consensus_vsearch	3262	T	T	393	5	1.24%	2	1	93	93	0.03085766177318207	1	1	142	251	5	0	-GC
G4_BC76_191109_LF_LIB_consensus_vsearch	3263	G	G	392	2	0.5%	2	1	93	93	0.24968233799211464	1	1	141	251	0	2	A
G4_BC76_191109_LF_LIB_consensus_vsearch	3264	C	Y	377	11	2.74%	2	2	93	93	4.544286380884945E-4	1	1	135	242	1	10	T
G4_BC76_191109_LF_LIB_consensus_vsearch	3265	A	A	378	5	1.26%	2	2	93	93	0.030842306341483338	1	1	136	242	4	1	G
G4_BC76_191109_LF_LIB_consensus_vsearch	3266	C	C	387	3	0.75%	2	1	93	93	0.12451861360729544	1	1	139	248	0	3	T
G4_BC76_191109_LF_LIB_consensus_vsearch	3267	T	T	384	5	1.25%	2	1	93	93	0.030848590526024323	1	1	144	240	0	5	+G
G4_BC76_191109_LF_LIB_consensus_vsearch	3268	G	G	396	2	0.5%	2	1	93	93	0.24968553459123424	1	1	144	252	0	2	A
G4_BC76_191109_LF_LIB_consensus_vsearch	3269	C	Y	376	10	2.48%	2	1	93	93	9.205956089622115E-4	1	1	144	232	0	10	T
G4_BC76_191109_LF_LIB_consensus_vsearch	3270	G	R	359	23	5.81%	2	2	93	93	8.474342957223857E-8	1	1	119	240	22	1	A
G4_BC76_191109_LF_LIB_consensus_vsearch	3271	G	G	397	5	1.24%	2	2	93	93	0.03086156314569468	1	1	143	254	3	2	-T
G4_BC76_191109_LF_LIB_consensus_vsearch	3272	T	*/+A	378	11	2.74%	2	1	93	93	4.5451373534606624E-4	1	1	127	251	11	0	+A
G4_BC76_191109_LF_LIB_consensus_vsearch	3273	A	R	388	9	2.23%	2	2	93	93	0.0018656305641170923	1	1	135	253	8	1	G
G4_BC76_191109_LF_LIB_consensus_vsearch	3274	G	G	397	5	1.23%	2	2	93	93	0.03086156314569468	1	1	142	255	4	1	-A
G4_BC76_191109_LF_LIB_consensus_vsearch	3275	A	R	383	8	2%	2	2	93	93	0.0037675500295774327	1	1	130	253	6	2	G
G4_BC76_191109_LF_LIB_consensus_vsearch	3276	G	G	400	2	0.49%	2	1	93	93	0.24968866749695368	1	1	145	255	0	2	-C
G4_BC76_191109_LF_LIB_consensus_vsearch	3277	C	*/+A	388	10	2.46%	2	2	93	93	9.222551090526941E-4	1	1	140	248	9	1	+A
G4_BC76_191109_LF_LIB_consensus_vsearch	3278	G	*/-A	397	8	1.97%	2	2	93	93	0.003772305589141729	1	1	141	256	7	1	-A
G4_BC76_191109_LF_LIB_consensus_vsearch	3279	A	A	391	4	1%	2	2	93	93	0.06202501678889606	1	1	137	254	2	2	G
G4_BC76_191109_LF_LIB_consensus_vsearch	3280	A	*/-T	396	7	1.72%	2	2	93	93	0.007609963086240239	1	1	143	253	1	6	-T
G4_BC76_191109_LF_LIB_consensus_vsearch	3281	T	T	396	3	0.75%	2	2	93	93	0.12452948557099502	1	1	146	250	1	2	C
G4_BC76_191109_LF_LIB_consensus_vsearch	3282	G	G	402	2	0.49%	2	1	93	93	0.2496902106567468	1	1	146	256	2	0	-A
G4_BC76_191109_LF_LIB_consensus_vsearch	3283	A	A	395	6	1.48%	2	2	93	93	0.015333495178783761	1	1	145	250	1	5	-T
G4_BC76_191109_LF_LIB_consensus_vsearch	3284	T	T	399	1	0.25%	2	1	93	93	0.4999999999999138	1	1	148	251	0	1	+G
G4_BC76_191109_LF_LIB_consensus_vsearch	3285	T	T	390	5	1.23%	2	2	93	93	0.030854683924238017	1	1	143	247	4	1	+G
G4_BC76_191109_LF_LIB_consensus_vsearch	3286	A	*/-G	324	43	10.67%	2	2	93	93	3.077701755084485E-14	1	1	133	191	4	39	-G
G4_BC76_191109_LF_LIB_consensus_vsearch	3287	G	G	348	3	0.84%	2	2	93	93	0.12446504992864586	1	1	139	209	1	2	A
G4_BC76_191109_LF_LIB_consensus_vsearch	3288	G	G	394	4	0.99%	2	2	93	93	0.06202859930052086	1	1	143	251	2	2	A
G4_BC76_191109_LF_LIB_consensus_vsearch	3289	C	Y	387	9	2.25%	2	1	93	93	0.0018654123049784304	1	1	145	242	0	9	T
G4_BC76_191109_LF_LIB_consensus_vsearch	3290	G	G	397	3	0.74%	2	1	93	93	0.12453066332921275	1	1	144	253	3	0	A
G4_BC76_191109_LF_LIB_consensus_vsearch	3291	T	T	399	3	0.74%	2	1	93	93	0.12453300124551302	1	1	147	252	0	3	-C
G4_BC76_191109_LF_LIB_consensus_vsearch	3292	C	*/-T	389	13	3.22%	2	1	93	93	1.1061393736967548E-4	1	1	148	241	0	13	-T
G4_BC76_191109_LF_LIB_consensus_vsearch	3293	T	*/+C	368	10	2.53%	2	1	93	93	9.194317755037062E-4	1	1	129	239	10	0	+C
G4_BC76_191109_LF_LIB_consensus_vsearch	3294	C	*/-G	353	26	6.44%	2	2	93	93	9.560726489103875E-9	1	1	140	213	3	23	-G
G4_BC76_191109_LF_LIB_consensus_vsearch	3295	G	R	332	32	8.7%	2	2	93	93	1.1419833450431916E-10	1	1	116	216	29	3	A
G4_BC76_191109_LF_LIB_consensus_vsearch	3296	G	R	384	10	2.53%	2	2	93	93	9.217129834227815E-4	1	1	142	242	7	3	A
G4_BC76_191109_LF_LIB_consensus_vsearch	3297	G	R	392	15	3.68%	2	2	93	93	2.6761482303826905E-5	1	1	148	244	1	14	A
G4_BC76_191109_LF_LIB_consensus_vsearch	3298	G	R	397	7	1.72%	2	2	93	93	0.00761046189928152	1	1	146	251	1	6	A
G4_BC76_191109_LF_LIB_consensus_vsearch	3299	C	Y	390	7	1.73%	2	2	93	93	0.007606917708857565	1	1	146	244	1	6	T
G4_BC76_191109_LF_LIB_consensus_vsearch	3300	C	Y	396	9	2.21%	2	2	93	93	0.0018673383028544072	1	1	148	248	1	8	T
G4_BC76_191109_LF_LIB_consensus_vsearch	3301	A	*/-T	395	8	1.97%	2	2	93	93	0.00377164628554966	1	1	146	249	1	7	-T
G4_BC76_191109_LF_LIB_consensus_vsearch	3302	T	T	392	5	1.25%	2	2	93	93	0.030856674154206513	1	1	145	247	2	3	-C
G4_BC76_191109_LF_LIB_consensus_vsearch	3303	C	C	395	5	1.24%	2	1	93	93	0.030859622206549208	1	1	145	250	0	5	-A
G4_BC76_191109_LF_LIB_consensus_vsearch	3304	A	R	378	11	2.74%	2	2	93	93	4.5451373534606624E-4	1	1	138	240	7	4	G
G4_BC76_191109_LF_LIB_consensus_vsearch	3305	T	T	387	3	0.75%	2	1	93	93	0.12451861360729544	1	1	146	241	0	3	-G
G4_BC76_191109_LF_LIB_consensus_vsearch	3306	G	G	393	4	1%	2	1	93	93	0.0620274111497499	1	1	149	244	0	4	C
G4_BC76_191109_LF_LIB_consensus_vsearch	3307	G	*/+C	382	11	2.72%	2	2	93	93	4.548498903980809E-4	1	1	142	240	1	10	+C
G4_BC76_191109_LF_LIB_consensus_vsearch	3308	C	C	392	2	0.5%	2	1	93	93	0.24968233799211464	1	1	143	249	0	2	A
G4_BC76_191109_LF_LIB_consensus_vsearch	3309	C	*/-T	382	10	2.46%	2	2	93	93	9.214378424824657E-4	1	1	146	236	1	9	-T
G4_BC76_191109_LF_LIB_consensus_vsearch	3310	T	Y	368	10	2.55%	2	2	93	93	9.194317755037062E-4	1	1	140	228	1	9	C
G4_BC76_191109_LF_LIB_consensus_vsearch	3311	C	C	388	3	0.76%	2	2	93	93	0.12451984635071693	1	1	145	243	1	2	-G
G4_BC76_191109_LF_LIB_consensus_vsearch	3312	G	G	396	6	1.49%	2	2	93	93	0.015334218484153218	1	1	143	253	3	3	A
G4_BC76_191109_LF_LIB_consensus_vsearch	3313	G	G	401	3	0.74%	2	1	93	93	0.1245353159851805	1	1	146	255	0	3	+C
G4_BC76_191109_LF_LIB_consensus_vsearch	3314	C	C	401	4	0.98%	2	2	93	93	0.06203675196794108	1	1	147	254	1	3	-T
G4_BC76_191109_LF_LIB_consensus_vsearch	3315	T	T	390	5	1.24%	2	1	93	93	0.030854683924238017	1	1	143	247	0	5	C
G4_BC76_191109_LF_LIB_consensus_vsearch	3316	C	C	402	2	0.49%	2	1	93	93	0.2496902106567468	1	1	146	256	2	0	-A
G4_BC76_191109_LF_LIB_consensus_vsearch	3317	A	A	394	4	0.99%	2	1	93	93	0.06202859930052086	1	1	145	249	0	4	+T
G4_BC76_191109_LF_LIB_consensus_vsearch	3318	T	T	396	3	0.75%	2	2	93	93	0.12452948557099502	1	1	146	250	2	1	G
G4_BC76_191109_LF_LIB_consensus_vsearch	3319	T	T	392	6	1.48%	2	2	93	93	0.015331303510572384	1	1	145	247	1	5	C
G4_BC76_191109_LF_LIB_consensus_vsearch	3320	C	C	399	2	0.5%	2	1	93	93	0.24968789013733722	1	1	147	252	0	2	+T
G4_BC76_191109_LF_LIB_consensus_vsearch	3321	T	T	397	3	0.74%	2	1	93	93	0.12453066332921275	1	1	144	253	3	0	+C
G4_BC76_191109_LF_LIB_consensus_vsearch	3322	C	*/-A	383	18	4.43%	2	2	93	93	3.13872460829863E-6	1	1	145	238	2	16	-A
G4_BC76_191109_LF_LIB_consensus_vsearch	3323	A	A	384	2	0.51%	2	2	93	93	0.24967574578483906	1	1	145	239	1	1	C
G4_BC76_191109_LF_LIB_consensus_vsearch	3324	A	A	404	2	0.49%	2	2	93	93	0.24969173859492816	1	1	146	258	1	1	C
G4_BC76_191109_LF_LIB_consensus_vsearch	3325	A	A	400	6	1.47%	2	1	93	93	0.015337076164670276	1	1	143	257	6	0	G
G4_BC76_191109_LF_LIB_consensus_vsearch	3326	C	*/-T	352	54	13.24%	2	2	93	93	8.401406273332462E-18	1	1	146	206	1	53	-T
G4_BC76_191109_LF_LIB_consensus_vsearch	3327	T	*/-C	323	24	6.82%	2	2	93	93	3.9488770690058475E-8	1	1	124	199	21	3	-C
G4_BC76_191109_LF_LIB_consensus_vsearch	3328	C	C	379	0	0%	2	0	93	0	1.0	1	0	126	253	0	0	
G4_BC76_191109_LF_LIB_consensus_vsearch	3329	C	*/+G	363	11	2.72%	2	2	93	93	4.5319061514943347E-4	1	1	129	234	4	7	+G
G4_BC76_191109_LF_LIB_consensus_vsearch	3330	G	G	381	5	1.28%	2	2	93	93	0.03084547283766662	1	1	126	255	4	1	-A
G4_BC76_191109_LF_LIB_consensus_vsearch	3331	A	A	386	6	1.53%	2	1	93	93	0.015326819799317902	1	1	128	258	6	0	G
G4_BC76_191109_LF_LIB_consensus_vsearch	3332	A	A	396	3	0.74%	2	1	93	93	0.12452948557099502	1	1	139	257	3	0	-T
G4_BC76_191109_LF_LIB_consensus_vsearch	3333	T	K	385	16	3.98%	2	1	93	93	1.3099462057416885E-5	1	1	129	256	16	0	G
G4_BC76_191109_LF_LIB_consensus_vsearch	3334	T	T	400	2	0.49%	2	1	93	93	0.24968866749695368	1	1	146	254	0	2	-G
G4_BC76_191109_LF_LIB_consensus_vsearch	3335	G	G	393	6	1.49%	2	2	93	93	0.015332037719180692	1	1	144	249	3	3	A
G4_BC76_191109_LF_LIB_consensus_vsearch	3336	C	Y	378	21	5.19%	2	2	93	93	3.6396125108305166E-7	1	1	147	231	1	20	T
G4_BC76_191109_LF_LIB_consensus_vsearch	3337	A	A	391	5	1.23%	2	2	93	93	0.030855681550508444	1	1	145	246	2	3	G
G4_BC76_191109_LF_LIB_consensus_vsearch	3338	T	Y	389	9	2.23%	2	2	93	93	0.0018658477399051397	1	1	146	243	1	8	C
G4_BC76_191109_LF_LIB_consensus_vsearch	3339	G	G	396	5	1.23%	2	2	93	93	0.03086059509471206	1	1	143	253	1	4	-CG
G4_BC76_191109_LF_LIB_consensus_vsearch	3340	C	C	395	4	0.99%	2	2	93	93	0.06202978149183676	1	1	145	250	2	2	T
G4_BC76_191109_LF_LIB_consensus_vsearch	3341	G	G	390	3	0.75%	2	1	93	93	0.12452229299364298	1	1	146	244	0	3	+TG
G4_BC76_191109_LF_LIB_consensus_vsearch	3342	A	A	403	1	0.25%	2	1	93	93	0.4999999999999138	1	1	146	257	0	1	+C
G4_BC76_191109_LF_LIB_consensus_vsearch	3343	T	*/-C	367	38	9.34%	2	2	93	93	1.4638040883170877E-12	1	1	113	254	35	3	-C
G4_BC76_191109_LF_LIB_consensus_vsearch	3344	C	C	367	2	0.54%	2	2	93	93	0.24966078697405694	1	1	112	255	1	1	T
G4_BC76_191109_LF_LIB_consensus_vsearch	3345	C	C	401	2	0.49%	2	1	93	93	0.24968944099344345	1	1	147	254	0	2	+TG
G4_BC76_191109_LF_LIB_consensus_vsearch	3346	C	C	401	4	0.98%	2	1	93	93	0.06203675196794108	1	1	149	252	0	4	T
G4_BC76_191109_LF_LIB_consensus_vsearch	3347	G	G	403	2	0.49%	2	1	93	93	0.24969097651407932	1	1	148	255	0	2	-TG
G4_BC76_191109_LF_LIB_consensus_vsearch	3348	T	T	402	3	0.74%	2	2	93	93	0.1245364647713705	1	1	148	254	1	2	C
G4_BC76_191109_LF_LIB_consensus_vsearch	3349	G	G	404	1	0.25%	2	1	93	93	0.4999999999999138	1	1	148	256	1	0	+TT
G4_BC76_191109_LF_LIB_consensus_vsearch	3350	C	Y	388	7	1.72%	2	1	93	93	0.007605882130108492	1	1	147	241	0	7	T
G4_BC76_191109_LF_LIB_consensus_vsearch	3351	T	T	392	4	0.99%	2	2	93	93	0.06202621699451153	1	1	143	249	1	3	C
G4_BC76_191109_LF_LIB_consensus_vsearch	3352	G	G	390	4	0.99%	2	2	93	93	0.062023810487337606	1	1	143	247	2	2	-T
G4_BC76_191109_LF_LIB_consensus_vsearch	3353	T	W	382	10	2.49%	2	2	93	93	9.214378424824657E-4	1	1	139	243	2	8	A
G4_BC76_191109_LF_LIB_consensus_vsearch	3354	G	G	399	2	0.49%	2	1	93	93	0.24968789013733722	1	1	145	254	0	2	C
G4_BC76_191109_LF_LIB_consensus_vsearch	3355	A	*/-C	388	9	2.22%	2	2	93	93	0.0018656305641170923	1	1	135	253	7	2	-C
G4_BC76_191109_LF_LIB_consensus_vsearch	3356	C	C	394	1	0.25%	2	1	93	93	0.4999999999999138	1	1	137	257	1	0	+A
G4_BC76_191109_LF_LIB_consensus_vsearch	3357	C	*/-T	358	25	6.14%	2	2	93	93	1.9884242625123982E-8	1	1	133	225	5	20	-T
G4_BC76_191109_LF_LIB_consensus_vsearch	3358	T	T	366	6	1.6%	2	2	93	93	0.015310832380401212	1	1	135	231	1	5	C
G4_BC76_191109_LF_LIB_consensus_vsearch	3359	T	T	384	6	1.49%	2	2	93	93	0.015325294651568566	1	1	137	247	1	5	C
G4_BC76_191109_LF_LIB_consensus_vsearch	3360	G	*/-TG	378	15	3.74%	2	2	93	93	2.663420769821532E-5	1	1	126	252	14	1	-TG
G4_BC76_191109_LF_LIB_consensus_vsearch	3361	T	Y	367	8	2.06%	2	2	93	93	0.0037616841729398503	1	1	127	240	4	4	C
G4_BC76_191109_LF_LIB_consensus_vsearch	3362	G	G	381	3	0.78%	2	2	93	93	0.12451108213814827	1	1	133	248	1	2	A
G4_BC76_191109_LF_LIB_consensus_vsearch	3363	G	G	398	3	0.74%	2	2	93	93	0.12453183520605009	1	1	148	250	1	2	A
G4_BC76_191109_LF_LIB_consensus_vsearch	3364	C	*/-AC	390	7	1.72%	2	2	93	93	0.007606917708857565	1	1	142	248	6	1	-AC
G4_BC76_191109_LF_LIB_consensus_vsearch	3365	A	A	399	2	0.5%	2	1	93	93	0.24968789013733722	1	1	143	256	0	2	T
G4_BC76_191109_LF_LIB_consensus_vsearch	3366	C	C	395	4	1%	2	2	93	93	0.06202978149183676	1	1	140	255	2	2	T
G4_BC76_191109_LF_LIB_consensus_vsearch	3367	G	G	394	4	0.99%	2	2	93	93	0.06202859930052086	1	1	143	251	1	3	-C
G4_BC76_191109_LF_LIB_consensus_vsearch	3368	C	C	393	3	0.75%	2	2	93	93	0.12452591656124207	1	1	144	249	1	2	T
G4_BC76_191109_LF_LIB_consensus_vsearch	3369	C	*/-G	377	14	3.47%	2	2	93	93	5.421900571236966E-5	1	1	142	235	2	12	-G
G4_BC76_191109_LF_LIB_consensus_vsearch	3370	G	G	377	3	0.77%	2	2	93	93	0.124505928853663	1	1	139	238	1	2	A
G4_BC76_191109_LF_LIB_consensus_vsearch	3371	G	G	395	3	0.74%	2	2	93	93	0.12452830188671389	1	1	143	252	1	2	C
G4_BC76_191109_LF_LIB_consensus_vsearch	3372	G	G	390	4	0.99%	2	2	93	93	0.062023810487337606	1	1	141	249	2	2	-C
G4_BC76_191109_LF_LIB_consensus_vsearch	3373	C	*/+A	286	82	20.45%	2	1	93	93	1.2768993820811783E-27	1	1	138	148	0	82	+A
G4_BC76_191109_LF_LIB_consensus_vsearch	3374	A	A	386	1	0.26%	2	1	93	93	0.4999999999999138	1	1	144	242	1	0	G
G4_BC76_191109_LF_LIB_consensus_vsearch	3375	A	A	393	5	1.24%	2	2	93	93	0.03085766177318207	1	1	141	252	3	2	G
G4_BC76_191109_LF_LIB_consensus_vsearch	3376	A	*/-T	392	7	1.72%	2	2	93	93	0.007607942959128091	1	1	146	246	2	5	-T
G4_BC76_191109_LF_LIB_consensus_vsearch	3377	T	T	389	5	1.25%	2	1	93	93	0.030853681237272182	1	1	144	245	0	5	C
G4_BC76_191109_LF_LIB_consensus_vsearch	3378	G	G	389	6	1.48%	2	1	93	93	0.015329078637527195	1	1	140	249	0	6	C
G4_BC76_191109_LF_LIB_consensus_vsearch	3379	A	A	390	6	1.48%	2	2	93	93	0.015329823997787357	1	1	137	253	4	2	G
G4_BC76_191109_LF_LIB_consensus_vsearch	3380	C	C	395	3	0.74%	2	1	93	93	0.12452830188671389	1	1	141	254	0	3	T
G4_BC76_191109_LF_LIB_consensus_vsearch	3381	A	*/-G	356	39	9.68%	2	2	93	93	6.782915052865659E-13	1	1	136	220	5	34	-G
G4_BC76_191109_LF_LIB_consensus_vsearch	3382	G	G	359	4	1.09%	2	1	93	93	0.06198311632559368	1	1	138	221	4	0	+A
G4_BC76_191109_LF_LIB_consensus_vsearch	3383	G	G	401	3	0.74%	2	2	93	93	0.1245353159851805	1	1	146	255	2	1	A
G4_BC76_191109_LF_LIB_consensus_vsearch	3384	A	A	399	2	0.49%	2	1	93	93	0.24968789013733722	1	1	143	256	2	0	+C
G4_BC76_191109_LF_LIB_consensus_vsearch	3385	C	*/+A	385	9	2.22%	2	1	93	93	0.001864972504119446	1	1	130	255	9	0	+A
G4_BC76_191109_LF_LIB_consensus_vsearch	3386	G	S	375	9	2.25%	2	1	93	93	0.001862705653908663	1	1	124	251	9	0	C
G4_BC76_191109_LF_LIB_consensus_vsearch	3387	C	*/-AA	368	8	2.03%	2	1	93	93	0.003762065284927124	1	1	131	237	0	8	-AA
G4_BC76_191109_LF_LIB_consensus_vsearch	3388	A	R	368	8	2.07%	2	2	93	93	0.003762065284927124	1	1	134	234	4	4	G
G4_BC76_191109_LF_LIB_consensus_vsearch	3389	A	A	379	5	1.27%	2	2	93	93	0.030843367333892417	1	1	142	237	3	2	-G
G4_BC76_191109_LF_LIB_consensus_vsearch	3390	G	*/-TG	367	19	4.75%	2	2	93	93	1.5200610461929761E-6	1	1	141	226	1	18	-TG
G4_BC76_191109_LF_LIB_consensus_vsearch	3391	T	*/-G	333	18	4.74%	2	2	93	93	3.0505328272218947E-6	1	1	141	192	3	15	-G
G4_BC76_191109_LF_LIB_consensus_vsearch	3392	G	G	350	6	1.65%	2	2	93	93	0.015296752807464519	1	1	140	210	4	2	A
G4_BC76_191109_LF_LIB_consensus_vsearch	3393	G	G	390	5	1.25%	2	2	93	93	0.030854683924238017	1	1	141	249	4	1	A
G4_BC76_191109_LF_LIB_consensus_vsearch	3394	G	G	397	6	1.48%	2	2	93	93	0.015334938209013941	1	1	145	252	2	4	A
G4_BC76_191109_LF_LIB_consensus_vsearch	3395	C	Y	382	13	3.21%	2	1	93	93	1.1041780449831012E-4	1	1	141	241	0	13	T
G4_BC76_191109_LF_LIB_consensus_vsearch	3396	T	T	395	5	1.24%	2	2	93	93	0.030859622206549208	1	1	141	254	4	1	C
G4_BC76_191109_LF_LIB_consensus_vsearch	3397	G	G	398	4	0.99%	2	2	93	93	0.06203329275530562	1	1	143	255	3	1	A
G4_BC76_191109_LF_LIB_consensus_vsearch	3398	G	*/-T	340	50	12.35%	2	2	93	93	1.6582852594465432E-16	1	1	112	228	26	24	-T
G4_BC76_191109_LF_LIB_consensus_vsearch	3399	T	T	353	1	0.28%	2	1	93	93	0.4999999999999138	1	1	122	231	0	1	+C
G4_BC76_191109_LF_LIB_consensus_vsearch	3400	T	T	403	3	0.74%	2	1	93	93	0.12453760789147728	1	1	148	255	0	3	C
G4_BC76_191109_LF_LIB_consensus_vsearch	3401	T	T	403	2	0.49%	2	2	93	93	0.24969097651407932	1	1	147	256	1	1	C
G4_BC76_191109_LF_LIB_consensus_vsearch	3402	T	*/-G	322	73	17.98%	2	2	93	93	2.7001949295687945E-24	1	1	145	177	1	72	-G
G4_BC76_191109_LF_LIB_consensus_vsearch	3403	G	R	310	10	3.04%	2	1	93	93	9.092900924742661E-4	1	1	133	177	10	0	A
G4_BC76_191109_LF_LIB_consensus_vsearch	3404	G	*/-T	379	14	3.48%	2	1	93	93	5.425226475721076E-5	1	1	145	234	0	14	-T
G4_BC76_191109_LF_LIB_consensus_vsearch	3405	T	Y	303	46	12.01%	2	1	93	93	2.905229193224223E-15	1	1	142	161	0	46	C
G4_BC76_191109_LF_LIB_consensus_vsearch	3406	A	M	368	13	3.37%	2	1	93	93	1.1000469648005649E-4	1	1	147	221	0	13	C
G4_BC76_191109_LF_LIB_consensus_vsearch	3407	A	*/-G	381	8	1.99%	2	2	93	93	0.003766842960150322	1	1	146	235	3	5	-G
G4_BC76_191109_LF_LIB_consensus_vsearch	3408	G	R	380	7	1.77%	2	2	93	93	0.007601633344865528	1	1	139	241	6	1	A
G4_BC76_191109_LF_LIB_consensus_vsearch	3409	C	S	386	7	1.75%	2	1	93	93	0.0076048360660226225	1	1	147	239	0	7	G
G4_BC76_191109_LF_LIB_consensus_vsearch	3410	A	W	385	9	2.25%	2	2	93	93	0.001864972504119446	1	1	145	240	1	8	T
G4_BC76_191109_LF_LIB_consensus_vsearch	3411	G	G	396	2	0.5%	2	1	93	93	0.24968553459123424	1	1	147	249	0	2	+A
G4_BC76_191109_LF_LIB_consensus_vsearch	3412	A	A	398	2	0.5%	2	2	93	93	0.249687108886017	1	1	144	254	1	1	G
G4_BC76_191109_LF_LIB_consensus_vsearch	3413	A	A	402	1	0.25%	2	1	93	93	0.4999999999999138	1	1	146	256	0	1	+T
G4_BC76_191109_LF_LIB_consensus_vsearch	3414	C	C	397	5	1.23%	2	2	93	93	0.03086156314569468	1	1	144	253	1	4	-T
G4_BC76_191109_LF_LIB_consensus_vsearch	3415	T	Y	379	11	2.76%	2	2	93	93	4.5459840602315744E-4	1	1	140	239	3	8	C
G4_BC76_191109_LF_LIB_consensus_vsearch	3416	G	G	396	3	0.75%	2	1	93	93	0.12452948557099502	1	1	146	250	0	3	C
G4_BC76_191109_LF_LIB_consensus_vsearch	3417	G	G	401	3	0.74%	2	2	93	93	0.1245353159851805	1	1	147	254	1	2	A
G4_BC76_191109_LF_LIB_consensus_vsearch	3418	C	C	392	3	0.74%	2	2	93	93	0.12452471482865957	1	1	140	252	1	2	T
G4_BC76_191109_LF_LIB_consensus_vsearch	3419	G	G	396	3	0.74%	2	1	93	93	0.12452948557099502	1	1	145	251	0	3	-C
G4_BC76_191109_LF_LIB_consensus_vsearch	3420	C	C	389	3	0.75%	2	1	93	93	0.12452107279688855	1	1	145	244	0	3	-TG
G4_BC76_191109_LF_LIB_consensus_vsearch	3421	T	T	395	2	0.5%	2	1	93	93	0.24968474148789518	1	1	146	249	0	2	-G
G4_BC76_191109_LF_LIB_consensus_vsearch	3422	G	*/-C	363	20	4.99%	2	2	93	93	7.393506545509728E-7	1	1	135	228	2	18	-C
G4_BC76_191109_LF_LIB_consensus_vsearch	3423	C	*/-G	272	78	20.91%	2	2	93	93	2.6250493147318843E-26	1	1	127	145	3	75	-G
G4_BC76_191109_LF_LIB_consensus_vsearch	3424	G	R	248	38	12.06%	2	2	93	93	9.754080080158818E-13	1	1	101	147	35	3	A
G4_BC76_191109_LF_LIB_consensus_vsearch	3425	G	R	390	8	1.98%	2	1	93	93	0.0037699692796093966	1	1	137	253	8	0	A
G4_BC76_191109_LF_LIB_consensus_vsearch	3426	G	G	397	5	1.23%	2	1	93	93	0.03086156314569468	1	1	139	258	5	0	A
G4_BC76_191109_LF_LIB_consensus_vsearch	3427	A	A	396	3	0.74%	2	1	93	93	0.12452948557099502	1	1	140	256	3	0	+G
G4_BC76_191109_LF_LIB_consensus_vsearch	3428	T	Y	394	9	2.22%	2	2	93	93	0.0018669176476072253	1	1	144	250	2	7	C
G4_BC76_191109_LF_LIB_consensus_vsearch	3429	C	*/+A	386	8	1.97%	2	1	93	93	0.003768597288121233	1	1	140	246	0	8	+A
G4_BC76_191109_LF_LIB_consensus_vsearch	3430	A	A	395	4	1%	2	2	93	93	0.06202978149183676	1	1	141	254	2	2	G
G4_BC76_191109_LF_LIB_consensus_vsearch	3431	A	R	389	14	3.44%	2	2	93	93	5.441381266881181E-5	1	1	136	253	11	3	G
G4_BC76_191109_LF_LIB_consensus_vsearch	3432	C	C	397	6	1.48%	2	1	93	93	0.015334938209013941	1	1	142	255	6	0	G
G4_BC76_191109_LF_LIB_consensus_vsearch	3433	C	C	398	3	0.74%	2	1	93	93	0.12453183520605009	1	1	144	254	3	0	+A
G4_BC76_191109_LF_LIB_consensus_vsearch	3434	G	G	400	2	0.49%	2	2	93	93	0.24968866749695368	1	1	146	254	1	1	+A
G4_BC76_191109_LF_LIB_consensus_vsearch	3435	A	A	404	1	0.25%	2	1	93	93	0.4999999999999138	1	1	147	257	1	0	+G
G4_BC76_191109_LF_LIB_consensus_vsearch	3436	A	A	403	1	0.25%	2	1	93	93	0.4999999999999138	1	1	146	257	1	0	+GAA
G4_BC76_191109_LF_LIB_consensus_vsearch	3437	C	C	399	3	0.74%	2	2	93	93	0.12453300124551302	1	1	147	252	1	2	-GC
G4_BC76_191109_LF_LIB_consensus_vsearch	3438	G	G	394	3	0.75%	2	2	93	93	0.1245271122321419	1	1	144	250	2	1	A
G4_BC76_191109_LF_LIB_consensus_vsearch	3439	C	C	391	4	1%	2	1	93	93	0.06202501678889606	1	1	145	246	0	4	+T
G4_BC76_191109_LF_LIB_consensus_vsearch	3440	C	Y	386	12	2.95%	2	2	93	93	2.244406705806723E-4	1	1	147	239	1	11	T
G4_BC76_191109_LF_LIB_consensus_vsearch	3441	A	A	392	4	1%	2	2	93	93	0.06202621699451153	1	1	144	248	2	2	G
G4_BC76_191109_LF_LIB_consensus_vsearch	3442	T	*/-GCT	384	12	2.97%	2	1	93	93	2.2434391137769687E-4	1	1	147	237	0	12	-GCT
G4_BC76_191109_LF_LIB_consensus_vsearch	3443	G	G	381	4	1.02%	2	2	93	93	0.062012671598070994	1	1	144	237	2	2	-C
G4_BC76_191109_LF_LIB_consensus_vsearch	3444	C	C	377	4	1.03%	2	2	93	93	0.06200755195210619	1	1	144	233	1	3	-T
G4_BC76_191109_LF_LIB_consensus_vsearch	3445	T	*/-A	347	14	3.63%	2	2	93	93	5.367793185268658E-5	1	1	121	226	10	4	-A
G4_BC76_191109_LF_LIB_consensus_vsearch	3446	A	A	378	5	1.3%	2	2	93	93	0.030842306341483338	1	1	134	244	3	2	G
G4_BC76_191109_LF_LIB_consensus_vsearch	3447	A	*/-G	384	8	1.99%	2	2	93	93	0.0037679008816766993	1	1	138	246	6	2	-G
G4_BC76_191109_LF_LIB_consensus_vsearch	3448	G	G	383	5	1.27%	2	1	93	93	0.030847556649813805	1	1	136	247	5	0	+A
G4_BC76_191109_LF_LIB_consensus_vsearch	3449	G	G	394	5	1.23%	2	1	93	93	0.030858644444955494	1	1	142	252	5	0	T
G4_BC76_191109_LF_LIB_consensus_vsearch	3450	T	T	395	5	1.23%	2	2	93	93	0.030859622206549208	1	1	143	252	1	4	C
G4_BC76_191109_LF_LIB_consensus_vsearch	3451	G	*/-C	366	25	6.2%	2	1	93	93	2.0054986841706538E-8	1	1	114	252	25	0	-C
G4_BC76_191109_LF_LIB_consensus_vsearch	3452	C	C	371	4	1.05%	2	1	93	93	0.06199966756219321	1	1	120	251	0	4	+T
G4_BC76_191109_LF_LIB_consensus_vsearch	3453	C	*/-T	392	12	2.94%	2	1	93	93	2.2472535825225005E-4	1	1	147	245	0	12	-T
G4_BC76_191109_LF_LIB_consensus_vsearch	3454	T	Y	366	11	2.81%	2	1	93	93	4.534634661352225E-4	1	1	143	223	0	11	C
G4_BC76_191109_LF_LIB_consensus_vsearch	3455	A	A	383	4	1.02%	2	1	93	93	0.06201519170852023	1	1	139	244	0	4	G
G4_BC76_191109_LF_LIB_consensus_vsearch	3456	A	R	388	10	2.49%	2	2	93	93	9.222551090526941E-4	1	1	143	245	3	7	G
G4_BC76_191109_LF_LIB_consensus_vsearch	3457	G	*/+T	377	17	4.21%	2	1	93	93	6.396270971981517E-6	1	1	144	233	0	17	+T
G4_BC76_191109_LF_LIB_consensus_vsearch	3458	T	Y	394	7	1.73%	2	1	93	93	0.007608958034696689	1	1	147	247	0	7	C
G4_BC76_191109_LF_LIB_consensus_vsearch	3459	C	*/-T	383	20	4.95%	2	1	93	93	7.489865143008543E-7	1	1	147	236	0	20	-T
G4_BC76_191109_LF_LIB_consensus_vsearch	3460	T	Y	368	11	2.85%	2	1	93	93	4.536430226559371E-4	1	1	143	225	0	11	C
G4_BC76_191109_LF_LIB_consensus_vsearch	3461	A	*/-G	347	40	9.9%	2	2	93	93	3.143259107056887E-13	1	1	137	210	2	38	-G
G4_BC76_191109_LF_LIB_consensus_vsearch	3462	G	G	363	2	0.55%	2	1	93	93	0.24965706447191202	1	1	145	218	2	0	+A
G4_BC76_191109_LF_LIB_consensus_vsearch	3463	G	G	402	4	0.98%	2	2	93	93	0.06203789367157223	1	1	145	257	3	1	-C
G4_BC76_191109_LF_LIB_consensus_vsearch	3464	C	C	398	2	0.5%	2	2	93	93	0.249687108886017	1	1	144	254	1	1	T
G4_BC76_191109_LF_LIB_consensus_vsearch	3465	C	C	399	6	1.47%	2	2	93	93	0.01533636702317035	1	1	147	252	2	4	T
G4_BC76_191109_LF_LIB_consensus_vsearch	3466	A	A	401	2	0.49%	2	2	93	93	0.24968944099344345	1	1	148	253	1	1	G
G4_BC76_191109_LF_LIB_consensus_vsearch	3467	A	A	399	4	0.98%	2	1	93	93	0.06203445155203153	1	1	147	252	0	4	C
G4_BC76_191109_LF_LIB_consensus_vsearch	3468	T	T	396	5	1.23%	2	1	93	93	0.03086059509471206	1	1	148	248	0	5	-G
G4_BC76_191109_LF_LIB_consensus_vsearch	3469	G	G	402	1	0.25%	2	1	93	93	0.4999999999999138	1	1	149	253	0	1	A
G4_BC76_191109_LF_LIB_consensus_vsearch	3470	G	G	405	1	0.25%	2	1	93	93	0.5000000000008233	1	1	148	257	1	0	+A
G4_BC76_191109_LF_LIB_consensus_vsearch	3471	A	A	404	2	0.49%	2	2	93	93	0.24969173859492816	1	1	147	257	1	1	G
G4_BC76_191109_LF_LIB_consensus_vsearch	3472	T	T	401	3	0.74%	2	1	93	93	0.1245353159851805	1	1	147	254	0	3	-GT
G4_BC76_191109_LF_LIB_consensus_vsearch	3473	G	G	395	4	0.99%	2	2	93	93	0.06202978149183676	1	1	146	249	1	3	-T
G4_BC76_191109_LF_LIB_consensus_vsearch	3474	T	*/-A	260	61	15.29%	2	2	93	93	1.8533425193006165E-20	1	1	77	183	30	31	-A
G4_BC76_191109_LF_LIB_consensus_vsearch	3475	A	A	302	4	1.29%	2	2	93	93	0.06188675594400937	1	1	97	205	1	3	C
G4_BC76_191109_LF_LIB_consensus_vsearch	3476	A	A	362	6	1.61%	2	1	93	93	0.015307426946136056	1	1	127	235	0	6	G
G4_BC76_191109_LF_LIB_consensus_vsearch	3477	A	A	384	4	1.02%	2	1	93	93	0.06201644201482272	1	1	141	243	0	4	C
G4_BC76_191109_LF_LIB_consensus_vsearch	3478	A	A	392	6	1.49%	2	2	93	93	0.015331303510572384	1	1	145	247	2	4	G
G4_BC76_191109_LF_LIB_consensus_vsearch	3479	A	*/-G	387	8	1.97%	2	2	93	93	0.0037689428690762675	1	1	143	244	5	3	-G
G4_BC76_191109_LF_LIB_consensus_vsearch	3480	G	G	391	4	1.01%	2	2	93	93	0.06202501678889606	1	1	141	250	1	3	T
G4_BC76_191109_LF_LIB_consensus_vsearch	3481	G	G	400	5	1.23%	2	2	93	93	0.030864438634128317	1	1	147	253	1	4	-CG
G4_BC76_191109_LF_LIB_consensus_vsearch	3482	C	C	396	3	0.74%	2	1	93	93	0.12452948557099502	1	1	145	251	3	0	+AC
G4_BC76_191109_LF_LIB_consensus_vsearch	3483	G	G	400	2	0.5%	2	1	93	93	0.24968866749695368	1	1	147	253	0	2	+C
G4_BC76_191109_LF_LIB_consensus_vsearch	3484	T	T	393	5	1.23%	2	2	93	93	0.03085766177318207	1	1	143	250	1	4	C
G4_BC76_191109_LF_LIB_consensus_vsearch	3485	C	C	398	4	0.99%	2	2	93	93	0.06203329275530562	1	1	145	253	1	3	-G
G4_BC76_191109_LF_LIB_consensus_vsearch	3486	G	R	389	10	2.49%	2	2	93	93	9.223889705434762E-4	1	1	137	252	7	3	A
G4_BC76_191109_LF_LIB_consensus_vsearch	3487	G	G	399	4	0.98%	2	1	93	93	0.06203445155203153	1	1	147	252	0	4	T
G4_BC76_191109_LF_LIB_consensus_vsearch	3488	G	G	398	4	0.98%	2	2	93	93	0.06203329275530562	1	1	146	252	1	3	A
G4_BC76_191109_LF_LIB_consensus_vsearch	3489	C	C	390	3	0.74%	2	2	93	93	0.12452229299364298	1	1	144	246	2	1	+G
G4_BC76_191109_LF_LIB_consensus_vsearch	3490	G	R	371	19	4.76%	2	2	93	93	1.5236904962679662E-6	1	1	123	248	17	2	A
G4_BC76_191109_LF_LIB_consensus_vsearch	3491	G	G	393	3	0.74%	2	1	93	93	0.12452591656124207	1	1	141	252	3	0	+C
G4_BC76_191109_LF_LIB_consensus_vsearch	3492	T	T	395	3	0.75%	2	2	93	93	0.12452830188671389	1	1	145	250	1	2	-G
G4_BC76_191109_LF_LIB_consensus_vsearch	3493	G	G	398	1	0.25%	2	1	93	93	0.4999999999999138	1	1	146	252	1	0	+CG
G4_BC76_191109_LF_LIB_consensus_vsearch	3494	A	A	396	3	0.74%	2	1	93	93	0.12452948557099502	1	1	143	253	3	0	-TGA
G4_BC76_191109_LF_LIB_consensus_vsearch	3495	T	T	396	2	0.5%	2	1	93	93	0.24968553459123424	1	1	143	253	0	2	+G
G4_BC76_191109_LF_LIB_consensus_vsearch	3496	G	G	396	2	0.5%	2	2	93	93	0.24968553459123424	1	1	144	252	1	1	-ACA
G4_BC76_191109_LF_LIB_consensus_vsearch	3497	A	A	388	6	1.49%	2	2	93	93	0.015328329503561841	1	1	140	248	4	2	G
G4_BC76_191109_LF_LIB_consensus_vsearch	3498	C	Y	387	10	2.47%	2	1	93	93	9.221205845541368E-4	1	1	145	242	0	10	T
G4_BC76_191109_LF_LIB_consensus_vsearch	3499	A	A	392	6	1.49%	2	2	93	93	0.015331303510572384	1	1	142	250	4	2	G
G4_BC76_191109_LF_LIB_consensus_vsearch	3500	G	G	393	5	1.23%	2	1	93	93	0.03085766177318207	1	1	139	254	5	0	-CAG
G4_BC76_191109_LF_LIB_consensus_vsearch	3501	C	C	395	1	0.25%	2	1	93	93	0.5000000000008233	1	1	140	255	1	0	+GC
G4_BC76_191109_LF_LIB_consensus_vsearch	3502	A	*/-G	367	24	5.99%	2	1	93	93	4.1421471460521575E-8	1	1	137	230	0	24	-G
G4_BC76_191109_LF_LIB_consensus_vsearch	3503	G	*/+T	366	9	2.38%	2	1	93	93	0.0018605634655903113	1	1	144	222	0	9	+T
G4_BC76_191109_LF_LIB_consensus_vsearch	3504	G	G	404	2	0.49%	2	1	93	93	0.24969173859492816	1	1	149	255	0	2	-A
G4_BC76_191109_LF_LIB_consensus_vsearch	3505	A	A	398	3	0.74%	2	2	93	93	0.12453183520605009	1	1	148	250	1	2	G
G4_BC76_191109_LF_LIB_consensus_vsearch	3506	C	Y	385	10	2.46%	2	1	93	93	9.218495267512253E-4	1	1	148	237	0	10	T
G4_BC76_191109_LF_LIB_consensus_vsearch	3507	G	G	399	5	1.24%	2	1	93	93	0.030863484879977227	1	1	144	255	5	0	A
G4_BC76_191109_LF_LIB_consensus_vsearch	3508	G	G	398	3	0.74%	2	1	93	93	0.12453183520605009	1	1	149	249	0	3	-TGG
G4_BC76_191109_LF_LIB_consensus_vsearch	3509	T	*/-G	382	9	2.23%	2	1	93	93	0.00186430447199865	1	1	149	233	0	9	-G
G4_BC76_191109_LF_LIB_consensus_vsearch	3510	G	G	388	3	0.76%	2	2	93	93	0.12451984635071693	1	1	148	240	1	2	A
G4_BC76_191109_LF_LIB_consensus_vsearch	3511	G	R	389	8	1.99%	2	1	93	93	0.0037696288519149155	1	1	148	241	0	8	A
G4_BC76_191109_LF_LIB_consensus_vsearch	3512	C	Y	390	7	1.74%	2	1	93	93	0.007606917708857565	1	1	149	241	0	7	T
G4_BC76_191109_LF_LIB_consensus_vsearch	3513	C	Y	369	27	6.63%	2	1	93	93	4.709947320642096E-9	1	1	145	224	0	27	T
G4_BC76_191109_LF_LIB_consensus_vsearch	3514	A	R	379	9	2.25%	2	2	93	93	0.001863626239388145	1	1	141	238	3	6	G
G4_BC76_191109_LF_LIB_consensus_vsearch	3515	T	*/-G	338	33	8.31%	2	2	93	93	5.5296967709215907E-11	1	1	124	214	17	16	-G
G4_BC76_191109_LF_LIB_consensus_vsearch	3516	G	G	350	4	1.11%	2	2	93	93	0.06196996599360747	1	1	121	229	1	3	+C
G4_BC76_191109_LF_LIB_consensus_vsearch	3517	G	*/-A	362	10	2.54%	2	2	93	93	9.185266415574814E-4	1	1	130	232	8	2	-A
G4_BC76_191109_LF_LIB_consensus_vsearch	3518	A	A	356	6	1.6%	2	2	93	93	0.015302178085640468	1	1	131	225	5	1	+G
G4_BC76_191109_LF_LIB_consensus_vsearch	3519	A	*/-G	376	10	2.56%	2	1	93	93	9.205956089622115E-4	1	1	135	241	10	0	-G
G4_BC76_191109_LF_LIB_consensus_vsearch	3520	G	R	375	7	1.79%	2	1	93	93	0.007598887968539548	1	1	129	246	7	0	A
G4_BC76_191109_LF_LIB_consensus_vsearch	3521	T	T	395	6	1.48%	2	2	93	93	0.015333495178783761	1	1	142	253	2	4	C
G4_BC76_191109_LF_LIB_consensus_vsearch	3522	C	C	390	6	1.49%	2	1	93	93	0.015329823997787357	1	1	143	247	0	6	-G
G4_BC76_191109_LF_LIB_consensus_vsearch	3523	G	G	394	2	0.5%	2	2	93	93	0.24968394437400754	1	1	143	251	1	1	A
G4_BC76_191109_LF_LIB_consensus_vsearch	3524	G	G	402	2	0.5%	2	1	93	93	0.2496902106567468	1	1	145	257	0	2	A
G4_BC76_191109_LF_LIB_consensus_vsearch	3525	C	Y	396	8	1.98%	2	1	93	93	0.0037719767465882576	1	1	146	250	0	8	T
G4_BC76_191109_LF_LIB_consensus_vsearch	3526	A	A	403	2	0.49%	2	1	93	93	0.24969097651407932	1	1	147	256	2	0	G
G4_BC76_191109_LF_LIB_consensus_vsearch	3527	T	T	400	4	0.98%	2	1	93	93	0.06203560460879861	1	1	143	257	4	0	+C
G4_BC76_191109_LF_LIB_consensus_vsearch	3528	C	C	407	0	0%	2	0	93	0	1.0	1	0	148	259	0	0	
G4_BC76_191109_LF_LIB_consensus_vsearch	3529	C	C	404	1	0.25%	2	1	93	93	0.4999999999999138	1	1	146	258	1	0	+A
G4_BC76_191109_LF_LIB_consensus_vsearch	3530	G	G	401	3	0.74%	2	2	93	93	0.1245353159851805	1	1	143	258	2	1	-C
G4_BC76_191109_LF_LIB_consensus_vsearch	3531	C	C	397	2	0.5%	2	1	93	93	0.24968632371350802	1	1	141	256	2	0	+GC
G4_BC76_191109_LF_LIB_consensus_vsearch	3532	T	Y	373	13	3.23%	2	1	93	93	1.1015555261551726E-4	1	1	137	236	0	13	C
G4_BC76_191109_LF_LIB_consensus_vsearch	3533	A	A	387	4	1.02%	2	2	93	93	0.062020154536760255	1	1	137	250	3	1	G
G4_BC76_191109_LF_LIB_consensus_vsearch	3534	A	*/-GA	374	16	3.98%	2	1	93	93	1.3042061767525985E-5	1	1	122	252	16	0	-GA
G4_BC76_191109_LF_LIB_consensus_vsearch	3535	G	*/-A	349	10	2.65%	2	2	93	93	9.164636628305845E-4	1	1	102	247	8	2	-A
G4_BC76_191109_LF_LIB_consensus_vsearch	3536	A	A	356	4	1.09%	2	1	93	93	0.06197880598931451	1	1	108	248	0	4	C
G4_BC76_191109_LF_LIB_consensus_vsearch	3537	A	R	370	16	4.04%	2	2	93	93	1.3020426605057041E-5	1	1	122	248	14	2	G
G4_BC76_191109_LF_LIB_consensus_vsearch	3538	G	K	375	12	3.06%	2	1	93	93	2.2389647410688774E-4	1	1	126	249	12	0	T
G4_BC76_191109_LF_LIB_consensus_vsearch	3539	T	Y	377	16	3.97%	2	2	93	93	1.3058016225586293E-5	1	1	142	235	2	14	C
G4_BC76_191109_LF_LIB_consensus_vsearch	3540	G	R	389	8	2%	2	1	93	93	0.0037696288519149155	1	1	140	249	8	0	A
G4_BC76_191109_LF_LIB_consensus_vsearch	3541	T	*/-GT	318	72	17.91%	2	1	93	93	5.70690587593368E-24	1	1	143	175	0	72	-GT
G4_BC76_191109_LF_LIB_consensus_vsearch	3542	G	G	317	5	1.53%	2	1	93	93	0.03076513418234888	1	1	142	175	0	5	A
G4_BC76_191109_LF_LIB_consensus_vsearch	3543	T	T	310	6	1.82%	2	1	93	93	0.015255336373214445	1	1	144	166	0	6	+GT
G4_BC76_191109_LF_LIB_consensus_vsearch	3544	A	A	403	1	0.25%	2	1	93	93	0.4999999999999138	1	1	148	255	1	0	T
G4_BC76_191109_LF_LIB_consensus_vsearch	3545	A	R	394	8	1.97%	2	2	93	93	0.0037713141940397903	1	1	145	249	3	5	G
G4_BC76_191109_LF_LIB_consensus_vsearch	3546	C	Y	372	12	2.96%	2	2	93	93	2.2374280247256466E-4	1	1	140	232	1	11	T
G4_BC76_191109_LF_LIB_consensus_vsearch	3547	A	A	393	3	0.76%	2	2	93	93	0.12452591656124207	1	1	142	251	1	2	G
G4_BC76_191109_LF_LIB_consensus_vsearch	3548	A	R	380	7	1.75%	2	2	93	93	0.007601633344865528	1	1	136	244	6	1	G
G4_BC76_191109_LF_LIB_consensus_vsearch	3549	C	*/-TT	345	26	6.52%	2	1	93	93	9.466409941979082E-9	1	1	118	227	26	0	-TT
G4_BC76_191109_LF_LIB_consensus_vsearch	3550	T	T	356	3	0.83%	2	1	93	93	0.12447698744772026	1	1	122	234	0	3	C
G4_BC76_191109_LF_LIB_consensus_vsearch	3551	T	Y	357	14	3.67%	2	1	93	93	5.386757614476661E-5	1	1	117	240	0	14	C
G4_BC76_191109_LF_LIB_consensus_vsearch	3552	A	R	392	7	1.73%	2	2	93	93	0.007607942959128091	1	1	135	257	5	2	G
G4_BC76_191109_LF_LIB_consensus_vsearch	3553	C	C	391	5	1.24%	2	1	93	93	0.030855681550508444	1	1	139	252	0	5	T
G4_BC76_191109_LF_LIB_consensus_vsearch	3554	C	*/-T	394	7	1.72%	2	2	93	93	0.007608958034696689	1	1	145	249	1	6	-T
G4_BC76_191109_LF_LIB_consensus_vsearch	3555	T	Y	339	52	13.07%	2	2	93	93	3.609583791365759E-17	1	1	141	198	3	49	C
G4_BC76_191109_LF_LIB_consensus_vsearch	3556	G	G	393	5	1.23%	2	2	93	93	0.03085766177318207	1	1	140	253	2	3	A
G4_BC76_191109_LF_LIB_consensus_vsearch	3557	C	C	399	2	0.5%	2	1	93	93	0.24968789013733722	1	1	145	254	0	2	+A
G4_BC76_191109_LF_LIB_consensus_vsearch	3558	C	*/+A	381	7	1.72%	2	1	93	93	0.007602173974125566	1	1	132	249	7	0	+A
G4_BC76_191109_LF_LIB_consensus_vsearch	3559	G	*/-A	388	9	2.24%	2	2	93	93	0.0018656305641170923	1	1	132	256	8	1	-A
G4_BC76_191109_LF_LIB_consensus_vsearch	3560	A	A	387	4	1.02%	2	1	93	93	0.062020154536760255	1	1	135	252	0	4	G
G4_BC76_191109_LF_LIB_consensus_vsearch	3561	A	A	401	2	0.49%	2	1	93	93	0.24968944099344345	1	1	146	255	2	0	-TC
G4_BC76_191109_LF_LIB_consensus_vsearch	3562	T	T	396	4	0.99%	2	2	93	93	0.06203095776871511	1	1	144	252	3	1	+C
G4_BC76_191109_LF_LIB_consensus_vsearch	3563	C	C	395	4	0.99%	2	1	93	93	0.06202978149183676	1	1	142	253	4	0	-G
G4_BC76_191109_LF_LIB_consensus_vsearch	3564	G	G	385	5	1.24%	2	2	93	93	0.030849619103815673	1	1	142	243	1	4	-C
G4_BC76_191109_LF_LIB_consensus_vsearch	3565	C	C	388	5	1.24%	2	2	93	93	0.030852673450990298	1	1	143	245	1	4	T
G4_BC76_191109_LF_LIB_consensus_vsearch	3566	T	T	394	6	1.48%	2	1	93	93	0.015332768266138878	1	1	148	246	0	6	-C
G4_BC76_191109_LF_LIB_consensus_vsearch	3567	C	*/-G	391	7	1.75%	2	1	93	93	0.007607431615374521	1	1	148	243	0	7	-G
G4_BC76_191109_LF_LIB_consensus_vsearch	3568	G	G	393	6	1.5%	2	2	93	93	0.015332037719180692	1	1	145	248	4	2	A
G4_BC76_191109_LF_LIB_consensus_vsearch	3569	G	*/-C	375	17	4.18%	2	2	93	93	6.390395927916272E-6	1	1	132	243	14	3	-C
G4_BC76_191109_LF_LIB_consensus_vsearch	3570	C	C	384	3	0.77%	2	1	93	93	0.12451487710233766	1	1	134	250	0	3	+T
G4_BC76_191109_LF_LIB_consensus_vsearch	3571	C	C	403	2	0.49%	2	1	93	93	0.24969097651407932	1	1	148	255	0	2	T
G4_BC76_191109_LF_LIB_consensus_vsearch	3572	C	C	400	3	0.74%	2	1	93	93	0.12453416149047736	1	1	148	252	0	3	-T
G4_BC76_191109_LF_LIB_consensus_vsearch	3573	T	Y	374	20	4.95%	2	1	93	93	7.447591948950539E-7	1	1	148	226	0	20	C
G4_BC76_191109_LF_LIB_consensus_vsearch	3574	G	*/-A	349	28	6.88%	2	2	93	93	2.213816447458215E-9	1	1	141	208	2	26	-A
G4_BC76_191109_LF_LIB_consensus_vsearch	3575	A	A	368	5	1.34%	2	1	93	93	0.03083138374265857	1	1	144	224	0	5	G
G4_BC76_191109_LF_LIB_consensus_vsearch	3576	A	A	400	1	0.25%	2	1	93	93	0.4999999999999138	1	1	146	254	0	1	+T
G4_BC76_191109_LF_LIB_consensus_vsearch	3577	A	A	401	4	0.99%	2	2	93	93	0.06203675196794108	1	1	146	255	2	2	G
G4_BC76_191109_LF_LIB_consensus_vsearch	3578	A	A	403	1	0.25%	2	1	93	93	0.4999999999999138	1	1	147	256	0	1	+C
G4_BC76_191109_LF_LIB_consensus_vsearch	3579	T	*/-G	392	9	2.22%	2	1	93	93	0.0018664928473143382	1	1	145	247	0	9	-G
G4_BC76_191109_LF_LIB_consensus_vsearch	3580	G	G	396	1	0.25%	2	1	93	93	0.4999999999999138	1	1	147	249	1	0	+A
G4_BC76_191109_LF_LIB_consensus_vsearch	3581	G	G	406	1	0.25%	2	1	93	93	0.4999999999999138	1	1	149	257	0	1	-AT
G4_BC76_191109_LF_LIB_consensus_vsearch	3582	A	A	400	2	0.49%	2	1	93	93	0.24968866749695368	1	1	147	253	2	0	-TGG
G4_BC76_191109_LF_LIB_consensus_vsearch	3583	T	T	397	4	0.99%	2	2	93	93	0.062032128175275904	1	1	145	252	2	2	C
G4_BC76_191109_LF_LIB_consensus_vsearch	3584	G	R	392	8	1.98%	2	1	93	93	0.0037706450711110975	1	1	139	253	8	0	A
G4_BC76_191109_LF_LIB_consensus_vsearch	3585	G	G	402	2	0.49%	2	1	93	93	0.2496902106567468	1	1	146	256	0	2	+TGG
G4_BC76_191109_LF_LIB_consensus_vsearch	3586	C	C	395	3	0.74%	2	1	93	93	0.12452830188671389	1	1	139	256	3	0	+A
G4_BC76_191109_LF_LIB_consensus_vsearch	3587	G	G	395	2	0.5%	2	1	93	93	0.24968474148789518	1	1	143	252	0	2	+C
G4_BC76_191109_LF_LIB_consensus_vsearch	3588	C	*/-T	355	30	7.43%	2	2	93	93	5.175000443872132E-10	1	1	134	221	2	28	-T
G4_BC76_191109_LF_LIB_consensus_vsearch	3589	T	T	355	5	1.37%	2	2	93	93	0.030816277838216152	1	1	134	221	4	1	C
G4_BC76_191109_LF_LIB_consensus_vsearch	3590	T	*/-AA	357	16	4.05%	2	1	93	93	1.2947107227624673E-5	1	1	136	221	0	16	-AA
G4_BC76_191109_LF_LIB_consensus_vsearch	3591	A	A	369	4	1.07%	2	2	93	93	0.0619969830272361	1	1	146	223	2	2	C
G4_BC76_191109_LF_LIB_consensus_vsearch	3592	A	R	364	7	1.81%	2	2	93	93	0.007592589101619866	1	1	139	225	4	3	G
G4_BC76_191109_LF_LIB_consensus_vsearch	3593	G	*/-C	380	10	2.5%	2	2	93	93	9.211599279939985E-4	1	1	129	251	9	1	-C
G4_BC76_191109_LF_LIB_consensus_vsearch	3594	C	*/+T	365	16	4.06%	2	2	93	93	1.2992782788164772E-5	1	1	134	231	1	15	+T
G4_BC76_191109_LF_LIB_consensus_vsearch	3595	C	*/-T	366	25	6.17%	2	1	93	93	2.0054986841706538E-8	1	1	142	224	0	25	-T
G4_BC76_191109_LF_LIB_consensus_vsearch	3596	T	Y	339	22	5.8%	2	2	93	93	1.714363075667261E-7	1	1	141	198	2	20	C
G4_BC76_191109_LF_LIB_consensus_vsearch	3597	A	R	380	15	3.74%	2	2	93	93	2.6652914497861675E-5	1	1	131	249	12	3	G
G4_BC76_191109_LF_LIB_consensus_vsearch	3598	G	G	399	3	0.74%	2	1	93	93	0.12453300124551302	1	1	145	254	3	0	A
G4_BC76_191109_LF_LIB_consensus_vsearch	3599	C	C	388	6	1.48%	2	1	93	93	0.015328329503561841	1	1	145	243	0	6	+A
G4_BC76_191109_LF_LIB_consensus_vsearch	3600	A	A	392	6	1.49%	2	2	93	93	0.015331303510572384	1	1	140	252	3	3	-C
G4_BC76_191109_LF_LIB_consensus_vsearch	3601	C	C	388	5	1.26%	2	1	93	93	0.030852673450990298	1	1	145	243	0	5	T
G4_BC76_191109_LF_LIB_consensus_vsearch	3602	C	Y	386	9	2.22%	2	2	93	93	0.0018651929543866046	1	1	145	241	1	8	T
G4_BC76_191109_LF_LIB_consensus_vsearch	3603	G	*/-A	390	10	2.49%	2	1	93	93	9.225221739189795E-4	1	1	136	254	10	0	-A
G4_BC76_191109_LF_LIB_consensus_vsearch	3604	A	A	385	3	0.76%	2	1	93	93	0.12451612903217696	1	1	137	248	0	3	C
G4_BC76_191109_LF_LIB_consensus_vsearch	3605	T	*/+G	379	9	2.23%	2	1	93	93	0.001863626239388145	1	1	141	238	0	9	+G
G4_BC76_191109_LF_LIB_consensus_vsearch	3606	G	G	367	6	1.52%	2	2	93	93	0.015311672358019005	1	1	130	237	1	5	+T
G4_BC76_191109_LF_LIB_consensus_vsearch	3607	C	Y	366	9	2.3%	2	2	93	93	0.0018605634655903113	1	1	138	228	1	8	T
G4_BC76_191109_LF_LIB_consensus_vsearch	3608	A	A	373	6	1.53%	2	2	93	93	0.015316619391186111	1	1	142	231	2	4	G
G4_BC76_191109_LF_LIB_consensus_vsearch	3609	T	Y	373	8	2.03%	2	2	93	93	0.0037639410987491528	1	1	143	230	2	6	C
G4_BC76_191109_LF_LIB_consensus_vsearch	3610	G	G	386	6	1.52%	2	2	93	93	0.015326819799317902	1	1	144	242	2	4	A
G4_BC76_191109_LF_LIB_consensus_vsearch	3611	G	*/-C	390	7	1.74%	2	2	93	93	0.007606917708857565	1	1	143	247	6	1	-C
G4_BC76_191109_LF_LIB_consensus_vsearch	3612	C	*/+T	380	12	3.02%	2	2	93	93	2.2414751491838127E-4	1	1	142	238	1	11	+T
G4_BC76_191109_LF_LIB_consensus_vsearch	3613	C	C	399	2	0.49%	2	1	93	93	0.24968789013733722	1	1	148	251	0	2	+TT
G4_BC76_191109_LF_LIB_consensus_vsearch	3614	C	Y	388	11	2.71%	2	1	93	93	4.5534176337797E-4	1	1	147	241	0	11	T
G4_BC76_191109_LF_LIB_consensus_vsearch	3615	A	A	386	5	1.24%	2	1	93	93	0.030850642423789317	1	1	146	240	0	5	G
G4_BC76_191109_LF_LIB_consensus_vsearch	3616	T	T	389	5	1.25%	2	1	93	93	0.030853681237272182	1	1	149	240	0	5	C
G4_BC76_191109_LF_LIB_consensus_vsearch	3617	G	G	396	3	0.74%	2	1	93	93	0.12452948557099502	1	1	148	248	0	3	+CG
G4_BC76_191109_LF_LIB_consensus_vsearch	3618	T	*/-C	375	24	5.94%	2	2	93	93	4.173416239328845E-8	1	1	125	250	23	1	-C
G4_BC76_191109_LF_LIB_consensus_vsearch	3619	C	C	379	2	0.52%	2	2	93	93	0.24967148488839994	1	1	125	254	1	1	T
G4_BC76_191109_LF_LIB_consensus_vsearch	3620	C	*/-G	386	12	2.95%	2	2	93	93	2.244406705806723E-4	1	1	144	242	2	10	-G
G4_BC76_191109_LF_LIB_consensus_vsearch	3621	G	R	384	7	1.78%	2	2	93	93	0.007603779356567615	1	1	141	243	6	1	A
G4_BC76_191109_LF_LIB_consensus_vsearch	3622	G	G	400	2	0.49%	2	2	93	93	0.24968866749695368	1	1	148	252	1	1	C
G4_BC76_191109_LF_LIB_consensus_vsearch	3623	C	Y	382	14	3.46%	2	1	93	93	5.430154987343997E-5	1	1	146	236	0	14	T
G4_BC76_191109_LF_LIB_consensus_vsearch	3624	T	T	401	2	0.5%	2	1	93	93	0.24968944099344345	1	1	147	254	0	2	+C
G4_BC76_191109_LF_LIB_consensus_vsearch	3625	T	T	399	2	0.49%	2	1	93	93	0.24968789013733722	1	1	147	252	0	2	+G
G4_BC76_191109_LF_LIB_consensus_vsearch	3626	G	G	398	3	0.74%	2	1	93	93	0.12453183520605009	1	1	143	255	3	0	+C
G4_BC76_191109_LF_LIB_consensus_vsearch	3627	C	C	393	2	0.5%	2	1	93	93	0.24968314321918028	1	1	145	248	0	2	A
G4_BC76_191109_LF_LIB_consensus_vsearch	3628	C	Y	364	22	5.41%	2	2	93	93	1.752460710463997E-7	1	1	146	218	1	21	T
G4_BC76_191109_LF_LIB_consensus_vsearch	3629	G	G	397	3	0.74%	2	2	93	93	0.12453066332921275	1	1	145	252	1	2	A
G4_BC76_191109_LF_LIB_consensus_vsearch	3630	G	G	399	2	0.49%	2	2	93	93	0.24968789013733722	1	1	146	253	1	1	T
G4_BC76_191109_LF_LIB_consensus_vsearch	3631	C	C	387	4	0.99%	2	1	93	93	0.062020154536760255	1	1	142	245	0	4	-A
G4_BC76_191109_LF_LIB_consensus_vsearch	3632	A	A	390	2	0.5%	2	1	93	93	0.24968071519789278	1	1	143	247	2	0	G
G4_BC76_191109_LF_LIB_consensus_vsearch	3633	T	*/+G	365	22	5.46%	2	2	93	93	1.7538954990429567E-7	1	1	141	224	3	19	+G
G4_BC76_191109_LF_LIB_consensus_vsearch	3634	G	G	392	3	0.76%	2	2	93	93	0.12452471482865957	1	1	145	247	2	1	A
G4_BC76_191109_LF_LIB_consensus_vsearch	3635	G	*/-A	367	27	6.67%	2	2	93	93	4.69861011781461E-9	1	1	115	252	26	1	-A
G4_BC76_191109_LF_LIB_consensus_vsearch	3636	A	A	369	5	1.32%	2	2	93	93	0.03083250226854639	1	1	117	252	2	3	-G
G4_BC76_191109_LF_LIB_consensus_vsearch	3637	G	G	388	6	1.5%	2	2	93	93	0.015328329503561841	1	1	140	248	4	2	-T
G4_BC76_191109_LF_LIB_consensus_vsearch	3638	T	Y	369	11	2.76%	2	1	93	93	4.537321085165141E-4	1	1	127	242	0	11	C
G4_BC76_191109_LF_LIB_consensus_vsearch	3639	A	*/-G	331	40	10.05%	2	2	93	93	2.994608669172783E-13	1	1	115	216	10	30	-G
G4_BC76_191109_LF_LIB_consensus_vsearch	3640	G	G	353	2	0.56%	2	1	93	93	0.2496473906911767	1	1	128	225	2	0	T
G4_BC76_191109_LF_LIB_consensus_vsearch	3641	G	G	381	6	1.5%	2	2	93	93	0.01532297745106865	1	1	125	256	4	2	-A
G4_BC76_191109_LF_LIB_consensus_vsearch	3642	A	*/-G	355	18	4.62%	2	2	93	93	3.0920077264270893E-6	1	1	116	239	7	11	-G
G4_BC76_191109_LF_LIB_consensus_vsearch	3643	G	G	361	4	1.09%	2	1	93	93	0.061985950492774826	1	1	120	241	0	4	+T
G4_BC76_191109_LF_LIB_consensus_vsearch	3644	G	*/+A	362	16	4.1%	2	1	93	93	1.2975867062135552E-5	1	1	108	254	16	0	+A
G4_BC76_191109_LF_LIB_consensus_vsearch	3645	G	R	382	11	2.74%	2	1	93	93	4.548498903980809E-4	1	1	131	251	11	0	A
G4_BC76_191109_LF_LIB_consensus_vsearch	3646	C	C	394	1	0.25%	2	1	93	93	0.4999999999999138	1	1	144	250	0	1	+G
G4_BC76_191109_LF_LIB_consensus_vsearch	3647	G	*/-TG	350	42	10.47%	2	1	93	93	7.126426142507143E-14	1	1	146	204	0	42	-TG
G4_BC76_191109_LF_LIB_consensus_vsearch	3648	T	*/-G	340	7	1.98%	2	2	93	93	0.007577468131623444	1	1	143	197	4	3	-G
G4_BC76_191109_LF_LIB_consensus_vsearch	3649	G	G	353	1	0.28%	2	1	93	93	0.4999999999999138	1	1	144	209	0	1	A
G4_BC76_191109_LF_LIB_consensus_vsearch	3650	G	G	393	3	0.74%	2	2	93	93	0.12452591656124207	1	1	142	251	1	2	-A
G4_BC76_191109_LF_LIB_consensus_vsearch	3651	A	*/-G	371	18	4.56%	2	2	93	93	3.1194609634520567E-6	1	1	124	247	15	3	-G
G4_BC76_191109_LF_LIB_consensus_vsearch	3652	G	G	368	3	0.79%	2	2	93	93	0.12449392712559995	1	1	124	244	2	1	A
G4_BC76_191109_LF_LIB_consensus_vsearch	3653	G	G	395	3	0.75%	2	2	93	93	0.12452830188671389	1	1	142	253	2	1	A
G4_BC76_191109_LF_LIB_consensus_vsearch	3654	T	Y	396	7	1.73%	2	1	93	93	0.007609963086240239	1	1	147	249	0	7	C
G4_BC76_191109_LF_LIB_consensus_vsearch	3655	T	T	387	6	1.48%	2	2	93	93	0.015327576567173378	1	1	131	256	4	2	-A
G4_BC76_191109_LF_LIB_consensus_vsearch	3656	A	A	388	2	0.51%	2	1	93	93	0.2496790757377846	1	1	137	251	0	2	G
G4_BC76_191109_LF_LIB_consensus_vsearch	3657	A	*/-T	380	11	2.75%	2	2	93	93	4.546826533185083E-4	1	1	131	249	5	6	-T
G4_BC76_191109_LF_LIB_consensus_vsearch	3658	T	T	385	4	1.02%	2	1	93	93	0.06201768588877767	1	1	136	249	4	0	G
G4_BC76_191109_LF_LIB_consensus_vsearch	3659	T	T	394	4	0.99%	2	1	93	93	0.06202859930052086	1	1	140	254	4	0	G
G4_BC76_191109_LF_LIB_consensus_vsearch	3660	T	T	394	3	0.74%	2	1	93	93	0.1245271122321419	1	1	145	249	0	3	+G
G4_BC76_191109_LF_LIB_consensus_vsearch	3661	G	G	398	3	0.74%	2	2	93	93	0.12453183520605009	1	1	147	251	1	2	A
G4_BC76_191109_LF_LIB_consensus_vsearch	3662	C	Y	372	27	6.65%	2	1	93	93	4.726782820473113E-9	1	1	146	226	0	27	T
G4_BC76_191109_LF_LIB_consensus_vsearch	3663	T	*/+G	367	30	7.43%	2	1	93	93	5.271395680881799E-10	1	1	148	219	0	30	+G
G4_BC76_191109_LF_LIB_consensus_vsearch	3664	G	G	400	2	0.5%	2	1	93	93	0.24968866749695368	1	1	147	253	0	2	-A
G4_BC76_191109_LF_LIB_consensus_vsearch	3665	A	*/-GA	358	36	8.91%	2	1	93	93	6.297816100162011E-12	1	1	107	251	36	0	-GA
G4_BC76_191109_LF_LIB_consensus_vsearch	3666	G	*/-A	347	12	3.26%	2	1	93	93	2.2236541920972585E-4	1	1	91	256	12	0	-A
G4_BC76_191109_LF_LIB_consensus_vsearch	3667	A	A	347	3	0.85%	2	1	93	93	0.12446351931328528	1	1	96	251	0	3	T
G4_BC76_191109_LF_LIB_consensus_vsearch	3668	A	*/-G	382	12	2.99%	2	2	93	93	2.2424619755304767E-4	1	1	142	240	3	9	-G
G4_BC76_191109_LF_LIB_consensus_vsearch	3669	G	G	388	1	0.26%	2	1	93	93	0.4999999999999138	1	1	143	245	0	1	+T
G4_BC76_191109_LF_LIB_consensus_vsearch	3670	G	*/-C	388	17	4.19%	2	2	93	93	6.427615629419297E-6	1	1	146	242	1	16	-C
G4_BC76_191109_LF_LIB_consensus_vsearch	3671	C	Y	367	22	5.66%	2	1	93	93	1.75674578621761E-7	1	1	147	220	0	22	T
G4_BC76_191109_LF_LIB_consensus_vsearch	3672	T	*/-G	378	21	5.16%	2	1	93	93	3.6396125108305166E-7	1	1	149	229	0	21	-G
G4_BC76_191109_LF_LIB_consensus_vsearch	3673	G	K	370	16	4.15%	2	1	93	93	1.3020426605057041E-5	1	1	149	221	0	16	T
G4_BC76_191109_LF_LIB_consensus_vsearch	3674	G	G	406	1	0.25%	2	1	93	93	0.4999999999999138	1	1	149	257	0	1	C
G4_BC76_191109_LF_LIB_consensus_vsearch	3675	A	A	391	6	1.47%	2	1	93	93	0.01533056561273411	1	1	144	247	0	6	+T
G4_BC76_191109_LF_LIB_consensus_vsearch	3676	C	C	401	3	0.74%	2	2	93	93	0.1245353159851805	1	1	148	253	1	2	T
G4_BC76_191109_LF_LIB_consensus_vsearch	3677	G	*/-CG	390	10	2.46%	2	2	93	93	9.225221739189795E-4	1	1	140	250	8	2	-CG
G4_BC76_191109_LF_LIB_consensus_vsearch	3678	C	C	393	1	0.25%	2	1	93	93	0.4999999999999138	1	1	140	253	0	1	+G
G4_BC76_191109_LF_LIB_consensus_vsearch	3679	G	*/-TG	370	12	3.04%	2	1	93	93	2.236390528231034E-4	1	1	137	233	0	12	-TG
G4_BC76_191109_LF_LIB_consensus_vsearch	3680	T	T	372	5	1.3%	2	2	93	93	0.03083582226799183	1	1	146	226	1	4	C
G4_BC76_191109_LF_LIB_consensus_vsearch	3681	G	G	389	5	1.27%	2	2	93	93	0.030853681237272182	1	1	146	243	2	3	-A
G4_BC76_191109_LF_LIB_consensus_vsearch	3682	A	A	394	4	1%	2	1	93	93	0.06202859930052086	1	1	141	253	4	0	+G
G4_BC76_191109_LF_LIB_consensus_vsearch	3683	G	G	400	4	0.99%	2	2	93	93	0.06203560460879861	1	1	147	253	1	3	-CG
G4_BC76_191109_LF_LIB_consensus_vsearch	3684	C	C	397	3	0.75%	2	1	93	93	0.12453066332921275	1	1	148	249	0	3	T
G4_BC76_191109_LF_LIB_consensus_vsearch	3685	G	G	388	5	1.24%	2	1	93	93	0.030852673450990298	1	1	148	240	0	5	-TG
G4_BC76_191109_LF_LIB_consensus_vsearch	3686	T	T	386	4	1.01%	2	2	93	93	0.062018923379747036	1	1	146	240	1	3	-G
G4_BC76_191109_LF_LIB_consensus_vsearch	3687	G	G	386	4	1.01%	2	2	93	93	0.062018923379747036	1	1	145	241	2	2	A
G4_BC76_191109_LF_LIB_consensus_vsearch	3688	G	G	394	6	1.48%	2	2	93	93	0.015332768266138878	1	1	145	249	1	5	A
G4_BC76_191109_LF_LIB_consensus_vsearch	3689	C	C	401	3	0.74%	2	2	93	93	0.1245353159851805	1	1	147	254	1	2	-T
G4_BC76_191109_LF_LIB_consensus_vsearch	3690	T	*/-G	360	31	7.65%	2	1	93	93	2.5076754199881873E-10	1	1	142	218	0	31	-G
G4_BC76_191109_LF_LIB_consensus_vsearch	3691	G	G	371	2	0.53%	2	1	93	93	0.24966442953001958	1	1	147	224	2	0	+CA
G4_BC76_191109_LF_LIB_consensus_vsearch	3692	G	*/-A	391	11	2.7%	2	2	93	93	4.5558231391399246E-4	1	1	136	255	10	1	-A
G4_BC76_191109_LF_LIB_consensus_vsearch	3693	A	A	391	2	0.5%	2	2	93	93	0.24968152866242077	1	1	135	256	1	1	C
G4_BC76_191109_LF_LIB_consensus_vsearch	3694	G	G	397	6	1.47%	2	2	93	93	0.015334938209013941	1	1	142	255	5	1	A
G4_BC76_191109_LF_LIB_consensus_vsearch	3695	C	C	398	4	0.98%	2	2	93	93	0.06203329275530562	1	1	144	254	1	3	-A
G4_BC76_191109_LF_LIB_consensus_vsearch	3696	A	A	397	2	0.5%	2	1	93	93	0.24968632371350802	1	1	143	254	2	0	G
G4_BC76_191109_LF_LIB_consensus_vsearch	3697	G	R	354	29	7.16%	2	2	93	93	1.0739595384188928E-9	1	1	114	240	28	1	A
G4_BC76_191109_LF_LIB_consensus_vsearch	3698	C	C	383	4	1.02%	2	1	93	93	0.06201519170852023	1	1	142	241	0	4	+T
G4_BC76_191109_LF_LIB_consensus_vsearch	3699	C	*/-T	378	11	2.7%	2	1	93	93	4.5451373534606624E-4	1	1	147	231	0	11	-T
G4_BC76_191109_LF_LIB_consensus_vsearch	3700	T	Y	376	8	2.02%	2	1	93	93	0.0037650433430064176	1	1	147	229	0	8	C
G4_BC76_191109_LF_LIB_consensus_vsearch	3701	C	*/-T	367	32	8%	2	2	93	93	1.2187942027213766E-10	1	1	147	220	2	30	-T
G4_BC76_191109_LF_LIB_consensus_vsearch	3702	T	*/+G	333	24	6.49%	2	2	93	93	3.9962687086002605E-8	1	1	119	214	23	1	+G
G4_BC76_191109_LF_LIB_consensus_vsearch	3703	A	R	362	36	8.87%	2	2	93	93	6.353587133281144E-12	1	1	113	249	33	3	G
G4_BC76_191109_LF_LIB_consensus_vsearch	3704	G	G	396	1	0.25%	2	1	93	93	0.4999999999999138	1	1	143	253	1	0	+ATT
G4_BC76_191109_LF_LIB_consensus_vsearch	3705	T	T	393	3	0.74%	2	2	93	93	0.12452591656124207	1	1	139	254	2	1	C
G4_BC76_191109_LF_LIB_consensus_vsearch	3706	G	R	380	15	3.7%	2	2	93	93	2.6652914497861675E-5	1	1	126	254	14	1	A
G4_BC76_191109_LF_LIB_consensus_vsearch	3707	C	C	394	3	0.75%	2	1	93	93	0.1245271122321419	1	1	138	256	3	0	+GC
G4_BC76_191109_LF_LIB_consensus_vsearch	3708	C	C	397	4	0.98%	2	2	93	93	0.062032128175275904	1	1	144	253	1	3	T
G4_BC76_191109_LF_LIB_consensus_vsearch	3709	G	G	395	4	0.99%	2	2	93	93	0.06202978149183676	1	1	141	254	2	2	+CCG
G4_BC76_191109_LF_LIB_consensus_vsearch	3710	A	A	400	3	0.74%	2	2	93	93	0.12453416149047736	1	1	143	257	1	2	-T
G4_BC76_191109_LF_LIB_consensus_vsearch	3711	T	T	398	3	0.74%	2	1	93	93	0.12453183520605009	1	1	145	253	0	3	C
G4_BC76_191109_LF_LIB_consensus_vsearch	3712	C	*/-T	381	20	4.91%	2	2	93	93	7.480618802321155E-7	1	1	144	237	1	19	-T
G4_BC76_191109_LF_LIB_consensus_vsearch	3713	T	T	381	2	0.52%	2	2	93	93	0.24967320261436957	1	1	144	237	1	1	C
G4_BC76_191109_LF_LIB_consensus_vsearch	3714	T	*/-G	374	18	4.44%	2	1	93	93	3.1243787131250986E-6	1	1	147	227	0	18	-G
G4_BC76_191109_LF_LIB_consensus_vsearch	3715	G	G	376	2	0.52%	2	1	93	93	0.2496688741720519	1	1	144	232	2	0	A
G4_BC76_191109_LF_LIB_consensus_vsearch	3716	G	G	388	2	0.5%	2	1	93	93	0.2496790757377846	1	1	147	241	0	2	-T
G4_BC76_191109_LF_LIB_consensus_vsearch	3717	T	Y	373	9	2.28%	2	1	93	93	0.0018622382238204073	1	1	148	225	0	9	C
G4_BC76_191109_LF_LIB_consensus_vsearch	3718	G	R	380	10	2.54%	2	2	93	93	9.211599279939985E-4	1	1	144	236	4	6	A
G4_BC76_191109_LF_LIB_consensus_vsearch	3719	G	G	389	6	1.48%	2	1	93	93	0.015329078637527195	1	1	147	242	0	6	-CA
G4_BC76_191109_LF_LIB_consensus_vsearch	3720	C	C	389	4	1.01%	2	1	93	93	0.06202259804292181	1	1	144	245	4	0	-A
G4_BC76_191109_LF_LIB_consensus_vsearch	3721	A	R	363	29	7.34%	2	2	93	93	1.0881487866993488E-9	1	1	117	246	27	2	G
G4_BC76_191109_LF_LIB_consensus_vsearch	3722	G	G	394	3	0.74%	2	2	93	93	0.1245271122321419	1	1	143	251	2	1	A
G4_BC76_191109_LF_LIB_consensus_vsearch	3723	T	T	384	6	1.49%	2	1	93	93	0.015325294651568566	1	1	139	245	6	0	+A
G4_BC76_191109_LF_LIB_consensus_vsearch	3724	A	R	389	7	1.74%	2	1	93	93	0.0076064012202881484	1	1	138	251	7	0	G
G4_BC76_191109_LF_LIB_consensus_vsearch	3725	G	G	388	5	1.25%	2	1	93	93	0.030852673450990298	1	1	139	249	5	0	+C
G4_BC76_191109_LF_LIB_consensus_vsearch	3726	C	*/-A	351	30	7.46%	2	2	93	93	5.141878840814134E-10	1	1	135	216	5	25	-A
G4_BC76_191109_LF_LIB_consensus_vsearch	3727	A	A	368	2	0.54%	2	1	93	93	0.24966170500678367	1	1	143	225	0	2	+GC
G4_BC76_191109_LF_LIB_consensus_vsearch	3728	A	A	400	2	0.49%	2	2	93	93	0.24968866749695368	1	1	144	256	1	1	C
G4_BC76_191109_LF_LIB_consensus_vsearch	3729	A	A	403	2	0.49%	2	1	93	93	0.24969097651407932	1	1	146	257	2	0	G
G4_BC76_191109_LF_LIB_consensus_vsearch	3730	T	Y	392	10	2.46%	2	2	93	93	9.227866256324819E-4	1	1	145	247	2	8	C
G4_BC76_191109_LF_LIB_consensus_vsearch	3731	A	A	396	4	0.98%	2	2	93	93	0.06203095776871511	1	1	148	248	1	3	G
G4_BC76_191109_LF_LIB_consensus_vsearch	3732	T	T	401	4	0.99%	2	1	93	93	0.06203675196794108	1	1	149	252	0	4	C
G4_BC76_191109_LF_LIB_consensus_vsearch	3733	T	T	393	6	1.47%	2	1	93	93	0.015332037719180692	1	1	148	245	0	6	-C
G4_BC76_191109_LF_LIB_consensus_vsearch	3734	C	*/-TC	385	11	2.74%	2	2	93	93	4.550976487942495E-4	1	1	146	239	2	9	-TC
G4_BC76_191109_LF_LIB_consensus_vsearch	3735	T	T	392	1	0.25%	2	1	93	93	0.4999999999990043	1	1	145	247	0	1	+C
G4_BC76_191109_LF_LIB_consensus_vsearch	3736	C	*/+A	377	8	2.02%	2	2	93	93	0.003765406973524696	1	1	140	237	3	5	+A
G4_BC76_191109_LF_LIB_consensus_vsearch	3737	G	R	384	13	3.21%	2	2	93	93	1.1047452382467976E-4	1	1	142	242	3	10	A
G4_BC76_191109_LF_LIB_consensus_vsearch	3738	T	W	384	13	3.19%	2	1	93	93	1.1047452382467976E-4	1	1	148	236	0	13	A
G4_BC76_191109_LF_LIB_consensus_vsearch	3739	G	R	384	9	2.22%	2	2	93	93	0.0018647509458963453	1	1	141	243	4	5	A
G4_BC76_191109_LF_LIB_consensus_vsearch	3740	C	Y	371	8	2.02%	2	1	93	93	0.0037631966602129988	1	1	134	237	0	8	T
G4_BC76_191109_LF_LIB_consensus_vsearch	3741	G	G	383	5	1.26%	2	2	93	93	0.030847556649813805	1	1	131	252	4	1	-A
G4_BC76_191109_LF_LIB_consensus_vsearch	3742	A	R	391	7	1.74%	2	2	93	93	0.007607431615374521	1	1	140	251	3	4	G
G4_BC76_191109_LF_LIB_consensus_vsearch	3743	G	*/-C	390	7	1.73%	2	2	93	93	0.007606917708857565	1	1	138	252	4	3	-C
G4_BC76_191109_LF_LIB_consensus_vsearch	3744	C	S	390	7	1.75%	2	1	93	93	0.007606917708857565	1	1	136	254	7	0	G
G4_BC76_191109_LF_LIB_consensus_vsearch	3745	C	*/-G	358	22	5.42%	2	2	93	93	1.7437142008679426E-7	1	1	138	220	6	16	-G
G4_BC76_191109_LF_LIB_consensus_vsearch	3746	G	R	346	22	5.87%	2	2	93	93	1.725481335683033E-7	1	1	119	227	21	1	A
G4_BC76_191109_LF_LIB_consensus_vsearch	3747	G	G	395	2	0.5%	2	2	93	93	0.24968474148789518	1	1	146	249	1	1	T
G4_BC76_191109_LF_LIB_consensus_vsearch	3748	G	*/-A	388	8	1.98%	2	2	93	93	0.0037692867193449852	1	1	141	247	7	1	-A
G4_BC76_191109_LF_LIB_consensus_vsearch	3749	A	A	393	0	0%	2	0	93	0	1.0	1	0	141	252	0	0	
G4_BC76_191109_LF_LIB_consensus_vsearch	3750	A	A	388	6	1.49%	2	2	93	93	0.015328329503561841	1	1	144	244	2	4	-G
G4_BC76_191109_LF_LIB_consensus_vsearch	3751	G	G	395	1	0.25%	2	1	93	93	0.5000000000008233	1	1	146	249	0	1	+C
G4_BC76_191109_LF_LIB_consensus_vsearch	3752	G	G	396	4	0.99%	2	2	93	93	0.06203095776871511	1	1	147	249	2	2	-C
G4_BC76_191109_LF_LIB_consensus_vsearch	3753	C	Y	389	11	2.73%	2	1	93	93	4.554223390235558E-4	1	1	147	242	0	11	T
G4_BC76_191109_LF_LIB_consensus_vsearch	3754	T	*/+G	382	15	3.69%	2	1	93	93	2.6671442214013996E-5	1	1	149	233	0	15	+G
G4_BC76_191109_LF_LIB_consensus_vsearch	3755	G	G	400	2	0.5%	2	1	93	93	0.24968866749695368	1	1	149	251	0	2	C
G4_BC76_191109_LF_LIB_consensus_vsearch	3756	A	A	403	1	0.25%	2	1	93	93	0.4999999999999138	1	1	148	255	1	0	+G
G4_BC76_191109_LF_LIB_consensus_vsearch	3757	T	T	400	5	1.23%	2	1	93	93	0.030864438634128317	1	1	149	251	0	5	C
G4_BC76_191109_LF_LIB_consensus_vsearch	3758	G	*/-TG	376	14	3.44%	2	1	93	93	5.420225372441819E-5	1	1	148	228	0	14	-TG
G4_BC76_191109_LF_LIB_consensus_vsearch	3759	T	*/-G	339	19	5.01%	2	2	93	93	1.4926069640751038E-6	1	1	141	198	2	17	-G
G4_BC76_191109_LF_LIB_consensus_vsearch	3760	G	G	361	1	0.27%	2	1	93	93	0.4999999999999138	1	1	143	218	0	1	+TG
G4_BC76_191109_LF_LIB_consensus_vsearch	3761	G	G	396	1	0.25%	2	1	93	93	0.4999999999999138	1	1	145	251	0	1	T
G4_BC76_191109_LF_LIB_consensus_vsearch	3762	A	*/-G	387	7	1.75%	2	1	93	93	0.007605360418658285	1	1	135	252	7	0	-G
G4_BC76_191109_LF_LIB_consensus_vsearch	3763	G	*/-A	358	22	5.57%	2	2	93	93	1.7437142008679426E-7	1	1	119	239	13	9	-A
G4_BC76_191109_LF_LIB_consensus_vsearch	3764	A	A	374	2	0.53%	2	1	93	93	0.2496671105194291	1	1	133	241	0	2	G
G4_BC76_191109_LF_LIB_consensus_vsearch	3765	A	A	399	4	0.99%	2	1	93	93	0.06203445155203153	1	1	147	252	0	4	G
G4_BC76_191109_LF_LIB_consensus_vsearch	3766	A	A	392	6	1.47%	2	2	93	93	0.015331303510572384	1	1	145	247	2	4	-G
G4_BC76_191109_LF_LIB_consensus_vsearch	3767	G	G	387	5	1.25%	2	1	93	93	0.030851660526274274	1	1	144	243	0	5	+C
G4_BC76_191109_LF_LIB_consensus_vsearch	3768	G	*/-T	395	9	2.21%	2	2	93	93	0.0018671284895574335	1	1	147	248	1	8	-T
G4_BC76_191109_LF_LIB_consensus_vsearch	3769	T	T	387	5	1.26%	2	1	93	93	0.030851660526274274	1	1	148	239	0	5	+C
G4_BC76_191109_LF_LIB_consensus_vsearch	3770	T	*/-C	338	60	14.74%	2	2	93	93	7.822409520717689E-20	1	1	110	228	38	22	-C
G4_BC76_191109_LF_LIB_consensus_vsearch	3771	C	C	344	2	0.58%	2	1	93	93	0.2496382054993181	1	1	108	236	2	0	T
G4_BC76_191109_LF_LIB_consensus_vsearch	3772	C	*/-T	381	19	4.67%	2	2	93	93	1.532474593520809E-6	1	1	143	238	2	17	-T
G4_BC76_191109_LF_LIB_consensus_vsearch	3773	T	Y	364	10	2.6%	2	1	93	93	9.188315219247524E-4	1	1	143	221	0	10	C
G4_BC76_191109_LF_LIB_consensus_vsearch	3774	G	G	390	4	1.01%	2	1	93	93	0.062023810487337606	1	1	143	247	0	4	C
G4_BC76_191109_LF_LIB_consensus_vsearch	3775	G	G	399	2	0.49%	2	1	93	93	0.24968789013733722	1	1	148	251	0	2	+T
G4_BC76_191109_LF_LIB_consensus_vsearch	3776	C	Y	381	10	2.48%	2	1	93	93	9.212992345460898E-4	1	1	144	237	0	10	T
G4_BC76_191109_LF_LIB_consensus_vsearch	3777	T	T	391	4	1%	2	2	93	93	0.06202501678889606	1	1	142	249	2	2	C
G4_BC76_191109_LF_LIB_consensus_vsearch	3778	T	Y	386	9	2.22%	2	2	93	93	0.0018651929543866046	1	1	141	245	3	6	C
G4_BC76_191109_LF_LIB_consensus_vsearch	3779	A	A	390	4	0.99%	2	2	93	93	0.062023810487337606	1	1	138	252	3	1	G
G4_BC76_191109_LF_LIB_consensus_vsearch	3780	C	C	395	2	0.5%	2	1	93	93	0.24968474148789518	1	1	144	251	0	2	+T
G4_BC76_191109_LF_LIB_consensus_vsearch	3781	C	Y	390	8	1.97%	2	1	93	93	0.0037699692796093966	1	1	144	246	0	8	T
G4_BC76_191109_LF_LIB_consensus_vsearch	3782	G	G	402	1	0.25%	2	1	93	93	0.4999999999999138	1	1	146	256	0	1	+C
G4_BC76_191109_LF_LIB_consensus_vsearch	3783	C	C	401	2	0.49%	2	1	93	93	0.24968944099344345	1	1	145	256	2	0	-A
G4_BC76_191109_LF_LIB_consensus_vsearch	3784	A	A	395	4	0.99%	2	2	93	93	0.06202978149183676	1	1	140	255	2	2	-T
G4_BC76_191109_LF_LIB_consensus_vsearch	3785	T	T	396	4	0.99%	2	2	93	93	0.06203095776871511	1	1	143	253	1	3	C
G4_BC76_191109_LF_LIB_consensus_vsearch	3786	T	T	395	4	0.98%	2	1	93	93	0.06202978149183676	1	1	147	248	0	4	-G
G4_BC76_191109_LF_LIB_consensus_vsearch	3787	G	R	389	7	1.75%	2	2	93	93	0.0076064012202881484	1	1	140	249	5	2	A
G4_BC76_191109_LF_LIB_consensus_vsearch	3788	G	G	396	3	0.74%	2	1	93	93	0.12452948557099502	1	1	147	249	0	3	A
G4_BC76_191109_LF_LIB_consensus_vsearch	3789	T	T	397	4	0.99%	2	1	93	93	0.062032128175275904	1	1	148	249	0	4	C
G4_BC76_191109_LF_LIB_consensus_vsearch	3790	G	*/-C	381	17	4.18%	2	2	93	93	6.407855928137532E-6	1	1	131	250	12	5	-C
G4_BC76_191109_LF_LIB_consensus_vsearch	3791	C	C	388	1	0.26%	2	1	93	93	0.4999999999999138	1	1	137	251	0	1	T
G4_BC76_191109_LF_LIB_consensus_vsearch	3792	C	*/-G	333	19	4.67%	2	2	93	93	1.4862126505302066E-6	1	1	129	204	8	11	-G
G4_BC76_191109_LF_LIB_consensus_vsearch	3793	G	R	356	7	1.92%	2	1	93	93	0.007587769685234888	1	1	126	230	7	0	A
G4_BC76_191109_LF_LIB_consensus_vsearch	3794	G	R	373	10	2.6%	2	2	93	93	9.201647694189105E-4	1	1	132	241	9	1	A
G4_BC76_191109_LF_LIB_consensus_vsearch	3795	G	R	386	7	1.75%	2	2	93	93	0.0076048360660226225	1	1	140	246	2	5	A
G4_BC76_191109_LF_LIB_consensus_vsearch	3796	G	G	394	4	0.99%	2	2	93	93	0.06202859930052086	1	1	143	251	1	3	-T
G4_BC76_191109_LF_LIB_consensus_vsearch	3797	T	Y	375	10	2.48%	2	2	93	93	9.204527288502928E-4	1	1	137	238	2	8	C
G4_BC76_191109_LF_LIB_consensus_vsearch	3798	G	G	386	3	0.75%	2	2	93	93	0.12451737451743523	1	1	140	246	2	1	-A
G4_BC76_191109_LF_LIB_consensus_vsearch	3799	A	*/-G	386	9	2.24%	2	2	93	93	0.0018651929543866046	1	1	139	247	4	5	-G
G4_BC76_191109_LF_LIB_consensus_vsearch	3800	G	G	384	3	0.76%	2	1	93	93	0.12451487710233766	1	1	142	242	0	3	+C
G4_BC76_191109_LF_LIB_consensus_vsearch	3801	T	T	395	4	0.99%	2	2	93	93	0.06202978149183676	1	1	145	250	2	2	-C
G4_BC76_191109_LF_LIB_consensus_vsearch	3802	C	C	394	4	0.99%	2	2	93	93	0.06202859930052086	1	1	141	253	3	1	+A
G4_BC76_191109_LF_LIB_consensus_vsearch	3803	G	G	401	3	0.74%	2	1	93	93	0.1245353159851805	1	1	144	257	3	0	-A
G4_BC76_191109_LF_LIB_consensus_vsearch	3804	A	A	398	2	0.5%	2	1	93	93	0.249687108886017	1	1	144	254	0	2	-T
G4_BC76_191109_LF_LIB_consensus_vsearch	3805	T	*/-C	339	56	13.86%	2	2	93	93	1.7016979800527335E-18	1	1	90	249	50	6	-C
G4_BC76_191109_LF_LIB_consensus_vsearch	3806	C	*/+T	317	20	5.75%	2	1	93	93	7.13356662328966E-7	1	1	95	222	0	20	+T
G4_BC76_191109_LF_LIB_consensus_vsearch	3807	C	*/-T	376	15	3.71%	2	1	93	93	2.6615319210402104E-5	1	1	143	233	0	15	-T
G4_BC76_191109_LF_LIB_consensus_vsearch	3808	T	*/-A	357	9	2.32%	2	2	93	93	0.0018583173294912504	1	1	135	222	5	4	-A
G4_BC76_191109_LF_LIB_consensus_vsearch	3809	A	A	374	6	1.56%	2	2	93	93	0.015317428749418825	1	1	139	235	1	5	C
G4_BC76_191109_LF_LIB_consensus_vsearch	3810	A	W	359	20	5.06%	2	1	93	93	7.373142498379733E-7	1	1	145	214	0	20	T
G4_BC76_191109_LF_LIB_consensus_vsearch	3811	G	*/-CG	370	20	5%	2	1	93	93	7.428241446984615E-7	1	1	143	227	0	20	-CG
G4_BC76_191109_LF_LIB_consensus_vsearch	3812	C	Y	358	11	2.86%	2	2	93	93	4.52726239014979E-4	1	1	142	216	1	10	T
G4_BC76_191109_LF_LIB_consensus_vsearch	3813	G	R	367	7	1.84%	2	2	93	93	0.0075943435189384555	1	1	140	227	6	1	A
G4_BC76_191109_LF_LIB_consensus_vsearch	3814	G	G	400	2	0.49%	2	2	93	93	0.24968866749695368	1	1	143	257	1	1	-T
G4_BC76_191109_LF_LIB_consensus_vsearch	3815	T	Y	387	12	2.98%	2	2	93	93	2.2448869655710964E-4	1	1	143	244	2	10	C
G4_BC76_191109_LF_LIB_consensus_vsearch	3816	A	A	403	1	0.25%	2	1	93	93	0.4999999999999138	1	1	146	257	1	0	-GCC
G4_BC76_191109_LF_LIB_consensus_vsearch	3817	G	*/-C	367	25	6.17%	2	2	93	93	2.0075923907157618E-8	1	1	112	255	23	2	-C
G4_BC76_191109_LF_LIB_consensus_vsearch	3818	C	C	378	1	0.26%	2	1	93	93	0.4999999999999138	1	1	124	254	0	1	+T
G4_BC76_191109_LF_LIB_consensus_vsearch	3819	C	C	399	4	0.99%	2	2	93	93	0.06203445155203153	1	1	146	253	1	3	-T
G4_BC76_191109_LF_LIB_consensus_vsearch	3820	T	Y	377	16	3.97%	2	1	93	93	1.3058016225586293E-5	1	1	143	234	0	16	C
G4_BC76_191109_LF_LIB_consensus_vsearch	3821	A	A	398	3	0.75%	2	2	93	93	0.12453183520605009	1	1	142	256	2	1	G
G4_BC76_191109_LF_LIB_consensus_vsearch	3822	A	R	394	7	1.74%	2	1	93	93	0.007608958034696689	1	1	139	255	7	0	G
G4_BC76_191109_LF_LIB_consensus_vsearch	3823	C	C	390	4	0.99%	2	1	93	93	0.062023810487337606	1	1	145	245	0	4	+G
G4_BC76_191109_LF_LIB_consensus_vsearch	3824	G	G	400	2	0.5%	2	1	93	93	0.24968866749695368	1	1	144	256	2	0	A
G4_BC76_191109_LF_LIB_consensus_vsearch	3825	G	G	400	3	0.74%	2	1	93	93	0.12453416149047736	1	1	142	258	3	0	+C
G4_BC76_191109_LF_LIB_consensus_vsearch	3826	C	*/-TT	322	35	8.64%	2	1	93	93	1.2119914089400908E-11	1	1	81	241	35	0	-TT
G4_BC76_191109_LF_LIB_consensus_vsearch	3827	T	T	330	4	1.19%	2	2	93	93	0.06193820383042259	1	1	78	252	3	1	C
G4_BC76_191109_LF_LIB_consensus_vsearch	3828	T	W	316	15	4.17%	2	1	93	93	2.594884873672003E-5	1	1	69	247	15	0	A
G4_BC76_191109_LF_LIB_consensus_vsearch	3829	G	*/-A	357	16	4.2%	2	2	93	93	1.2947107227624673E-5	1	1	103	254	15	1	-A
G4_BC76_191109_LF_LIB_consensus_vsearch	3830	A	A	384	1	0.26%	2	1	93	93	0.4999999999999138	1	1	128	256	1	0	G
G4_BC76_191109_LF_LIB_consensus_vsearch	3831	A	A	387	4	0.99%	2	2	93	93	0.062020154536760255	1	1	143	244	1	3	+T
G4_BC76_191109_LF_LIB_consensus_vsearch	3832	T	T	392	2	0.51%	2	2	93	93	0.24968233799211464	1	1	144	248	1	1	C
G4_BC76_191109_LF_LIB_consensus_vsearch	3833	T	T	391	5	1.24%	2	2	93	93	0.030855681550508444	1	1	144	247	3	2	C
G4_BC76_191109_LF_LIB_consensus_vsearch	3834	T	*/+G	359	12	2.96%	2	1	93	93	2.230490343830887E-4	1	1	137	222	0	12	+G
G4_BC76_191109_LF_LIB_consensus_vsearch	3835	C	*/-A	337	22	5.5%	2	2	93	93	1.7111178927582392E-7	1	1	138	199	4	18	-A
G4_BC76_191109_LF_LIB_consensus_vsearch	3836	A	R	305	15	4.13%	2	2	93	93	2.5801231658812913E-5	1	1	139	166	2	13	G
G4_BC76_191109_LF_LIB_consensus_vsearch	3837	A	*/-G	335	17	4.39%	2	2	93	93	6.259945217329066E-6	1	1	145	190	1	16	-G
G4_BC76_191109_LF_LIB_consensus_vsearch	3838	G	K	324	35	9.41%	2	1	93	93	1.2182261649920363E-11	1	1	143	181	0	35	T
G4_BC76_191109_LF_LIB_consensus_vsearch	3839	G	*/-CG	364	30	7.48%	2	1	93	93	5.247704825203226E-10	1	1	144	220	0	30	-CG
G4_BC76_191109_LF_LIB_consensus_vsearch	3840	C	Y	348	13	3.49%	2	1	93	93	1.0936107380339226E-4	1	1	146	202	0	13	T
G4_BC76_191109_LF_LIB_consensus_vsearch	3841	G	*/+T	348	10	2.69%	2	1	93	93	9.162988826076158E-4	1	1	144	204	0	10	+T
G4_BC76_191109_LF_LIB_consensus_vsearch	3842	T	*/-C	341	52	13.03%	2	2	93	93	3.645531995270098E-17	1	1	146	195	1	51	-C
G4_BC76_191109_LF_LIB_consensus_vsearch	3843	C	*/-T	335	15	4.23%	2	2	93	93	2.618321754652276E-5	1	1	147	188	1	14	-T
G4_BC76_191109_LF_LIB_consensus_vsearch	3844	T	Y	364	8	2.04%	2	2	93	93	0.003760528653296498	1	1	136	228	1	7	C
G4_BC76_191109_LF_LIB_consensus_vsearch	3845	C	*/-T	375	9	2.31%	2	1	93	93	0.001862705653908663	1	1	139	236	0	9	-T
G4_BC76_191109_LF_LIB_consensus_vsearch	3846	T	W	368	7	1.8%	2	1	93	93	0.007594922120899784	1	1	139	229	0	7	A
G4_BC76_191109_LF_LIB_consensus_vsearch	3847	G	G	389	4	1%	2	1	93	93	0.06202259804292181	1	1	146	243	0	4	C
G4_BC76_191109_LF_LIB_consensus_vsearch	3848	C	*/+A	376	8	2%	2	1	93	93	0.0037650433430064176	1	1	140	236	0	8	+A
G4_BC76_191109_LF_LIB_consensus_vsearch	3849	G	*/-CG	357	33	8.25%	2	2	93	93	5.7431176442248834E-11	1	1	132	225	6	27	-CG
G4_BC76_191109_LF_LIB_consensus_vsearch	3850	C	Y	349	7	1.89%	2	2	93	93	0.007583376037704121	1	1	131	218	1	6	T
G4_BC76_191109_LF_LIB_consensus_vsearch	3851	G	R	349	10	2.74%	2	2	93	93	9.164636628305845E-4	1	1	126	223	8	2	A
G4_BC76_191109_LF_LIB_consensus_vsearch	3852	T	*/-C	378	17	4.23%	2	2	93	93	6.39918770690152E-6	1	1	128	250	15	2	-C
G4_BC76_191109_LF_LIB_consensus_vsearch	3853	C	C	383	1	0.26%	2	1	93	93	0.4999999999999138	1	1	128	255	1	0	+A
G4_BC76_191109_LF_LIB_consensus_vsearch	3854	C	*/-T	331	51	12.62%	2	2	93	93	7.425951116548738E-17	1	1	141	190	1	50	-T
G4_BC76_191109_LF_LIB_consensus_vsearch	3855	T	W	334	8	2.29%	2	2	93	93	0.003747869361231707	1	1	133	201	7	1	A
G4_BC76_191109_LF_LIB_consensus_vsearch	3856	T	*/-G	368	17	4.24%	2	2	93	93	6.369386231588866E-6	1	1	143	225	1	16	-G
G4_BC76_191109_LF_LIB_consensus_vsearch	3857	G	G	383	2	0.52%	2	2	93	93	0.24967490247067214	1	1	145	238	1	1	A
G4_BC76_191109_LF_LIB_consensus_vsearch	3858	G	*/+T	368	14	3.45%	2	1	93	93	5.40652177981554E-5	1	1	138	230	0	14	+T
G4_BC76_191109_LF_LIB_consensus_vsearch	3859	C	Y	370	18	4.58%	2	1	93	93	3.117806163061259E-6	1	1	139	231	0	18	T
G4_BC76_191109_LF_LIB_consensus_vsearch	3860	C	Y	364	17	4.23%	2	1	93	93	6.357058602775765E-6	1	1	146	218	0	17	T
G4_BC76_191109_LF_LIB_consensus_vsearch	3861	G	G	396	2	0.5%	2	1	93	93	0.24968553459123424	1	1	145	251	2	0	T
G4_BC76_191109_LF_LIB_consensus_vsearch	3862	C	Y	372	28	6.93%	2	2	93	93	2.283527119779282E-9	1	1	145	227	2	26	T
G4_BC76_191109_LF_LIB_consensus_vsearch	3863	T	*/+G	387	9	2.22%	2	1	93	93	0.0018654123049784304	1	1	148	239	0	9	+G
G4_BC76_191109_LF_LIB_consensus_vsearch	3864	G	*/-AA	374	17	4.18%	2	2	93	93	6.387437421351367E-6	1	1	132	242	5	12	-AA
G4_BC76_191109_LF_LIB_consensus_vsearch	3865	A	A	374	2	0.53%	2	2	93	93	0.2496671105194291	1	1	133	241	1	1	+G
G4_BC76_191109_LF_LIB_consensus_vsearch	3866	A	R	380	8	2.05%	2	2	93	93	0.003766486715388715	1	1	142	238	1	7	G
G4_BC76_191109_LF_LIB_consensus_vsearch	3867	A	*/-G	270	113	27.76%	2	2	93	93	5.71758040034157E-39	1	1	80	190	54	59	-G
G4_BC76_191109_LF_LIB_consensus_vsearch	3868	G	*/+C	269	12	4.2%	2	1	93	93	2.1655504769447275E-4	1	1	88	181	0	12	+C
G4_BC76_191109_LF_LIB_consensus_vsearch	3869	G	G	390	6	1.5%	2	1	93	93	0.015329823997787357	1	1	143	247	0	6	+A
G4_BC76_191109_LF_LIB_consensus_vsearch	3870	G	*/-AA	360	12	2.98%	2	2	93	93	2.231040711565667E-4	1	1	132	228	1	11	-AA
G4_BC76_191109_LF_LIB_consensus_vsearch	3871	A	A	381	2	0.52%	2	1	93	93	0.24967320261436957	1	1	140	241	0	2	G
G4_BC76_191109_LF_LIB_consensus_vsearch	3872	A	R	383	8	2.04%	2	2	93	93	0.0037675500295774327	1	1	142	241	3	5	G
G4_BC76_191109_LF_LIB_consensus_vsearch	3873	A	W	384	10	2.48%	2	1	93	93	9.217129834227815E-4	1	1	142	242	0	10	T
G4_BC76_191109_LF_LIB_consensus_vsearch	3874	G	G	395	4	0.99%	2	1	93	93	0.06202978149183676	1	1	137	258	4	0	-C
G4_BC76_191109_LF_LIB_consensus_vsearch	3875	C	C	400	1	0.25%	2	1	93	93	0.4999999999999138	1	1	144	256	0	1	+T
G4_BC76_191109_LF_LIB_consensus_vsearch	3876	C	C	393	6	1.47%	2	1	93	93	0.015332037719180692	1	1	146	247	0	6	T
G4_BC76_191109_LF_LIB_consensus_vsearch	3877	G	G	399	2	0.5%	2	2	93	93	0.24968789013733722	1	1	146	253	1	1	A
G4_BC76_191109_LF_LIB_consensus_vsearch	3878	C	C	387	5	1.24%	2	2	93	93	0.030851660526274274	1	1	137	250	3	2	-T
G4_BC76_191109_LF_LIB_consensus_vsearch	3879	T	Y	320	34	8.61%	2	2	93	93	2.5328950347770452E-11	1	1	113	207	2	32	C
G4_BC76_191109_LF_LIB_consensus_vsearch	3880	A	A	366	4	1.07%	2	1	93	93	0.061992901772438824	1	1	118	248	4	0	G
G4_BC76_191109_LF_LIB_consensus_vsearch	3881	A	A	396	4	0.99%	2	1	93	93	0.06203095776871511	1	1	143	253	4	0	-G
G4_BC76_191109_LF_LIB_consensus_vsearch	3882	G	G	392	6	1.49%	2	1	93	93	0.015331303510572384	1	1	141	251	0	6	C
G4_BC76_191109_LF_LIB_consensus_vsearch	3883	A	A	400	3	0.74%	2	1	93	93	0.12453416149047736	1	1	145	255	0	3	-T
G4_BC76_191109_LF_LIB_consensus_vsearch	3884	T	*/+C	386	13	3.22%	2	1	93	93	1.1053069410618301E-4	1	1	147	239	0	13	+C
G4_BC76_191109_LF_LIB_consensus_vsearch	3885	T	*/-C	391	12	2.95%	2	2	93	93	2.2467848276270147E-4	1	1	146	245	1	11	-C
G4_BC76_191109_LF_LIB_consensus_vsearch	3886	C	*/-G	379	11	2.78%	2	1	93	93	4.5459840602315744E-4	1	1	147	232	0	11	-G
G4_BC76_191109_LF_LIB_consensus_vsearch	3887	G	R	386	10	2.53%	2	2	93	93	9.219853921161506E-4	1	1	142	244	7	3	A
G4_BC76_191109_LF_LIB_consensus_vsearch	3888	G	G	406	1	0.25%	2	1	93	93	0.4999999999999138	1	1	149	257	0	1	-C
G4_BC76_191109_LF_LIB_consensus_vsearch	3889	C	C	396	3	0.74%	2	1	93	93	0.12452948557099502	1	1	144	252	3	0	-T
G4_BC76_191109_LF_LIB_consensus_vsearch	3890	T	Y	377	15	3.74%	2	2	93	93	2.662478633010287E-5	1	1	140	237	1	14	C
G4_BC76_191109_LF_LIB_consensus_vsearch	3891	A	R	389	7	1.74%	2	1	93	93	0.0076064012202881484	1	1	139	250	7	0	G
G4_BC76_191109_LF_LIB_consensus_vsearch	3892	C	C	392	5	1.24%	2	2	93	93	0.030856674154206513	1	1	144	248	1	4	+A
G4_BC76_191109_LF_LIB_consensus_vsearch	3893	A	A	392	6	1.49%	2	2	93	93	0.015331303510572384	1	1	143	249	3	3	G
G4_BC76_191109_LF_LIB_consensus_vsearch	3894	A	R	396	7	1.72%	2	2	93	93	0.007609963086240239	1	1	141	255	6	1	G
G4_BC76_191109_LF_LIB_consensus_vsearch	3895	C	C	396	3	0.74%	2	1	93	93	0.12452948557099502	1	1	144	252	0	3	-G
G4_BC76_191109_LF_LIB_consensus_vsearch	3896	G	G	397	3	0.74%	2	1	93	93	0.12453066332921275	1	1	143	254	3	0	A
G4_BC76_191109_LF_LIB_consensus_vsearch	3897	G	G	399	4	0.98%	2	2	93	93	0.06203445155203153	1	1	145	254	1	3	-C
G4_BC76_191109_LF_LIB_consensus_vsearch	3898	C	C	395	4	1%	2	1	93	93	0.06202978149183676	1	1	142	253	4	0	+A
G4_BC76_191109_LF_LIB_consensus_vsearch	3899	A	*/+G	359	23	5.67%	2	2	93	93	8.474342957223857E-8	1	1	143	216	1	22	+G
G4_BC76_191109_LF_LIB_consensus_vsearch	3900	G	*/+A	379	7	1.79%	2	1	93	93	0.007601089929303789	1	1	138	241	7	0	+A
G4_BC76_191109_LF_LIB_consensus_vsearch	3901	G	*/+A	370	27	6.68%	2	1	93	93	4.715581728157463E-9	1	1	118	252	27	0	+A
G4_BC76_191109_LF_LIB_consensus_vsearch	3902	G	G	402	3	0.74%	2	1	93	93	0.1245364647713705	1	1	147	255	0	3	-T
G4_BC76_191109_LF_LIB_consensus_vsearch	3903	T	T	393	6	1.48%	2	2	93	93	0.015332037719180692	1	1	145	248	2	4	C
G4_BC76_191109_LF_LIB_consensus_vsearch	3904	G	G	402	3	0.74%	2	1	93	93	0.1245364647713705	1	1	148	254	0	3	C
G4_BC76_191109_LF_LIB_consensus_vsearch	3905	A	*/+T	392	8	1.97%	2	2	93	93	0.0037706450711110975	1	1	143	249	1	7	+T
G4_BC76_191109_LF_LIB_consensus_vsearch	3906	C	*/-T	387	9	2.23%	2	2	93	93	0.0018654123049784304	1	1	142	245	1	8	-T
G4_BC76_191109_LF_LIB_consensus_vsearch	3907	T	T	380	5	1.26%	2	2	93	93	0.030844422818352438	1	1	141	239	1	4	-ATT
G4_BC76_191109_LF_LIB_consensus_vsearch	3908	A	A	390	5	1.26%	2	2	93	93	0.030854683924238017	1	1	138	252	3	2	-T
G4_BC76_191109_LF_LIB_consensus_vsearch	3909	T	T	388	6	1.51%	2	1	93	93	0.015328329503561841	1	1	137	251	6	0	G
G4_BC76_191109_LF_LIB_consensus_vsearch	3910	T	T	392	4	0.99%	2	2	93	93	0.06202621699451153	1	1	144	248	2	2	+G
G4_BC76_191109_LF_LIB_consensus_vsearch	3911	G	G	404	1	0.25%	2	1	93	93	0.4999999999999138	1	1	148	256	1	0	A
G4_BC76_191109_LF_LIB_consensus_vsearch	3912	G	G	407	1	0.25%	2	1	93	93	0.5000000000008233	1	1	149	258	0	1	-C
G4_BC76_191109_LF_LIB_consensus_vsearch	3913	C	*/-G	389	10	2.46%	2	2	93	93	9.223889705434762E-4	1	1	144	245	3	7	-G
G4_BC76_191109_LF_LIB_consensus_vsearch	3914	G	R	378	16	4.06%	2	2	93	93	1.3063283572416325E-5	1	1	131	247	14	2	A
G4_BC76_191109_LF_LIB_consensus_vsearch	3915	G	G	401	2	0.5%	2	2	93	93	0.24968944099344345	1	1	147	254	1	1	A
G4_BC76_191109_LF_LIB_consensus_vsearch	3916	C	*/-A	388	10	2.48%	2	2	93	93	9.222551090526941E-4	1	1	139	249	7	3	-A
G4_BC76_191109_LF_LIB_consensus_vsearch	3917	A	A	392	3	0.76%	2	2	93	93	0.12452471482865957	1	1	138	254	2	1	G
G4_BC76_191109_LF_LIB_consensus_vsearch	3918	A	R	391	10	2.45%	2	2	93	93	9.226547240173711E-4	1	1	134	257	9	1	G
G4_BC76_191109_LF_LIB_consensus_vsearch	3919	C	*/-GC	392	8	1.99%	2	1	93	93	0.0037706450711110975	1	1	134	258	8	0	-GC
G4_BC76_191109_LF_LIB_consensus_vsearch	3920	G	G	387	3	0.75%	2	2	93	93	0.12451861360729544	1	1	132	255	2	1	+C
G4_BC76_191109_LF_LIB_consensus_vsearch	3921	C	C	381	6	1.52%	2	2	93	93	0.01532297745106865	1	1	132	249	1	5	T
G4_BC76_191109_LF_LIB_consensus_vsearch	3922	T	*/+G	382	8	2.01%	2	1	93	93	0.0037671973936205536	1	1	142	240	0	8	+G
G4_BC76_191109_LF_LIB_consensus_vsearch	3923	G	G	398	4	0.99%	2	1	93	93	0.06203329275530562	1	1	146	252	0	4	C
G4_BC76_191109_LF_LIB_consensus_vsearch	3924	A	R	387	7	1.72%	2	2	93	93	0.007605360418658285	1	1	139	248	5	2	G
G4_BC76_191109_LF_LIB_consensus_vsearch	3925	C	*/-T	383	8	1.98%	2	2	93	93	0.0037675500295774327	1	1	139	244	2	6	-T
G4_BC76_191109_LF_LIB_consensus_vsearch	3926	T	Y	376	9	2.29%	2	2	93	93	0.00186293757088788	1	1	136	240	3	6	C
G4_BC76_191109_LF_LIB_consensus_vsearch	3927	G	G	394	3	0.75%	2	2	93	93	0.1245271122321419	1	1	139	255	1	2	+A
G4_BC76_191109_LF_LIB_consensus_vsearch	3928	A	*/-C	357	18	4.5%	2	2	93	93	3.0955569052562397E-6	1	1	117	240	6	12	-C
G4_BC76_191109_LF_LIB_consensus_vsearch	3929	C	C	360	5	1.36%	2	1	93	93	0.030822215052165283	1	1	120	240	0	5	T
G4_BC76_191109_LF_LIB_consensus_vsearch	3930	C	C	385	5	1.28%	2	2	93	93	0.030849619103815673	1	1	131	254	1	4	T
G4_BC76_191109_LF_LIB_consensus_vsearch	3931	C	Y	330	41	10.1%	2	2	93	93	1.4119878482839466E-13	1	1	126	204	2	39	T
G4_BC76_191109_LF_LIB_consensus_vsearch	3932	A	R	348	14	3.73%	2	2	93	93	5.369734605836364E-5	1	1	125	223	4	10	G
G4_BC76_191109_LF_LIB_consensus_vsearch	3933	A	*/-G	280	87	21.86%	2	2	93	93	1.9664935906884345E-29	1	1	126	154	16	71	-G
G4_BC76_191109_LF_LIB_consensus_vsearch	3934	G	*/+C	286	8	2.52%	2	1	93	93	0.0037223018487570997	1	1	123	163	0	8	+C
G4_BC76_191109_LF_LIB_consensus_vsearch	3935	G	S	383	9	2.23%	2	1	93	93	0.001864528271344425	1	1	149	234	0	9	C
G4_BC76_191109_LF_LIB_consensus_vsearch	3936	G	G	404	2	0.49%	2	2	93	93	0.24969173859492816	1	1	148	256	1	1	-A
G4_BC76_191109_LF_LIB_consensus_vsearch	3937	A	A	398	2	0.49%	2	1	93	93	0.249687108886017	1	1	147	251	0	2	-C
G4_BC76_191109_LF_LIB_consensus_vsearch	3938	C	C	392	4	0.99%	2	2	93	93	0.06202621699451153	1	1	145	247	2	2	-G
G4_BC76_191109_LF_LIB_consensus_vsearch	3939	G	R	387	9	2.24%	2	2	93	93	0.0018654123049784304	1	1	137	250	8	1	A
G4_BC76_191109_LF_LIB_consensus_vsearch	3940	G	G	392	5	1.23%	2	1	93	93	0.030856674154206513	1	1	145	247	0	5	-TG
G4_BC76_191109_LF_LIB_consensus_vsearch	3941	T	Y	384	7	1.75%	2	2	93	93	0.007603779356567615	1	1	144	240	1	6	C
G4_BC76_191109_LF_LIB_consensus_vsearch	3942	G	G	390	2	0.51%	2	1	93	93	0.24968071519789278	1	1	145	245	0	2	+TG
G4_BC76_191109_LF_LIB_consensus_vsearch	3943	C	*/-A	383	7	1.75%	2	2	93	93	0.007603246958909687	1	1	138	245	5	2	-A
G4_BC76_191109_LF_LIB_consensus_vsearch	3944	A	*/-C	377	12	3.02%	2	2	93	93	2.2399764271290005E-4	1	1	130	247	7	5	-C
G4_BC76_191109_LF_LIB_consensus_vsearch	3945	C	C	378	4	1.03%	2	1	93	93	0.062008841921801575	1	1	134	244	4	0	G
G4_BC76_191109_LF_LIB_consensus_vsearch	3946	C	C	393	3	0.74%	2	1	93	93	0.12452591656124207	1	1	145	248	0	3	-A
G4_BC76_191109_LF_LIB_consensus_vsearch	3947	A	*/-G	309	73	18.25%	2	1	93	93	2.351076075100649E-24	1	1	137	172	0	73	-G
G4_BC76_191109_LF_LIB_consensus_vsearch	3948	G	G	324	4	1.2%	2	1	93	93	0.061927919292029066	1	1	149	175	0	4	+T
G4_BC76_191109_LF_LIB_consensus_vsearch	3949	G	G	404	2	0.49%	2	1	93	93	0.24969173859492816	1	1	148	256	0	2	A
G4_BC76_191109_LF_LIB_consensus_vsearch	3950	A	A	401	3	0.74%	2	2	93	93	0.1245353159851805	1	1	145	256	1	2	-C
G4_BC76_191109_LF_LIB_consensus_vsearch	3951	C	C	401	2	0.5%	2	1	93	93	0.24968944099344345	1	1	147	254	0	2	T
G4_BC76_191109_LF_LIB_consensus_vsearch	3952	C	*/+G	387	8	1.97%	2	2	93	93	0.0037689428690762675	1	1	144	243	1	7	+G
G4_BC76_191109_LF_LIB_consensus_vsearch	3953	G	*/-AG	390	8	1.98%	2	1	93	93	0.0037699692796093966	1	1	137	253	8	0	-AG
G4_BC76_191109_LF_LIB_consensus_vsearch	3954	A	*/-G	374	13	3.28%	2	2	93	93	1.1018527269038747E-4	1	1	125	249	10	3	-G
G4_BC76_191109_LF_LIB_consensus_vsearch	3955	G	G	378	2	0.52%	2	1	93	93	0.24967061923567593	1	1	131	247	0	2	+C
G4_BC76_191109_LF_LIB_consensus_vsearch	3956	G	G	402	2	0.49%	2	1	93	93	0.2496902106567468	1	1	147	255	2	0	-A
G4_BC76_191109_LF_LIB_consensus_vsearch	3957	A	A	391	6	1.49%	2	2	93	93	0.01533056561273411	1	1	142	249	2	4	G
G4_BC76_191109_LF_LIB_consensus_vsearch	3958	C	*/+A	384	9	2.22%	2	2	93	93	0.0018647509458963453	1	1	145	239	1	8	+A
G4_BC76_191109_LF_LIB_consensus_vsearch	3959	A	A	390	5	1.25%	2	1	93	93	0.030854683924238017	1	1	146	244	0	5	G
G4_BC76_191109_LF_LIB_consensus_vsearch	3960	A	A	398	3	0.74%	2	2	93	93	0.12453183520605009	1	1	144	254	1	2	C
G4_BC76_191109_LF_LIB_consensus_vsearch	3961	G	G	391	6	1.47%	2	1	93	93	0.01533056561273411	1	1	147	244	0	6	+C
G4_BC76_191109_LF_LIB_consensus_vsearch	3962	T	T	389	6	1.5%	2	2	93	93	0.015329078637527195	1	1	148	241	1	5	C
G4_BC76_191109_LF_LIB_consensus_vsearch	3963	T	Y	376	12	2.98%	2	2	93	93	2.2394718504488464E-4	1	1	148	228	1	11	C
G4_BC76_191109_LF_LIB_consensus_vsearch	3964	C	C	395	5	1.24%	2	2	93	93	0.030859622206549208	1	1	146	249	1	4	-T
G4_BC76_191109_LF_LIB_consensus_vsearch	3965	T	*/-CT	364	18	4.5%	2	2	93	93	3.1077101688596113E-6	1	1	141	223	4	14	-CT
G4_BC76_191109_LF_LIB_consensus_vsearch	3966	C	*/-T	351	16	4.23%	2	2	93	93	1.2911626608697888E-5	1	1	142	209	2	14	-T
G4_BC76_191109_LF_LIB_consensus_vsearch	3967	T	T	361	4	1.09%	2	2	93	93	0.061985950492774826	1	1	140	221	1	3	+CT
G4_BC76_191109_LF_LIB_consensus_vsearch	3968	T	T	393	4	0.99%	2	2	93	93	0.0620274111497499	1	1	147	246	2	2	+C
G4_BC76_191109_LF_LIB_consensus_vsearch	3969	G	G	399	3	0.74%	2	1	93	93	0.12453300124551302	1	1	145	254	0	3	-T
G4_BC76_191109_LF_LIB_consensus_vsearch	3970	T	T	396	3	0.74%	2	1	93	93	0.12452948557099502	1	1	148	248	0	3	C
G4_BC76_191109_LF_LIB_consensus_vsearch	3971	T	T	390	5	1.23%	2	1	93	93	0.030854683924238017	1	1	147	243	0	5	C
G4_BC76_191109_LF_LIB_consensus_vsearch	3972	G	R	383	15	3.69%	2	1	93	93	2.6680639716138052E-5	1	1	146	237	0	15	A
G4_BC76_191109_LF_LIB_consensus_vsearch	3973	T	Y	380	14	3.44%	2	2	93	93	5.426877300342222E-5	1	1	145	235	2	12	C
G4_BC76_191109_LF_LIB_consensus_vsearch	3974	C	*/+A	377	7	1.75%	2	1	93	93	0.007599994652592844	1	1	133	244	7	0	+A
G4_BC76_191109_LF_LIB_consensus_vsearch	3975	G	S	380	11	2.72%	2	2	93	93	4.546826533185083E-4	1	1	135	245	10	1	C
G4_BC76_191109_LF_LIB_consensus_vsearch	3976	C	*/-A	361	19	4.73%	2	1	93	93	1.514486893723883E-6	1	1	147	214	0	19	-A
G4_BC76_191109_LF_LIB_consensus_vsearch	3977	A	A	382	4	1.03%	2	2	93	93	0.06201393491983747	1	1	145	237	1	3	G
G4_BC76_191109_LF_LIB_consensus_vsearch	3978	A	A	397	5	1.23%	2	1	93	93	0.03086156314569468	1	1	146	251	0	5	-T
G4_BC76_191109_LF_LIB_consensus_vsearch	3979	T	Y	379	20	4.99%	2	1	93	93	7.47128900641539E-7	1	1	148	231	0	20	C
G4_BC76_191109_LF_LIB_consensus_vsearch	3980	C	C	401	1	0.25%	2	1	93	93	0.5000000000008233	1	1	146	255	1	0	+A
G4_BC76_191109_LF_LIB_consensus_vsearch	3981	G	G	402	1	0.25%	2	1	93	93	0.4999999999999138	1	1	147	255	0	1	-CCG
G4_BC76_191109_LF_LIB_consensus_vsearch	3982	C	C	398	3	0.74%	2	2	93	93	0.12453183520605009	1	1	144	254	1	2	T
G4_BC76_191109_LF_LIB_consensus_vsearch	3983	C	C	393	4	0.98%	2	1	93	93	0.0620274111497499	1	1	145	248	0	4	T
G4_BC76_191109_LF_LIB_consensus_vsearch	3984	G	G	397	6	1.48%	2	1	93	93	0.015334938209013941	1	1	143	254	6	0	A
G4_BC76_191109_LF_LIB_consensus_vsearch	3985	T	Y	393	7	1.72%	2	2	93	93	0.007608451759263046	1	1	141	252	2	5	C
G4_BC76_191109_LF_LIB_consensus_vsearch	3986	C	*/+G	396	7	1.72%	2	1	93	93	0.007609963086240239	1	1	139	257	7	0	+G
G4_BC76_191109_LF_LIB_consensus_vsearch	3987	A	*/-G	375	13	3.19%	2	2	93	93	1.102148449959401E-4	1	1	130	245	8	5	-G
G4_BC76_191109_LF_LIB_consensus_vsearch	3988	G	G	394	1	0.25%	2	1	93	93	0.4999999999999138	1	1	141	253	0	1	A
G4_BC76_191109_LF_LIB_consensus_vsearch	3989	G	*/+C	381	10	2.45%	2	2	93	93	9.212992345460898E-4	1	1	139	242	4	6	+C
G4_BC76_191109_LF_LIB_consensus_vsearch	3990	C	C	390	4	1.01%	2	1	93	93	0.062023810487337606	1	1	146	244	0	4	T
G4_BC76_191109_LF_LIB_consensus_vsearch	3991	C	*/-T	384	17	4.18%	2	1	93	93	6.4164031706101775E-6	1	1	148	236	0	17	-T
G4_BC76_191109_LF_LIB_consensus_vsearch	3992	T	T	373	6	1.54%	2	1	93	93	0.015316619391186111	1	1	146	227	0	6	-C
G4_BC76_191109_LF_LIB_consensus_vsearch	3993	C	*/-G	346	44	11.08%	2	2	93	93	1.572261010494183E-14	1	1	127	219	17	27	-G
G4_BC76_191109_LF_LIB_consensus_vsearch	3994	G	G	350	4	1.11%	2	2	93	93	0.06196996599360747	1	1	128	222	1	3	A
G4_BC76_191109_LF_LIB_consensus_vsearch	3995	G	*/-A	386	9	2.22%	2	2	93	93	0.0018651929543866046	1	1	139	247	4	5	-A
G4_BC76_191109_LF_LIB_consensus_vsearch	3996	A	A	391	2	0.51%	2	2	93	93	0.24968152866242077	1	1	139	252	1	1	G
G4_BC76_191109_LF_LIB_consensus_vsearch	3997	A	A	400	2	0.5%	2	1	93	93	0.24968866749695368	1	1	142	258	2	0	+G
G4_BC76_191109_LF_LIB_consensus_vsearch	3998	A	A	396	4	0.99%	2	2	93	93	0.06203095776871511	1	1	141	255	1	3	-TG
G4_BC76_191109_LF_LIB_consensus_vsearch	3999	T	T	391	4	1%	2	1	93	93	0.06202501678889606	1	1	139	252	4	0	-G
G4_BC76_191109_LF_LIB_consensus_vsearch	4000	G	R	373	17	4.27%	2	1	93	93	6.384464791951477E-6	1	1	125	248	17	0	A
G4_BC76_191109_LF_LIB_consensus_vsearch	4001	C	C	393	3	0.75%	2	2	93	93	0.12452591656124207	1	1	145	248	1	2	T
G4_BC76_191109_LF_LIB_consensus_vsearch	4002	A	A	394	4	0.99%	2	2	93	93	0.06202859930052086	1	1	143	251	1	3	+T
G4_BC76_191109_LF_LIB_consensus_vsearch	4003	T	T	400	1	0.25%	2	1	93	93	0.4999999999999138	1	1	145	255	0	1	C
G4_BC76_191109_LF_LIB_consensus_vsearch	4004	T	*/+G	385	14	3.46%	2	1	93	93	5.435012474528051E-5	1	1	146	239	0	14	+G
G4_BC76_191109_LF_LIB_consensus_vsearch	4005	G	G	393	6	1.48%	2	2	93	93	0.015332037719180692	1	1	145	248	1	5	-C
G4_BC76_191109_LF_LIB_consensus_vsearch	4006	C	Y	365	19	4.76%	2	1	93	93	1.518220570262078E-6	1	1	142	223	0	19	T
G4_BC76_191109_LF_LIB_consensus_vsearch	4007	G	G	389	2	0.51%	2	1	93	93	0.24967989756723366	1	1	141	248	0	2	A
G4_BC76_191109_LF_LIB_consensus_vsearch	4008	C	*/-A	379	7	1.78%	2	2	93	93	0.007601089929303789	1	1	132	247	6	1	-A
G4_BC76_191109_LF_LIB_consensus_vsearch	4009	A	A	390	3	0.76%	2	1	93	93	0.12452229299364298	1	1	134	256	3	0	-G
G4_BC76_191109_LF_LIB_consensus_vsearch	4010	G	G	390	5	1.25%	2	2	93	93	0.030854683924238017	1	1	134	256	4	1	+C
G4_BC76_191109_LF_LIB_consensus_vsearch	4011	A	A	398	2	0.5%	2	2	93	93	0.249687108886017	1	1	142	256	1	1	+G
G4_BC76_191109_LF_LIB_consensus_vsearch	4012	G	*/-AG	324	32	7.94%	2	2	93	93	1.1230017863221747E-10	1	1	93	231	15	17	-AG
G4_BC76_191109_LF_LIB_consensus_vsearch	4013	A	*/-G	156	98	29.88%	2	2	93	93	2.6435300007594046E-35	1	1	20	136	19	79	-G
G4_BC76_191109_LF_LIB_consensus_vsearch	4014	G	G	165	2	1.18%	2	1	93	93	0.24924924924929934	1	1	24	141	0	2	+AG
G4_BC76_191109_LF_LIB_consensus_vsearch	4015	G	G	299	4	1.32%	2	2	93	93	0.06188067924846094	1	1	59	240	3	1	A
G4_BC76_191109_LF_LIB_consensus_vsearch	4016	G	G	376	3	0.79%	2	2	93	93	0.12450462351395263	1	1	123	253	2	1	A
G4_BC76_191109_LF_LIB_consensus_vsearch	4017	G	G	403	2	0.49%	2	1	93	93	0.24969097651407932	1	1	145	258	2	0	A
G4_BC76_191109_LF_LIB_consensus_vsearch	4018	G	*/-C	398	9	2.21%	2	1	93	93	0.0018677548734163589	1	1	139	259	9	0	-C
G4_BC76_191109_LF_LIB_consensus_vsearch	4019	C	C	390	5	1.26%	2	1	93	93	0.030854683924238017	1	1	139	251	0	5	+T
G4_BC76_191109_LF_LIB_consensus_vsearch	4020	C	C	399	5	1.23%	2	1	93	93	0.030863484879977227	1	1	147	252	0	5	-T
G4_BC76_191109_LF_LIB_consensus_vsearch	4021	T	Y	385	11	2.73%	2	2	93	93	4.550976487942495E-4	1	1	147	238	2	9	C
G4_BC76_191109_LF_LIB_consensus_vsearch	4022	G	G	405	2	0.49%	2	1	93	93	0.2496924969251474	1	1	149	256	0	2	-A
G4_BC76_191109_LF_LIB_consensus_vsearch	4023	A	A	405	1	0.25%	2	1	93	93	0.5000000000008233	1	1	148	257	1	0	-TCG
G4_BC76_191109_LF_LIB_consensus_vsearch	4024	T	T	403	2	0.49%	2	1	93	93	0.24969097651407932	1	1	147	256	0	2	C
G4_BC76_191109_LF_LIB_consensus_vsearch	4025	C	*/-G	391	7	1.73%	2	1	93	93	0.007607431615374521	1	1	143	248	0	7	-G
G4_BC76_191109_LF_LIB_consensus_vsearch	4026	G	G	392	4	1.01%	2	1	93	93	0.06202621699451153	1	1	142	250	4	0	A
G4_BC76_191109_LF_LIB_consensus_vsearch	4027	G	G	396	4	0.98%	2	2	93	93	0.06203095776871511	1	1	142	254	2	2	-T
G4_BC76_191109_LF_LIB_consensus_vsearch	4028	T	Y	388	9	2.23%	2	1	93	93	0.0018656305641170923	1	1	146	242	0	9	C
G4_BC76_191109_LF_LIB_consensus_vsearch	4029	G	G	394	4	0.99%	2	1	93	93	0.06202859930052086	1	1	140	254	4	0	+A
G4_BC76_191109_LF_LIB_consensus_vsearch	4030	A	*/-G	301	33	8.21%	2	2	93	93	5.0701746670513196E-11	1	1	73	228	26	7	-G
G4_BC76_191109_LF_LIB_consensus_vsearch	4031	G	R	311	13	3.93%	2	1	93	93	1.0796978097540301E-4	1	1	63	248	13	0	A
G4_BC76_191109_LF_LIB_consensus_vsearch	4032	G	*/+A	337	12	3.29%	2	2	93	93	2.2176097531794397E-4	1	1	84	253	11	1	+A
G4_BC76_191109_LF_LIB_consensus_vsearch	4033	A	A	347	6	1.66%	2	2	93	93	0.015293971208790802	1	1	92	255	5	1	-G
G4_BC76_191109_LF_LIB_consensus_vsearch	4034	G	R	373	10	2.55%	2	1	93	93	9.201647694189105E-4	1	1	121	252	10	0	A
G4_BC76_191109_LF_LIB_consensus_vsearch	4035	C	C	377	4	1.01%	2	2	93	93	0.06200755195210619	1	1	133	244	3	1	A
G4_BC76_191109_LF_LIB_consensus_vsearch	4036	G	*/-C	323	55	13.78%	2	2	93	93	3.334794097193485E-18	1	1	79	244	53	2	-C
G4_BC76_191109_LF_LIB_consensus_vsearch	4037	C	*/+T	321	11	3.23%	2	1	93	93	4.4886662930169725E-4	1	1	82	239	0	11	+T
G4_BC76_191109_LF_LIB_consensus_vsearch	4038	C	*/+T	381	8	2.01%	2	1	93	93	0.003766842960150322	1	1	137	244	0	8	+T
G4_BC76_191109_LF_LIB_consensus_vsearch	4039	C	*/-T	376	17	4.17%	2	2	93	93	6.393340411735821E-6	1	1	142	234	2	15	-T
G4_BC76_191109_LF_LIB_consensus_vsearch	4040	T	Y	355	16	4.1%	2	1	93	93	1.293539985828286E-5	1	1	133	222	0	16	C
G4_BC76_191109_LF_LIB_consensus_vsearch	4041	A	A	387	5	1.24%	2	1	93	93	0.030851660526274274	1	1	140	247	0	5	-G
G4_BC76_191109_LF_LIB_consensus_vsearch	4042	G	K	381	8	2%	2	1	93	93	0.003766842960150322	1	1	137	244	8	0	T
G4_BC76_191109_LF_LIB_consensus_vsearch	4043	T	Y	383	8	2.02%	2	1	93	93	0.0037675500295774327	1	1	145	238	0	8	C
G4_BC76_191109_LF_LIB_consensus_vsearch	4044	G	*/-CG	362	29	7.32%	2	1	93	93	1.0865966641283314E-9	1	1	143	219	0	29	-CG
G4_BC76_191109_LF_LIB_consensus_vsearch	4045	C	C	369	3	0.8%	2	1	93	93	0.12449528936743005	1	1	146	223	0	3	+A
G4_BC76_191109_LF_LIB_consensus_vsearch	4046	G	R	359	7	1.87%	2	2	93	93	0.007589601517637295	1	1	144	215	1	6	A
G4_BC76_191109_LF_LIB_consensus_vsearch	4047	T	T	388	6	1.49%	2	2	93	93	0.015328329503561841	1	1	143	245	2	4	C
G4_BC76_191109_LF_LIB_consensus_vsearch	4048	C	*/-T	384	11	2.7%	2	1	93	93	4.5501547153779163E-4	1	1	143	241	0	11	-T
G4_BC76_191109_LF_LIB_consensus_vsearch	4049	T	T	377	6	1.53%	2	1	93	93	0.01531983153360656	1	1	144	233	0	6	-C
G4_BC76_191109_LF_LIB_consensus_vsearch	4050	C	C	377	6	1.51%	2	2	93	93	0.01531983153360656	1	1	142	235	1	5	-G
G4_BC76_191109_LF_LIB_consensus_vsearch	4051	G	G	387	5	1.24%	2	1	93	93	0.030851660526274274	1	1	146	241	0	5	+C
G4_BC76_191109_LF_LIB_consensus_vsearch	4052	T	W	382	11	2.74%	2	2	93	93	4.548498903980809E-4	1	1	141	241	1	10	A
G4_BC76_191109_LF_LIB_consensus_vsearch	4053	G	*/-C	388	7	1.75%	2	1	93	93	0.007605882130108492	1	1	144	244	0	7	-C
G4_BC76_191109_LF_LIB_consensus_vsearch	4054	C	*/-T	363	28	7%	2	2	93	93	2.2570079469832566E-9	1	1	140	223	6	22	-T
G4_BC76_191109_LF_LIB_consensus_vsearch	4055	T	T	373	5	1.32%	2	2	93	93	0.03083691723172624	1	1	141	232	1	4	C
G4_BC76_191109_LF_LIB_consensus_vsearch	4056	T	*/-C	382	7	1.72%	2	1	93	93	0.0076027118384171	1	1	143	239	0	7	-C
G4_BC76_191109_LF_LIB_consensus_vsearch	4057	C	C	380	5	1.27%	2	2	93	93	0.030844422818352438	1	1	143	237	2	3	-T
G4_BC76_191109_LF_LIB_consensus_vsearch	4058	T	T	383	4	1.01%	2	2	93	93	0.06201519170852023	1	1	144	239	1	3	-G
G4_BC76_191109_LF_LIB_consensus_vsearch	4059	G	G	392	4	1%	2	1	93	93	0.06202621699451153	1	1	139	253	4	0	A
G4_BC76_191109_LF_LIB_consensus_vsearch	4060	G	G	401	1	0.25%	2	1	93	93	0.5000000000008233	1	1	146	255	1	0	+A
G4_BC76_191109_LF_LIB_consensus_vsearch	4061	T	T	400	2	0.49%	2	2	93	93	0.24968866749695368	1	1	144	256	1	1	C
G4_BC76_191109_LF_LIB_consensus_vsearch	4062	G	G	397	5	1.23%	2	2	93	93	0.03086156314569468	1	1	143	254	2	3	A
G4_BC76_191109_LF_LIB_consensus_vsearch	4063	C	C	398	5	1.23%	2	2	93	93	0.030862526395586183	1	1	144	254	4	1	-GC
G4_BC76_191109_LF_LIB_consensus_vsearch	4064	G	*/-C	315	63	15.75%	2	2	93	93	6.462664751361808E-21	1	1	122	193	16	47	-C
G4_BC76_191109_LF_LIB_consensus_vsearch	4065	C	*/+T	319	8	2.39%	2	1	93	93	0.0037406775635562078	1	1	125	194	0	8	+T
G4_BC76_191109_LF_LIB_consensus_vsearch	4066	C	C	399	2	0.5%	2	1	93	93	0.24968789013733722	1	1	145	254	0	2	T
G4_BC76_191109_LF_LIB_consensus_vsearch	4067	C	C	400	4	0.98%	2	1	93	93	0.06203560460879861	1	1	147	253	0	4	+T
G4_BC76_191109_LF_LIB_consensus_vsearch	4068	C	*/-T	367	25	6.13%	2	2	93	93	2.0075923907157618E-8	1	1	143	224	2	23	-T
G4_BC76_191109_LF_LIB_consensus_vsearch	4069	T	T	368	5	1.33%	2	2	93	93	0.03083138374265857	1	1	139	229	4	1	A
G4_BC76_191109_LF_LIB_consensus_vsearch	4070	T	T	392	3	0.75%	2	2	93	93	0.12452471482865957	1	1	142	250	1	2	C
G4_BC76_191109_LF_LIB_consensus_vsearch	4071	G	*/-A	341	51	12.56%	2	2	93	93	7.79766380459576E-17	1	1	138	203	9	42	-A
G4_BC76_191109_LF_LIB_consensus_vsearch	4072	A	A	345	6	1.71%	2	2	93	93	0.015292090471053536	1	1	137	208	2	4	G
G4_BC76_191109_LF_LIB_consensus_vsearch	4073	A	A	397	3	0.75%	2	2	93	93	0.12453066332921275	1	1	145	252	1	2	G
G4_BC76_191109_LF_LIB_consensus_vsearch	4074	A	A	399	3	0.74%	2	2	93	93	0.12453300124551302	1	1	145	254	1	2	G
G4_BC76_191109_LF_LIB_consensus_vsearch	4075	A	R	375	14	3.44%	2	1	93	93	5.41854192901933E-5	1	1	130	245	14	0	G
G4_BC76_191109_LF_LIB_consensus_vsearch	4076	C	*/+T	391	7	1.75%	2	2	93	93	0.007607431615374521	1	1	145	246	1	6	+T
G4_BC76_191109_LF_LIB_consensus_vsearch	4077	C	*/-T	366	25	6.14%	2	2	93	93	2.0054986841706538E-8	1	1	147	219	1	24	-T
G4_BC76_191109_LF_LIB_consensus_vsearch	4078	T	T	371	4	1.05%	2	1	93	93	0.06199966756219321	1	1	146	225	0	4	-C
G4_BC76_191109_LF_LIB_consensus_vsearch	4079	C	*/-G	385	8	1.99%	2	2	93	93	0.0037682499633968467	1	1	147	238	1	7	-G
G4_BC76_191109_LF_LIB_consensus_vsearch	4080	G	R	375	18	4.52%	2	2	93	93	3.1260025940381716E-6	1	1	129	246	15	3	A
G4_BC76_191109_LF_LIB_consensus_vsearch	4081	G	G	384	6	1.48%	2	1	93	93	0.015325294651568566	1	1	139	245	0	6	-T
G4_BC76_191109_LF_LIB_consensus_vsearch	4082	T	W	370	15	3.77%	2	1	93	93	2.6557536805524368E-5	1	1	144	226	0	15	A
G4_BC76_191109_LF_LIB_consensus_vsearch	4083	G	G	397	4	0.99%	2	1	93	93	0.062032128175275904	1	1	146	251	0	4	C
G4_BC76_191109_LF_LIB_consensus_vsearch	4084	A	A	400	4	0.99%	2	1	93	93	0.06203560460879861	1	1	147	253	0	4	-T
G4_BC76_191109_LF_LIB_consensus_vsearch	4085	T	*/+C	383	11	2.74%	2	1	93	93	4.549328864195511E-4	1	1	133	250	11	0	+C
G4_BC76_191109_LF_LIB_consensus_vsearch	4086	C	*/-A	381	10	2.48%	2	2	93	93	9.212992345460898E-4	1	1	137	244	6	4	-A
G4_BC76_191109_LF_LIB_consensus_vsearch	4087	A	R	372	12	3.02%	2	2	93	93	2.2374280247256466E-4	1	1	136	236	3	9	G
G4_BC76_191109_LF_LIB_consensus_vsearch	4088	C	*/+T	378	11	2.73%	2	2	93	93	4.5451373534606624E-4	1	1	139	239	3	8	+T
G4_BC76_191109_LF_LIB_consensus_vsearch	4089	A	R	389	7	1.75%	2	1	93	93	0.0076064012202881484	1	1	135	254	7	0	G
G4_BC76_191109_LF_LIB_consensus_vsearch	4090	A	R	375	15	3.69%	2	2	93	93	2.6605806005741526E-5	1	1	129	246	14	1	G
G4_BC76_191109_LF_LIB_consensus_vsearch	4091	C	C	388	6	1.49%	2	2	93	93	0.015328329503561841	1	1	138	250	1	5	-T
G4_BC76_191109_LF_LIB_consensus_vsearch	4092	T	Y	378	14	3.51%	2	2	93	93	5.423567585746075E-5	1	1	143	235	1	13	C
G4_BC76_191109_LF_LIB_consensus_vsearch	4093	A	W	381	8	1.99%	2	1	93	93	0.003766842960150322	1	1	132	249	8	0	T
G4_BC76_191109_LF_LIB_consensus_vsearch	4094	C	C	391	5	1.24%	2	1	93	93	0.030855681550508444	1	1	146	245	0	5	T
G4_BC76_191109_LF_LIB_consensus_vsearch	4095	G	*/-C	385	9	2.22%	2	1	93	93	0.001864972504119446	1	1	132	253	9	0	-C
G4_BC76_191109_LF_LIB_consensus_vsearch	4096	C	C	385	6	1.52%	2	2	93	93	0.01532605917062568	1	1	136	249	1	5	T
G4_BC76_191109_LF_LIB_consensus_vsearch	4097	C	C	396	5	1.23%	2	2	93	93	0.03086059509471206	1	1	145	251	1	4	T
G4_BC76_191109_LF_LIB_consensus_vsearch	4098	C	Y	389	12	2.94%	2	2	93	93	2.245840498305788E-4	1	1	146	243	1	11	T
G4_BC76_191109_LF_LIB_consensus_vsearch	4099	G	G	392	5	1.23%	2	1	93	93	0.030856674154206513	1	1	139	253	5	0	+A
G4_BC76_191109_LF_LIB_consensus_vsearch	4100	T	T	394	5	1.23%	2	2	93	93	0.030858644444955494	1	1	145	249	3	2	+A
G4_BC76_191109_LF_LIB_consensus_vsearch	4101	G	G	394	4	0.99%	2	1	93	93	0.06202859930052086	1	1	145	249	0	4	-CT
G4_BC76_191109_LF_LIB_consensus_vsearch	4102	C	*/-T	386	8	1.99%	2	2	93	93	0.003768597288121233	1	1	143	243	1	7	-T
G4_BC76_191109_LF_LIB_consensus_vsearch	4103	T	T	385	4	1.02%	2	1	93	93	0.06201768588877767	1	1	144	241	0	4	C
G4_BC76_191109_LF_LIB_consensus_vsearch	4104	T	T	396	3	0.74%	2	1	93	93	0.12452948557099502	1	1	144	252	3	0	G
G4_BC76_191109_LF_LIB_consensus_vsearch	4105	C	C	386	4	0.98%	2	1	93	93	0.062018923379747036	1	1	147	239	0	4	T
G4_BC76_191109_LF_LIB_consensus_vsearch	4106	G	G	394	4	0.99%	2	2	93	93	0.06202859930052086	1	1	147	247	2	2	A
G4_BC76_191109_LF_LIB_consensus_vsearch	4107	T	Y	395	8	1.99%	2	1	93	93	0.00377164628554966	1	1	149	246	0	8	C
G4_BC76_191109_LF_LIB_consensus_vsearch	4108	T	T	400	2	0.49%	2	1	93	93	0.24968866749695368	1	1	148	252	0	2	+G
G4_BC76_191109_LF_LIB_consensus_vsearch	4109	G	G	400	2	0.5%	2	1	93	93	0.24968866749695368	1	1	149	251	0	2	A
G4_BC76_191109_LF_LIB_consensus_vsearch	4110	T	T	399	4	0.98%	2	1	93	93	0.06203445155203153	1	1	147	252	0	4	C
G4_BC76_191109_LF_LIB_consensus_vsearch	4111	C	C	393	5	1.23%	2	1	93	93	0.03085766177318207	1	1	142	251	5	0	+A
G4_BC76_191109_LF_LIB_consensus_vsearch	4112	G	G	389	5	1.24%	2	1	93	93	0.030853681237272182	1	1	141	248	5	0	T
G4_BC76_191109_LF_LIB_consensus_vsearch	4113	T	Y	386	10	2.49%	2	1	93	93	9.219853921161506E-4	1	1	149	237	0	10	C
G4_BC76_191109_LF_LIB_consensus_vsearch	4114	A	R	393	8	1.97%	2	2	93	93	0.003770980459969231	1	1	143	250	6	2	G
G4_BC76_191109_LF_LIB_consensus_vsearch	4115	C	*/-T	368	24	5.9%	2	1	93	93	4.146114719952999E-8	1	1	147	221	0	24	-T
G4_BC76_191109_LF_LIB_consensus_vsearch	4116	T	*/-C	356	13	3.39%	2	1	93	93	1.096265828921135E-4	1	1	140	216	0	13	-C
G4_BC76_191109_LF_LIB_consensus_vsearch	4117	C	*/+T	366	13	3.29%	2	1	93	93	1.0994327994336431E-4	1	1	146	220	0	13	+T
G4_BC76_191109_LF_LIB_consensus_vsearch	4118	T	*/+A	367	17	4.27%	2	2	93	93	6.366326708947693E-6	1	1	142	225	2	15	+A
G4_BC76_191109_LF_LIB_consensus_vsearch	4119	A	A	401	1	0.25%	2	1	93	93	0.5000000000008233	1	1	147	254	1	0	+TG
G4_BC76_191109_LF_LIB_consensus_vsearch	4120	A	A	402	2	0.49%	2	2	93	93	0.2496902106567468	1	1	147	255	1	1	G
G4_BC76_191109_LF_LIB_consensus_vsearch	4121	A	R	391	7	1.72%	2	2	93	93	0.007607431615374521	1	1	138	253	3	4	G
G4_BC76_191109_LF_LIB_consensus_vsearch	4122	C	C	396	3	0.75%	2	2	93	93	0.12452948557099502	1	1	140	256	1	2	A
G4_BC76_191109_LF_LIB_consensus_vsearch	4123	C	C	388	6	1.48%	2	2	93	93	0.015328329503561841	1	1	138	250	2	4	-G
G4_BC76_191109_LF_LIB_consensus_vsearch	4124	G	R	382	10	2.51%	2	2	93	93	9.214378424824657E-4	1	1	132	250	9	1	A
G4_BC76_191109_LF_LIB_consensus_vsearch	4125	C	C	393	3	0.75%	2	2	93	93	0.12452591656124207	1	1	142	251	2	1	+A
G4_BC76_191109_LF_LIB_consensus_vsearch	4126	A	A	393	4	0.99%	2	2	93	93	0.0620274111497499	1	1	141	252	3	1	T
G4_BC76_191109_LF_LIB_consensus_vsearch	4127	G	*/-CAG	388	7	1.72%	2	1	93	93	0.007605882130108492	1	1	139	249	0	7	-CAG
G4_BC76_191109_LF_LIB_consensus_vsearch	4128	C	C	389	2	0.51%	2	1	93	93	0.24967989756723366	1	1	140	249	2	0	G
G4_BC76_191109_LF_LIB_consensus_vsearch	4129	A	*/-G	383	12	3.01%	2	2	93	93	2.2429517467312504E-4	1	1	138	245	8	4	-G
G4_BC76_191109_LF_LIB_consensus_vsearch	4130	G	G	385	1	0.26%	2	1	93	93	0.4999999999999138	1	1	138	247	1	0	+A
G4_BC76_191109_LF_LIB_consensus_vsearch	4131	G	G	404	1	0.25%	2	1	93	93	0.4999999999999138	1	1	147	257	0	1	+T
G4_BC76_191109_LF_LIB_consensus_vsearch	4132	T	T	397	6	1.48%	2	1	93	93	0.015334938209013941	1	1	148	249	0	6	+C
G4_BC76_191109_LF_LIB_consensus_vsearch	4133	C	*/-T	396	7	1.73%	2	2	93	93	0.007609963086240239	1	1	147	249	1	6	-T
G4_BC76_191109_LF_LIB_consensus_vsearch	4134	T	*/-C	320	58	14.57%	2	2	93	93	3.2459305005615314E-19	1	1	99	221	43	15	-C
G4_BC76_191109_LF_LIB_consensus_vsearch	4135	C	C	344	2	0.58%	2	2	93	93	0.2496382054993181	1	1	103	241	1	1	+T
G4_BC76_191109_LF_LIB_consensus_vsearch	4136	C	C	397	4	0.98%	2	1	93	93	0.062032128175275904	1	1	145	252	0	4	+T
G4_BC76_191109_LF_LIB_consensus_vsearch	4137	T	Y	377	9	2.23%	2	2	93	93	0.0018631683014264863	1	1	136	241	2	7	C
G4_BC76_191109_LF_LIB_consensus_vsearch	4138	A	*/+G	363	21	5.16%	2	2	93	93	3.600358141784112E-7	1	1	133	230	1	20	+G
G4_BC76_191109_LF_LIB_consensus_vsearch	4139	G	G	392	3	0.75%	2	2	93	93	0.12452471482865957	1	1	141	251	2	1	A
G4_BC76_191109_LF_LIB_consensus_vsearch	4140	G	G	398	2	0.49%	2	1	93	93	0.249687108886017	1	1	143	255	2	0	A
G4_BC76_191109_LF_LIB_consensus_vsearch	4141	C	*/+A	384	8	1.98%	2	1	93	93	0.0037679008816766993	1	1	135	249	8	0	+A
G4_BC76_191109_LF_LIB_consensus_vsearch	4142	G	*/-A	391	9	2.23%	2	2	93	93	0.0018662788735768444	1	1	138	253	8	1	-A
G4_BC76_191109_LF_LIB_consensus_vsearch	4143	A	*/-G	380	10	2.51%	2	2	93	93	9.211599279939985E-4	1	1	127	253	6	4	-G
G4_BC76_191109_LF_LIB_consensus_vsearch	4144	G	G	390	1	0.25%	2	1	93	93	0.4999999999999138	1	1	140	250	1	0	+AG
G4_BC76_191109_LF_LIB_consensus_vsearch	4145	C	*/+A	392	7	1.72%	2	1	93	93	0.007607942959128091	1	1	146	246	0	7	+A
G4_BC76_191109_LF_LIB_consensus_vsearch	4146	A	A	402	2	0.49%	2	2	93	93	0.2496902106567468	1	1	147	255	1	1	G
G4_BC76_191109_LF_LIB_consensus_vsearch	4147	A	*/-C	385	10	2.45%	2	1	93	93	9.218495267512253E-4	1	1	143	242	0	10	-C
G4_BC76_191109_LF_LIB_consensus_vsearch	4148	C	M	383	9	2.27%	2	1	93	93	0.001864528271344425	1	1	146	237	0	9	A
G4_BC76_191109_LF_LIB_consensus_vsearch	4149	C	*/-T	385	20	4.91%	2	1	93	93	7.4990291364355E-7	1	1	148	237	0	20	-T
G4_BC76_191109_LF_LIB_consensus_vsearch	4150	T	T	371	6	1.55%	2	2	93	93	0.015314987828685175	1	1	145	226	2	4	C
G4_BC76_191109_LF_LIB_consensus_vsearch	4151	C	*/-T	379	14	3.5%	2	2	93	93	5.425226475721076E-5	1	1	145	234	1	13	-T
G4_BC76_191109_LF_LIB_consensus_vsearch	4152	T	Y	369	7	1.8%	2	2	93	93	0.007595497661975396	1	1	138	231	1	6	C
G4_BC76_191109_LF_LIB_consensus_vsearch	4153	A	R	389	10	2.48%	2	2	93	93	9.223889705434762E-4	1	1	139	250	7	3	G
G4_BC76_191109_LF_LIB_consensus_vsearch	4154	G	G	397	4	0.99%	2	2	93	93	0.062032128175275904	1	1	147	250	1	3	A
G4_BC76_191109_LF_LIB_consensus_vsearch	4155	T	*/+C	390	7	1.72%	2	2	93	93	0.007606917708857565	1	1	147	243	1	6	+C
G4_BC76_191109_LF_LIB_consensus_vsearch	4156	C	C	394	4	0.99%	2	1	93	93	0.06202859930052086	1	1	145	249	4	0	-TC
G4_BC76_191109_LF_LIB_consensus_vsearch	4157	T	T	390	4	1%	2	2	93	93	0.062023810487337606	1	1	140	250	1	3	C
G4_BC76_191109_LF_LIB_consensus_vsearch	4158	C	C	388	3	0.75%	2	1	93	93	0.12451984635071693	1	1	139	249	0	3	+A
G4_BC76_191109_LF_LIB_consensus_vsearch	4159	A	A	398	3	0.74%	2	2	93	93	0.12453183520605009	1	1	143	255	2	1	G
G4_BC76_191109_LF_LIB_consensus_vsearch	4160	C	C	391	5	1.23%	2	1	93	93	0.030855681550508444	1	1	143	248	0	5	-G
G4_BC76_191109_LF_LIB_consensus_vsearch	4161	G	G	398	2	0.5%	2	1	93	93	0.249687108886017	1	1	145	253	2	0	A
G4_BC76_191109_LF_LIB_consensus_vsearch	4162	G	G	406	1	0.25%	2	1	93	93	0.4999999999999138	1	1	147	259	1	0	-A
G4_BC76_191109_LF_LIB_consensus_vsearch	4163	A	A	397	3	0.74%	2	2	93	93	0.12453066332921275	1	1	143	254	1	2	G
G4_BC76_191109_LF_LIB_consensus_vsearch	4164	C	C	400	2	0.49%	2	1	93	93	0.24968866749695368	1	1	146	254	0	2	-T
G4_BC76_191109_LF_LIB_consensus_vsearch	4165	T	T	393	6	1.49%	2	2	93	93	0.015332037719180692	1	1	143	250	2	4	-A
G4_BC76_191109_LF_LIB_consensus_vsearch	4166	A	A	396	2	0.5%	2	1	93	93	0.24968553459123424	1	1	143	253	0	2	G
G4_BC76_191109_LF_LIB_consensus_vsearch	4167	A	M	396	8	1.96%	2	2	93	93	0.0037719767465882576	1	1	146	250	1	7	C
G4_BC76_191109_LF_LIB_consensus_vsearch	4168	T	T	397	6	1.48%	2	1	93	93	0.015334938209013941	1	1	146	251	0	6	C
G4_BC76_191109_LF_LIB_consensus_vsearch	4169	G	*/-TG	385	12	2.95%	2	2	93	93	2.2439240943114192E-4	1	1	143	242	2	10	-TG
G4_BC76_191109_LF_LIB_consensus_vsearch	4170	T	*/-G	325	37	9.54%	2	2	93	93	2.760448496466305E-12	1	1	141	184	2	35	-G
G4_BC76_191109_LF_LIB_consensus_vsearch	4171	G	R	328	16	4.58%	2	2	93	93	1.2764926855016624E-5	1	1	130	198	13	3	A
G4_BC76_191109_LF_LIB_consensus_vsearch	4172	G	*/+A	377	13	3.27%	2	1	93	93	1.1027355068065241E-4	1	1	134	243	13	0	+A
G4_BC76_191109_LF_LIB_consensus_vsearch	4173	G	G	397	3	0.74%	2	1	93	93	0.12453066332921275	1	1	146	251	0	3	-T
G4_BC76_191109_LF_LIB_consensus_vsearch	4174	T	*/-A	339	27	6.77%	2	2	93	93	4.529699971810764E-9	1	1	122	217	14	13	-A
G4_BC76_191109_LF_LIB_consensus_vsearch	4175	A	R	351	11	2.98%	2	2	93	93	4.5205508421492045E-4	1	1	126	225	5	6	G
G4_BC76_191109_LF_LIB_consensus_vsearch	4176	A	*/-G	271	83	20.8%	2	2	93	93	4.414252461452134E-28	1	1	81	190	46	37	-G
G4_BC76_191109_LF_LIB_consensus_vsearch	4177	G	K	279	9	2.92%	2	1	93	93	0.0018330701083030451	1	1	87	192	0	9	T
G4_BC76_191109_LF_LIB_consensus_vsearch	4178	G	G	384	2	0.51%	2	1	93	93	0.24967574578483906	1	1	135	249	0	2	+CG
G4_BC76_191109_LF_LIB_consensus_vsearch	4179	G	*/-A	379	9	2.24%	2	2	93	93	0.001863626239388145	1	1	142	237	4	5	-A
G4_BC76_191109_LF_LIB_consensus_vsearch	4180	A	A	376	4	1.03%	2	2	93	93	0.06200625518874251	1	1	142	234	2	2	G
G4_BC76_191109_LF_LIB_consensus_vsearch	4181	A	A	390	3	0.76%	2	1	93	93	0.12452229299364298	1	1	148	242	0	3	G
G4_BC76_191109_LF_LIB_consensus_vsearch	4182	G	G	391	2	0.5%	2	1	93	93	0.24968152866242077	1	1	147	244	0	2	+C
G4_BC76_191109_LF_LIB_consensus_vsearch	4183	T	Y	395	9	2.22%	2	2	93	93	0.0018671284895574335	1	1	148	247	1	8	C
G4_BC76_191109_LF_LIB_consensus_vsearch	4184	C	C	392	4	0.99%	2	1	93	93	0.06202621699451153	1	1	146	246	0	4	-G
G4_BC76_191109_LF_LIB_consensus_vsearch	4185	G	R	379	17	4.25%	2	1	93	93	6.402090713768902E-6	1	1	131	248	17	0	A
G4_BC76_191109_LF_LIB_consensus_vsearch	4186	G	R	389	7	1.73%	2	2	93	93	0.0076064012202881484	1	1	143	246	3	4	A
G4_BC76_191109_LF_LIB_consensus_vsearch	4187	C	*/-A	381	7	1.75%	2	2	93	93	0.007602173974125566	1	1	143	238	3	4	-A
G4_BC76_191109_LF_LIB_consensus_vsearch	4188	A	A	384	5	1.27%	2	2	93	93	0.030848590526024323	1	1	138	246	4	1	G
G4_BC76_191109_LF_LIB_consensus_vsearch	4189	A	A	390	4	0.99%	2	2	93	93	0.062023810487337606	1	1	143	247	3	1	G
G4_BC76_191109_LF_LIB_consensus_vsearch	4190	G	G	397	2	0.5%	2	1	93	93	0.24968632371350802	1	1	144	253	0	2	+C
G4_BC76_191109_LF_LIB_consensus_vsearch	4191	T	T	401	2	0.49%	2	1	93	93	0.24968944099344345	1	1	146	255	2	0	-C
G4_BC76_191109_LF_LIB_consensus_vsearch	4192	C	C	401	2	0.49%	2	2	93	93	0.24968944099344345	1	1	144	257	1	1	-A
G4_BC76_191109_LF_LIB_consensus_vsearch	4193	A	R	379	20	4.93%	2	2	93	93	7.47128900641539E-7	1	1	136	243	12	8	G
G4_BC76_191109_LF_LIB_consensus_vsearch	4194	G	*/-C	391	8	1.97%	2	1	93	93	0.003770308015149166	1	1	146	245	0	8	-C
G4_BC76_191109_LF_LIB_consensus_vsearch	4195	C	*/-T	373	19	4.75%	2	2	93	93	1.5254799460974752E-6	1	1	148	225	1	18	-T
G4_BC76_191109_LF_LIB_consensus_vsearch	4196	T	*/-C	375	8	2.06%	2	2	93	93	0.003764677830168862	1	1	138	237	7	1	-C
G4_BC76_191109_LF_LIB_consensus_vsearch	4197	C	C	395	1	0.25%	2	1	93	93	0.5000000000008233	1	1	141	254	0	1	+GGG
G4_BC76_191109_LF_LIB_consensus_vsearch	4198	C	Y	377	10	2.45%	2	1	93	93	9.207377634483318E-4	1	1	147	230	0	10	T
G4_BC76_191109_LF_LIB_consensus_vsearch	4199	G	G	395	6	1.48%	2	2	93	93	0.015333495178783761	1	1	142	253	5	1	A
G4_BC76_191109_LF_LIB_consensus_vsearch	4200	T	T	394	4	1%	2	1	93	93	0.06202859930052086	1	1	147	247	0	4	C
G4_BC76_191109_LF_LIB_consensus_vsearch	4201	A	A	401	3	0.74%	2	1	93	93	0.1245353159851805	1	1	146	255	0	3	C
G4_BC76_191109_LF_LIB_consensus_vsearch	4202	A	A	395	6	1.47%	2	2	93	93	0.015333495178783761	1	1	138	257	5	1	-C
G4_BC76_191109_LF_LIB_consensus_vsearch	4203	C	*/+T	387	10	2.49%	2	1	93	93	9.221205845541368E-4	1	1	141	246	0	10	+T
G4_BC76_191109_LF_LIB_consensus_vsearch	4204	C	*/-T	390	12	2.94%	2	2	93	93	2.2463138050531574E-4	1	1	146	244	1	11	-T
G4_BC76_191109_LF_LIB_consensus_vsearch	4205	T	*/+G	364	13	3.31%	2	2	93	93	1.0988123554092724E-4	1	1	130	234	11	2	+G
G4_BC76_191109_LF_LIB_consensus_vsearch	4206	A	*/-G	310	78	19.4%	2	2	93	93	4.453355296738877E-26	1	1	129	181	11	67	-G
G4_BC76_191109_LF_LIB_consensus_vsearch	4207	G	G	317	3	0.93%	2	1	93	93	0.12441314553991895	1	1	135	182	0	3	+T
G4_BC76_191109_LF_LIB_consensus_vsearch	4208	G	G	396	2	0.5%	2	2	93	93	0.24968553459123424	1	1	144	252	1	1	A
G4_BC76_191109_LF_LIB_consensus_vsearch	4209	G	G	402	2	0.49%	2	1	93	93	0.2496902106567468	1	1	144	258	2	0	-A
G4_BC76_191109_LF_LIB_consensus_vsearch	4210	A	A	396	4	0.99%	2	2	93	93	0.06203095776871511	1	1	143	253	3	1	-T
G4_BC76_191109_LF_LIB_consensus_vsearch	4211	T	*/+A	83	294	73.13%	2	2	93	93	3.538593364799013E-133	1	1	33	50	97	197	+A
G4_BC76_191109_LF_LIB_consensus_vsearch	4212	A	*/-G	342	25	6.22%	2	2	93	93	1.9524488830449574E-8	1	1	124	218	7	18	-G
G4_BC76_191109_LF_LIB_consensus_vsearch	4213	G	R	336	37	9.74%	2	2	93	93	2.8447417073364575E-12	1	1	117	219	19	18	A
G4_BC76_191109_LF_LIB_consensus_vsearch	4214	G	R	379	25	6.13%	2	2	93	93	2.032043082814734E-8	1	1	141	238	6	19	A
G4_BC76_191109_LF_LIB_consensus_vsearch	4215	G	G	392	6	1.47%	2	2	93	93	0.015331303510572384	1	1	136	256	5	1	A
G4_BC76_191109_LF_LIB_consensus_vsearch	4216	G	G	399	2	0.49%	2	1	93	93	0.24968789013733722	1	1	143	256	0	2	+C
G4_BC76_191109_LF_LIB_consensus_vsearch	4217	T	T	393	5	1.23%	2	1	93	93	0.03085766177318207	1	1	149	244	0	5	-G
G4_BC76_191109_LF_LIB_consensus_vsearch	4218	G	G	397	1	0.25%	2	1	93	93	0.4999999999990043	1	1	148	249	1	0	+AA
G4_BC76_191109_LF_LIB_consensus_vsearch	4219	G	*/-C	391	8	1.97%	2	1	93	93	0.003770308015149166	1	1	149	242	0	8	-C
G4_BC76_191109_LF_LIB_consensus_vsearch	4220	C	C	385	6	1.51%	2	1	93	93	0.01532605917062568	1	1	149	236	0	6	T
G4_BC76_191109_LF_LIB_consensus_vsearch	4221	T	*/+C	392	7	1.73%	2	2	93	93	0.007607942959128091	1	1	144	248	5	2	+C
G4_BC76_191109_LF_LIB_consensus_vsearch	4222	C	Y	380	9	2.23%	2	1	93	93	0.0018638534646934156	1	1	142	238	0	9	T
G4_BC76_191109_LF_LIB_consensus_vsearch	4223	T	*/+G	371	18	4.51%	2	1	93	93	3.1194609634520567E-6	1	1	140	231	0	18	+G
G4_BC76_191109_LF_LIB_consensus_vsearch	4224	G	G	400	3	0.74%	2	1	93	93	0.12453416149047736	1	1	147	253	0	3	-A
G4_BC76_191109_LF_LIB_consensus_vsearch	4225	A	*/-G	346	44	10.92%	2	2	93	93	1.572261010494183E-14	1	1	111	235	31	13	-G
G4_BC76_191109_LF_LIB_consensus_vsearch	4226	G	G	356	1	0.28%	2	1	93	93	0.4999999999999138	1	1	115	241	0	1	+TG
G4_BC76_191109_LF_LIB_consensus_vsearch	4227	G	G	400	3	0.74%	2	1	93	93	0.12453416149047736	1	1	144	256	3	0	+A
G4_BC76_191109_LF_LIB_consensus_vsearch	4228	G	G	401	3	0.74%	2	2	93	93	0.1245353159851805	1	1	147	254	1	2	+C
G4_BC76_191109_LF_LIB_consensus_vsearch	4229	C	C	399	2	0.49%	2	1	93	93	0.24968789013733722	1	1	145	254	0	2	+T
G4_BC76_191109_LF_LIB_consensus_vsearch	4230	T	Y	379	13	3.2%	2	2	93	93	1.1033167832753745E-4	1	1	144	235	1	12	C
G4_BC76_191109_LF_LIB_consensus_vsearch	4231	G	G	396	5	1.23%	2	2	93	93	0.03086059509471206	1	1	144	252	1	4	+A
G4_BC76_191109_LF_LIB_consensus_vsearch	4232	A	A	402	1	0.25%	2	1	93	93	0.4999999999999138	1	1	145	257	1	0	G
G4_BC76_191109_LF_LIB_consensus_vsearch	4233	A	A	401	1	0.25%	2	1	93	93	0.5000000000008233	1	1	146	255	0	1	+G
G4_BC76_191109_LF_LIB_consensus_vsearch	4234	T	T	399	4	0.98%	2	1	93	93	0.06203445155203153	1	1	146	253	0	4	C
G4_BC76_191109_LF_LIB_consensus_vsearch	4235	G	G	396	3	0.74%	2	2	93	93	0.12452948557099502	1	1	143	253	1	2	+C
G4_BC76_191109_LF_LIB_consensus_vsearch	4236	C	C	398	2	0.5%	2	1	93	93	0.249687108886017	1	1	145	253	0	2	T
G4_BC76_191109_LF_LIB_consensus_vsearch	4237	C	*/-T	392	7	1.73%	2	2	93	93	0.007607942959128091	1	1	139	253	4	3	-T
G4_BC76_191109_LF_LIB_consensus_vsearch	4238	T	Y	353	34	8.56%	2	2	93	93	2.728023726267249E-11	1	1	138	215	1	33	C
G4_BC76_191109_LF_LIB_consensus_vsearch	4239	G	G	394	3	0.74%	2	1	93	93	0.1245271122321419	1	1	142	252	0	3	+C
G4_BC76_191109_LF_LIB_consensus_vsearch	4240	C	C	395	5	1.24%	2	1	93	93	0.030859622206549208	1	1	144	251	0	5	T
G4_BC76_191109_LF_LIB_consensus_vsearch	4241	T	*/+G	380	9	2.24%	2	1	93	93	0.0018638534646934156	1	1	143	237	0	9	+G
G4_BC76_191109_LF_LIB_consensus_vsearch	4242	G	G	402	1	0.25%	2	1	93	93	0.4999999999999138	1	1	146	256	0	1	+CTG
G4_BC76_191109_LF_LIB_consensus_vsearch	4243	A	A	398	3	0.74%	2	1	93	93	0.12453183520605009	1	1	145	253	0	3	-T
G4_BC76_191109_LF_LIB_consensus_vsearch	4244	T	T	398	3	0.74%	2	2	93	93	0.12453183520605009	1	1	145	253	1	2	C
G4_BC76_191109_LF_LIB_consensus_vsearch	4245	C	*/-G	313	63	15.52%	2	2	93	93	6.357513359498106E-21	1	1	103	210	36	27	-G
G4_BC76_191109_LF_LIB_consensus_vsearch	4246	G	R	306	17	5.04%	2	2	93	93	6.14684795518175E-6	1	1	85	221	16	1	A
G4_BC76_191109_LF_LIB_consensus_vsearch	4247	G	R	385	14	3.5%	2	2	93	93	5.435012474528051E-5	1	1	134	251	12	2	A
G4_BC76_191109_LF_LIB_consensus_vsearch	4248	G	G	398	4	0.99%	2	2	93	93	0.06203329275530562	1	1	144	254	2	2	A
G4_BC76_191109_LF_LIB_consensus_vsearch	4249	G	G	399	3	0.74%	2	1	93	93	0.12453300124551302	1	1	145	254	3	0	-AA
G4_BC76_191109_LF_LIB_consensus_vsearch	4250	A	A	398	2	0.5%	2	1	93	93	0.249687108886017	1	1	142	256	2	0	C
G4_BC76_191109_LF_LIB_consensus_vsearch	4251	A	A	397	3	0.74%	2	2	93	93	0.12453066332921275	1	1	141	256	2	1	G
G4_BC76_191109_LF_LIB_consensus_vsearch	4252	C	C	402	1	0.25%	2	1	93	93	0.4999999999999138	1	1	145	257	1	0	+A
G4_BC76_191109_LF_LIB_consensus_vsearch	4253	G	G	400	1	0.25%	2	1	93	93	0.4999999999999138	1	1	143	257	1	0	+A
G4_BC76_191109_LF_LIB_consensus_vsearch	4254	A	*/+TT	376	8	1.98%	2	1	93	93	0.0037650433430064176	1	1	139	237	0	8	+TT
G4_BC76_191109_LF_LIB_consensus_vsearch	4255	C	Y	374	16	3.94%	2	1	93	93	1.3042061767525985E-5	1	1	142	232	0	16	T
G4_BC76_191109_LF_LIB_consensus_vsearch	4256	G	R	383	10	2.49%	2	2	93	93	9.215757570452482E-4	1	1	133	250	9	1	A
G4_BC76_191109_LF_LIB_consensus_vsearch	4257	G	G	398	2	0.49%	2	1	93	93	0.249687108886017	1	1	146	252	0	2	+T
G4_BC76_191109_LF_LIB_consensus_vsearch	4258	C	*/+A	373	11	2.72%	2	1	93	93	4.5408391815452684E-4	1	1	142	231	0	11	+A
G4_BC76_191109_LF_LIB_consensus_vsearch	4259	A	A	386	6	1.49%	2	1	93	93	0.015326819799317902	1	1	139	247	0	6	+T
G4_BC76_191109_LF_LIB_consensus_vsearch	4260	C	*/-T	354	18	4.46%	2	2	93	93	3.0902200199808705E-6	1	1	139	215	4	14	-T
G4_BC76_191109_LF_LIB_consensus_vsearch	4261	T	T	379	3	0.78%	2	2	93	93	0.12450851900378244	1	1	139	240	2	1	A
G4_BC76_191109_LF_LIB_consensus_vsearch	4262	T	K	381	7	1.74%	2	1	93	93	0.007602173974125566	1	1	141	240	0	7	G
G4_BC76_191109_LF_LIB_consensus_vsearch	4263	G	G	395	2	0.5%	2	1	93	93	0.24968474148789518	1	1	140	255	2	0	-TC
G4_BC76_191109_LF_LIB_consensus_vsearch	4264	T	T	398	2	0.5%	2	1	93	93	0.249687108886017	1	1	142	256	2	0	-C
G4_BC76_191109_LF_LIB_consensus_vsearch	4265	C	C	400	1	0.25%	2	1	93	93	0.4999999999999138	1	1	143	257	0	1	+A
G4_BC76_191109_LF_LIB_consensus_vsearch	4266	G	G	397	4	0.99%	2	2	93	93	0.062032128175275904	1	1	143	254	3	1	A
G4_BC76_191109_LF_LIB_consensus_vsearch	4267	C	*/-G	381	8	1.98%	2	1	93	93	0.003766842960150322	1	1	145	236	0	8	-G
G4_BC76_191109_LF_LIB_consensus_vsearch	4268	G	R	381	8	2.03%	2	2	93	93	0.003766842960150322	1	1	138	243	5	3	A
G4_BC76_191109_LF_LIB_consensus_vsearch	4269	G	G	394	6	1.48%	2	2	93	93	0.015332768266138878	1	1	138	256	5	1	-C
G4_BC76_191109_LF_LIB_consensus_vsearch	4270	C	C	390	4	1%	2	1	93	93	0.062023810487337606	1	1	139	251	0	4	+T
G4_BC76_191109_LF_LIB_consensus_vsearch	4271	C	C	396	2	0.49%	2	2	93	93	0.24968553459123424	1	1	144	252	1	1	+TT
G4_BC76_191109_LF_LIB_consensus_vsearch	4272	T	T	391	5	1.24%	2	1	93	93	0.030855681550508444	1	1	141	250	0	5	C
G4_BC76_191109_LF_LIB_consensus_vsearch	4273	G	G	391	4	0.99%	2	1	93	93	0.06202501678889606	1	1	140	251	0	4	-CT
G4_BC76_191109_LF_LIB_consensus_vsearch	4274	C	*/-TT	327	42	10.53%	2	2	93	93	6.600180975170193E-14	1	1	129	198	10	32	-TT
G4_BC76_191109_LF_LIB_consensus_vsearch	4275	T	T	343	1	0.29%	2	1	93	93	0.4999999999999138	1	1	131	212	1	0	+CT
G4_BC76_191109_LF_LIB_consensus_vsearch	4276	T	T	355	2	0.56%	2	1	93	93	0.24964936886380987	1	1	134	221	0	2	+C
G4_BC76_191109_LF_LIB_consensus_vsearch	4277	T	*/-C	343	36	8.96%	2	2	93	93	6.082401416343547E-12	1	1	131	212	1	35	-C
G4_BC76_191109_LF_LIB_consensus_vsearch	4278	C	*/-GG	332	12	3.31%	2	1	93	93	2.214460024514316E-4	1	1	146	186	0	12	-GG
G4_BC76_191109_LF_LIB_consensus_vsearch	4279	G	R	358	15	3.98%	2	2	93	93	2.6436691015052886E-5	1	1	136	222	11	4	A
G4_BC76_191109_LF_LIB_consensus_vsearch	4280	G	G	385	3	0.77%	2	1	93	93	0.12451612903217696	1	1	146	239	0	3	A
G4_BC76_191109_LF_LIB_consensus_vsearch	4281	G	G	399	3	0.74%	2	2	93	93	0.12453300124551302	1	1	144	255	1	2	-C
G4_BC76_191109_LF_LIB_consensus_vsearch	4282	C	*/-G	346	41	10.17%	2	2	93	93	1.4859821664134393E-13	1	1	141	205	2	39	-G
G4_BC76_191109_LF_LIB_consensus_vsearch	4283	G	R	298	51	14.09%	2	1	93	93	6.186247139556543E-17	1	1	90	208	51	0	A
G4_BC76_191109_LF_LIB_consensus_vsearch	4284	G	R	387	9	2.23%	2	1	93	93	0.0018654123049784304	1	1	136	251	9	0	A
G4_BC76_191109_LF_LIB_consensus_vsearch	4285	G	G	395	5	1.24%	2	1	93	93	0.030859622206549208	1	1	141	254	5	0	T
G4_BC76_191109_LF_LIB_consensus_vsearch	4286	T	T	398	5	1.24%	2	2	93	93	0.030862526395586183	1	1	146	252	1	4	C
G4_BC76_191109_LF_LIB_consensus_vsearch	4287	G	G	399	3	0.74%	2	2	93	93	0.12453300124551302	1	1	145	254	1	2	-C
G4_BC76_191109_LF_LIB_consensus_vsearch	4288	C	C	397	4	0.99%	2	2	93	93	0.062032128175275904	1	1	144	253	1	3	-T
G4_BC76_191109_LF_LIB_consensus_vsearch	4289	T	Y	380	10	2.49%	2	2	93	93	9.211599279939985E-4	1	1	138	242	3	7	C
G4_BC76_191109_LF_LIB_consensus_vsearch	4290	G	*/-TG	386	9	2.24%	2	2	93	93	0.0018651929543866046	1	1	142	244	3	6	-TG
G4_BC76_191109_LF_LIB_consensus_vsearch	4291	T	T	380	4	1.01%	2	1	93	93	0.06201140169241078	1	1	139	241	0	4	A
G4_BC76_191109_LF_LIB_consensus_vsearch	4292	G	G	385	3	0.77%	2	2	93	93	0.12451612903217696	1	1	137	248	2	1	-C
G4_BC76_191109_LF_LIB_consensus_vsearch	4293	C	Y	367	10	2.51%	2	1	93	93	9.192828850276177E-4	1	1	134	233	0	10	T
G4_BC76_191109_LF_LIB_consensus_vsearch	4294	T	T	381	5	1.29%	2	2	93	93	0.03084547283766662	1	1	133	248	2	3	C
G4_BC76_191109_LF_LIB_consensus_vsearch	4295	T	T	388	4	1.01%	2	2	93	93	0.0620213794085142	1	1	137	251	2	2	C
G4_BC76_191109_LF_LIB_consensus_vsearch	4296	G	G	390	5	1.26%	2	2	93	93	0.030854683924238017	1	1	137	253	3	2	A
G4_BC76_191109_LF_LIB_consensus_vsearch	4297	C	Y	365	16	4%	2	1	93	93	1.2992782788164772E-5	1	1	131	234	0	16	T
G4_BC76_191109_LF_LIB_consensus_vsearch	4298	T	T	384	5	1.27%	2	1	93	93	0.030848590526024323	1	1	137	247	0	5	C
G4_BC76_191109_LF_LIB_consensus_vsearch	4299	G	*/-C	372	13	3.28%	2	2	93	93	1.1012568366163888E-4	1	1	133	239	2	11	-C
G4_BC76_191109_LF_LIB_consensus_vsearch	4300	C	*/+T	368	7	1.83%	2	1	93	93	0.007594922120899784	1	1	134	234	0	7	+T
G4_BC76_191109_LF_LIB_consensus_vsearch	4301	C	*/-T	346	46	11.39%	2	2	93	93	3.4960344793831906E-15	1	1	143	203	2	44	-T
G4_BC76_191109_LF_LIB_consensus_vsearch	4302	T	*/-C	338	11	3.07%	2	1	93	93	4.5073902379692165E-4	1	1	141	197	0	11	-C
G4_BC76_191109_LF_LIB_consensus_vsearch	4303	C	*/-T	369	13	3.31%	2	2	93	93	1.1003517226665928E-4	1	1	143	226	4	9	-T
G4_BC76_191109_LF_LIB_consensus_vsearch	4304	T	T	379	5	1.28%	2	2	93	93	0.030843367333892417	1	1	141	238	1	4	C
G4_BC76_191109_LF_LIB_consensus_vsearch	4305	A	A	389	6	1.48%	2	2	93	93	0.015329078637527195	1	1	143	246	2	4	+G
G4_BC76_191109_LF_LIB_consensus_vsearch	4306	T	T	394	5	1.24%	2	1	93	93	0.030858644444955494	1	1	140	254	5	0	A
G4_BC76_191109_LF_LIB_consensus_vsearch	4307	T	*/-A	387	8	1.97%	2	2	93	93	0.0037689428690762675	1	1	141	246	2	6	-A
G4_BC76_191109_LF_LIB_consensus_vsearch	4308	A	*/-C	376	8	2.03%	2	2	93	93	0.0037650433430064176	1	1	139	237	3	5	-C
G4_BC76_191109_LF_LIB_consensus_vsearch	4309	C	*/+T	374	11	2.79%	2	1	93	93	4.541707543665027E-4	1	1	141	233	0	11	+T
G4_BC76_191109_LF_LIB_consensus_vsearch	4310	C	*/+TC	379	9	2.23%	2	1	93	93	0.001863626239388145	1	1	146	233	0	9	+TC
G4_BC76_191109_LF_LIB_consensus_vsearch	4311	C	C	395	3	0.74%	2	2	93	93	0.12452830188671389	1	1	146	249	1	2	T
G4_BC76_191109_LF_LIB_consensus_vsearch	4312	A	A	400	4	0.99%	2	2	93	93	0.06203560460879861	1	1	144	256	3	1	G
G4_BC76_191109_LF_LIB_consensus_vsearch	4313	G	G	394	4	0.99%	2	1	93	93	0.06202859930052086	1	1	145	249	0	4	-C
G4_BC76_191109_LF_LIB_consensus_vsearch	4314	C	C	395	2	0.5%	2	1	93	93	0.24968474148789518	1	1	146	249	0	2	T
G4_BC76_191109_LF_LIB_consensus_vsearch	4315	G	G	396	3	0.75%	2	1	93	93	0.12452948557099502	1	1	147	249	0	3	+CG
G4_BC76_191109_LF_LIB_consensus_vsearch	4316	T	T	396	3	0.74%	2	2	93	93	0.12452948557099502	1	1	140	256	1	2	C
G4_BC76_191109_LF_LIB_consensus_vsearch	4317	C	C	392	6	1.48%	2	1	93	93	0.015331303510572384	1	1	144	248	0	6	-G
G4_BC76_191109_LF_LIB_consensus_vsearch	4318	G	R	371	23	5.76%	2	2	93	93	8.56552316708921E-8	1	1	124	247	22	1	A
G4_BC76_191109_LF_LIB_consensus_vsearch	4319	G	G	400	2	0.49%	2	1	93	93	0.24968866749695368	1	1	144	256	0	2	-C
G4_BC76_191109_LF_LIB_consensus_vsearch	4320	C	C	398	1	0.25%	2	1	93	93	0.4999999999999138	1	1	145	253	0	1	+A
G4_BC76_191109_LF_LIB_consensus_vsearch	4321	A	R	378	18	4.42%	2	2	93	93	3.130828878088153E-6	1	1	132	246	12	6	G
G4_BC76_191109_LF_LIB_consensus_vsearch	4322	G	G	400	2	0.5%	2	1	93	93	0.24968866749695368	1	1	145	255	2	0	A
G4_BC76_191109_LF_LIB_consensus_vsearch	4323	C	C	390	6	1.49%	2	1	93	93	0.015329823997787357	1	1	138	252	6	0	-A
G4_BC76_191109_LF_LIB_consensus_vsearch	4324	A	A	386	3	0.76%	2	1	93	93	0.12451737451743523	1	1	140	246	0	3	-T
G4_BC76_191109_LF_LIB_consensus_vsearch	4325	T	Y	390	7	1.74%	2	2	93	93	0.007606917708857565	1	1	140	250	3	4	C
G4_BC76_191109_LF_LIB_consensus_vsearch	4326	T	T	398	3	0.74%	2	2	93	93	0.12453183520605009	1	1	146	252	2	1	C
G4_BC76_191109_LF_LIB_consensus_vsearch	4327	G	*/+T	381	19	4.67%	2	1	93	93	1.532474593520809E-6	1	1	145	236	0	19	+T
G4_BC76_191109_LF_LIB_consensus_vsearch	4328	T	T	397	3	0.74%	2	1	93	93	0.12453066332921275	1	1	145	252	0	3	-C
G4_BC76_191109_LF_LIB_consensus_vsearch	4329	C	*/-T	378	23	5.72%	2	2	93	93	8.616540172478816E-8	1	1	142	236	4	19	-T
G4_BC76_191109_LF_LIB_consensus_vsearch	4330	T	T	369	4	1.05%	2	2	93	93	0.0619969830272361	1	1	139	230	1	3	-G
G4_BC76_191109_LF_LIB_consensus_vsearch	4331	G	R	383	13	3.23%	2	2	93	93	1.104462332935663E-4	1	1	131	252	11	2	A
G4_BC76_191109_LF_LIB_consensus_vsearch	4332	C	C	389	4	1%	2	2	93	93	0.06202259804292181	1	1	141	248	2	2	-A
G4_BC76_191109_LF_LIB_consensus_vsearch	4333	A	A	391	4	1.01%	2	1	93	93	0.06202501678889606	1	1	142	249	0	4	-GC
G4_BC76_191109_LF_LIB_consensus_vsearch	4334	G	R	383	10	2.49%	2	2	93	93	9.215757570452482E-4	1	1	130	253	9	1	A
G4_BC76_191109_LF_LIB_consensus_vsearch	4335	C	C	384	6	1.52%	2	1	93	93	0.015325294651568566	1	1	139	245	0	6	T
G4_BC76_191109_LF_LIB_consensus_vsearch	4336	C	C	397	4	0.99%	2	2	93	93	0.062032128175275904	1	1	147	250	1	3	T
G4_BC76_191109_LF_LIB_consensus_vsearch	4337	A	A	402	2	0.5%	2	2	93	93	0.2496902106567468	1	1	147	255	1	1	G
G4_BC76_191109_LF_LIB_consensus_vsearch	4338	A	A	392	6	1.48%	2	1	93	93	0.015331303510572384	1	1	145	247	0	6	+T
G4_BC76_191109_LF_LIB_consensus_vsearch	4339	C	*/-T	392	7	1.74%	2	2	93	93	0.007607942959128091	1	1	146	246	1	6	-T
G4_BC76_191109_LF_LIB_consensus_vsearch	4340	T	*/+C	364	28	7.04%	2	2	93	93	2.2600013262196055E-9	1	1	138	226	8	20	+C
G4_BC76_191109_LF_LIB_consensus_vsearch	4341	C	C	396	3	0.74%	2	1	93	93	0.12452948557099502	1	1	143	253	3	0	+A
G4_BC76_191109_LF_LIB_consensus_vsearch	4342	A	A	394	3	0.75%	2	2	93	93	0.1245271122321419	1	1	142	252	2	1	+G
G4_BC76_191109_LF_LIB_consensus_vsearch	4343	G	G	395	2	0.5%	2	1	93	93	0.24968474148789518	1	1	141	254	2	0	-A
G4_BC76_191109_LF_LIB_consensus_vsearch	4344	A	A	396	2	0.5%	2	2	93	93	0.24968553459123424	1	1	141	255	1	1	G
G4_BC76_191109_LF_LIB_consensus_vsearch	4345	A	A	395	6	1.49%	2	2	93	93	0.015333495178783761	1	1	140	255	4	2	G
G4_BC76_191109_LF_LIB_consensus_vsearch	4346	C	C	392	4	1%	2	1	93	93	0.06202621699451153	1	1	136	256	4	0	-T
G4_BC76_191109_LF_LIB_consensus_vsearch	4347	T	T	387	3	0.75%	2	1	93	93	0.12451861360729544	1	1	141	246	0	3	+G
G4_BC76_191109_LF_LIB_consensus_vsearch	4348	G	G	390	6	1.5%	2	1	93	93	0.015329823997787357	1	1	138	252	6	0	A
G4_BC76_191109_LF_LIB_consensus_vsearch	4349	G	G	399	2	0.5%	2	1	93	93	0.24968789013733722	1	1	144	255	2	0	-CACGG
G4_BC76_191109_LF_LIB_consensus_vsearch	4350	C	Y	379	14	3.47%	2	1	93	93	5.425226475721076E-5	1	1	142	237	0	14	T
G4_BC76_191109_LF_LIB_consensus_vsearch	4351	A	A	389	4	0.99%	2	2	93	93	0.06202259804292181	1	1	137	252	3	1	G
G4_BC76_191109_LF_LIB_consensus_vsearch	4352	C	*/-G	362	19	4.76%	2	1	93	93	1.5154269814942053E-6	1	1	138	224	0	19	-G
G4_BC76_191109_LF_LIB_consensus_vsearch	4353	G	G	367	5	1.31%	2	1	93	93	0.030830259207390184	1	1	140	227	0	5	T
G4_BC76_191109_LF_LIB_consensus_vsearch	4354	G	G	395	3	0.75%	2	2	93	93	0.12452830188671389	1	1	140	255	1	2	A
G4_BC76_191109_LF_LIB_consensus_vsearch	4355	A	A	394	3	0.75%	2	1	93	93	0.1245271122321419	1	1	142	252	0	3	-C
G4_BC76_191109_LF_LIB_consensus_vsearch	4356	C	C	377	6	1.51%	2	2	93	93	0.01531983153360656	1	1	137	240	1	5	+T
G4_BC76_191109_LF_LIB_consensus_vsearch	4357	T	T	385	1	0.26%	2	1	93	93	0.4999999999999138	1	1	137	248	0	1	+C
G4_BC76_191109_LF_LIB_consensus_vsearch	4358	T	*/-G	294	77	19.4%	2	2	93	93	8.072424538668031E-26	1	1	83	211	45	32	-G
G4_BC76_191109_LF_LIB_consensus_vsearch	4359	G	R	290	17	5.31%	2	2	93	93	6.076109907771699E-6	1	1	77	213	12	5	A
G4_BC76_191109_LF_LIB_consensus_vsearch	4360	G	R	391	7	1.75%	2	2	93	93	0.007607431615374521	1	1	138	253	6	1	A
G4_BC76_191109_LF_LIB_consensus_vsearch	4361	G	G	397	3	0.75%	2	2	93	93	0.12453066332921275	1	1	142	255	2	1	A
G4_BC76_191109_LF_LIB_consensus_vsearch	4362	G	G	400	3	0.74%	2	2	93	93	0.12453416149047736	1	1	146	254	2	1	-A
G4_BC76_191109_LF_LIB_consensus_vsearch	4363	A	A	401	1	0.25%	2	1	93	93	0.5000000000008233	1	1	146	255	0	1	G
G4_BC76_191109_LF_LIB_consensus_vsearch	4364	A	*/-T	391	7	1.73%	2	1	93	93	0.007607431615374521	1	1	142	249	0	7	-T
G4_BC76_191109_LF_LIB_consensus_vsearch	4365	T	Y	386	8	2.01%	2	2	93	93	0.003768597288121233	1	1	143	243	4	4	C
G4_BC76_191109_LF_LIB_consensus_vsearch	4366	C	*/-T	385	10	2.47%	2	1	93	93	9.218495267512253E-4	1	1	135	250	10	0	-T
G4_BC76_191109_LF_LIB_consensus_vsearch	4367	T	Y	318	64	16.24%	2	2	93	93	3.037303993492796E-21	1	1	111	207	25	39	C
G4_BC76_191109_LF_LIB_consensus_vsearch	4368	G	G	398	2	0.5%	2	1	93	93	0.249687108886017	1	1	142	256	2	0	-A
G4_BC76_191109_LF_LIB_consensus_vsearch	4369	A	A	393	3	0.75%	2	1	93	93	0.12452591656124207	1	1	143	250	0	3	+T
G4_BC76_191109_LF_LIB_consensus_vsearch	4370	C	C	389	5	1.25%	2	2	93	93	0.030853681237272182	1	1	142	247	1	4	-T
G4_BC76_191109_LF_LIB_consensus_vsearch	4371	T	T	388	2	0.5%	2	1	93	93	0.2496790757377846	1	1	143	245	0	2	+C
G4_BC76_191109_LF_LIB_consensus_vsearch	4372	G	*/+T	375	19	4.76%	2	1	93	93	1.527252855664675E-6	1	1	141	234	0	19	+T
G4_BC76_191109_LF_LIB_consensus_vsearch	4373	T	T	393	3	0.75%	2	1	93	93	0.12452591656124207	1	1	140	253	3	0	+C
G4_BC76_191109_LF_LIB_consensus_vsearch	4374	C	*/-T	373	21	5.29%	2	1	93	93	3.626822120973365E-7	1	1	143	230	0	21	-T
G4_BC76_191109_LF_LIB_consensus_vsearch	4375	T	T	368	3	0.8%	2	1	93	93	0.12449392712559995	1	1	138	230	3	0	+G
G4_BC76_191109_LF_LIB_consensus_vsearch	4376	A	A	392	1	0.25%	2	1	93	93	0.4999999999990043	1	1	141	251	1	0	+GC
G4_BC76_191109_LF_LIB_consensus_vsearch	4377	A	A	383	2	0.51%	2	1	93	93	0.24967490247067214	1	1	134	249	2	0	+G
G4_BC76_191109_LF_LIB_consensus_vsearch	4378	T	T	380	3	0.78%	2	1	93	93	0.12450980392156931	1	1	130	250	3	0	G
G4_BC76_191109_LF_LIB_consensus_vsearch	4379	T	*/-A	318	50	13.12%	2	2	93	93	1.4889042176339288E-16	1	1	128	190	1	49	-A
G4_BC76_191109_LF_LIB_consensus_vsearch	4380	A	A	315	2	0.62%	2	1	93	93	0.24960505529237537	1	1	116	199	0	2	G
G4_BC76_191109_LF_LIB_consensus_vsearch	4381	A	A	360	2	0.55%	2	1	93	93	0.24965421853373454	1	1	109	251	2	0	G
G4_BC76_191109_LF_LIB_consensus_vsearch	4382	A	A	349	0	0%	2	0	93	0	1.0	1	0	98	251	0	0	
G4_BC76_191109_LF_LIB_consensus_vsearch	4383	A	A	335	2	0.59%	2	2	93	93	0.24962852897455212	1	1	86	249	1	1	G
G4_BC76_191109_LF_LIB_consensus_vsearch	4384	C	C	321	0	0%	2	0	93	0	1.0	1	0	78	243	0	0	
G4_BC76_191109_LF_LIB_consensus_vsearch	4385	A	A	312	0	0%	2	0	93	0	1.0	1	0	69	243	0	0	
G4_BC76_191109_LF_LIB_consensus_vsearch	4386	T	T	304	0	0%	2	0	93	0	1.0	1	0	61	243	0	0	
