Chrom	Position	Ref	Cons	Reads1	Reads2	VarFreq	Strands1	Strands2	Qual1	Qual2	Pvalue	MapQual1	MapQual2	Reads1Plus	Reads1Minus	Reads2Plus	Reads2Minus	VarAllele
H3_BC87_191109_LF_LIB_consensus_vsearch	1	G	G	156	0	0%	2	0	93	0	1.0	1	0	75	81	0	0	
H3_BC87_191109_LF_LIB_consensus_vsearch	2	T	T	163	0	0%	2	0	93	0	1.0	1	0	75	88	0	0	
H3_BC87_191109_LF_LIB_consensus_vsearch	3	A	A	178	0	0%	2	0	93	0	1.0	1	0	77	101	0	0	
H3_BC87_191109_LF_LIB_consensus_vsearch	4	G	G	187	0	0%	2	0	93	0	1.0	1	0	77	110	0	0	
H3_BC87_191109_LF_LIB_consensus_vsearch	5	T	T	192	3	1.54%	2	1	93	93	0.12403598971719802	1	1	74	118	3	0	+C
H3_BC87_191109_LF_LIB_consensus_vsearch	6	C	C	203	1	0.49%	2	1	93	93	0.4999999999999138	1	1	76	127	1	0	+G
H3_BC87_191109_LF_LIB_consensus_vsearch	7	A	A	201	5	2.37%	2	1	93	93	0.03049244790271922	1	1	70	131	5	0	T
H3_BC87_191109_LF_LIB_consensus_vsearch	8	T	T	211	2	0.93%	2	1	93	93	0.24941176470603904	1	1	76	135	0	2	-AT
H3_BC87_191109_LF_LIB_consensus_vsearch	9	A	A	214	1	0.46%	2	1	93	93	0.5000000000001412	1	1	76	138	0	1	+G
H3_BC87_191109_LF_LIB_consensus_vsearch	10	T	T	215	1	0.46%	2	1	93	93	0.4999999999999138	1	1	76	139	1	0	+A
H3_BC87_191109_LF_LIB_consensus_vsearch	11	G	G	217	1	0.45%	2	1	93	93	0.4999999999999138	1	1	75	142	0	1	+T
H3_BC87_191109_LF_LIB_consensus_vsearch	12	C	Y	203	13	5.91%	2	1	93	93	1.0135552209744578E-4	1	1	74	129	0	13	T
H3_BC87_191109_LF_LIB_consensus_vsearch	13	T	T	219	1	0.45%	2	1	93	93	0.4999999999999138	1	1	76	143	0	1	A
H3_BC87_191109_LF_LIB_consensus_vsearch	14	T	T	216	2	0.9%	2	1	93	93	0.249425287356441	1	1	78	138	0	2	+C
H3_BC87_191109_LF_LIB_consensus_vsearch	15	G	G	221	1	0.45%	2	1	93	93	0.4999999999999138	1	1	78	143	1	0	-T
H3_BC87_191109_LF_LIB_consensus_vsearch	16	T	T	220	3	1.35%	2	1	93	93	0.12415730337075404	1	1	75	145	3	0	-C
H3_BC87_191109_LF_LIB_consensus_vsearch	17	C	C	223	0	0%	2	0	93	0	1.0	1	0	77	146	0	0	
H3_BC87_191109_LF_LIB_consensus_vsearch	18	C	C	224	1	0.44%	2	1	93	93	0.4999999999999138	1	1	78	146	1	0	+A
H3_BC87_191109_LF_LIB_consensus_vsearch	19	A	A	222	1	0.44%	2	1	93	93	0.4999999999999138	1	1	79	143	1	0	+C
H3_BC87_191109_LF_LIB_consensus_vsearch	20	T	*/+C	210	10	4.46%	2	1	93	93	8.796295164637225E-4	1	1	67	143	10	0	+C
H3_BC87_191109_LF_LIB_consensus_vsearch	21	C	*/-G	211	8	3.6%	2	1	93	93	0.0036602593149509337	1	1	76	135	0	8	-G
H3_BC87_191109_LF_LIB_consensus_vsearch	22	G	G	212	1	0.46%	2	1	93	93	0.5000000000001412	1	1	78	134	1	0	+AG
H3_BC87_191109_LF_LIB_consensus_vsearch	23	G	G	225	1	0.44%	2	1	93	93	0.5000000000003686	1	1	79	146	1	0	T
H3_BC87_191109_LF_LIB_consensus_vsearch	24	A	A	222	1	0.44%	2	1	93	93	0.4999999999999138	1	1	76	146	1	0	+C
H3_BC87_191109_LF_LIB_consensus_vsearch	25	C	C	223	2	0.89%	2	1	93	93	0.24944320712692292	1	1	79	144	0	2	T
H3_BC87_191109_LF_LIB_consensus_vsearch	26	T	T	214	4	1.77%	2	2	93	93	0.061638926495252586	1	1	77	137	1	3	C
H3_BC87_191109_LF_LIB_consensus_vsearch	27	A	A	220	1	0.45%	2	1	93	93	0.4999999999999138	1	1	78	142	0	1	G
H3_BC87_191109_LF_LIB_consensus_vsearch	28	A	A	221	2	0.89%	2	1	93	93	0.24943820224728358	1	1	78	143	2	0	C
H3_BC87_191109_LF_LIB_consensus_vsearch	29	G	G	219	3	1.33%	2	1	93	93	0.12415349887135622	1	1	79	140	0	3	A
H3_BC87_191109_LF_LIB_consensus_vsearch	30	C	C	222	3	1.33%	2	1	93	93	0.12416481069040536	1	1	80	142	0	3	T
H3_BC87_191109_LF_LIB_consensus_vsearch	31	C	C	221	3	1.33%	2	2	93	93	0.12416107382546236	1	1	79	142	1	2	T
H3_BC87_191109_LF_LIB_consensus_vsearch	32	A	A	218	3	1.33%	2	1	93	93	0.12414965986396012	1	1	78	140	0	3	-TG
H3_BC87_191109_LF_LIB_consensus_vsearch	33	T	T	212	5	2.24%	2	2	93	93	0.030530802741347875	1	1	77	135	1	4	C
H3_BC87_191109_LF_LIB_consensus_vsearch	34	G	G	217	4	1.8%	2	2	93	93	0.0616506283607095	1	1	75	142	3	1	A
H3_BC87_191109_LF_LIB_consensus_vsearch	35	C	C	220	3	1.33%	2	2	93	93	0.12415730337075404	1	1	77	143	1	2	-A
H3_BC87_191109_LF_LIB_consensus_vsearch	36	A	A	217	2	0.9%	2	1	93	93	0.24942791762028085	1	1	76	141	0	2	-T
H3_BC87_191109_LF_LIB_consensus_vsearch	37	T	T	221	1	0.45%	2	1	93	93	0.4999999999999138	1	1	79	142	0	1	+A
H3_BC87_191109_LF_LIB_consensus_vsearch	38	G	R	214	7	3.12%	2	2	93	93	0.007444703667648697	1	1	72	142	6	1	A
H3_BC87_191109_LF_LIB_consensus_vsearch	39	C	C	209	4	1.81%	2	2	93	93	0.061618690029214815	1	1	73	136	1	3	-G
H3_BC87_191109_LF_LIB_consensus_vsearch	40	G	G	216	2	0.91%	2	2	93	93	0.249425287356441	1	1	76	140	1	1	A
H3_BC87_191109_LF_LIB_consensus_vsearch	41	A	*/-G	207	12	5.33%	2	1	93	93	2.091345729349345E-4	1	1	60	147	12	0	-G
H3_BC87_191109_LF_LIB_consensus_vsearch	42	G	*/-AG	151	59	27.57%	2	2	93	93	1.494953377433165E-20	1	1	13	138	51	8	-AG
H3_BC87_191109_LF_LIB_consensus_vsearch	43	A	A	160	4	2.41%	2	1	93	93	0.06135497529993208	1	1	23	137	4	0	-G
H3_BC87_191109_LF_LIB_consensus_vsearch	44	G	G	160	1	0.62%	2	1	93	93	0.4999999999999138	1	1	23	137	0	1	+AG
H3_BC87_191109_LF_LIB_consensus_vsearch	45	T	T	221	2	0.89%	2	2	93	93	0.24943820224728358	1	1	77	144	1	1	C
H3_BC87_191109_LF_LIB_consensus_vsearch	46	T	T	221	2	0.88%	2	1	93	93	0.24943820224728358	1	1	75	146	2	0	+C
H3_BC87_191109_LF_LIB_consensus_vsearch	47	C	C	214	6	2.65%	2	2	93	93	0.015094778470947015	1	1	70	144	4	2	-A
H3_BC87_191109_LF_LIB_consensus_vsearch	48	A	*/+G	204	7	3.17%	2	1	93	93	0.007427442022474603	1	1	68	136	0	7	+G
H3_BC87_191109_LF_LIB_consensus_vsearch	49	G	G	218	1	0.45%	2	1	93	93	0.5000000000003686	1	1	74	144	1	0	+A
H3_BC87_191109_LF_LIB_consensus_vsearch	50	A	A	220	1	0.44%	2	1	93	93	0.4999999999999138	1	1	77	143	1	0	+G
H3_BC87_191109_LF_LIB_consensus_vsearch	51	G	G	222	2	0.89%	2	2	93	93	0.24944071588395061	1	1	78	144	1	1	-A
H3_BC87_191109_LF_LIB_consensus_vsearch	52	A	*/-C	210	10	4.46%	2	2	93	93	8.796295164637225E-4	1	1	77	133	1	9	-C
H3_BC87_191109_LF_LIB_consensus_vsearch	53	C	C	214	1	0.46%	2	1	93	93	0.5000000000001412	1	1	79	135	0	1	+T
H3_BC87_191109_LF_LIB_consensus_vsearch	54	C	*/-T	206	13	5.75%	2	1	93	93	1.016217291023551E-4	1	1	78	128	0	13	-T
H3_BC87_191109_LF_LIB_consensus_vsearch	55	T	T	211	2	0.93%	2	2	93	93	0.24941176470603904	1	1	78	133	1	1	C
H3_BC87_191109_LF_LIB_consensus_vsearch	56	T	T	217	5	2.2%	2	2	93	93	0.03054698177238809	1	1	79	138	1	4	C
H3_BC87_191109_LF_LIB_consensus_vsearch	57	A	A	221	3	1.34%	2	1	93	93	0.12416107382546236	1	1	80	141	0	3	C
H3_BC87_191109_LF_LIB_consensus_vsearch	58	A	A	224	1	0.44%	2	1	93	93	0.4999999999999138	1	1	79	145	0	1	+C
H3_BC87_191109_LF_LIB_consensus_vsearch	59	A	A	223	2	0.88%	2	1	93	93	0.24944320712692292	1	1	78	145	2	0	G
H3_BC87_191109_LF_LIB_consensus_vsearch	60	C	C	217	6	2.67%	2	2	93	93	0.015101878629034914	1	1	74	143	4	2	-A
H3_BC87_191109_LF_LIB_consensus_vsearch	61	A	A	218	2	0.91%	2	2	93	93	0.24943052391823226	1	1	75	143	1	1	G
H3_BC87_191109_LF_LIB_consensus_vsearch	62	A	A	222	2	0.88%	2	1	93	93	0.24944071588395061	1	1	79	143	0	2	+T
H3_BC87_191109_LF_LIB_consensus_vsearch	63	T	T	218	5	2.2%	2	2	93	93	0.030550130621104243	1	1	75	143	4	1	G
H3_BC87_191109_LF_LIB_consensus_vsearch	64	T	T	217	5	2.2%	2	2	93	93	0.03054698177238809	1	1	74	143	4	1	+G
H3_BC87_191109_LF_LIB_consensus_vsearch	65	G	G	219	3	1.32%	2	1	93	93	0.12415349887135622	1	1	78	141	0	3	-A
H3_BC87_191109_LF_LIB_consensus_vsearch	66	A	A	224	0	0%	2	0	93	0	1.0	1	0	80	144	0	0	
H3_BC87_191109_LF_LIB_consensus_vsearch	67	A	A	227	0	0%	2	0	93	0	1.0	1	0	80	147	0	0	
H3_BC87_191109_LF_LIB_consensus_vsearch	68	A	A	223	1	0.44%	2	1	93	93	0.5000000000003686	1	1	79	144	0	1	+C
H3_BC87_191109_LF_LIB_consensus_vsearch	69	C	C	222	1	0.44%	2	1	93	93	0.4999999999999138	1	1	79	143	0	1	+A
H3_BC87_191109_LF_LIB_consensus_vsearch	70	T	T	218	5	2.2%	2	1	93	93	0.030550130621104243	1	1	79	139	0	5	C
H3_BC87_191109_LF_LIB_consensus_vsearch	71	G	G	224	1	0.44%	2	1	93	93	0.4999999999999138	1	1	79	145	0	1	-C
H3_BC87_191109_LF_LIB_consensus_vsearch	72	C	C	207	4	1.77%	2	2	93	93	0.06161032658914256	1	1	74	133	1	3	T
H3_BC87_191109_LF_LIB_consensus_vsearch	73	G	G	216	4	1.78%	2	1	93	93	0.061646763238677425	1	1	74	142	4	0	-A
H3_BC87_191109_LF_LIB_consensus_vsearch	74	A	A	223	1	0.45%	2	1	93	93	0.5000000000003686	1	1	76	147	0	1	G
H3_BC87_191109_LF_LIB_consensus_vsearch	75	A	A	224	2	0.88%	2	1	93	93	0.24944567627499675	1	1	78	146	2	0	G
H3_BC87_191109_LF_LIB_consensus_vsearch	76	T	T	218	4	1.77%	2	2	93	93	0.061654458623218986	1	1	77	141	1	3	-G
H3_BC87_191109_LF_LIB_consensus_vsearch	77	G	G	219	3	1.35%	2	1	93	93	0.12415349887135622	1	1	75	144	3	0	A
H3_BC87_191109_LF_LIB_consensus_vsearch	78	G	G	218	5	2.19%	2	1	93	93	0.030550130621104243	1	1	76	142	0	5	+C
H3_BC87_191109_LF_LIB_consensus_vsearch	79	C	C	220	3	1.33%	2	2	93	93	0.12415730337075404	1	1	76	144	1	2	-T
H3_BC87_191109_LF_LIB_consensus_vsearch	80	T	Y	209	10	4.44%	2	2	93	93	8.792003591123169E-4	1	1	77	132	1	9	C
H3_BC87_191109_LF_LIB_consensus_vsearch	81	C	C	219	2	0.89%	2	1	93	93	0.24943310657599216	1	1	78	141	0	2	-AT
H3_BC87_191109_LF_LIB_consensus_vsearch	82	A	A	219	4	1.77%	2	2	93	93	0.06165825449566743	1	1	78	141	1	3	-T
H3_BC87_191109_LF_LIB_consensus_vsearch	83	T	T	218	2	0.9%	2	1	93	93	0.24943052391823226	1	1	78	140	0	2	+AT
H3_BC87_191109_LF_LIB_consensus_vsearch	84	T	T	218	4	1.76%	2	2	93	93	0.061654458623218986	1	1	74	144	1	3	C
H3_BC87_191109_LF_LIB_consensus_vsearch	85	A	A	222	1	0.44%	2	1	93	93	0.4999999999999138	1	1	77	145	0	1	+C
H3_BC87_191109_LF_LIB_consensus_vsearch	86	A	A	227	1	0.44%	2	1	93	93	0.4999999999999138	1	1	79	148	1	0	G
H3_BC87_191109_LF_LIB_consensus_vsearch	87	A	A	223	4	1.75%	2	1	93	93	0.061673103185009646	1	1	80	143	0	4	-T
H3_BC87_191109_LF_LIB_consensus_vsearch	88	T	T	220	2	0.89%	2	1	93	93	0.2494356659142869	1	1	80	140	0	2	-C
H3_BC87_191109_LF_LIB_consensus_vsearch	89	C	C	215	3	1.33%	2	1	93	93	0.12413793103441495	1	1	77	138	3	0	+G
H3_BC87_191109_LF_LIB_consensus_vsearch	90	A	A	217	3	1.34%	2	1	93	93	0.12414578587710072	1	1	75	142	3	0	-G
H3_BC87_191109_LF_LIB_consensus_vsearch	91	G	G	222	1	0.45%	2	1	93	93	0.4999999999999138	1	1	76	146	1	0	A
H3_BC87_191109_LF_LIB_consensus_vsearch	92	T	T	220	4	1.77%	2	1	93	93	0.061662016439223415	1	1	78	142	0	4	C
H3_BC87_191109_LF_LIB_consensus_vsearch	93	T	T	216	4	1.75%	2	1	93	93	0.061646763238677425	1	1	76	140	0	4	+G
H3_BC87_191109_LF_LIB_consensus_vsearch	94	A	A	219	5	2.19%	2	2	93	93	0.030553251388732716	1	1	78	141	1	4	G
H3_BC87_191109_LF_LIB_consensus_vsearch	95	T	T	217	5	2.2%	2	2	93	93	0.03054698177238809	1	1	78	139	2	3	C
H3_BC87_191109_LF_LIB_consensus_vsearch	96	G	G	224	2	0.88%	2	2	93	93	0.24944567627499675	1	1	79	145	1	1	A
H3_BC87_191109_LF_LIB_consensus_vsearch	97	A	A	227	1	0.44%	2	1	93	93	0.4999999999999138	1	1	80	147	0	1	G
H3_BC87_191109_LF_LIB_consensus_vsearch	98	T	T	223	3	1.32%	2	1	93	93	0.12416851441234596	1	1	80	143	0	3	C
H3_BC87_191109_LF_LIB_consensus_vsearch	99	T	T	226	2	0.88%	2	1	93	93	0.24945054945064127	1	1	80	146	0	2	-C
H3_BC87_191109_LF_LIB_consensus_vsearch	100	C	C	221	2	0.88%	2	1	93	93	0.24943820224728358	1	1	78	143	2	0	-AC
H3_BC87_191109_LF_LIB_consensus_vsearch	101	A	A	213	5	2.21%	2	2	93	93	0.030534097847134272	1	1	71	142	4	1	G
H3_BC87_191109_LF_LIB_consensus_vsearch	102	C	Y	200	9	4.04%	2	1	93	93	0.0017887416879729845	1	1	71	129	0	9	T
H3_BC87_191109_LF_LIB_consensus_vsearch	103	T	T	212	3	1.4%	2	2	93	93	0.1241258741259166	1	1	72	140	2	1	C
H3_BC87_191109_LF_LIB_consensus_vsearch	104	T	*/+G	211	7	3.12%	2	2	93	93	0.007439689863414905	1	1	70	141	3	4	+G
H3_BC87_191109_LF_LIB_consensus_vsearch	105	G	G	226	1	0.44%	2	1	93	93	0.4999999999999138	1	1	78	148	1	0	-AAG
H3_BC87_191109_LF_LIB_consensus_vsearch	106	A	A	225	1	0.44%	2	1	93	93	0.5000000000003686	1	1	78	147	1	0	+G
H3_BC87_191109_LF_LIB_consensus_vsearch	107	A	A	221	3	1.32%	2	1	93	93	0.12416107382546236	1	1	75	146	3	0	+G
H3_BC87_191109_LF_LIB_consensus_vsearch	108	G	*/-AG	212	7	3.08%	2	1	93	93	0.00744137624879223	1	1	64	148	7	0	-AG
H3_BC87_191109_LF_LIB_consensus_vsearch	109	A	A	215	2	0.91%	2	2	93	93	0.2494226327944578	1	1	69	146	1	1	G
H3_BC87_191109_LF_LIB_consensus_vsearch	110	G	G	216	2	0.9%	2	2	93	93	0.249425287356441	1	1	71	145	1	1	+AG
H3_BC87_191109_LF_LIB_consensus_vsearch	111	T	T	221	3	1.32%	2	2	93	93	0.12416107382546236	1	1	74	147	2	1	C
H3_BC87_191109_LF_LIB_consensus_vsearch	112	C	*/-G	207	15	6.64%	2	1	93	93	2.3897801371672697E-5	1	1	59	148	15	0	-G
H3_BC87_191109_LF_LIB_consensus_vsearch	113	G	G	206	1	0.47%	2	1	93	93	0.5000000000001412	1	1	60	146	1	0	+T
H3_BC87_191109_LF_LIB_consensus_vsearch	114	A	A	224	0	0%	2	0	93	0	1.0	1	0	77	147	0	0	
H3_BC87_191109_LF_LIB_consensus_vsearch	115	A	*/-T	169	39	17.26%	2	2	93	93	2.5460401693304653E-13	1	1	67	102	3	36	-T
H3_BC87_191109_LF_LIB_consensus_vsearch	116	T	T	186	1	0.53%	2	1	93	93	0.4999999999999138	1	1	76	110	0	1	C
H3_BC87_191109_LF_LIB_consensus_vsearch	117	T	T	222	3	1.33%	2	1	93	93	0.12416481069040536	1	1	79	143	0	3	C
H3_BC87_191109_LF_LIB_consensus_vsearch	118	T	T	225	2	0.88%	2	2	93	93	0.24944812362040697	1	1	78	147	1	1	C
H3_BC87_191109_LF_LIB_consensus_vsearch	119	T	T	222	3	1.32%	2	2	93	93	0.12416481069040536	1	1	77	145	2	1	G
H3_BC87_191109_LF_LIB_consensus_vsearch	120	G	G	220	3	1.32%	2	1	93	93	0.12415730337075404	1	1	79	141	0	3	-TA
H3_BC87_191109_LF_LIB_consensus_vsearch	121	T	Y	211	11	4.91%	2	2	93	93	4.300945555177922E-4	1	1	77	134	3	8	C
H3_BC87_191109_LF_LIB_consensus_vsearch	122	A	A	216	4	1.79%	2	2	93	93	0.061646763238677425	1	1	76	140	2	2	G
H3_BC87_191109_LF_LIB_consensus_vsearch	123	C	C	220	1	0.45%	2	1	93	93	0.4999999999999138	1	1	78	142	0	1	+T
H3_BC87_191109_LF_LIB_consensus_vsearch	124	A	A	221	3	1.33%	2	2	93	93	0.12416107382546236	1	1	76	145	1	2	G
H3_BC87_191109_LF_LIB_consensus_vsearch	125	T	T	219	5	2.2%	2	2	93	93	0.030553251388732716	1	1	78	141	1	4	-G
H3_BC87_191109_LF_LIB_consensus_vsearch	126	G	G	218	1	0.45%	2	1	93	93	0.5000000000003686	1	1	78	140	0	1	+C
H3_BC87_191109_LF_LIB_consensus_vsearch	127	G	G	222	2	0.88%	2	1	93	93	0.24944071588395061	1	1	78	144	0	2	A
H3_BC87_191109_LF_LIB_consensus_vsearch	128	C	C	218	5	2.2%	2	2	93	93	0.030550130621104243	1	1	76	142	3	2	T
H3_BC87_191109_LF_LIB_consensus_vsearch	129	T	T	215	4	1.78%	2	1	93	93	0.06164286277914926	1	1	77	138	0	4	C
H3_BC87_191109_LF_LIB_consensus_vsearch	130	A	A	211	6	2.63%	2	1	93	93	0.015087482939793164	1	1	78	133	0	6	-GC
H3_BC87_191109_LF_LIB_consensus_vsearch	131	G	G	212	3	1.38%	2	2	93	93	0.1241258741259166	1	1	78	134	1	2	-C
H3_BC87_191109_LF_LIB_consensus_vsearch	132	C	C	209	5	2.29%	2	2	93	93	0.030520732883336912	1	1	77	132	1	4	T
H3_BC87_191109_LF_LIB_consensus_vsearch	133	C	C	223	1	0.44%	2	1	93	93	0.5000000000003686	1	1	78	145	1	0	+A
H3_BC87_191109_LF_LIB_consensus_vsearch	134	G	G	212	5	2.2%	2	1	93	93	0.030530802741347875	1	1	75	137	0	5	-TG
H3_BC87_191109_LF_LIB_consensus_vsearch	135	T	T	210	5	2.27%	2	1	93	93	0.0305241206880699	1	1	78	132	0	5	C
H3_BC87_191109_LF_LIB_consensus_vsearch	136	G	G	216	2	0.91%	2	1	93	93	0.249425287356441	1	1	78	138	0	2	C
H3_BC87_191109_LF_LIB_consensus_vsearch	137	A	A	222	3	1.31%	2	2	93	93	0.12416481069040536	1	1	77	145	1	2	+T
H3_BC87_191109_LF_LIB_consensus_vsearch	138	C	Y	218	7	3.08%	2	2	93	93	0.007451182688346346	1	1	78	140	1	6	T
H3_BC87_191109_LF_LIB_consensus_vsearch	139	A	A	226	1	0.44%	2	1	93	93	0.4999999999999138	1	1	79	147	0	1	+CA
H3_BC87_191109_LF_LIB_consensus_vsearch	140	A	A	229	0	0%	2	0	93	0	1.0	1	0	80	149	0	0	
H3_BC87_191109_LF_LIB_consensus_vsearch	141	A	A	224	2	0.87%	2	1	93	93	0.24944567627499675	1	1	79	145	0	2	-T
H3_BC87_191109_LF_LIB_consensus_vsearch	142	T	T	225	1	0.44%	2	1	93	93	0.5000000000003686	1	1	80	145	0	1	+C
H3_BC87_191109_LF_LIB_consensus_vsearch	143	T	T	221	3	1.32%	2	1	93	93	0.12416107382546236	1	1	76	145	3	0	+C
H3_BC87_191109_LF_LIB_consensus_vsearch	144	C	C	223	1	0.44%	2	1	93	93	0.5000000000003686	1	1	78	145	1	0	+G
H3_BC87_191109_LF_LIB_consensus_vsearch	145	A	*/-G	202	15	6.64%	2	2	93	93	2.375885795125084E-5	1	1	70	132	1	14	-G
H3_BC87_191109_LF_LIB_consensus_vsearch	146	G	G	211	1	0.47%	2	1	93	93	0.5000000000001412	1	1	78	133	1	0	+AG
H3_BC87_191109_LF_LIB_consensus_vsearch	147	G	G	225	1	0.44%	2	1	93	93	0.5000000000003686	1	1	79	146	0	1	+T
H3_BC87_191109_LF_LIB_consensus_vsearch	148	A	A	222	4	1.75%	2	1	93	93	0.061669440342892484	1	1	74	148	4	0	-G
H3_BC87_191109_LF_LIB_consensus_vsearch	149	G	G	219	2	0.89%	2	1	93	93	0.24943310657599216	1	1	70	149	2	0	+A
H3_BC87_191109_LF_LIB_consensus_vsearch	150	A	A	223	2	0.88%	2	1	93	93	0.24944320712692292	1	1	76	147	0	2	+GA
H3_BC87_191109_LF_LIB_consensus_vsearch	151	T	T	214	5	2.18%	2	2	93	93	0.030537362897492103	1	1	73	141	2	3	-AAT
H3_BC87_191109_LF_LIB_consensus_vsearch	152	A	A	215	2	0.92%	2	1	93	93	0.2494226327944578	1	1	74	141	2	0	C
H3_BC87_191109_LF_LIB_consensus_vsearch	153	A	A	213	5	2.25%	2	1	93	93	0.030534097847134272	1	1	70	143	5	0	+C
H3_BC87_191109_LF_LIB_consensus_vsearch	154	T	T	208	5	2.27%	2	2	93	93	0.03051731330830772	1	1	69	139	2	3	C
H3_BC87_191109_LF_LIB_consensus_vsearch	155	A	A	212	5	2.21%	2	1	93	93	0.030530802741347875	1	1	69	143	5	0	C
H3_BC87_191109_LF_LIB_consensus_vsearch	156	C	Y	215	8	3.56%	2	2	93	93	0.0036646057936482192	1	1	76	139	1	7	T
H3_BC87_191109_LF_LIB_consensus_vsearch	157	A	A	221	1	0.45%	2	1	93	93	0.4999999999999138	1	1	75	146	0	1	+T
H3_BC87_191109_LF_LIB_consensus_vsearch	158	T	T	216	5	2.22%	2	2	93	93	0.030543804461782422	1	1	75	141	1	4	C
H3_BC87_191109_LF_LIB_consensus_vsearch	159	G	G	220	2	0.89%	2	2	93	93	0.2494356659142869	1	1	75	145	1	1	+TG
H3_BC87_191109_LF_LIB_consensus_vsearch	160	C	C	211	5	2.21%	2	1	93	93	0.030527477163211258	1	1	73	138	0	5	+A
H3_BC87_191109_LF_LIB_consensus_vsearch	161	A	A	217	3	1.33%	2	2	93	93	0.12414578587710072	1	1	72	145	1	2	G
H3_BC87_191109_LF_LIB_consensus_vsearch	162	C	Y	213	7	3.08%	2	2	93	93	0.007443047448823043	1	1	74	139	2	5	T
H3_BC87_191109_LF_LIB_consensus_vsearch	163	A	A	221	2	0.89%	2	1	93	93	0.24943820224728358	1	1	75	146	2	0	T
H3_BC87_191109_LF_LIB_consensus_vsearch	164	A	A	220	2	0.88%	2	1	93	93	0.2494356659142869	1	1	76	144	2	0	G
H3_BC87_191109_LF_LIB_consensus_vsearch	165	C	C	220	3	1.33%	2	2	93	93	0.12415730337075404	1	1	78	142	1	2	T
H3_BC87_191109_LF_LIB_consensus_vsearch	166	A	A	223	3	1.32%	2	2	93	93	0.12416851441234596	1	1	77	146	2	1	G
H3_BC87_191109_LF_LIB_consensus_vsearch	167	G	G	224	2	0.87%	2	1	93	93	0.24944567627499675	1	1	79	145	0	2	-T
H3_BC87_191109_LF_LIB_consensus_vsearch	168	T	T	220	4	1.76%	2	2	93	93	0.061662016439223415	1	1	75	145	3	1	-C
H3_BC87_191109_LF_LIB_consensus_vsearch	169	C	C	222	1	0.45%	2	1	93	93	0.4999999999999138	1	1	74	148	1	0	T
H3_BC87_191109_LF_LIB_consensus_vsearch	170	C	C	224	2	0.88%	2	2	93	93	0.24944567627499675	1	1	77	147	1	1	T
H3_BC87_191109_LF_LIB_consensus_vsearch	171	C	C	222	5	2.18%	2	2	93	93	0.030562448911634975	1	1	78	144	1	4	T
H3_BC87_191109_LF_LIB_consensus_vsearch	172	A	A	226	1	0.44%	2	1	93	93	0.4999999999999138	1	1	79	147	0	1	G
H3_BC87_191109_LF_LIB_consensus_vsearch	173	A	R	214	8	3.49%	2	2	93	93	0.003663533633296164	1	1	72	142	7	1	G
H3_BC87_191109_LF_LIB_consensus_vsearch	174	C	C	218	5	2.22%	2	2	93	93	0.030550130621104243	1	1	78	140	1	4	-T
H3_BC87_191109_LF_LIB_consensus_vsearch	175	T	*/+C	216	7	3.12%	2	2	93	93	0.007447971960236055	1	1	74	142	5	2	+C
H3_BC87_191109_LF_LIB_consensus_vsearch	176	C	*/-A	206	15	6.55%	2	2	93	93	2.3870469071571428E-5	1	1	63	143	14	1	-A
H3_BC87_191109_LF_LIB_consensus_vsearch	177	A	A	210	1	0.47%	2	1	93	93	0.4999999999999138	1	1	64	146	1	0	G
H3_BC87_191109_LF_LIB_consensus_vsearch	178	A	A	221	2	0.88%	2	1	93	93	0.24943820224728358	1	1	74	147	2	0	-G
H3_BC87_191109_LF_LIB_consensus_vsearch	179	G	*/-AG	211	9	3.98%	2	1	93	93	0.0017967787753331713	1	1	64	147	9	0	-AG
H3_BC87_191109_LF_LIB_consensus_vsearch	180	A	A	215	2	0.92%	2	1	93	93	0.2494226327944578	1	1	70	145	0	2	-G
H3_BC87_191109_LF_LIB_consensus_vsearch	181	G	G	212	2	0.92%	2	1	93	93	0.24941451990645544	1	1	68	144	2	0	+A
H3_BC87_191109_LF_LIB_consensus_vsearch	182	T	*/-G	211	11	4.87%	2	1	93	93	4.300945555177922E-4	1	1	79	132	0	11	-G
H3_BC87_191109_LF_LIB_consensus_vsearch	183	G	G	214	0	0%	2	0	93	0	1.0	1	0	80	134	0	0	
H3_BC87_191109_LF_LIB_consensus_vsearch	184	G	G	227	0	0%	2	0	93	0	1.0	1	0	80	147	0	0	
H3_BC87_191109_LF_LIB_consensus_vsearch	185	A	A	228	0	0%	2	0	93	0	1.0	1	0	80	148	0	0	
H3_BC87_191109_LF_LIB_consensus_vsearch	186	C	C	225	2	0.88%	2	1	93	93	0.24944812362040697	1	1	77	148	2	0	+A
H3_BC87_191109_LF_LIB_consensus_vsearch	187	G	*/-TG	212	14	6.11%	2	1	93	93	4.9595092839070994E-5	1	1	77	135	0	14	-TG
H3_BC87_191109_LF_LIB_consensus_vsearch	188	T	T	213	2	0.93%	2	2	93	93	0.249417249417318	1	1	79	134	1	1	-G
H3_BC87_191109_LF_LIB_consensus_vsearch	189	G	G	201	6	2.82%	2	2	93	93	0.01506164496890816	1	1	75	126	2	4	A
H3_BC87_191109_LF_LIB_consensus_vsearch	190	C	C	219	4	1.76%	2	1	93	93	0.06165825449566743	1	1	75	144	0	4	-T
H3_BC87_191109_LF_LIB_consensus_vsearch	191	T	T	211	5	2.24%	2	2	93	93	0.030527477163211258	1	1	73	138	1	4	-C
H3_BC87_191109_LF_LIB_consensus_vsearch	192	C	C	217	3	1.35%	2	1	93	93	0.12414578587710072	1	1	72	145	3	0	-A
H3_BC87_191109_LF_LIB_consensus_vsearch	193	A	A	213	5	2.22%	2	1	93	93	0.030534097847134272	1	1	70	143	0	5	-T
H3_BC87_191109_LF_LIB_consensus_vsearch	194	T	T	211	5	2.26%	2	1	93	93	0.030527477163211258	1	1	70	141	5	0	G
H3_BC87_191109_LF_LIB_consensus_vsearch	195	T	T	210	5	2.21%	2	2	93	93	0.0305241206880699	1	1	67	143	1	4	C
H3_BC87_191109_LF_LIB_consensus_vsearch	196	A	*/-G	207	7	3.12%	2	2	93	93	0.007432788253078562	1	1	66	141	6	1	-G
H3_BC87_191109_LF_LIB_consensus_vsearch	197	G	G	218	4	1.8%	2	2	93	93	0.061654458623218986	1	1	71	147	3	1	-A
H3_BC87_191109_LF_LIB_consensus_vsearch	198	A	A	219	4	1.78%	2	2	93	93	0.06165825449566743	1	1	73	146	3	1	G
H3_BC87_191109_LF_LIB_consensus_vsearch	199	T	*/-C	196	28	12.28%	2	1	93	93	1.515241069806662E-9	1	1	48	148	28	0	-C
H3_BC87_191109_LF_LIB_consensus_vsearch	200	C	C	194	6	2.99%	2	1	93	93	0.015042029075490227	1	1	51	143	0	6	T
H3_BC87_191109_LF_LIB_consensus_vsearch	201	C	*/-A	217	7	3.06%	2	2	93	93	0.007449584424390529	1	1	77	140	1	6	-A
H3_BC87_191109_LF_LIB_consensus_vsearch	202	A	A	219	2	0.9%	2	2	93	93	0.24943310657599216	1	1	77	142	1	1	G
H3_BC87_191109_LF_LIB_consensus_vsearch	203	A	A	228	0	0%	2	0	93	0	1.0	1	0	79	149	0	0	
H3_BC87_191109_LF_LIB_consensus_vsearch	204	A	*/-C	175	47	20.52%	2	2	93	93	4.653946214811715E-16	1	1	78	97	2	45	-C
H3_BC87_191109_LF_LIB_consensus_vsearch	205	C	C	173	4	2.2%	2	1	93	93	0.06143919033436361	1	1	77	96	0	4	A
H3_BC87_191109_LF_LIB_consensus_vsearch	206	C	C	223	3	1.31%	2	1	93	93	0.12416851441234596	1	1	79	144	0	3	-T
H3_BC87_191109_LF_LIB_consensus_vsearch	207	T	T	218	5	2.22%	2	2	93	93	0.030550130621104243	1	1	78	140	1	4	C
H3_BC87_191109_LF_LIB_consensus_vsearch	208	C	C	223	3	1.32%	2	2	93	93	0.12416851441234596	1	1	77	146	2	1	T
H3_BC87_191109_LF_LIB_consensus_vsearch	209	G	G	224	4	1.75%	2	1	93	93	0.06167673386217682	1	1	80	144	0	4	A
H3_BC87_191109_LF_LIB_consensus_vsearch	210	T	T	219	3	1.32%	2	2	93	93	0.12415349887135622	1	1	75	144	1	2	A
H3_BC87_191109_LF_LIB_consensus_vsearch	211	C	C	224	1	0.44%	2	1	93	93	0.4999999999999138	1	1	76	148	1	0	+A
H3_BC87_191109_LF_LIB_consensus_vsearch	212	C	C	223	2	0.87%	2	1	93	93	0.24944320712692292	1	1	78	145	0	2	+T
H3_BC87_191109_LF_LIB_consensus_vsearch	213	T	Y	192	28	12.44%	2	1	93	93	1.48899698039867E-9	1	1	75	117	0	28	C
H3_BC87_191109_LF_LIB_consensus_vsearch	214	G	G	219	3	1.33%	2	2	93	93	0.12415349887135622	1	1	74	145	2	1	A
H3_BC87_191109_LF_LIB_consensus_vsearch	215	C	Y	192	27	11.95%	2	1	93	93	3.173153759197354E-9	1	1	76	116	0	27	T
H3_BC87_191109_LF_LIB_consensus_vsearch	216	T	T	217	3	1.35%	2	2	93	93	0.12414578587710072	1	1	74	143	1	2	C
H3_BC87_191109_LF_LIB_consensus_vsearch	217	T	T	211	4	1.78%	2	1	93	93	0.06162689769249	1	1	73	138	0	4	+G
H3_BC87_191109_LF_LIB_consensus_vsearch	218	G	G	214	4	1.79%	2	2	93	93	0.061638926495252586	1	1	72	142	3	1	A
H3_BC87_191109_LF_LIB_consensus_vsearch	219	C	C	211	3	1.35%	2	2	93	93	0.12412177985949331	1	1	73	138	1	2	+A
H3_BC87_191109_LF_LIB_consensus_vsearch	220	A	*/-GGCA	197	8	3.62%	2	1	93	93	0.003643733038795537	1	1	69	128	0	8	-GGCA
H3_BC87_191109_LF_LIB_consensus_vsearch	221	G	G	204	1	0.48%	2	1	93	93	0.5000000000001412	1	1	73	131	1	0	+A
H3_BC87_191109_LF_LIB_consensus_vsearch	222	G	G	214	1	0.46%	2	1	93	93	0.5000000000001412	1	1	77	137	0	1	+AAG
H3_BC87_191109_LF_LIB_consensus_vsearch	223	C	*/-A	195	16	7.41%	2	2	93	93	1.1357537987418757E-5	1	1	66	129	10	6	-A
H3_BC87_191109_LF_LIB_consensus_vsearch	224	A	A	199	0	0%	2	0	93	0	1.0	1	0	68	131	0	0	
H3_BC87_191109_LF_LIB_consensus_vsearch	225	A	A	211	4	1.79%	2	2	93	93	0.06162689769249	1	1	75	136	3	1	+G
H3_BC87_191109_LF_LIB_consensus_vsearch	226	G	G	219	1	0.45%	2	1	93	93	0.4999999999999138	1	1	79	140	0	1	+T
H3_BC87_191109_LF_LIB_consensus_vsearch	227	G	G	219	1	0.45%	2	1	93	93	0.4999999999999138	1	1	79	140	0	1	+T
H3_BC87_191109_LF_LIB_consensus_vsearch	228	T	T	213	5	2.25%	2	2	93	93	0.030534097847134272	1	1	77	136	1	4	C
H3_BC87_191109_LF_LIB_consensus_vsearch	229	G	G	220	2	0.88%	2	2	93	93	0.2494356659142869	1	1	76	144	1	1	-A
H3_BC87_191109_LF_LIB_consensus_vsearch	230	A	A	213	6	2.68%	2	2	93	93	0.0150923687299321	1	1	77	136	1	5	+C
H3_BC87_191109_LF_LIB_consensus_vsearch	231	C	C	208	6	2.68%	2	2	93	93	0.015079983859610983	1	1	76	132	1	5	-T
H3_BC87_191109_LF_LIB_consensus_vsearch	232	T	T	206	4	1.83%	2	2	93	93	0.06160608506034647	1	1	75	131	1	3	+C
H3_BC87_191109_LF_LIB_consensus_vsearch	233	C	C	213	3	1.35%	2	1	93	93	0.12412993039444345	1	1	78	135	0	3	-A
H3_BC87_191109_LF_LIB_consensus_vsearch	234	A	A	217	4	1.78%	2	2	93	93	0.0616506283607095	1	1	74	143	2	2	G
H3_BC87_191109_LF_LIB_consensus_vsearch	235	T	*/-A	204	14	6.17%	2	2	93	93	4.920666598282105E-5	1	1	73	131	2	12	-A
H3_BC87_191109_LF_LIB_consensus_vsearch	236	A	A	206	3	1.41%	2	1	93	93	0.1241007194244273	1	1	77	129	0	3	+TA
H3_BC87_191109_LF_LIB_consensus_vsearch	237	A	*/-G	209	11	4.82%	2	1	93	93	4.2958650804029443E-4	1	1	77	132	0	11	-G
H3_BC87_191109_LF_LIB_consensus_vsearch	238	G	G	213	1	0.46%	2	1	93	93	0.4999999999999138	1	1	77	136	0	1	-C
H3_BC87_191109_LF_LIB_consensus_vsearch	239	C	C	223	2	0.89%	2	1	93	93	0.24944320712692292	1	1	76	147	2	0	-A
H3_BC87_191109_LF_LIB_consensus_vsearch	240	A	A	222	2	0.89%	2	1	93	93	0.24944071588395061	1	1	76	146	0	2	-T
H3_BC87_191109_LF_LIB_consensus_vsearch	241	T	T	224	1	0.44%	2	1	93	93	0.4999999999999138	1	1	78	146	0	1	+CCC
H3_BC87_191109_LF_LIB_consensus_vsearch	242	C	C	225	1	0.44%	2	1	93	93	0.5000000000003686	1	1	77	148	0	1	+G
H3_BC87_191109_LF_LIB_consensus_vsearch	243	A	A	218	5	2.2%	2	1	93	93	0.030550130621104243	1	1	76	142	0	5	-T
H3_BC87_191109_LF_LIB_consensus_vsearch	244	T	T	217	2	0.9%	2	1	93	93	0.24942791762028085	1	1	79	138	0	2	G
H3_BC87_191109_LF_LIB_consensus_vsearch	245	T	T	217	6	2.62%	2	2	93	93	0.015101878629034914	1	1	73	144	2	4	C
H3_BC87_191109_LF_LIB_consensus_vsearch	246	C	*/-G	163	61	26.87%	2	1	93	93	3.782411124069203E-21	1	1	78	85	0	61	-G
H3_BC87_191109_LF_LIB_consensus_vsearch	247	G	G	161	4	2.38%	2	1	93	93	0.06136192521119663	1	1	80	81	0	4	T
H3_BC87_191109_LF_LIB_consensus_vsearch	248	G	G	227	1	0.44%	2	1	93	93	0.4999999999999138	1	1	80	147	0	1	A
H3_BC87_191109_LF_LIB_consensus_vsearch	249	A	A	228	1	0.44%	2	1	93	93	0.4999999999999138	1	1	79	149	1	0	+G
H3_BC87_191109_LF_LIB_consensus_vsearch	250	C	C	227	1	0.44%	2	1	93	93	0.4999999999999138	1	1	79	148	0	1	A
H3_BC87_191109_LF_LIB_consensus_vsearch	251	C	C	224	2	0.87%	2	1	93	93	0.24944567627499675	1	1	79	145	0	2	+G
H3_BC87_191109_LF_LIB_consensus_vsearch	252	G	G	220	3	1.32%	2	1	93	93	0.12415730337075404	1	1	79	141	0	3	-C
H3_BC87_191109_LF_LIB_consensus_vsearch	253	C	C	216	4	1.78%	2	1	93	93	0.061646763238677425	1	1	80	136	0	4	-T
H3_BC87_191109_LF_LIB_consensus_vsearch	254	T	T	215	4	1.79%	2	2	93	93	0.06164286277914926	1	1	75	140	3	1	+C
H3_BC87_191109_LF_LIB_consensus_vsearch	255	C	C	219	2	0.88%	2	1	93	93	0.24943310657599216	1	1	78	141	0	2	T
H3_BC87_191109_LF_LIB_consensus_vsearch	256	A	*/+G	162	40	17.62%	2	1	93	93	1.065663789013873E-13	1	1	71	91	0	40	+G
H3_BC87_191109_LF_LIB_consensus_vsearch	257	G	G	211	2	0.93%	2	1	93	93	0.24941176470603904	1	1	80	131	0	2	T
H3_BC87_191109_LF_LIB_consensus_vsearch	258	G	*/-C	210	7	3.08%	2	1	93	93	0.007437988084800957	1	1	80	130	0	7	-C
H3_BC87_191109_LF_LIB_consensus_vsearch	259	C	*/+T	193	10	4.52%	2	1	93	93	8.717782032788638E-4	1	1	78	115	0	10	+T
H3_BC87_191109_LF_LIB_consensus_vsearch	260	T	T	220	3	1.34%	2	2	93	93	0.12415730337075404	1	1	77	143	2	1	C
H3_BC87_191109_LF_LIB_consensus_vsearch	261	T	T	219	3	1.31%	2	2	93	93	0.12415349887135622	1	1	78	141	1	2	C
H3_BC87_191109_LF_LIB_consensus_vsearch	262	T	T	210	4	1.75%	2	1	93	93	0.06162281305968737	1	1	78	132	0	4	+G
H3_BC87_191109_LF_LIB_consensus_vsearch	263	A	R	194	24	10.86%	2	1	93	93	3.0516921928395854E-8	1	1	79	115	0	24	G
H3_BC87_191109_LF_LIB_consensus_vsearch	264	T	Y	209	9	4.04%	2	1	93	93	0.0017953764342624938	1	1	78	131	0	9	C
H3_BC87_191109_LF_LIB_consensus_vsearch	265	G	G	214	2	0.89%	2	1	93	93	0.24941995359642635	1	1	73	141	2	0	+C
H3_BC87_191109_LF_LIB_consensus_vsearch	266	C	C	214	4	1.79%	2	1	93	93	0.061638926495252586	1	1	77	137	0	4	+GC
H3_BC87_191109_LF_LIB_consensus_vsearch	267	C	C	222	3	1.32%	2	1	93	93	0.12416481069040536	1	1	78	144	0	3	T
H3_BC87_191109_LF_LIB_consensus_vsearch	268	G	G	224	2	0.88%	2	1	93	93	0.24944567627499675	1	1	77	147	2	0	A
H3_BC87_191109_LF_LIB_consensus_vsearch	269	G	G	227	1	0.44%	2	1	93	93	0.4999999999999138	1	1	79	148	1	0	+A
H3_BC87_191109_LF_LIB_consensus_vsearch	270	C	C	224	2	0.87%	2	1	93	93	0.24944567627499675	1	1	80	144	0	2	-GGC
H3_BC87_191109_LF_LIB_consensus_vsearch	271	G	R	218	7	3.1%	2	1	93	93	0.007451182688346346	1	1	73	145	7	0	A
H3_BC87_191109_LF_LIB_consensus_vsearch	272	G	G	226	1	0.44%	2	1	93	93	0.4999999999999138	1	1	80	146	0	1	-C
H3_BC87_191109_LF_LIB_consensus_vsearch	273	C	C	222	3	1.33%	2	2	93	93	0.12416481069040536	1	1	78	144	2	1	-GC
H3_BC87_191109_LF_LIB_consensus_vsearch	274	G	G	220	2	0.88%	2	1	93	93	0.2494356659142869	1	1	75	145	0	2	-C
H3_BC87_191109_LF_LIB_consensus_vsearch	275	C	*/-T	196	13	5.86%	2	2	93	93	1.0070666248340834E-4	1	1	63	133	8	5	-T
H3_BC87_191109_LF_LIB_consensus_vsearch	276	T	T	200	4	1.91%	2	1	93	93	0.061579761579775204	1	1	65	135	0	4	C
H3_BC87_191109_LF_LIB_consensus_vsearch	277	T	*/-C	192	8	3.57%	2	2	93	93	0.0036372796311357324	1	1	54	138	4	4	-C
H3_BC87_191109_LF_LIB_consensus_vsearch	278	C	C	211	2	0.92%	2	2	93	93	0.24941176470603904	1	1	70	141	1	1	+TCT
H3_BC87_191109_LF_LIB_consensus_vsearch	279	A	R	213	7	3.1%	2	2	93	93	0.007443047448823043	1	1	72	141	5	2	G
H3_BC87_191109_LF_LIB_consensus_vsearch	280	T	T	213	4	1.8%	2	2	93	93	0.06163495389099757	1	1	75	138	1	3	+C
H3_BC87_191109_LF_LIB_consensus_vsearch	281	T	T	218	3	1.31%	2	1	93	93	0.12414965986396012	1	1	75	143	3	0	+C
H3_BC87_191109_LF_LIB_consensus_vsearch	282	C	*/-A	210	7	3.1%	2	1	93	93	0.007437988084800957	1	1	67	143	7	0	-A
H3_BC87_191109_LF_LIB_consensus_vsearch	283	A	A	209	4	1.84%	2	1	93	93	0.061618690029214815	1	1	72	137	0	4	G
H3_BC87_191109_LF_LIB_consensus_vsearch	284	A	A	214	4	1.79%	2	1	93	93	0.061638926495252586	1	1	77	137	0	4	G
H3_BC87_191109_LF_LIB_consensus_vsearch	285	G	G	223	1	0.44%	2	1	93	93	0.5000000000003686	1	1	76	147	0	1	-T
H3_BC87_191109_LF_LIB_consensus_vsearch	286	T	Y	214	9	3.96%	2	2	93	93	0.0017988361772468277	1	1	78	136	1	8	C
H3_BC87_191109_LF_LIB_consensus_vsearch	287	A	A	222	4	1.75%	2	1	93	93	0.061669440342892484	1	1	77	145	0	4	C
H3_BC87_191109_LF_LIB_consensus_vsearch	288	A	A	220	4	1.75%	2	1	93	93	0.061662016439223415	1	1	77	143	0	4	+T
H3_BC87_191109_LF_LIB_consensus_vsearch	289	C	C	220	5	2.2%	2	2	93	93	0.03055634444922604	1	1	75	145	2	3	-T
H3_BC87_191109_LF_LIB_consensus_vsearch	290	T	T	215	4	1.79%	2	1	93	93	0.06164286277914926	1	1	76	139	0	4	C
H3_BC87_191109_LF_LIB_consensus_vsearch	291	G	*/-C	204	13	5.75%	2	1	93	93	1.0144502228683225E-4	1	1	62	142	13	0	-C
H3_BC87_191109_LF_LIB_consensus_vsearch	292	C	C	202	6	2.84%	2	1	93	93	0.015064340002589747	1	1	63	139	0	6	+T
H3_BC87_191109_LF_LIB_consensus_vsearch	293	C	C	217	6	2.68%	2	1	93	93	0.015101878629034914	1	1	75	142	0	6	T
H3_BC87_191109_LF_LIB_consensus_vsearch	294	C	C	221	3	1.32%	2	1	93	93	0.12416107382546236	1	1	79	142	0	3	-T
H3_BC87_191109_LF_LIB_consensus_vsearch	295	T	Y	206	16	7.14%	2	1	93	93	1.1531106955580906E-5	1	1	80	126	0	16	C
H3_BC87_191109_LF_LIB_consensus_vsearch	296	A	A	225	1	0.44%	2	1	93	93	0.5000000000003686	1	1	79	146	0	1	-TCA
H3_BC87_191109_LF_LIB_consensus_vsearch	297	T	T	222	2	0.88%	2	2	93	93	0.24944071588395061	1	1	79	143	1	1	A
H3_BC87_191109_LF_LIB_consensus_vsearch	298	C	C	219	6	2.63%	2	1	93	93	0.015106507368173285	1	1	71	148	6	0	-AC
H3_BC87_191109_LF_LIB_consensus_vsearch	299	A	A	218	1	0.45%	2	1	93	93	0.5000000000003686	1	1	71	147	0	1	+TCA
H3_BC87_191109_LF_LIB_consensus_vsearch	300	C	C	221	2	0.9%	2	1	93	93	0.24943820224728358	1	1	74	147	0	2	+AA
H3_BC87_191109_LF_LIB_consensus_vsearch	301	G	G	221	2	0.87%	2	1	93	93	0.24943820224728358	1	1	76	145	0	2	+CG
H3_BC87_191109_LF_LIB_consensus_vsearch	302	T	Y	221	7	3.07%	2	1	93	93	0.007455894130096957	1	1	80	141	0	7	C
H3_BC87_191109_LF_LIB_consensus_vsearch	303	T	T	226	2	0.87%	2	1	93	93	0.24945054945064127	1	1	80	146	0	2	C
H3_BC87_191109_LF_LIB_consensus_vsearch	304	G	G	227	1	0.44%	2	1	93	93	0.4999999999999138	1	1	80	147	0	1	+C
H3_BC87_191109_LF_LIB_consensus_vsearch	305	T	T	220	4	1.75%	2	2	93	93	0.061662016439223415	1	1	73	147	3	1	+C
H3_BC87_191109_LF_LIB_consensus_vsearch	306	C	C	217	4	1.75%	2	1	93	93	0.0616506283607095	1	1	75	142	4	0	+A
H3_BC87_191109_LF_LIB_consensus_vsearch	307	G	G	220	3	1.33%	2	1	93	93	0.12415730337075404	1	1	77	143	3	0	A
H3_BC87_191109_LF_LIB_consensus_vsearch	308	G	G	217	4	1.75%	2	1	93	93	0.0616506283607095	1	1	71	146	4	0	T
H3_BC87_191109_LF_LIB_consensus_vsearch	309	T	Y	218	7	3.1%	2	2	93	93	0.007451182688346346	1	1	76	142	1	6	C
H3_BC87_191109_LF_LIB_consensus_vsearch	310	T	T	223	2	0.88%	2	1	93	93	0.24944320712692292	1	1	77	146	2	0	+A
H3_BC87_191109_LF_LIB_consensus_vsearch	311	G	G	224	2	0.88%	2	1	93	93	0.24944567627499675	1	1	76	148	2	0	T
H3_BC87_191109_LF_LIB_consensus_vsearch	312	T	T	214	4	1.75%	2	1	93	93	0.061638926495252586	1	1	74	140	0	4	C
H3_BC87_191109_LF_LIB_consensus_vsearch	313	G	G	219	3	1.35%	2	2	93	93	0.12415349887135622	1	1	74	145	1	2	A
H3_BC87_191109_LF_LIB_consensus_vsearch	314	T	T	220	3	1.33%	2	2	93	93	0.12415730337075404	1	1	73	147	2	1	A
H3_BC87_191109_LF_LIB_consensus_vsearch	315	C	*/-T	215	10	4.37%	2	2	93	93	8.817198236951184E-4	1	1	77	138	1	9	-T
H3_BC87_191109_LF_LIB_consensus_vsearch	316	T	T	217	1	0.46%	2	1	93	93	0.4999999999999138	1	1	79	138	0	1	+C
H3_BC87_191109_LF_LIB_consensus_vsearch	317	T	*/-G	175	50	21.93%	2	1	93	93	4.137456653375524E-17	1	1	78	97	0	50	-G
H3_BC87_191109_LF_LIB_consensus_vsearch	318	G	G	178	0	0%	2	0	93	0	1.0	1	0	80	98	0	0	
H3_BC87_191109_LF_LIB_consensus_vsearch	319	G	G	229	0	0%	2	0	93	0	1.0	1	0	80	149	0	0	
H3_BC87_191109_LF_LIB_consensus_vsearch	320	A	A	227	1	0.44%	2	1	93	93	0.4999999999999138	1	1	78	149	1	0	+TA
H3_BC87_191109_LF_LIB_consensus_vsearch	321	C	C	227	1	0.44%	2	1	93	93	0.4999999999999138	1	1	79	148	0	1	+T
H3_BC87_191109_LF_LIB_consensus_vsearch	322	C	C	227	1	0.44%	2	1	93	93	0.4999999999999138	1	1	79	148	0	1	-ACC
H3_BC87_191109_LF_LIB_consensus_vsearch	323	A	A	225	3	1.32%	2	1	93	93	0.12417582417582212	1	1	77	148	3	0	G
H3_BC87_191109_LF_LIB_consensus_vsearch	324	C	C	226	2	0.88%	2	2	93	93	0.24945054945064127	1	1	79	147	1	1	T
H3_BC87_191109_LF_LIB_consensus_vsearch	325	C	C	219	3	1.32%	2	1	93	93	0.12415349887135622	1	1	76	143	3	0	+A
H3_BC87_191109_LF_LIB_consensus_vsearch	326	G	G	225	3	1.31%	2	1	93	93	0.12417582417582212	1	1	76	149	3	0	-A
H3_BC87_191109_LF_LIB_consensus_vsearch	327	A	A	223	2	0.88%	2	1	93	93	0.24944320712692292	1	1	75	148	2	0	G
H3_BC87_191109_LF_LIB_consensus_vsearch	328	G	G	224	1	0.44%	2	1	93	93	0.4999999999999138	1	1	78	146	1	0	+AG
H3_BC87_191109_LF_LIB_consensus_vsearch	329	C	*/-G	217	8	3.52%	2	1	93	93	0.0036667219549938834	1	1	80	137	0	8	-G
H3_BC87_191109_LF_LIB_consensus_vsearch	330	G	G	218	0	0%	2	0	93	0	1.0	1	0	80	138	0	0	
H3_BC87_191109_LF_LIB_consensus_vsearch	331	G	G	227	0	0%	2	0	93	0	1.0	1	0	80	147	0	0	
H3_BC87_191109_LF_LIB_consensus_vsearch	332	A	A	226	1	0.44%	2	1	93	93	0.4999999999999138	1	1	79	147	0	1	-C
H3_BC87_191109_LF_LIB_consensus_vsearch	333	C	C	218	5	2.2%	2	2	93	93	0.030550130621104243	1	1	77	141	1	4	T
H3_BC87_191109_LF_LIB_consensus_vsearch	334	G	G	223	2	0.88%	2	1	93	93	0.24944320712692292	1	1	79	144	0	2	+TG
H3_BC87_191109_LF_LIB_consensus_vsearch	335	A	A	220	3	1.32%	2	1	93	93	0.12415730337075404	1	1	79	141	0	3	-C
H3_BC87_191109_LF_LIB_consensus_vsearch	336	C	*/-G	195	23	10.22%	2	1	93	93	6.46332756739895E-8	1	1	80	115	0	23	-G
H3_BC87_191109_LF_LIB_consensus_vsearch	337	G	R	142	53	26.11%	2	1	93	93	1.8407095684146932E-18	1	1	24	118	53	0	A
H3_BC87_191109_LF_LIB_consensus_vsearch	338	G	G	222	2	0.88%	2	1	93	93	0.24944071588395061	1	1	78	144	0	2	T
H3_BC87_191109_LF_LIB_consensus_vsearch	339	G	G	227	1	0.44%	2	1	93	93	0.4999999999999138	1	1	80	147	0	1	-T
H3_BC87_191109_LF_LIB_consensus_vsearch	340	T	Y	206	18	7.93%	2	2	93	93	2.6734324964115575E-6	1	1	79	127	1	17	C
H3_BC87_191109_LF_LIB_consensus_vsearch	341	A	A	225	1	0.44%	2	1	93	93	0.5000000000003686	1	1	80	145	0	1	C
H3_BC87_191109_LF_LIB_consensus_vsearch	342	A	A	226	1	0.44%	2	1	93	93	0.4999999999999138	1	1	79	147	0	1	+G
H3_BC87_191109_LF_LIB_consensus_vsearch	343	C	*/-G	174	36	15.72%	2	2	93	93	2.820455781252021E-12	1	1	46	128	22	14	-G
H3_BC87_191109_LF_LIB_consensus_vsearch	344	G	R	168	8	4.32%	2	1	93	93	0.0036012982281518587	1	1	39	129	8	0	A
H3_BC87_191109_LF_LIB_consensus_vsearch	345	G	G	214	5	2.26%	2	1	93	93	0.030537362897492103	1	1	68	146	5	0	A
H3_BC87_191109_LF_LIB_consensus_vsearch	346	G	G	219	4	1.78%	2	2	93	93	0.06165825449566743	1	1	74	145	3	1	A
H3_BC87_191109_LF_LIB_consensus_vsearch	347	G	*/-A	204	14	6.14%	2	2	93	93	4.920666598282105E-5	1	1	60	144	13	1	-A
H3_BC87_191109_LF_LIB_consensus_vsearch	348	A	A	207	2	0.94%	2	1	93	93	0.24940047961641743	1	1	62	145	2	0	+G
H3_BC87_191109_LF_LIB_consensus_vsearch	349	A	*/-T	216	7	3.1%	2	2	93	93	0.007447971960236055	1	1	72	144	4	3	-T
H3_BC87_191109_LF_LIB_consensus_vsearch	350	T	K	204	11	5.02%	2	1	93	93	4.2827676494109035E-4	1	1	61	143	11	0	G
H3_BC87_191109_LF_LIB_consensus_vsearch	351	T	T	208	6	2.65%	2	2	93	93	0.015079983859610983	1	1	66	142	2	4	-A
H3_BC87_191109_LF_LIB_consensus_vsearch	352	A	*/+G	200	10	4.52%	2	2	93	93	8.751600144021374E-4	1	1	65	135	1	9	+G
H3_BC87_191109_LF_LIB_consensus_vsearch	353	G	G	214	6	2.7%	2	2	93	93	0.015094778470947015	1	1	67	147	5	1	-A
H3_BC87_191109_LF_LIB_consensus_vsearch	354	A	A	216	4	1.8%	2	1	93	93	0.061646763238677425	1	1	71	145	4	0	-G
H3_BC87_191109_LF_LIB_consensus_vsearch	355	G	G	223	1	0.45%	2	1	93	93	0.5000000000003686	1	1	76	147	0	1	+AG
H3_BC87_191109_LF_LIB_consensus_vsearch	356	T	T	220	4	1.75%	2	1	93	93	0.061662016439223415	1	1	79	141	0	4	+C
H3_BC87_191109_LF_LIB_consensus_vsearch	357	T	T	220	5	2.18%	2	1	93	93	0.03055634444922604	1	1	79	141	0	5	-C
H3_BC87_191109_LF_LIB_consensus_vsearch	358	C	C	217	4	1.79%	2	1	93	93	0.0616506283607095	1	1	78	139	0	4	+G
H3_BC87_191109_LF_LIB_consensus_vsearch	359	G	G	226	1	0.44%	2	1	93	93	0.4999999999999138	1	1	78	148	0	1	+CTG
H3_BC87_191109_LF_LIB_consensus_vsearch	360	A	A	225	2	0.88%	2	1	93	93	0.24944812362040697	1	1	79	146	0	2	-T
H3_BC87_191109_LF_LIB_consensus_vsearch	361	T	T	224	2	0.88%	2	1	93	93	0.24944567627499675	1	1	80	144	0	2	+C
H3_BC87_191109_LF_LIB_consensus_vsearch	362	T	*/-C	200	25	10.92%	2	2	93	93	1.471907806965831E-8	1	1	61	139	19	6	-C
H3_BC87_191109_LF_LIB_consensus_vsearch	363	C	C	204	0	0%	2	0	93	0	1.0	1	0	61	143	0	0	
H3_BC87_191109_LF_LIB_consensus_vsearch	364	C	C	222	3	1.31%	2	2	93	93	0.12416481069040536	1	1	78	144	1	2	-G
H3_BC87_191109_LF_LIB_consensus_vsearch	365	G	*/+A	182	42	18.67%	2	1	93	93	2.7243710196804186E-14	1	1	79	103	0	42	+A
H3_BC87_191109_LF_LIB_consensus_vsearch	366	G	G	226	1	0.44%	2	1	93	93	0.4999999999999138	1	1	80	146	0	1	+AA
H3_BC87_191109_LF_LIB_consensus_vsearch	367	A	*/-G	183	43	18.78%	2	2	93	93	1.2482746997294313E-14	1	1	76	107	2	41	-G
H3_BC87_191109_LF_LIB_consensus_vsearch	368	G	*/+A	43	133	71.89%	2	2	93	93	2.2270440860882325E-59	1	1	36	7	40	93	+A
H3_BC87_191109_LF_LIB_consensus_vsearch	369	A	A	224	2	0.88%	2	2	93	93	0.24944567627499675	1	1	78	146	1	1	+G
H3_BC87_191109_LF_LIB_consensus_vsearch	370	A	A	219	5	2.19%	2	2	93	93	0.030553251388732716	1	1	77	142	2	3	+G
H3_BC87_191109_LF_LIB_consensus_vsearch	371	G	G	223	1	0.44%	2	1	93	93	0.5000000000003686	1	1	77	146	1	0	+A
H3_BC87_191109_LF_LIB_consensus_vsearch	372	A	A	221	4	1.75%	2	2	93	93	0.06166574490670126	1	1	74	147	3	1	+G
H3_BC87_191109_LF_LIB_consensus_vsearch	373	G	G	218	4	1.77%	2	1	93	93	0.061654458623218986	1	1	73	145	4	0	+AG
H3_BC87_191109_LF_LIB_consensus_vsearch	374	C	C	221	3	1.32%	2	1	93	93	0.12416107382546236	1	1	78	143	0	3	-AT
H3_BC87_191109_LF_LIB_consensus_vsearch	375	A	A	219	2	0.89%	2	1	93	93	0.24943310657599216	1	1	76	143	2	0	G
H3_BC87_191109_LF_LIB_consensus_vsearch	376	T	T	216	2	0.89%	2	2	93	93	0.249425287356441	1	1	78	138	1	1	+G
H3_BC87_191109_LF_LIB_consensus_vsearch	377	G	G	220	2	0.88%	2	2	93	93	0.2494356659142869	1	1	76	144	1	1	-A
H3_BC87_191109_LF_LIB_consensus_vsearch	378	A	A	217	3	1.33%	2	1	93	93	0.12414578587710072	1	1	75	142	3	0	-G
H3_BC87_191109_LF_LIB_consensus_vsearch	379	G	G	220	1	0.45%	2	1	93	93	0.4999999999999138	1	1	76	144	1	0	+A
H3_BC87_191109_LF_LIB_consensus_vsearch	380	A	A	222	2	0.88%	2	1	93	93	0.24944071588395061	1	1	75	147	2	0	+T
H3_BC87_191109_LF_LIB_consensus_vsearch	381	C	*/-AC	212	7	3.06%	2	2	93	93	0.00744137624879223	1	1	70	142	6	1	-AC
H3_BC87_191109_LF_LIB_consensus_vsearch	382	A	A	215	3	1.36%	2	2	93	93	0.12413793103441495	1	1	72	143	1	2	G
H3_BC87_191109_LF_LIB_consensus_vsearch	383	C	C	203	6	2.71%	2	1	93	93	0.01506700937567325	1	1	71	132	0	6	T
H3_BC87_191109_LF_LIB_consensus_vsearch	384	G	G	217	3	1.36%	2	1	93	93	0.12414578587710072	1	1	79	138	0	3	T
H3_BC87_191109_LF_LIB_consensus_vsearch	385	G	G	220	3	1.33%	2	1	93	93	0.12415730337075404	1	1	79	141	0	3	+C
H3_BC87_191109_LF_LIB_consensus_vsearch	386	C	*/-T	208	15	6.67%	2	1	93	93	2.392491102102212E-5	1	1	79	129	0	15	-T
H3_BC87_191109_LF_LIB_consensus_vsearch	387	T	T	203	4	1.9%	2	1	93	93	0.06159311429633927	1	1	78	125	0	4	-C
H3_BC87_191109_LF_LIB_consensus_vsearch	388	C	*/-T	170	47	21.17%	2	1	93	93	4.336371751026813E-16	1	1	79	91	0	47	-T
H3_BC87_191109_LF_LIB_consensus_vsearch	389	T	T	176	1	0.56%	2	1	93	93	0.4999999999999138	1	1	78	98	1	0	A
H3_BC87_191109_LF_LIB_consensus_vsearch	390	T	T	221	2	0.88%	2	1	93	93	0.24943820224728358	1	1	77	144	2	0	-A
H3_BC87_191109_LF_LIB_consensus_vsearch	391	A	A	218	5	2.21%	2	1	93	93	0.030550130621104243	1	1	77	141	0	5	G
H3_BC87_191109_LF_LIB_consensus_vsearch	392	C	C	225	1	0.44%	2	1	93	93	0.5000000000003686	1	1	80	145	0	1	+G
H3_BC87_191109_LF_LIB_consensus_vsearch	393	A	A	227	1	0.44%	2	1	93	93	0.4999999999999138	1	1	80	147	0	1	-TC
H3_BC87_191109_LF_LIB_consensus_vsearch	394	T	*/-C	218	10	4.39%	2	2	93	93	8.829313223014774E-4	1	1	71	147	9	1	-C
H3_BC87_191109_LF_LIB_consensus_vsearch	395	C	C	216	1	0.46%	2	1	93	93	0.4999999999999138	1	1	71	145	0	1	+T
H3_BC87_191109_LF_LIB_consensus_vsearch	396	C	*/-A	195	18	7.86%	2	2	93	93	2.622705226031456E-6	1	1	60	135	7	11	-A
H3_BC87_191109_LF_LIB_consensus_vsearch	397	A	A	204	4	1.9%	2	1	93	93	0.06159747950639958	1	1	72	132	0	4	G
H3_BC87_191109_LF_LIB_consensus_vsearch	398	A	A	217	4	1.75%	2	2	93	93	0.0616506283607095	1	1	77	140	3	1	-G
H3_BC87_191109_LF_LIB_consensus_vsearch	399	G	K	206	10	4.44%	2	1	93	93	8.778898007284436E-4	1	1	76	130	0	10	T
H3_BC87_191109_LF_LIB_consensus_vsearch	400	G	*/+A	211	11	4.8%	2	1	93	93	4.300945555177922E-4	1	1	65	146	11	0	+A
H3_BC87_191109_LF_LIB_consensus_vsearch	401	A	A	221	2	0.89%	2	1	93	93	0.24943820224728358	1	1	77	144	0	2	C
H3_BC87_191109_LF_LIB_consensus_vsearch	402	A	*/-G	218	7	3.07%	2	1	93	93	0.007451182688346346	1	1	80	138	0	7	-G
H3_BC87_191109_LF_LIB_consensus_vsearch	403	G	*/+C	206	7	3.18%	2	1	93	93	0.007431022745174962	1	1	79	127	0	7	+C
H3_BC87_191109_LF_LIB_consensus_vsearch	404	G	G	223	1	0.44%	2	1	93	93	0.5000000000003686	1	1	79	144	1	0	+AAA
H3_BC87_191109_LF_LIB_consensus_vsearch	405	C	C	219	3	1.33%	2	1	93	93	0.12415349887135622	1	1	78	141	0	3	-A
H3_BC87_191109_LF_LIB_consensus_vsearch	406	A	A	216	4	1.79%	2	2	93	93	0.061646763238677425	1	1	75	141	3	1	G
H3_BC87_191109_LF_LIB_consensus_vsearch	407	G	R	214	7	3.08%	2	2	93	93	0.007444703667648697	1	1	72	142	6	1	A
H3_BC87_191109_LF_LIB_consensus_vsearch	408	C	C	217	3	1.35%	2	1	93	93	0.12414578587710072	1	1	75	142	0	3	-A
H3_BC87_191109_LF_LIB_consensus_vsearch	409	A	A	213	4	1.8%	2	2	93	93	0.06163495389099757	1	1	76	137	2	2	-G
H3_BC87_191109_LF_LIB_consensus_vsearch	410	G	G	217	1	0.45%	2	1	93	93	0.4999999999999138	1	1	76	141	0	1	+T
H3_BC87_191109_LF_LIB_consensus_vsearch	411	G	G	226	1	0.44%	2	1	93	93	0.4999999999999138	1	1	79	147	1	0	-C
H3_BC87_191109_LF_LIB_consensus_vsearch	412	C	C	221	2	0.88%	2	2	93	93	0.24943820224728358	1	1	75	146	1	1	A
H3_BC87_191109_LF_LIB_consensus_vsearch	413	G	G	222	3	1.32%	2	1	93	93	0.12416481069040536	1	1	75	147	3	0	A
H3_BC87_191109_LF_LIB_consensus_vsearch	414	C	*/-GC	189	29	12.78%	2	2	93	93	6.871975409334308E-10	1	1	64	125	13	16	-GC
H3_BC87_191109_LF_LIB_consensus_vsearch	415	G	G	187	3	1.57%	2	2	93	93	0.12401055408976878	1	1	63	124	2	1	A
H3_BC87_191109_LF_LIB_consensus_vsearch	416	C	*/-A	145	37	19.37%	2	1	93	93	9.481545790224842E-13	1	1	61	84	0	37	-A
H3_BC87_191109_LF_LIB_consensus_vsearch	417	A	A	182	1	0.55%	2	1	93	93	0.4999999999999138	1	1	79	103	0	1	C
H3_BC87_191109_LF_LIB_consensus_vsearch	418	A	A	228	0	0%	2	0	93	0	1.0	1	0	79	149	0	0	
H3_BC87_191109_LF_LIB_consensus_vsearch	419	A	A	228	1	0.44%	2	1	93	93	0.4999999999999138	1	1	79	149	1	0	-T
H3_BC87_191109_LF_LIB_consensus_vsearch	420	T	T	227	1	0.44%	2	1	93	93	0.4999999999999138	1	1	79	148	0	1	C
H3_BC87_191109_LF_LIB_consensus_vsearch	421	T	*/-AC	214	12	5.24%	2	1	93	93	2.1016603336412182E-4	1	1	67	147	12	0	-AC
H3_BC87_191109_LF_LIB_consensus_vsearch	422	A	R	202	7	3.24%	2	2	93	93	0.007423793454516522	1	1	58	144	5	2	G
H3_BC87_191109_LF_LIB_consensus_vsearch	423	C	C	207	3	1.41%	2	1	93	93	0.12410501193315207	1	1	64	143	0	3	+T
H3_BC87_191109_LF_LIB_consensus_vsearch	424	C	S	215	12	5.26%	2	1	93	93	2.103084529771467E-4	1	1	67	148	12	0	G
H3_BC87_191109_LF_LIB_consensus_vsearch	425	C	C	217	6	2.62%	2	2	93	93	0.015101878629034914	1	1	77	140	2	4	T
H3_BC87_191109_LF_LIB_consensus_vsearch	426	A	A	219	1	0.44%	2	1	93	93	0.4999999999999138	1	1	77	142	0	1	+C
H3_BC87_191109_LF_LIB_consensus_vsearch	427	A	A	222	3	1.32%	2	2	93	93	0.12416481069040536	1	1	77	145	1	2	G
H3_BC87_191109_LF_LIB_consensus_vsearch	428	T	Y	217	7	3.08%	2	2	93	93	0.007449584424390529	1	1	77	140	2	5	C
H3_BC87_191109_LF_LIB_consensus_vsearch	429	A	A	226	1	0.44%	2	1	93	93	0.4999999999999138	1	1	79	147	0	1	+GCA
H3_BC87_191109_LF_LIB_consensus_vsearch	430	C	C	225	3	1.31%	2	1	93	93	0.12417582417582212	1	1	77	148	3	0	-AC
H3_BC87_191109_LF_LIB_consensus_vsearch	431	A	A	222	1	0.44%	2	1	93	93	0.4999999999999138	1	1	77	145	0	1	+TA
H3_BC87_191109_LF_LIB_consensus_vsearch	432	C	*/+AC	134	86	38.22%	2	2	93	93	3.8839402641051667E-31	1	1	39	95	37	49	+AC
H3_BC87_191109_LF_LIB_consensus_vsearch	433	G	R	146	79	34.5%	2	2	93	93	3.886552320367347E-28	1	1	71	75	7	72	A
H3_BC87_191109_LF_LIB_consensus_vsearch	434	T	Y	145	80	35.09%	2	2	93	93	1.5294788107105228E-28	1	1	71	74	7	73	C
H3_BC87_191109_LF_LIB_consensus_vsearch	435	G	G	219	6	2.64%	2	1	93	93	0.015106507368173285	1	1	78	141	0	6	-TGTG
H3_BC87_191109_LF_LIB_consensus_vsearch	436	T	T	218	2	0.9%	2	1	93	93	0.24943052391823226	1	1	79	139	0	2	C
H3_BC87_191109_LF_LIB_consensus_vsearch	437	G	*/-TG	196	22	9.95%	2	2	93	93	1.365213067807403E-7	1	1	74	122	3	19	-TG
H3_BC87_191109_LF_LIB_consensus_vsearch	438	T	T	193	2	1.01%	2	1	93	93	0.24935732647820702	1	1	73	120	2	0	A
H3_BC87_191109_LF_LIB_consensus_vsearch	439	G	G	188	4	2.01%	2	1	93	93	0.061522172652713904	1	1	69	119	4	0	-AG
H3_BC87_191109_LF_LIB_consensus_vsearch	440	A	A	208	6	2.71%	2	1	93	93	0.015079983859610983	1	1	64	144	6	0	-G
H3_BC87_191109_LF_LIB_consensus_vsearch	441	G	G	211	2	0.92%	2	1	93	93	0.24941176470603904	1	1	66	145	2	0	A
H3_BC87_191109_LF_LIB_consensus_vsearch	442	G	G	226	2	0.88%	2	2	93	93	0.24945054945064127	1	1	79	147	1	1	+C
H3_BC87_191109_LF_LIB_consensus_vsearch	443	T	T	214	6	2.63%	2	1	93	93	0.015094778470947015	1	1	78	136	0	6	+AA
H3_BC87_191109_LF_LIB_consensus_vsearch	444	A	A	219	5	2.18%	2	1	93	93	0.030553251388732716	1	1	75	144	0	5	-G
H3_BC87_191109_LF_LIB_consensus_vsearch	445	G	*/-C	217	7	3.12%	2	1	93	93	0.007449584424390529	1	1	80	137	0	7	-C
H3_BC87_191109_LF_LIB_consensus_vsearch	446	C	C	215	5	2.25%	2	1	93	93	0.03054059830172664	1	1	80	135	0	5	T
H3_BC87_191109_LF_LIB_consensus_vsearch	447	G	G	228	1	0.44%	2	1	93	93	0.4999999999999138	1	1	80	148	0	1	+C
H3_BC87_191109_LF_LIB_consensus_vsearch	448	A	A	227	1	0.44%	2	1	93	93	0.4999999999999138	1	1	80	147	0	1	-CAG
H3_BC87_191109_LF_LIB_consensus_vsearch	449	C	C	223	3	1.32%	2	1	93	93	0.12416851441234596	1	1	76	147	3	0	+A
H3_BC87_191109_LF_LIB_consensus_vsearch	450	A	A	224	1	0.44%	2	1	93	93	0.4999999999999138	1	1	78	146	0	1	+G
H3_BC87_191109_LF_LIB_consensus_vsearch	451	G	G	221	3	1.32%	2	1	93	93	0.12416107382546236	1	1	78	143	0	3	-T
H3_BC87_191109_LF_LIB_consensus_vsearch	452	T	T	216	6	2.68%	2	1	93	93	0.015099533131216845	1	1	80	136	0	6	C
H3_BC87_191109_LF_LIB_consensus_vsearch	453	A	A	213	4	1.76%	2	2	93	93	0.06163495389099757	1	1	79	134	1	3	-CA
H3_BC87_191109_LF_LIB_consensus_vsearch	454	C	C	213	2	0.9%	2	1	93	93	0.249417249417318	1	1	76	137	2	0	+GC
H3_BC87_191109_LF_LIB_consensus_vsearch	455	A	A	212	3	1.34%	2	1	93	93	0.1241258741259166	1	1	73	139	3	0	+CA
H3_BC87_191109_LF_LIB_consensus_vsearch	456	T	T	220	2	0.88%	2	1	93	93	0.2494356659142869	1	1	78	142	0	2	+A
H3_BC87_191109_LF_LIB_consensus_vsearch	457	A	A	225	1	0.44%	2	1	93	93	0.5000000000003686	1	1	79	146	0	1	+CA
H3_BC87_191109_LF_LIB_consensus_vsearch	458	A	A	221	2	0.87%	2	2	93	93	0.24943820224728358	1	1	77	144	1	1	-CAA
H3_BC87_191109_LF_LIB_consensus_vsearch	459	C	C	222	2	0.88%	2	1	93	93	0.24944071588395061	1	1	78	144	0	2	T
H3_BC87_191109_LF_LIB_consensus_vsearch	460	A	A	225	1	0.44%	2	1	93	93	0.5000000000003686	1	1	78	147	0	1	+G
H3_BC87_191109_LF_LIB_consensus_vsearch	461	A	A	221	3	1.32%	2	2	93	93	0.12416107382546236	1	1	76	145	1	2	G
H3_BC87_191109_LF_LIB_consensus_vsearch	462	T	*/-G	205	11	4.82%	2	2	93	93	4.285433624407098E-4	1	1	77	128	2	9	-G
H3_BC87_191109_LF_LIB_consensus_vsearch	463	G	G	209	3	1.41%	2	1	93	93	0.12411347517731831	1	1	73	136	3	0	A
H3_BC87_191109_LF_LIB_consensus_vsearch	464	G	G	225	0	0%	2	0	93	0	1.0	1	0	80	145	0	0	
H3_BC87_191109_LF_LIB_consensus_vsearch	465	G	G	225	1	0.44%	2	1	93	93	0.5000000000003686	1	1	80	145	0	1	A
H3_BC87_191109_LF_LIB_consensus_vsearch	466	G	G	224	2	0.88%	2	2	93	93	0.24944567627499675	1	1	78	146	1	1	A
H3_BC87_191109_LF_LIB_consensus_vsearch	467	C	*/-GC	206	10	4.41%	2	2	93	93	8.778898007284436E-4	1	1	74	132	4	6	-GC
H3_BC87_191109_LF_LIB_consensus_vsearch	468	G	G	206	3	1.4%	2	2	93	93	0.1241007194244273	1	1	74	132	1	2	A
H3_BC87_191109_LF_LIB_consensus_vsearch	469	C	*/+A	193	11	5.09%	2	1	93	93	4.251792957023273E-4	1	1	73	120	0	11	+A
H3_BC87_191109_LF_LIB_consensus_vsearch	470	A	A	222	2	0.89%	2	2	93	93	0.24944071588395061	1	1	76	146	1	1	T
H3_BC87_191109_LF_LIB_consensus_vsearch	471	C	Y	195	26	11.45%	2	2	93	93	6.825326034146069E-9	1	1	71	124	4	22	T
H3_BC87_191109_LF_LIB_consensus_vsearch	472	G	*/-A	216	7	3.08%	2	2	93	93	0.007447971960236055	1	1	71	145	6	1	-A
H3_BC87_191109_LF_LIB_consensus_vsearch	473	A	A	213	5	2.26%	2	2	93	93	0.030534097847134272	1	1	72	141	2	3	G
H3_BC87_191109_LF_LIB_consensus_vsearch	474	G	G	224	1	0.44%	2	1	93	93	0.4999999999999138	1	1	78	146	1	0	+A
H3_BC87_191109_LF_LIB_consensus_vsearch	475	C	C	221	4	1.75%	2	1	93	93	0.06166574490670126	1	1	79	142	0	4	-A
H3_BC87_191109_LF_LIB_consensus_vsearch	476	A	A	220	2	0.89%	2	2	93	93	0.2494356659142869	1	1	79	141	1	1	G
H3_BC87_191109_LF_LIB_consensus_vsearch	477	A	A	224	4	1.75%	2	2	93	93	0.06167673386217682	1	1	79	145	1	3	G
H3_BC87_191109_LF_LIB_consensus_vsearch	478	T	Y	219	8	3.49%	2	1	93	93	0.0036688013849068284	1	1	80	139	0	8	C
H3_BC87_191109_LF_LIB_consensus_vsearch	479	G	*/-TG	211	13	5.68%	2	1	93	93	1.0205056322589528E-4	1	1	77	134	0	13	-TG
H3_BC87_191109_LF_LIB_consensus_vsearch	480	T	T	206	4	1.88%	2	1	93	93	0.06160608506034647	1	1	78	128	0	4	+G
H3_BC87_191109_LF_LIB_consensus_vsearch	481	G	G	213	1	0.47%	2	1	93	93	0.4999999999999138	1	1	79	134	1	0	-ACCTAAT
H3_BC87_191109_LF_LIB_consensus_vsearch	482	A	A	217	4	1.75%	2	1	93	93	0.0616506283607095	1	1	73	144	4	0	+C
H3_BC87_191109_LF_LIB_consensus_vsearch	483	C	C	217	6	2.67%	2	1	93	93	0.015101878629034914	1	1	79	138	0	6	+T
H3_BC87_191109_LF_LIB_consensus_vsearch	484	C	*/-T	216	7	3.07%	2	1	93	93	0.007447971960236055	1	1	79	137	0	7	-T
H3_BC87_191109_LF_LIB_consensus_vsearch	485	T	*/-A	200	15	6.79%	2	2	93	93	2.3701643162627867E-5	1	1	64	136	13	2	-A
H3_BC87_191109_LF_LIB_consensus_vsearch	486	A	A	207	2	0.94%	2	1	93	93	0.24940047961641743	1	1	65	142	0	2	C
H3_BC87_191109_LF_LIB_consensus_vsearch	487	A	A	221	4	1.76%	2	1	93	93	0.06166574490670126	1	1	74	147	4	0	G
H3_BC87_191109_LF_LIB_consensus_vsearch	488	T	K	210	14	6.14%	2	2	93	93	4.950038813942507E-5	1	1	65	145	13	1	G
H3_BC87_191109_LF_LIB_consensus_vsearch	489	T	*/-G	184	34	14.85%	2	2	93	93	1.4420013005370066E-11	1	1	74	110	1	33	-G
H3_BC87_191109_LF_LIB_consensus_vsearch	490	G	G	192	2	1.03%	2	1	93	93	0.2493540051679821	1	1	79	113	0	2	C
H3_BC87_191109_LF_LIB_consensus_vsearch	491	G	G	219	4	1.75%	2	2	93	93	0.06165825449566743	1	1	77	142	2	2	-AA
H3_BC87_191109_LF_LIB_consensus_vsearch	492	A	A	219	2	0.89%	2	1	93	93	0.24943310657599216	1	1	73	146	2	0	+G
H3_BC87_191109_LF_LIB_consensus_vsearch	493	A	A	220	2	0.89%	2	2	93	93	0.2494356659142869	1	1	75	145	1	1	G
H3_BC87_191109_LF_LIB_consensus_vsearch	494	T	T	221	2	0.88%	2	1	93	93	0.24943820224728358	1	1	75	146	2	0	+AT
H3_BC87_191109_LF_LIB_consensus_vsearch	495	G	G	224	1	0.44%	2	1	93	93	0.4999999999999138	1	1	79	145	0	1	+TCG
H3_BC87_191109_LF_LIB_consensus_vsearch	496	A	A	222	2	0.88%	2	1	93	93	0.24944071588395061	1	1	76	146	2	0	-G
H3_BC87_191109_LF_LIB_consensus_vsearch	497	G	*/-C	212	12	5.31%	2	2	93	93	2.0987757342671282E-4	1	1	68	144	10	2	-C
H3_BC87_191109_LF_LIB_consensus_vsearch	498	C	*/+T	191	21	9.68%	2	1	93	93	2.832998157915201E-7	1	1	70	121	0	21	+T
H3_BC87_191109_LF_LIB_consensus_vsearch	499	C	*/-T	204	18	7.86%	2	2	93	93	2.6645289168846238E-6	1	1	79	125	1	17	-T
H3_BC87_191109_LF_LIB_consensus_vsearch	500	T	T	200	3	1.42%	2	1	93	93	0.12407407407409911	1	1	78	122	0	3	+C
H3_BC87_191109_LF_LIB_consensus_vsearch	501	A	A	223	2	0.88%	2	1	93	93	0.24944320712692292	1	1	79	144	0	2	C
H3_BC87_191109_LF_LIB_consensus_vsearch	502	A	A	224	2	0.87%	2	1	93	93	0.24944567627499675	1	1	79	145	0	2	+T
H3_BC87_191109_LF_LIB_consensus_vsearch	503	T	T	220	4	1.75%	2	2	93	93	0.061662016439223415	1	1	75	145	1	3	C
H3_BC87_191109_LF_LIB_consensus_vsearch	504	C	C	222	4	1.75%	2	1	93	93	0.061669440342892484	1	1	79	143	0	4	-T
H3_BC87_191109_LF_LIB_consensus_vsearch	505	T	Y	207	8	3.57%	2	2	93	93	0.003655753662936563	1	1	72	135	2	6	C
H3_BC87_191109_LF_LIB_consensus_vsearch	506	A	A	222	1	0.45%	2	1	93	93	0.4999999999999138	1	1	75	147	0	1	G
H3_BC87_191109_LF_LIB_consensus_vsearch	507	A	A	223	2	0.88%	2	1	93	93	0.24944320712692292	1	1	75	148	2	0	+GA
H3_BC87_191109_LF_LIB_consensus_vsearch	508	A	A	226	2	0.87%	2	1	93	93	0.24945054945064127	1	1	77	149	2	0	-G
H3_BC87_191109_LF_LIB_consensus_vsearch	509	G	G	223	4	1.76%	2	1	93	93	0.061673103185009646	1	1	78	145	0	4	+C
H3_BC87_191109_LF_LIB_consensus_vsearch	510	C	*/-T	213	12	5.24%	2	1	93	93	2.1002241192895544E-4	1	1	79	134	0	12	-T
H3_BC87_191109_LF_LIB_consensus_vsearch	511	T	T	206	6	2.76%	2	2	93	93	0.015074867144143777	1	1	75	131	2	4	+C
H3_BC87_191109_LF_LIB_consensus_vsearch	512	C	C	227	1	0.44%	2	1	93	93	0.4999999999999138	1	1	79	148	0	1	+T
H3_BC87_191109_LF_LIB_consensus_vsearch	513	T	*/+G	209	12	5.26%	2	2	93	93	2.0943559915765036E-4	1	1	76	133	1	11	+G
H3_BC87_191109_LF_LIB_consensus_vsearch	514	G	*/-A	216	9	3.96%	2	1	93	93	0.0018001779733764346	1	1	68	148	9	0	-A
H3_BC87_191109_LF_LIB_consensus_vsearch	515	A	A	214	2	0.91%	2	1	93	93	0.24941995359642635	1	1	70	144	0	2	C
H3_BC87_191109_LF_LIB_consensus_vsearch	516	G	*/-T	199	26	11.45%	2	1	93	93	6.926624973953721E-9	1	1	79	120	0	26	-T
H3_BC87_191109_LF_LIB_consensus_vsearch	517	T	T	199	1	0.5%	2	1	93	93	0.5000000000001412	1	1	79	120	1	0	+A
H3_BC87_191109_LF_LIB_consensus_vsearch	518	G	G	224	2	0.88%	2	2	93	93	0.24944567627499675	1	1	79	145	1	1	-A
H3_BC87_191109_LF_LIB_consensus_vsearch	519	A	A	221	3	1.33%	2	2	93	93	0.12416107382546236	1	1	77	144	2	1	-G
H3_BC87_191109_LF_LIB_consensus_vsearch	520	G	G	220	2	0.89%	2	1	93	93	0.2494356659142869	1	1	75	145	2	0	A
H3_BC87_191109_LF_LIB_consensus_vsearch	521	C	C	224	1	0.44%	2	1	93	93	0.4999999999999138	1	1	80	144	0	1	+A
H3_BC87_191109_LF_LIB_consensus_vsearch	522	A	A	227	1	0.44%	2	1	93	93	0.4999999999999138	1	1	80	147	0	1	G
H3_BC87_191109_LF_LIB_consensus_vsearch	523	A	R	220	9	3.93%	2	1	93	93	0.0018027927820038396	1	1	71	149	9	0	G
H3_BC87_191109_LF_LIB_consensus_vsearch	524	C	C	223	3	1.31%	2	1	93	93	0.12416851441234596	1	1	78	145	0	3	T
H3_BC87_191109_LF_LIB_consensus_vsearch	525	G	G	224	4	1.75%	2	1	93	93	0.06167673386217682	1	1	76	148	4	0	-A
H3_BC87_191109_LF_LIB_consensus_vsearch	526	A	A	221	1	0.45%	2	1	93	93	0.4999999999999138	1	1	75	146	0	1	+GA
H3_BC87_191109_LF_LIB_consensus_vsearch	527	T	T	224	4	1.75%	2	1	93	93	0.06167673386217682	1	1	76	148	4	0	G
H3_BC87_191109_LF_LIB_consensus_vsearch	528	T	*/-G	142	83	36.24%	2	2	93	93	9.089376383627345E-30	1	1	77	65	1	82	-G
H3_BC87_191109_LF_LIB_consensus_vsearch	529	G	G	144	1	0.69%	2	1	93	93	0.4999999999999138	1	1	78	66	0	1	A
H3_BC87_191109_LF_LIB_consensus_vsearch	530	G	G	222	3	1.32%	2	2	93	93	0.12416481069040536	1	1	77	145	1	2	-A
H3_BC87_191109_LF_LIB_consensus_vsearch	531	A	*/-G	205	14	6.28%	2	2	93	93	4.9256649870734555E-5	1	1	72	133	3	11	-G
H3_BC87_191109_LF_LIB_consensus_vsearch	532	G	G	201	4	1.9%	2	1	93	93	0.061584255960787086	1	1	70	131	4	0	+A
H3_BC87_191109_LF_LIB_consensus_vsearch	533	G	*/+A	200	18	8%	2	1	93	93	2.6463038722080364E-6	1	1	52	148	18	0	+A
H3_BC87_191109_LF_LIB_consensus_vsearch	534	G	G	216	6	2.63%	2	1	93	93	0.015099533131216845	1	1	69	147	6	0	A
H3_BC87_191109_LF_LIB_consensus_vsearch	535	C	C	210	5	2.21%	2	2	93	93	0.0305241206880699	1	1	71	139	3	2	-A
H3_BC87_191109_LF_LIB_consensus_vsearch	536	A	A	212	3	1.37%	2	1	93	93	0.1241258741259166	1	1	70	142	3	0	+G
H3_BC87_191109_LF_LIB_consensus_vsearch	537	A	A	222	1	0.44%	2	1	93	93	0.4999999999999138	1	1	79	143	0	1	-GT
H3_BC87_191109_LF_LIB_consensus_vsearch	538	G	G	217	4	1.76%	2	1	93	93	0.0616506283607095	1	1	76	141	0	4	+T
H3_BC87_191109_LF_LIB_consensus_vsearch	539	T	T	221	3	1.32%	2	2	93	93	0.12416107382546236	1	1	77	144	2	1	+C
H3_BC87_191109_LF_LIB_consensus_vsearch	540	C	C	225	3	1.31%	2	2	93	93	0.12417582417582212	1	1	78	147	1	2	-T
H3_BC87_191109_LF_LIB_consensus_vsearch	541	T	*/-G	187	28	12.39%	2	1	93	93	1.4554047345259757E-9	1	1	76	111	0	28	-G
H3_BC87_191109_LF_LIB_consensus_vsearch	542	G	G	194	3	1.51%	2	2	93	93	0.1240458015267009	1	1	77	117	2	1	A
H3_BC87_191109_LF_LIB_consensus_vsearch	543	G	G	217	5	2.2%	2	2	93	93	0.03054698177238809	1	1	76	141	4	1	T
H3_BC87_191109_LF_LIB_consensus_vsearch	544	T	Y	192	26	11.45%	2	1	93	93	6.747777093771561E-9	1	1	80	112	0	26	C
H3_BC87_191109_LF_LIB_consensus_vsearch	545	G	G	217	3	1.33%	2	2	93	93	0.12414578587710072	1	1	73	144	1	2	-C
H3_BC87_191109_LF_LIB_consensus_vsearch	546	C	C	216	3	1.35%	2	2	93	93	0.12414187643025615	1	1	76	140	2	1	T
H3_BC87_191109_LF_LIB_consensus_vsearch	547	C	C	214	6	2.62%	2	2	93	93	0.015094778470947015	1	1	77	137	1	5	-A
H3_BC87_191109_LF_LIB_consensus_vsearch	548	A	A	213	3	1.35%	2	1	93	93	0.12412993039444345	1	1	77	136	0	3	-G
H3_BC87_191109_LF_LIB_consensus_vsearch	549	G	G	219	3	1.33%	2	1	93	93	0.12415349887135622	1	1	76	143	3	0	A
H3_BC87_191109_LF_LIB_consensus_vsearch	550	C	C	224	3	1.32%	2	1	93	93	0.12417218543044797	1	1	79	145	0	3	T
H3_BC87_191109_LF_LIB_consensus_vsearch	551	A	A	221	3	1.31%	2	2	93	93	0.12416107382546236	1	1	76	145	2	1	G
H3_BC87_191109_LF_LIB_consensus_vsearch	552	G	G	216	4	1.77%	2	2	93	93	0.061646763238677425	1	1	70	146	3	1	A
H3_BC87_191109_LF_LIB_consensus_vsearch	553	C	C	216	4	1.79%	2	2	93	93	0.061646763238677425	1	1	73	143	1	3	T
H3_BC87_191109_LF_LIB_consensus_vsearch	554	C	C	219	6	2.62%	2	2	93	93	0.015106507368173285	1	1	75	144	2	4	T
H3_BC87_191109_LF_LIB_consensus_vsearch	555	G	G	219	5	2.18%	2	2	93	93	0.030553251388732716	1	1	75	144	3	2	A
H3_BC87_191109_LF_LIB_consensus_vsearch	556	C	C	216	4	1.77%	2	2	93	93	0.061646763238677425	1	1	78	138	1	3	T
H3_BC87_191109_LF_LIB_consensus_vsearch	557	G	G	213	5	2.23%	2	2	93	93	0.030534097847134272	1	1	75	138	3	2	A
H3_BC87_191109_LF_LIB_consensus_vsearch	558	G	G	223	3	1.32%	2	1	93	93	0.12416851441234596	1	1	76	147	3	0	A
H3_BC87_191109_LF_LIB_consensus_vsearch	559	T	T	222	2	0.88%	2	2	93	93	0.24944071588395061	1	1	77	145	1	1	-A
H3_BC87_191109_LF_LIB_consensus_vsearch	560	A	A	226	0	0%	2	0	93	0	1.0	1	0	79	147	0	0	
H3_BC87_191109_LF_LIB_consensus_vsearch	561	A	A	225	2	0.88%	2	1	93	93	0.24944812362040697	1	1	80	145	0	2	-TT
H3_BC87_191109_LF_LIB_consensus_vsearch	562	T	T	223	2	0.89%	2	1	93	93	0.24944320712692292	1	1	80	143	0	2	+C
H3_BC87_191109_LF_LIB_consensus_vsearch	563	T	T	217	4	1.77%	2	1	93	93	0.0616506283607095	1	1	77	140	0	4	C
H3_BC87_191109_LF_LIB_consensus_vsearch	564	C	C	224	1	0.44%	2	1	93	93	0.4999999999999138	1	1	79	145	0	1	+G
H3_BC87_191109_LF_LIB_consensus_vsearch	565	C	C	224	1	0.44%	2	1	93	93	0.4999999999999138	1	1	78	146	0	1	+GT
H3_BC87_191109_LF_LIB_consensus_vsearch	566	A	A	226	2	0.88%	2	1	93	93	0.24945054945064127	1	1	77	149	2	0	G
H3_BC87_191109_LF_LIB_consensus_vsearch	567	G	G	223	5	2.19%	2	1	93	93	0.03056546102900896	1	1	74	149	5	0	A
H3_BC87_191109_LF_LIB_consensus_vsearch	568	C	C	220	4	1.75%	2	1	93	93	0.061662016439223415	1	1	78	142	0	4	-T
H3_BC87_191109_LF_LIB_consensus_vsearch	569	T	T	214	6	2.67%	2	2	93	93	0.015094778470947015	1	1	74	140	3	3	-C
H3_BC87_191109_LF_LIB_consensus_vsearch	570	C	C	221	0	0%	2	0	93	0	1.0	1	0	75	146	0	0	
H3_BC87_191109_LF_LIB_consensus_vsearch	571	C	C	222	2	0.88%	2	1	93	93	0.24944071588395061	1	1	75	147	0	2	+A
H3_BC87_191109_LF_LIB_consensus_vsearch	572	A	A	221	1	0.45%	2	1	93	93	0.4999999999999138	1	1	75	146	0	1	+T
H3_BC87_191109_LF_LIB_consensus_vsearch	573	C	C	219	5	2.21%	2	2	93	93	0.030553251388732716	1	1	74	145	2	3	T
H3_BC87_191109_LF_LIB_consensus_vsearch	574	G	G	226	1	0.44%	2	1	93	93	0.4999999999999138	1	1	79	147	1	0	-A
H3_BC87_191109_LF_LIB_consensus_vsearch	575	A	A	223	2	0.88%	2	1	93	93	0.24944320712692292	1	1	77	146	2	0	-G
H3_BC87_191109_LF_LIB_consensus_vsearch	576	G	G	220	2	0.89%	2	2	93	93	0.2494356659142869	1	1	76	144	1	1	-CG
H3_BC87_191109_LF_LIB_consensus_vsearch	577	C	C	221	1	0.45%	2	1	93	93	0.4999999999999138	1	1	77	144	1	0	+G
H3_BC87_191109_LF_LIB_consensus_vsearch	578	G	G	224	1	0.44%	2	1	93	93	0.4999999999999138	1	1	78	146	1	0	+T
H3_BC87_191109_LF_LIB_consensus_vsearch	579	T	T	222	4	1.75%	2	2	93	93	0.061669440342892484	1	1	78	144	1	3	C
H3_BC87_191109_LF_LIB_consensus_vsearch	580	A	A	224	2	0.87%	2	2	93	93	0.24944567627499675	1	1	79	145	1	1	C
H3_BC87_191109_LF_LIB_consensus_vsearch	581	T	*/-AT	211	11	4.82%	2	2	93	93	4.300945555177922E-4	1	1	74	137	5	6	-AT
H3_BC87_191109_LF_LIB_consensus_vsearch	582	A	A	210	4	1.84%	2	2	93	93	0.06162281305968737	1	1	72	138	1	3	G
H3_BC87_191109_LF_LIB_consensus_vsearch	583	T	T	206	4	1.84%	2	2	93	93	0.06160608506034647	1	1	71	135	1	3	C
H3_BC87_191109_LF_LIB_consensus_vsearch	584	G	*/-TG	207	12	5.24%	2	2	93	93	2.091345729349345E-4	1	1	73	134	4	8	-TG
H3_BC87_191109_LF_LIB_consensus_vsearch	585	T	T	202	5	2.33%	2	2	93	93	0.030496102932097202	1	1	68	134	3	2	C
H3_BC87_191109_LF_LIB_consensus_vsearch	586	G	G	202	6	2.76%	2	1	93	93	0.015064340002589747	1	1	64	138	6	0	+A
H3_BC87_191109_LF_LIB_consensus_vsearch	587	A	A	213	5	2.25%	2	1	93	93	0.030534097847134272	1	1	67	146	5	0	-G
H3_BC87_191109_LF_LIB_consensus_vsearch	588	G	G	216	4	1.8%	2	2	93	93	0.061646763238677425	1	1	69	147	3	1	-T
H3_BC87_191109_LF_LIB_consensus_vsearch	589	T	Y	213	9	4.02%	2	1	93	93	0.0017981564163397133	1	1	74	139	0	9	C
H3_BC87_191109_LF_LIB_consensus_vsearch	590	T	T	219	4	1.75%	2	1	93	93	0.06165825449566743	1	1	74	145	4	0	+A
H3_BC87_191109_LF_LIB_consensus_vsearch	591	G	G	215	4	1.76%	2	1	93	93	0.06164286277914926	1	1	68	147	4	0	+T
H3_BC87_191109_LF_LIB_consensus_vsearch	592	T	Y	214	9	3.98%	2	1	93	93	0.0017988361772468277	1	1	76	138	0	9	C
H3_BC87_191109_LF_LIB_consensus_vsearch	593	T	Y	214	9	3.96%	2	2	93	93	0.0017988361772468277	1	1	73	141	4	5	C
H3_BC87_191109_LF_LIB_consensus_vsearch	594	G	G	218	4	1.76%	2	1	93	93	0.061654458623218986	1	1	70	148	4	0	C
H3_BC87_191109_LF_LIB_consensus_vsearch	595	C	C	215	6	2.64%	2	2	93	93	0.01509716650743782	1	1	74	141	1	5	T
H3_BC87_191109_LF_LIB_consensus_vsearch	596	A	A	215	5	2.23%	2	2	93	93	0.03054059830172664	1	1	73	142	2	3	G
H3_BC87_191109_LF_LIB_consensus_vsearch	597	G	G	220	3	1.33%	2	2	93	93	0.12415730337075404	1	1	76	144	1	2	-TT
H3_BC87_191109_LF_LIB_consensus_vsearch	598	T	T	222	3	1.33%	2	1	93	93	0.12416481069040536	1	1	79	143	0	3	C
H3_BC87_191109_LF_LIB_consensus_vsearch	599	T	*/-A	205	11	4.87%	2	2	93	93	4.285433624407098E-4	1	1	74	131	1	10	-A
H3_BC87_191109_LF_LIB_consensus_vsearch	600	A	A	213	3	1.39%	2	2	93	93	0.12412993039444345	1	1	77	136	1	2	C
H3_BC87_191109_LF_LIB_consensus_vsearch	601	A	A	225	1	0.44%	2	1	93	93	0.5000000000003686	1	1	77	148	1	0	+G
H3_BC87_191109_LF_LIB_consensus_vsearch	602	A	A	225	1	0.44%	2	1	93	93	0.5000000000003686	1	1	77	148	1	0	+C
H3_BC87_191109_LF_LIB_consensus_vsearch	603	A	A	221	3	1.31%	2	2	93	93	0.12416107382546236	1	1	75	146	2	1	G
H3_BC87_191109_LF_LIB_consensus_vsearch	604	C	C	224	1	0.44%	2	1	93	93	0.4999999999999138	1	1	77	147	0	1	+G
H3_BC87_191109_LF_LIB_consensus_vsearch	605	G	*/-TG	204	20	8.77%	2	1	93	93	6.120185088270156E-7	1	1	77	127	0	20	-TG
H3_BC87_191109_LF_LIB_consensus_vsearch	606	T	T	201	3	1.45%	2	1	93	93	0.12407862407864012	1	1	79	122	0	3	C
H3_BC87_191109_LF_LIB_consensus_vsearch	607	G	G	201	4	1.92%	2	1	93	93	0.061584255960787086	1	1	79	122	0	4	-CG
H3_BC87_191109_LF_LIB_consensus_vsearch	608	C	C	216	3	1.34%	2	1	93	93	0.12414187643025615	1	1	79	137	0	3	+G
H3_BC87_191109_LF_LIB_consensus_vsearch	609	G	G	217	2	0.9%	2	1	93	93	0.24942791762028085	1	1	78	139	0	2	+CG
H3_BC87_191109_LF_LIB_consensus_vsearch	610	T	T	219	4	1.78%	2	1	93	93	0.06165825449566743	1	1	80	139	0	4	C
H3_BC87_191109_LF_LIB_consensus_vsearch	611	A	A	221	1	0.44%	2	1	93	93	0.4999999999999138	1	1	79	142	0	1	-G
H3_BC87_191109_LF_LIB_consensus_vsearch	612	G	G	220	1	0.44%	2	1	93	93	0.4999999999999138	1	1	75	145	1	0	+A
H3_BC87_191109_LF_LIB_consensus_vsearch	613	T	Y	210	15	6.64%	2	1	93	93	2.3978473096487834E-5	1	1	79	131	0	15	C
H3_BC87_191109_LF_LIB_consensus_vsearch	614	T	T	222	2	0.88%	2	1	93	93	0.24944071588395061	1	1	80	142	0	2	C
H3_BC87_191109_LF_LIB_consensus_vsearch	615	G	G	225	1	0.44%	2	1	93	93	0.5000000000003686	1	1	80	145	0	1	C
H3_BC87_191109_LF_LIB_consensus_vsearch	616	A	A	225	1	0.44%	2	1	93	93	0.5000000000003686	1	1	80	145	0	1	G
H3_BC87_191109_LF_LIB_consensus_vsearch	617	T	T	223	3	1.32%	2	1	93	93	0.12416851441234596	1	1	79	144	0	3	-GC
H3_BC87_191109_LF_LIB_consensus_vsearch	618	G	G	224	1	0.44%	2	1	93	93	0.4999999999999138	1	1	80	144	0	1	-C
H3_BC87_191109_LF_LIB_consensus_vsearch	619	C	C	218	2	0.89%	2	2	93	93	0.24943052391823226	1	1	79	139	1	1	+TT
H3_BC87_191109_LF_LIB_consensus_vsearch	620	T	*/+C	210	11	4.89%	2	1	93	93	4.298416344617859E-4	1	1	69	141	11	0	+C
H3_BC87_191109_LF_LIB_consensus_vsearch	621	C	C	218	2	0.89%	2	1	93	93	0.24943052391823226	1	1	78	140	0	2	-A
H3_BC87_191109_LF_LIB_consensus_vsearch	622	A	*/-G	174	39	17.33%	2	2	93	93	2.679025912295411E-13	1	1	61	113	17	22	-G
H3_BC87_191109_LF_LIB_consensus_vsearch	623	G	G	179	1	0.55%	2	1	93	93	0.5000000000001412	1	1	62	117	1	0	+A
H3_BC87_191109_LF_LIB_consensus_vsearch	624	G	G	218	1	0.45%	2	1	93	93	0.5000000000003686	1	1	79	139	1	0	A
H3_BC87_191109_LF_LIB_consensus_vsearch	625	G	G	217	3	1.34%	2	2	93	93	0.12414578587710072	1	1	76	141	1	2	A
H3_BC87_191109_LF_LIB_consensus_vsearch	626	G	*/-C	215	7	3.1%	2	2	93	93	0.007446345105805389	1	1	70	145	6	1	-C
H3_BC87_191109_LF_LIB_consensus_vsearch	627	C	C	218	2	0.9%	2	1	93	93	0.24943052391823226	1	1	74	144	0	2	T
H3_BC87_191109_LF_LIB_consensus_vsearch	628	C	C	221	5	2.18%	2	2	93	93	0.03055941016990272	1	1	77	144	2	3	T
H3_BC87_191109_LF_LIB_consensus_vsearch	629	G	G	224	2	0.88%	2	1	93	93	0.24944567627499675	1	1	77	147	2	0	A
H3_BC87_191109_LF_LIB_consensus_vsearch	630	C	C	224	3	1.31%	2	2	93	93	0.12417218543044797	1	1	77	147	2	1	-GC
H3_BC87_191109_LF_LIB_consensus_vsearch	631	G	G	219	4	1.78%	2	2	93	93	0.06165825449566743	1	1	76	143	1	3	-C
H3_BC87_191109_LF_LIB_consensus_vsearch	632	C	*/+T	201	9	4.07%	2	1	93	93	0.0017895062981052791	1	1	75	126	0	9	+T
H3_BC87_191109_LF_LIB_consensus_vsearch	633	C	*/-T	210	7	3.07%	2	1	93	93	0.007437988084800957	1	1	77	133	0	7	-T
H3_BC87_191109_LF_LIB_consensus_vsearch	634	T	*/-AT	202	10	4.61%	2	2	93	93	8.760865562530377E-4	1	1	67	135	9	1	-AT
H3_BC87_191109_LF_LIB_consensus_vsearch	635	A	R	199	10	4.67%	2	2	93	93	8.746903119674215E-4	1	1	65	134	4	6	G
H3_BC87_191109_LF_LIB_consensus_vsearch	636	T	T	201	6	2.84%	2	1	93	93	0.01506164496890816	1	1	67	134	0	6	C
H3_BC87_191109_LF_LIB_consensus_vsearch	637	G	G	221	2	0.89%	2	1	93	93	0.24943820224728358	1	1	76	145	2	0	A
H3_BC87_191109_LF_LIB_consensus_vsearch	638	G	G	223	2	0.88%	2	1	93	93	0.24944320712692292	1	1	78	145	0	2	-C
H3_BC87_191109_LF_LIB_consensus_vsearch	639	C	*/-A	202	9	4%	2	2	93	93	0.0017902638323438202	1	1	71	131	3	6	-A
H3_BC87_191109_LF_LIB_consensus_vsearch	640	A	A	200	4	1.88%	2	1	93	93	0.061579761579775204	1	1	72	128	0	4	G
H3_BC87_191109_LF_LIB_consensus_vsearch	641	A	A	215	4	1.79%	2	1	93	93	0.06164286277914926	1	1	80	135	0	4	-G
H3_BC87_191109_LF_LIB_consensus_vsearch	642	G	G	216	2	0.9%	2	1	93	93	0.249425287356441	1	1	77	139	2	0	+AAG
H3_BC87_191109_LF_LIB_consensus_vsearch	643	C	C	217	2	0.88%	2	1	93	93	0.24942791762028085	1	1	78	139	0	2	+A
H3_BC87_191109_LF_LIB_consensus_vsearch	644	A	*/-C	180	26	11.56%	2	2	93	93	6.423415527178768E-9	1	1	76	104	1	25	-C
H3_BC87_191109_LF_LIB_consensus_vsearch	645	C	*/+T	162	19	10.11%	2	1	93	93	1.1591162089448843E-6	1	1	78	84	0	19	+T
H3_BC87_191109_LF_LIB_consensus_vsearch	646	C	C	208	4	1.85%	2	1	93	93	0.06161452805712106	1	1	79	129	0	4	T
H3_BC87_191109_LF_LIB_consensus_vsearch	647	C	Y	205	10	4.37%	2	1	93	93	8.774450793915666E-4	1	1	79	126	0	10	T
H3_BC87_191109_LF_LIB_consensus_vsearch	648	T	T	216	1	0.46%	2	1	93	93	0.4999999999999138	1	1	79	137	0	1	+CTCT
H3_BC87_191109_LF_LIB_consensus_vsearch	649	T	T	216	5	2.2%	2	2	93	93	0.030543804461782422	1	1	76	140	3	2	+C
H3_BC87_191109_LF_LIB_consensus_vsearch	650	C	*/-G	186	25	11.01%	2	2	93	93	1.4004688466474453E-8	1	1	72	114	2	23	-G
H3_BC87_191109_LF_LIB_consensus_vsearch	651	G	R	184	11	5.53%	2	1	93	93	4.223970856632319E-4	1	1	63	121	11	0	A
H3_BC87_191109_LF_LIB_consensus_vsearch	652	G	G	215	5	2.23%	2	1	93	93	0.03054059830172664	1	1	74	141	5	0	A
H3_BC87_191109_LF_LIB_consensus_vsearch	653	G	G	216	5	2.2%	2	2	93	93	0.030543804461782422	1	1	73	143	3	2	A
H3_BC87_191109_LF_LIB_consensus_vsearch	654	G	G	222	3	1.31%	2	1	93	93	0.12416481069040536	1	1	78	144	0	3	-TG
H3_BC87_191109_LF_LIB_consensus_vsearch	655	T	T	212	4	1.79%	2	1	93	93	0.061630944461591126	1	1	80	132	0	4	-G
H3_BC87_191109_LF_LIB_consensus_vsearch	656	G	G	216	1	0.46%	2	1	93	93	0.4999999999999138	1	1	79	137	1	0	+A
H3_BC87_191109_LF_LIB_consensus_vsearch	657	G	G	223	1	0.45%	2	1	93	93	0.5000000000003686	1	1	79	144	1	0	-A
H3_BC87_191109_LF_LIB_consensus_vsearch	658	A	*/+T	207	11	4.82%	2	1	93	93	4.2906952287648286E-4	1	1	78	129	0	11	+T
H3_BC87_191109_LF_LIB_consensus_vsearch	659	C	Y	203	9	4.05%	2	2	93	93	0.0017910143883990014	1	1	74	129	1	8	T
H3_BC87_191109_LF_LIB_consensus_vsearch	660	T	T	200	6	2.68%	2	1	93	93	0.01505892390281567	1	1	76	124	0	6	-G
H3_BC87_191109_LF_LIB_consensus_vsearch	661	G	G	207	5	2.28%	2	2	93	93	0.030513861513988962	1	1	74	133	1	4	-C
H3_BC87_191109_LF_LIB_consensus_vsearch	662	C	C	206	4	1.83%	2	1	93	93	0.06160608506034647	1	1	77	129	0	4	T
H3_BC87_191109_LF_LIB_consensus_vsearch	663	C	C	209	5	2.21%	2	1	93	93	0.030520732883336912	1	1	75	134	0	5	T
H3_BC87_191109_LF_LIB_consensus_vsearch	664	G	G	216	3	1.35%	2	1	93	93	0.12414187643025615	1	1	75	141	3	0	A
H3_BC87_191109_LF_LIB_consensus_vsearch	665	G	G	221	3	1.31%	2	1	93	93	0.12416107382546236	1	1	73	148	3	0	-C
H3_BC87_191109_LF_LIB_consensus_vsearch	666	C	C	223	3	1.33%	2	1	93	93	0.12416851441234596	1	1	77	146	0	3	T
H3_BC87_191109_LF_LIB_consensus_vsearch	667	C	Y	216	7	3.06%	2	2	93	93	0.007447971960236055	1	1	77	139	1	6	T
H3_BC87_191109_LF_LIB_consensus_vsearch	668	G	R	219	7	3.06%	2	2	93	93	0.007452766938834958	1	1	74	145	5	2	A
H3_BC87_191109_LF_LIB_consensus_vsearch	669	G	G	227	1	0.44%	2	1	93	93	0.4999999999999138	1	1	79	148	1	0	A
H3_BC87_191109_LF_LIB_consensus_vsearch	670	C	C	223	2	0.87%	2	2	93	93	0.24944320712692292	1	1	78	145	1	1	-GC
H3_BC87_191109_LF_LIB_consensus_vsearch	671	G	*/-C	183	31	13.78%	2	2	93	93	1.4438723128112539E-10	1	1	42	141	30	1	-C
H3_BC87_191109_LF_LIB_consensus_vsearch	672	C	C	185	4	2.08%	2	1	93	93	0.061506631299724945	1	1	44	141	0	4	+T
H3_BC87_191109_LF_LIB_consensus_vsearch	673	C	C	222	2	0.89%	2	1	93	93	0.24944071588395061	1	1	74	148	2	0	T
H3_BC87_191109_LF_LIB_consensus_vsearch	674	C	*/-T	206	13	5.75%	2	1	93	93	1.016217291023551E-4	1	1	75	131	0	13	-T
H3_BC87_191109_LF_LIB_consensus_vsearch	675	T	*/-A	166	26	12.32%	2	2	93	93	6.014180673907548E-9	1	1	72	94	2	24	-A
H3_BC87_191109_LF_LIB_consensus_vsearch	676	A	M	177	15	7.65%	2	1	93	93	2.2967098326715997E-5	1	1	72	105	0	15	C
H3_BC87_191109_LF_LIB_consensus_vsearch	677	A	A	207	6	2.65%	2	1	93	93	0.015077437453979417	1	1	60	147	6	0	-TGG
H3_BC87_191109_LF_LIB_consensus_vsearch	678	T	*/+C	170	32	14.75%	2	1	93	93	6.138582793783797E-11	1	1	65	105	0	32	+C
H3_BC87_191109_LF_LIB_consensus_vsearch	679	G	R	202	9	4.09%	2	2	93	93	0.0017902638323438202	1	1	62	140	8	1	A
H3_BC87_191109_LF_LIB_consensus_vsearch	680	G	*/+T	200	8	3.62%	2	1	93	93	0.003647458600901869	1	1	62	138	0	8	+T
H3_BC87_191109_LF_LIB_consensus_vsearch	681	C	Y	205	12	5.38%	2	1	93	93	2.0882828978061456E-4	1	1	73	132	0	12	T
H3_BC87_191109_LF_LIB_consensus_vsearch	682	C	Y	189	26	11.45%	2	2	93	93	6.668843736282787E-9	1	1	75	114	1	25	T
H3_BC87_191109_LF_LIB_consensus_vsearch	683	G	G	216	4	1.78%	2	2	93	93	0.061646763238677425	1	1	71	145	2	2	A
H3_BC87_191109_LF_LIB_consensus_vsearch	684	C	Y	204	10	4.37%	2	2	93	93	8.769963348909129E-4	1	1	78	126	1	9	T
H3_BC87_191109_LF_LIB_consensus_vsearch	685	G	G	208	3	1.36%	2	1	93	93	0.12410926365791558	1	1	75	133	3	0	A
H3_BC87_191109_LF_LIB_consensus_vsearch	686	G	G	228	1	0.44%	2	1	93	93	0.4999999999999138	1	1	79	149	1	0	C
H3_BC87_191109_LF_LIB_consensus_vsearch	687	A	*/-C	216	9	3.93%	2	2	93	93	0.0018001779733764346	1	1	78	138	1	8	-C
H3_BC87_191109_LF_LIB_consensus_vsearch	688	C	C	217	1	0.45%	2	1	93	93	0.4999999999999138	1	1	78	139	1	0	+A
H3_BC87_191109_LF_LIB_consensus_vsearch	689	C	*/-T	213	15	6.55%	2	1	93	93	2.4057212275525828E-5	1	1	80	133	0	15	-T
H3_BC87_191109_LF_LIB_consensus_vsearch	690	T	T	211	2	0.93%	2	2	93	93	0.24941176470603904	1	1	79	132	1	1	-C
H3_BC87_191109_LF_LIB_consensus_vsearch	691	C	C	224	1	0.44%	2	1	93	93	0.4999999999999138	1	1	79	145	0	1	+G
H3_BC87_191109_LF_LIB_consensus_vsearch	692	G	G	226	1	0.44%	2	1	93	93	0.4999999999999138	1	1	80	146	0	1	+CAGG
H3_BC87_191109_LF_LIB_consensus_vsearch	693	G	G	225	3	1.31%	2	2	93	93	0.12417582417582212	1	1	77	148	2	1	A
H3_BC87_191109_LF_LIB_consensus_vsearch	694	T	*/-C	211	8	3.51%	2	2	93	93	0.0036602593149509337	1	1	69	142	5	3	-C
H3_BC87_191109_LF_LIB_consensus_vsearch	695	C	C	217	0	0%	2	0	93	0	1.0	1	0	71	146	0	0	
H3_BC87_191109_LF_LIB_consensus_vsearch	696	C	C	225	0	0%	2	0	93	0	1.0	1	0	76	149	0	0	
H3_BC87_191109_LF_LIB_consensus_vsearch	697	C	Y	219	8	3.49%	2	2	93	93	0.0036688013849068284	1	1	79	140	1	7	T
H3_BC87_191109_LF_LIB_consensus_vsearch	698	G	G	221	5	2.2%	2	2	93	93	0.03055941016990272	1	1	76	145	4	1	A
H3_BC87_191109_LF_LIB_consensus_vsearch	699	G	G	227	2	0.87%	2	1	93	93	0.24945295404843976	1	1	78	149	2	0	A
H3_BC87_191109_LF_LIB_consensus_vsearch	700	T	T	226	3	1.31%	2	1	93	93	0.12417943107231426	1	1	80	146	0	3	C
H3_BC87_191109_LF_LIB_consensus_vsearch	701	C	*/-A	212	14	6.11%	2	1	93	93	4.9595092839070994E-5	1	1	64	148	14	0	-A
H3_BC87_191109_LF_LIB_consensus_vsearch	702	A	A	198	6	2.82%	2	1	93	93	0.015053402150168234	1	1	56	142	6	0	+C
H3_BC87_191109_LF_LIB_consensus_vsearch	703	C	S	198	14	6.33%	2	1	93	93	4.8897660884513865E-5	1	1	62	136	14	0	G
H3_BC87_191109_LF_LIB_consensus_vsearch	704	C	C	215	3	1.33%	2	1	93	93	0.12413793103441495	1	1	75	140	0	3	+A
H3_BC87_191109_LF_LIB_consensus_vsearch	705	A	A	213	2	0.91%	2	1	93	93	0.249417249417318	1	1	70	143	2	0	+G
H3_BC87_191109_LF_LIB_consensus_vsearch	706	A	A	214	5	2.22%	2	2	93	93	0.030537362897492103	1	1	68	146	4	1	G
H3_BC87_191109_LF_LIB_consensus_vsearch	707	T	Y	215	8	3.54%	2	2	93	93	0.0036646057936482192	1	1	72	143	4	4	C
H3_BC87_191109_LF_LIB_consensus_vsearch	708	A	*/-C	197	26	11.45%	2	2	93	93	6.876271656890017E-9	1	1	74	123	1	25	-C
H3_BC87_191109_LF_LIB_consensus_vsearch	709	C	C	201	1	0.5%	2	1	93	93	0.4999999999999138	1	1	78	123	0	1	A
H3_BC87_191109_LF_LIB_consensus_vsearch	710	C	*/-TC	197	16	7.02%	2	1	93	93	1.1390278653101552E-5	1	1	79	118	0	16	-TC
H3_BC87_191109_LF_LIB_consensus_vsearch	711	T	*/-C	171	25	12.32%	2	1	93	93	1.3166237659877573E-8	1	1	76	95	0	25	-C
H3_BC87_191109_LF_LIB_consensus_vsearch	712	C	C	176	3	1.6%	2	1	93	93	0.12394957983191404	1	1	77	99	0	3	+T
H3_BC87_191109_LF_LIB_consensus_vsearch	713	G	G	226	1	0.44%	2	1	93	93	0.4999999999999138	1	1	78	148	0	1	+CTG
H3_BC87_191109_LF_LIB_consensus_vsearch	714	A	A	226	1	0.44%	2	1	93	93	0.4999999999999138	1	1	78	148	0	1	C
H3_BC87_191109_LF_LIB_consensus_vsearch	715	A	A	220	2	0.87%	2	1	93	93	0.2494356659142869	1	1	77	143	0	2	-CAAA
H3_BC87_191109_LF_LIB_consensus_vsearch	716	C	*/+A	212	7	3.11%	2	2	93	93	0.00744137624879223	1	1	75	137	1	6	+A
H3_BC87_191109_LF_LIB_consensus_vsearch	717	A	A	220	1	0.45%	2	1	93	93	0.4999999999999138	1	1	77	143	1	0	G
H3_BC87_191109_LF_LIB_consensus_vsearch	718	A	A	224	1	0.44%	2	1	93	93	0.4999999999999138	1	1	77	147	1	0	C
H3_BC87_191109_LF_LIB_consensus_vsearch	719	A	A	220	5	2.2%	2	2	93	93	0.03055634444922604	1	1	76	144	3	2	G
H3_BC87_191109_LF_LIB_consensus_vsearch	720	T	T	223	3	1.32%	2	2	93	93	0.12416851441234596	1	1	77	146	2	1	+A
H3_BC87_191109_LF_LIB_consensus_vsearch	721	G	G	224	1	0.44%	2	1	93	93	0.4999999999999138	1	1	76	148	1	0	+CCAT
H3_BC87_191109_LF_LIB_consensus_vsearch	722	A	A	216	6	2.63%	2	1	93	93	0.015099533131216845	1	1	71	145	6	0	+G
H3_BC87_191109_LF_LIB_consensus_vsearch	723	G	*/+A	211	8	3.51%	2	2	93	93	0.0036602593149509337	1	1	65	146	6	2	+A
H3_BC87_191109_LF_LIB_consensus_vsearch	724	A	A	211	6	2.71%	2	2	93	93	0.015087482939793164	1	1	66	145	5	1	+G
H3_BC87_191109_LF_LIB_consensus_vsearch	725	G	G	220	1	0.45%	2	1	93	93	0.4999999999999138	1	1	75	145	1	0	+AG
H3_BC87_191109_LF_LIB_consensus_vsearch	726	C	C	223	2	0.88%	2	1	93	93	0.24944320712692292	1	1	80	143	0	2	-GC
H3_BC87_191109_LF_LIB_consensus_vsearch	727	G	G	221	3	1.33%	2	2	93	93	0.12416107382546236	1	1	78	143	1	2	A
H3_BC87_191109_LF_LIB_consensus_vsearch	728	C	C	217	4	1.77%	2	1	93	93	0.0616506283607095	1	1	77	140	0	4	T
H3_BC87_191109_LF_LIB_consensus_vsearch	729	A	A	220	1	0.44%	2	1	93	93	0.4999999999999138	1	1	76	144	0	1	+G
H3_BC87_191109_LF_LIB_consensus_vsearch	730	T	T	219	3	1.33%	2	2	93	93	0.12415349887135622	1	1	78	141	1	2	+G
H3_BC87_191109_LF_LIB_consensus_vsearch	731	G	G	221	2	0.87%	2	1	93	93	0.24943820224728358	1	1	75	146	2	0	+A
H3_BC87_191109_LF_LIB_consensus_vsearch	732	A	A	223	3	1.32%	2	2	93	93	0.12416851441234596	1	1	76	147	1	2	-G
H3_BC87_191109_LF_LIB_consensus_vsearch	733	G	G	222	2	0.89%	2	2	93	93	0.24944071588395061	1	1	76	146	1	1	T
H3_BC87_191109_LF_LIB_consensus_vsearch	734	G	G	223	2	0.87%	2	2	93	93	0.24944320712692292	1	1	76	147	1	1	-C
H3_BC87_191109_LF_LIB_consensus_vsearch	735	C	C	218	2	0.88%	2	1	93	93	0.24943052391823226	1	1	73	145	2	0	+G
H3_BC87_191109_LF_LIB_consensus_vsearch	736	A	*/-G	208	7	3.11%	2	2	93	93	0.007434537497224064	1	1	67	141	4	3	-G
H3_BC87_191109_LF_LIB_consensus_vsearch	737	G	G	218	2	0.91%	2	2	93	93	0.24943052391823226	1	1	75	143	1	1	A
H3_BC87_191109_LF_LIB_consensus_vsearch	738	G	G	221	2	0.88%	2	1	93	93	0.24943820224728358	1	1	76	145	0	2	+T
H3_BC87_191109_LF_LIB_consensus_vsearch	739	C	C	209	6	2.64%	2	1	93	93	0.015082506692930204	1	1	75	134	0	6	+T
H3_BC87_191109_LF_LIB_consensus_vsearch	740	T	T	216	2	0.9%	2	1	93	93	0.249425287356441	1	1	75	141	2	0	A
H3_BC87_191109_LF_LIB_consensus_vsearch	741	T	T	216	3	1.32%	2	1	93	93	0.12414187643025615	1	1	77	139	0	3	+CT
H3_BC87_191109_LF_LIB_consensus_vsearch	742	A	A	224	1	0.44%	2	1	93	93	0.4999999999999138	1	1	78	146	1	0	+CA
H3_BC87_191109_LF_LIB_consensus_vsearch	743	T	*/-AT	217	7	3.07%	2	2	93	93	0.007449584424390529	1	1	74	143	4	3	-AT
H3_BC87_191109_LF_LIB_consensus_vsearch	744	A	A	217	2	0.9%	2	2	93	93	0.24942791762028085	1	1	72	145	1	1	G
H3_BC87_191109_LF_LIB_consensus_vsearch	745	T	T	213	4	1.82%	2	1	93	93	0.06163495389099757	1	1	74	139	0	4	+AT
H3_BC87_191109_LF_LIB_consensus_vsearch	746	G	G	221	3	1.32%	2	1	93	93	0.12416107382546236	1	1	74	147	3	0	+C
H3_BC87_191109_LF_LIB_consensus_vsearch	747	C	C	223	1	0.44%	2	1	93	93	0.5000000000003686	1	1	78	145	0	1	+GT
H3_BC87_191109_LF_LIB_consensus_vsearch	748	C	*/-G	218	9	3.93%	2	2	93	93	0.001801496644156972	1	1	76	142	3	6	-G
H3_BC87_191109_LF_LIB_consensus_vsearch	749	G	G	215	1	0.46%	2	1	93	93	0.4999999999999138	1	1	76	139	0	1	+CCG
H3_BC87_191109_LF_LIB_consensus_vsearch	750	G	G	224	2	0.88%	2	1	93	93	0.24944567627499675	1	1	80	144	0	2	+A
H3_BC87_191109_LF_LIB_consensus_vsearch	751	A	A	228	0	0%	2	0	93	0	1.0	1	0	80	148	0	0	
H3_BC87_191109_LF_LIB_consensus_vsearch	752	A	A	228	1	0.44%	2	1	93	93	0.4999999999999138	1	1	80	148	0	1	-T
H3_BC87_191109_LF_LIB_consensus_vsearch	753	T	T	224	4	1.75%	2	2	93	93	0.06167673386217682	1	1	79	145	1	3	C
H3_BC87_191109_LF_LIB_consensus_vsearch	754	C	C	227	1	0.44%	2	1	93	93	0.4999999999999138	1	1	80	147	0	1	-T
H3_BC87_191109_LF_LIB_consensus_vsearch	755	T	T	222	4	1.75%	2	2	93	93	0.061669440342892484	1	1	77	145	1	3	C
H3_BC87_191109_LF_LIB_consensus_vsearch	756	A	A	222	2	0.88%	2	1	93	93	0.24944071588395061	1	1	77	145	0	2	G
H3_BC87_191109_LF_LIB_consensus_vsearch	757	T	T	223	2	0.88%	2	2	93	93	0.24944320712692292	1	1	77	146	1	1	A
H3_BC87_191109_LF_LIB_consensus_vsearch	758	T	T	226	1	0.44%	2	1	93	93	0.4999999999999138	1	1	78	148	1	0	+AAT
H3_BC87_191109_LF_LIB_consensus_vsearch	759	A	A	222	3	1.32%	2	1	93	93	0.12416481069040536	1	1	78	144	0	3	-G
H3_BC87_191109_LF_LIB_consensus_vsearch	760	G	G	222	2	0.89%	2	1	93	93	0.24944071588395061	1	1	78	144	2	0	A
H3_BC87_191109_LF_LIB_consensus_vsearch	761	C	C	224	1	0.44%	2	1	93	93	0.4999999999999138	1	1	80	144	0	1	+A
H3_BC87_191109_LF_LIB_consensus_vsearch	762	A	A	226	1	0.44%	2	1	93	93	0.4999999999999138	1	1	79	147	1	0	+GC
H3_BC87_191109_LF_LIB_consensus_vsearch	763	T	T	220	3	1.32%	2	1	93	93	0.12415730337075404	1	1	79	141	0	3	-G
H3_BC87_191109_LF_LIB_consensus_vsearch	764	G	G	223	1	0.44%	2	1	93	93	0.5000000000003686	1	1	79	144	1	0	+CA
H3_BC87_191109_LF_LIB_consensus_vsearch	765	G	G	225	2	0.88%	2	2	93	93	0.24944812362040697	1	1	79	146	1	1	-A
H3_BC87_191109_LF_LIB_consensus_vsearch	766	A	A	224	1	0.44%	2	1	93	93	0.4999999999999138	1	1	78	146	1	0	+G
H3_BC87_191109_LF_LIB_consensus_vsearch	767	A	A	221	3	1.32%	2	2	93	93	0.12416107382546236	1	1	78	143	1	2	-T
H3_BC87_191109_LF_LIB_consensus_vsearch	768	T	T	211	5	2.23%	2	1	93	93	0.030527477163211258	1	1	78	133	0	5	-AAC
H3_BC87_191109_LF_LIB_consensus_vsearch	769	A	A	213	5	2.28%	2	1	93	93	0.030534097847134272	1	1	79	134	0	5	G
H3_BC87_191109_LF_LIB_consensus_vsearch	770	A	A	211	4	1.81%	2	2	93	93	0.06162689769249	1	1	77	134	2	2	G
H3_BC87_191109_LF_LIB_consensus_vsearch	771	C	C	211	4	1.8%	2	1	93	93	0.06162689769249	1	1	80	131	0	4	G
H3_BC87_191109_LF_LIB_consensus_vsearch	772	A	*/-CA	201	13	5.75%	2	2	93	93	1.0117417827629507E-4	1	1	71	130	8	5	-CA
H3_BC87_191109_LF_LIB_consensus_vsearch	773	C	Y	199	13	6.07%	2	1	93	93	1.0098964132434686E-4	1	1	72	127	0	13	T
H3_BC87_191109_LF_LIB_consensus_vsearch	774	A	A	203	4	1.88%	2	2	93	93	0.06159311429633927	1	1	70	133	1	3	G
H3_BC87_191109_LF_LIB_consensus_vsearch	775	T	*/-G	202	10	4.48%	2	2	93	93	8.760865562530377E-4	1	1	78	124	1	9	-G
H3_BC87_191109_LF_LIB_consensus_vsearch	776	G	G	207	3	1.4%	2	1	93	93	0.12410501193315207	1	1	79	128	0	3	+TG
H3_BC87_191109_LF_LIB_consensus_vsearch	777	G	G	227	1	0.44%	2	1	93	93	0.4999999999999138	1	1	80	147	0	1	C
H3_BC87_191109_LF_LIB_consensus_vsearch	778	A	A	226	2	0.87%	2	2	93	93	0.24945054945064127	1	1	78	148	1	1	-C
H3_BC87_191109_LF_LIB_consensus_vsearch	779	C	C	224	1	0.44%	2	1	93	93	0.4999999999999138	1	1	79	145	0	1	+AC
H3_BC87_191109_LF_LIB_consensus_vsearch	780	C	Y	218	7	3.06%	2	1	93	93	0.007451182688346346	1	1	79	139	0	7	T
H3_BC87_191109_LF_LIB_consensus_vsearch	781	G	G	224	1	0.44%	2	1	93	93	0.4999999999999138	1	1	78	146	1	0	+CCGG
H3_BC87_191109_LF_LIB_consensus_vsearch	782	C	C	221	3	1.32%	2	1	93	93	0.12416107382546236	1	1	80	141	0	3	+A
H3_BC87_191109_LF_LIB_consensus_vsearch	783	A	A	225	2	0.88%	2	1	93	93	0.24944812362040697	1	1	79	146	0	2	G
H3_BC87_191109_LF_LIB_consensus_vsearch	784	G	G	223	1	0.44%	2	1	93	93	0.5000000000003686	1	1	78	145	1	0	+A
H3_BC87_191109_LF_LIB_consensus_vsearch	785	C	C	213	5	2.21%	2	2	93	93	0.030534097847134272	1	1	74	139	2	3	+T
H3_BC87_191109_LF_LIB_consensus_vsearch	786	G	G	220	3	1.32%	2	2	93	93	0.12415730337075404	1	1	76	144	1	2	+A
H3_BC87_191109_LF_LIB_consensus_vsearch	787	T	T	221	3	1.32%	2	2	93	93	0.12416107382546236	1	1	76	145	2	1	C
H3_BC87_191109_LF_LIB_consensus_vsearch	788	C	C	220	5	2.19%	2	1	93	93	0.03055634444922604	1	1	78	142	0	5	-T
H3_BC87_191109_LF_LIB_consensus_vsearch	789	T	T	219	3	1.35%	2	1	93	93	0.12415349887135622	1	1	78	141	0	3	C
H3_BC87_191109_LF_LIB_consensus_vsearch	790	T	T	218	4	1.76%	2	2	93	93	0.061654458623218986	1	1	77	141	1	3	C
H3_BC87_191109_LF_LIB_consensus_vsearch	791	G	G	222	3	1.31%	2	1	93	93	0.12416481069040536	1	1	76	146	3	0	+T
H3_BC87_191109_LF_LIB_consensus_vsearch	792	T	Y	220	7	3.07%	2	2	93	93	0.007454337359329176	1	1	79	141	1	6	C
H3_BC87_191109_LF_LIB_consensus_vsearch	793	T	T	224	2	0.88%	2	2	93	93	0.24944567627499675	1	1	79	145	1	1	C
H3_BC87_191109_LF_LIB_consensus_vsearch	794	G	G	223	2	0.88%	2	2	93	93	0.24944320712692292	1	1	77	146	1	1	A
H3_BC87_191109_LF_LIB_consensus_vsearch	795	T	Y	216	7	3.1%	2	2	93	93	0.007447971960236055	1	1	76	140	1	6	C
H3_BC87_191109_LF_LIB_consensus_vsearch	796	T	T	223	2	0.88%	2	1	93	93	0.24944320712692292	1	1	79	144	0	2	-G
H3_BC87_191109_LF_LIB_consensus_vsearch	797	G	R	215	7	3.11%	2	1	93	93	0.007446345105805389	1	1	71	144	7	0	A
H3_BC87_191109_LF_LIB_consensus_vsearch	798	G	G	221	4	1.75%	2	2	93	93	0.06166574490670126	1	1	77	144	1	3	A
H3_BC87_191109_LF_LIB_consensus_vsearch	799	T	T	226	2	0.88%	2	1	93	93	0.24945054945064127	1	1	79	147	0	2	C
H3_BC87_191109_LF_LIB_consensus_vsearch	800	T	T	220	3	1.31%	2	2	93	93	0.12415730337075404	1	1	74	146	2	1	+A
H3_BC87_191109_LF_LIB_consensus_vsearch	801	A	A	223	3	1.33%	2	2	93	93	0.12416851441234596	1	1	76	147	1	2	G
H3_BC87_191109_LF_LIB_consensus_vsearch	802	A	A	226	1	0.44%	2	1	93	93	0.4999999999999138	1	1	78	148	0	1	G
H3_BC87_191109_LF_LIB_consensus_vsearch	803	A	A	222	3	1.32%	2	2	93	93	0.12416481069040536	1	1	75	147	1	2	G
H3_BC87_191109_LF_LIB_consensus_vsearch	804	G	G	223	3	1.32%	2	2	93	93	0.12416851441234596	1	1	76	147	1	2	+C
H3_BC87_191109_LF_LIB_consensus_vsearch	805	A	A	224	2	0.88%	2	1	93	93	0.24944567627499675	1	1	76	148	2	0	G
H3_BC87_191109_LF_LIB_consensus_vsearch	806	C	C	223	4	1.75%	2	2	93	93	0.061673103185009646	1	1	78	145	1	3	T
H3_BC87_191109_LF_LIB_consensus_vsearch	807	G	G	223	3	1.32%	2	2	93	93	0.12416851441234596	1	1	76	147	2	1	-A
H3_BC87_191109_LF_LIB_consensus_vsearch	808	A	A	219	2	0.89%	2	2	93	93	0.24943310657599216	1	1	75	144	1	1	-T
H3_BC87_191109_LF_LIB_consensus_vsearch	809	T	T	222	3	1.33%	2	1	93	93	0.12416481069040536	1	1	78	144	0	3	C
H3_BC87_191109_LF_LIB_consensus_vsearch	810	G	*/-CA	212	12	5.26%	2	1	93	93	2.0987757342671282E-4	1	1	76	136	0	12	-CA
H3_BC87_191109_LF_LIB_consensus_vsearch	811	C	C	211	1	0.47%	2	1	93	93	0.5000000000001412	1	1	77	134	1	0	+G
H3_BC87_191109_LF_LIB_consensus_vsearch	812	A	A	207	2	0.93%	2	1	93	93	0.24940047961641743	1	1	78	129	0	2	-GTA
H3_BC87_191109_LF_LIB_consensus_vsearch	813	G	G	222	1	0.45%	2	1	93	93	0.4999999999999138	1	1	79	143	0	1	-T
H3_BC87_191109_LF_LIB_consensus_vsearch	814	T	T	211	6	2.7%	2	1	93	93	0.015087482939793164	1	1	78	133	0	6	C
H3_BC87_191109_LF_LIB_consensus_vsearch	815	A	A	220	0	0%	2	0	93	0	1.0	1	0	80	140	0	0	
H3_BC87_191109_LF_LIB_consensus_vsearch	816	A	A	224	1	0.44%	2	1	93	93	0.4999999999999138	1	1	79	145	1	0	+CT
H3_BC87_191109_LF_LIB_consensus_vsearch	817	T	Y	218	7	3.07%	2	1	93	93	0.007451182688346346	1	1	79	139	0	7	C
H3_BC87_191109_LF_LIB_consensus_vsearch	818	G	G	226	1	0.44%	2	1	93	93	0.4999999999999138	1	1	79	147	0	1	C
H3_BC87_191109_LF_LIB_consensus_vsearch	819	A	A	223	2	0.88%	2	2	93	93	0.24944320712692292	1	1	78	145	1	1	G
H3_BC87_191109_LF_LIB_consensus_vsearch	820	T	T	224	1	0.44%	2	1	93	93	0.4999999999999138	1	1	76	148	1	0	+CT
H3_BC87_191109_LF_LIB_consensus_vsearch	821	T	T	220	3	1.32%	2	2	93	93	0.12415730337075404	1	1	78	142	1	2	-A
H3_BC87_191109_LF_LIB_consensus_vsearch	822	A	A	218	1	0.45%	2	1	93	93	0.5000000000003686	1	1	77	141	0	1	+CT
H3_BC87_191109_LF_LIB_consensus_vsearch	823	A	A	220	2	0.89%	2	1	93	93	0.2494356659142869	1	1	78	142	0	2	T
H3_BC87_191109_LF_LIB_consensus_vsearch	824	C	C	209	4	1.78%	2	2	93	93	0.061618690029214815	1	1	70	139	3	1	+G
H3_BC87_191109_LF_LIB_consensus_vsearch	825	A	*/-G	151	45	20%	2	2	93	93	1.632971616755616E-15	1	1	58	93	17	28	-G
H3_BC87_191109_LF_LIB_consensus_vsearch	826	G	G	156	4	2.42%	2	1	93	93	0.061326305588268425	1	1	53	103	4	0	A
H3_BC87_191109_LF_LIB_consensus_vsearch	827	G	R	201	9	4.27%	2	2	93	93	0.0017895062981052791	1	1	70	131	8	1	A
H3_BC87_191109_LF_LIB_consensus_vsearch	828	G	G	213	4	1.78%	2	2	93	93	0.06163495389099757	1	1	70	143	3	1	A
H3_BC87_191109_LF_LIB_consensus_vsearch	829	G	G	220	5	2.19%	2	1	93	93	0.03055634444922604	1	1	75	145	5	0	T
H3_BC87_191109_LF_LIB_consensus_vsearch	830	T	T	219	4	1.75%	2	1	93	93	0.06165825449566743	1	1	78	141	0	4	C
H3_BC87_191109_LF_LIB_consensus_vsearch	831	A	A	220	2	0.89%	2	1	93	93	0.2494356659142869	1	1	76	144	0	2	-C
H3_BC87_191109_LF_LIB_consensus_vsearch	832	C	*/+T	204	10	4.42%	2	1	93	93	8.769963348909129E-4	1	1	78	126	0	10	+T
H3_BC87_191109_LF_LIB_consensus_vsearch	833	T	*/-C	138	54	24.66%	2	1	93	93	7.172591258849004E-19	1	1	70	68	0	54	-C
H3_BC87_191109_LF_LIB_consensus_vsearch	834	C	*/-G	126	10	6.45%	2	2	93	93	8.226850700552499E-4	1	1	70	56	2	8	-G
H3_BC87_191109_LF_LIB_consensus_vsearch	835	G	R	179	11	5.7%	2	2	93	93	4.2074294006989865E-4	1	1	67	112	9	2	A
H3_BC87_191109_LF_LIB_consensus_vsearch	836	G	R	205	11	5.05%	2	2	93	93	4.285433624407098E-4	1	1	73	132	7	4	A
H3_BC87_191109_LF_LIB_consensus_vsearch	837	G	R	215	10	4.41%	2	1	93	93	8.817198236951184E-4	1	1	78	137	0	10	A
H3_BC87_191109_LF_LIB_consensus_vsearch	838	G	R	219	7	3.07%	2	1	93	93	0.007452766938834958	1	1	78	141	0	7	A
H3_BC87_191109_LF_LIB_consensus_vsearch	839	C	C	221	6	2.63%	2	1	93	93	0.015111054918444918	1	1	79	142	0	6	A
H3_BC87_191109_LF_LIB_consensus_vsearch	840	C	C	214	6	2.62%	2	1	93	93	0.015094778470947015	1	1	78	136	0	6	+A
H3_BC87_191109_LF_LIB_consensus_vsearch	841	A	A	228	1	0.44%	2	1	93	93	0.4999999999999138	1	1	79	149	1	0	G
H3_BC87_191109_LF_LIB_consensus_vsearch	842	A	A	218	5	2.18%	2	1	93	93	0.030550130621104243	1	1	74	144	5	0	G
H3_BC87_191109_LF_LIB_consensus_vsearch	843	C	C	224	1	0.44%	2	1	93	93	0.4999999999999138	1	1	80	144	0	1	+T
H3_BC87_191109_LF_LIB_consensus_vsearch	844	C	C	214	6	2.62%	2	1	93	93	0.015094778470947015	1	1	77	137	0	6	T
H3_BC87_191109_LF_LIB_consensus_vsearch	845	G	G	215	4	1.77%	2	2	93	93	0.06164286277914926	1	1	74	141	3	1	A
H3_BC87_191109_LF_LIB_consensus_vsearch	846	T	T	219	6	2.65%	2	2	93	93	0.015106507368173285	1	1	76	143	3	3	C
H3_BC87_191109_LF_LIB_consensus_vsearch	847	A	A	221	4	1.75%	2	1	93	93	0.06166574490670126	1	1	75	146	4	0	G
H3_BC87_191109_LF_LIB_consensus_vsearch	848	C	*/-T	193	35	15.28%	2	1	93	93	7.082780409997741E-12	1	1	80	113	0	35	-T
H3_BC87_191109_LF_LIB_consensus_vsearch	849	T	T	184	4	2.06%	2	1	93	93	0.06150134048256699	1	1	79	105	0	4	-C
H3_BC87_191109_LF_LIB_consensus_vsearch	850	C	C	218	4	1.79%	2	2	93	93	0.061654458623218986	1	1	79	139	1	3	-T
H3_BC87_191109_LF_LIB_consensus_vsearch	851	T	T	205	5	2.25%	2	2	93	93	0.03050685942891605	1	1	76	129	1	4	-G
H3_BC87_191109_LF_LIB_consensus_vsearch	852	G	G	219	1	0.45%	2	1	93	93	0.4999999999999138	1	1	77	142	1	0	+CA
H3_BC87_191109_LF_LIB_consensus_vsearch	853	G	G	225	1	0.44%	2	1	93	93	0.5000000000003686	1	1	80	145	0	1	T
H3_BC87_191109_LF_LIB_consensus_vsearch	854	G	G	225	2	0.88%	2	1	93	93	0.24944812362040697	1	1	79	146	0	2	A
H3_BC87_191109_LF_LIB_consensus_vsearch	855	G	G	223	2	0.88%	2	1	93	93	0.24944320712692292	1	1	77	146	2	0	+C
H3_BC87_191109_LF_LIB_consensus_vsearch	856	C	Y	219	7	3.08%	2	2	93	93	0.007452766938834958	1	1	79	140	1	6	T
H3_BC87_191109_LF_LIB_consensus_vsearch	857	T	Y	207	10	4.39%	2	2	93	93	8.783305527122537E-4	1	1	70	137	1	9	C
H3_BC87_191109_LF_LIB_consensus_vsearch	858	A	*/+G	88	90	40.36%	2	2	93	93	1.7869494508001354E-34	1	1	42	46	27	63	+G
H3_BC87_191109_LF_LIB_consensus_vsearch	859	G	G	189	2	1.04%	2	2	93	93	0.24934383202100482	1	1	72	117	1	1	A
H3_BC87_191109_LF_LIB_consensus_vsearch	860	G	G	206	1	0.48%	2	1	93	93	0.5000000000001412	1	1	79	127	1	0	+A
H3_BC87_191109_LF_LIB_consensus_vsearch	861	G	G	221	4	1.75%	2	1	93	93	0.06166574490670126	1	1	79	142	0	4	-T
H3_BC87_191109_LF_LIB_consensus_vsearch	862	T	T	216	2	0.9%	2	1	93	93	0.249425287356441	1	1	79	137	0	2	-G
H3_BC87_191109_LF_LIB_consensus_vsearch	863	G	*/-A	210	8	3.57%	2	2	93	93	0.0036591481612605	1	1	76	134	1	7	-A
H3_BC87_191109_LF_LIB_consensus_vsearch	864	A	A	215	4	1.82%	2	2	93	93	0.06164286277914926	1	1	77	138	1	3	G
H3_BC87_191109_LF_LIB_consensus_vsearch	865	A	A	225	1	0.44%	2	1	93	93	0.5000000000003686	1	1	76	149	1	0	+TTT
H3_BC87_191109_LF_LIB_consensus_vsearch	866	A	*/-T	203	17	7.46%	2	1	93	93	5.533354906074952E-6	1	1	77	126	0	17	-T
H3_BC87_191109_LF_LIB_consensus_vsearch	867	T	*/-C	194	12	5.74%	2	2	93	93	2.070433166935576E-4	1	1	71	123	9	3	-C
H3_BC87_191109_LF_LIB_consensus_vsearch	868	C	C	213	1	0.47%	2	1	93	93	0.4999999999999138	1	1	70	143	1	0	G
H3_BC87_191109_LF_LIB_consensus_vsearch	869	C	*/-T	194	22	9.61%	2	1	93	93	1.357809470111312E-7	1	1	77	117	0	22	-T
H3_BC87_191109_LF_LIB_consensus_vsearch	870	T	Y	186	9	4.37%	2	1	93	93	0.0017772348172719874	1	1	79	107	0	9	C
H3_BC87_191109_LF_LIB_consensus_vsearch	871	G	S	187	26	11.56%	2	1	93	93	6.615436669138533E-9	1	1	74	113	0	26	C
H3_BC87_191109_LF_LIB_consensus_vsearch	872	T	W	187	29	13.18%	2	2	93	93	6.804270394596609E-10	1	1	75	112	1	28	A
H3_BC87_191109_LF_LIB_consensus_vsearch	873	G	G	218	2	0.91%	2	2	93	93	0.24943052391823226	1	1	77	141	1	1	-A
H3_BC87_191109_LF_LIB_consensus_vsearch	874	A	*/-C	178	43	18.94%	2	2	93	93	1.1808782212272701E-14	1	1	76	102	1	42	-C
H3_BC87_191109_LF_LIB_consensus_vsearch	875	C	C	183	1	0.54%	2	1	93	93	0.4999999999999138	1	1	79	104	0	1	A
H3_BC87_191109_LF_LIB_consensus_vsearch	876	C	C	225	1	0.44%	2	1	93	93	0.5000000000003686	1	1	80	145	0	1	A
H3_BC87_191109_LF_LIB_consensus_vsearch	877	C	C	220	4	1.75%	2	1	93	93	0.061662016439223415	1	1	79	141	0	4	-T
H3_BC87_191109_LF_LIB_consensus_vsearch	878	T	T	213	4	1.81%	2	1	93	93	0.06163495389099757	1	1	77	136	0	4	C
H3_BC87_191109_LF_LIB_consensus_vsearch	879	C	C	214	5	2.23%	2	2	93	93	0.030537362897492103	1	1	75	139	4	1	-A
H3_BC87_191109_LF_LIB_consensus_vsearch	880	A	A	219	3	1.34%	2	1	93	93	0.12415349887135622	1	1	74	145	0	3	T
H3_BC87_191109_LF_LIB_consensus_vsearch	881	G	G	220	3	1.31%	2	1	93	93	0.12415730337075404	1	1	77	143	0	3	-AAG
H3_BC87_191109_LF_LIB_consensus_vsearch	882	A	A	217	3	1.35%	2	2	93	93	0.12414578587710072	1	1	73	144	2	1	G
H3_BC87_191109_LF_LIB_consensus_vsearch	883	A	A	220	2	0.89%	2	1	93	93	0.2494356659142869	1	1	75	145	2	0	G
H3_BC87_191109_LF_LIB_consensus_vsearch	884	G	G	221	2	0.89%	2	1	93	93	0.24943820224728358	1	1	75	146	2	0	-A
H3_BC87_191109_LF_LIB_consensus_vsearch	885	A	A	223	3	1.33%	2	1	93	93	0.12416851441234596	1	1	74	149	3	0	G
H3_BC87_191109_LF_LIB_consensus_vsearch	886	C	C	218	4	1.75%	2	2	93	93	0.061654458623218986	1	1	75	143	2	2	-GAC
H3_BC87_191109_LF_LIB_consensus_vsearch	887	G	G	221	1	0.45%	2	1	93	93	0.4999999999999138	1	1	76	145	1	0	-A
H3_BC87_191109_LF_LIB_consensus_vsearch	888	A	A	213	4	1.79%	2	1	93	93	0.06163495389099757	1	1	69	144	4	0	-C
H3_BC87_191109_LF_LIB_consensus_vsearch	889	C	C	215	3	1.37%	2	1	93	93	0.12413793103441495	1	1	71	144	0	3	+T
H3_BC87_191109_LF_LIB_consensus_vsearch	890	C	C	218	4	1.76%	2	2	93	93	0.061654458623218986	1	1	77	141	1	3	-T
H3_BC87_191109_LF_LIB_consensus_vsearch	891	T	T	213	6	2.68%	2	2	93	93	0.0150923687299321	1	1	77	136	1	5	C
H3_BC87_191109_LF_LIB_consensus_vsearch	892	A	A	223	2	0.88%	2	1	93	93	0.24944320712692292	1	1	79	144	0	2	C
H3_BC87_191109_LF_LIB_consensus_vsearch	893	A	A	224	3	1.31%	2	2	93	93	0.12417218543044797	1	1	79	145	1	2	G
H3_BC87_191109_LF_LIB_consensus_vsearch	894	T	T	224	2	0.88%	2	1	93	93	0.24944567627499675	1	1	80	144	0	2	C
H3_BC87_191109_LF_LIB_consensus_vsearch	895	G	G	225	2	0.88%	2	1	93	93	0.24944812362040697	1	1	80	145	0	2	-CG
H3_BC87_191109_LF_LIB_consensus_vsearch	896	C	C	208	6	2.64%	2	1	93	93	0.015079983859610983	1	1	66	142	6	0	+A
H3_BC87_191109_LF_LIB_consensus_vsearch	897	G	*/-A	200	7	3.26%	2	2	93	93	0.007420075094973923	1	1	65	135	5	2	-A
H3_BC87_191109_LF_LIB_consensus_vsearch	898	A	A	208	1	0.48%	2	1	93	93	0.5000000000001412	1	1	67	141	0	1	+G
H3_BC87_191109_LF_LIB_consensus_vsearch	899	A	A	216	2	0.91%	2	1	93	93	0.249425287356441	1	1	74	142	0	2	C
H3_BC87_191109_LF_LIB_consensus_vsearch	900	A	A	223	4	1.75%	2	1	93	93	0.061673103185009646	1	1	75	148	4	0	-G
H3_BC87_191109_LF_LIB_consensus_vsearch	901	G	G	222	2	0.89%	2	1	93	93	0.24944071588395061	1	1	76	146	0	2	+T
H3_BC87_191109_LF_LIB_consensus_vsearch	902	C	C	215	5	2.18%	2	1	93	93	0.03054059830172664	1	1	73	142	5	0	+G
H3_BC87_191109_LF_LIB_consensus_vsearch	903	A	*/-G	214	9	3.93%	2	2	93	93	0.0017988361772468277	1	1	72	142	5	4	-G
H3_BC87_191109_LF_LIB_consensus_vsearch	904	G	G	212	2	0.91%	2	1	93	93	0.24941451990645544	1	1	72	140	2	0	+A
H3_BC87_191109_LF_LIB_consensus_vsearch	905	T	Y	214	11	4.85%	2	1	93	93	4.308403683968055E-4	1	1	80	134	0	11	C
H3_BC87_191109_LF_LIB_consensus_vsearch	906	T	T	215	4	1.75%	2	2	93	93	0.06164286277914926	1	1	77	138	1	3	-GGC
H3_BC87_191109_LF_LIB_consensus_vsearch	907	G	G	218	3	1.35%	2	2	93	93	0.12414965986396012	1	1	78	140	1	2	A
H3_BC87_191109_LF_LIB_consensus_vsearch	908	G	*/+C	208	10	4.46%	2	1	93	93	8.787673881990181E-4	1	1	79	129	0	10	+C
H3_BC87_191109_LF_LIB_consensus_vsearch	909	C	+T/+T	36	173	76.89%	2	2	93	93	6.963610417261483E-82	1	1	19	17	50	123	+T
H3_BC87_191109_LF_LIB_consensus_vsearch	910	A	*/-G	125	74	33.18%	2	2	93	93	1.194941946598748E-26	1	1	48	77	8	66	-G
H3_BC87_191109_LF_LIB_consensus_vsearch	911	G	*/+A	129	11	7.14%	2	1	93	93	3.9812224138320313E-4	1	1	50	79	11	0	+A
H3_BC87_191109_LF_LIB_consensus_vsearch	912	G	R	200	14	6.14%	2	2	93	93	4.9002433333818565E-5	1	1	54	146	12	2	A
H3_BC87_191109_LF_LIB_consensus_vsearch	913	G	G	215	6	2.62%	2	2	93	93	0.01509716650743782	1	1	70	145	4	2	A
H3_BC87_191109_LF_LIB_consensus_vsearch	914	T	T	219	5	2.19%	2	2	93	93	0.030553251388732716	1	1	76	143	1	4	C
H3_BC87_191109_LF_LIB_consensus_vsearch	915	A	A	220	3	1.32%	2	1	93	93	0.12415730337075404	1	1	74	146	3	0	G
H3_BC87_191109_LF_LIB_consensus_vsearch	916	C	*/-T	209	8	3.52%	2	1	93	93	0.003658026926953576	1	1	76	133	0	8	-T
H3_BC87_191109_LF_LIB_consensus_vsearch	917	T	T	214	3	1.38%	2	2	93	93	0.12413394919162732	1	1	76	138	2	1	C
H3_BC87_191109_LF_LIB_consensus_vsearch	918	T	T	222	1	0.44%	2	1	93	93	0.4999999999999138	1	1	77	145	0	1	+C
H3_BC87_191109_LF_LIB_consensus_vsearch	919	T	T	218	6	2.64%	2	1	93	93	0.015104203282490625	1	1	79	139	0	6	A
H3_BC87_191109_LF_LIB_consensus_vsearch	920	C	C	213	4	1.77%	2	1	93	93	0.06163495389099757	1	1	77	136	0	4	-AT
H3_BC87_191109_LF_LIB_consensus_vsearch	921	A	A	212	3	1.36%	2	2	93	93	0.1241258741259166	1	1	74	138	2	1	+T
H3_BC87_191109_LF_LIB_consensus_vsearch	922	T	T	213	2	0.91%	2	2	93	93	0.249417249417318	1	1	76	137	1	1	+G
H3_BC87_191109_LF_LIB_consensus_vsearch	923	T	T	221	3	1.32%	2	2	93	93	0.12416107382546236	1	1	79	142	1	2	C
H3_BC87_191109_LF_LIB_consensus_vsearch	924	G	G	226	1	0.44%	2	1	93	93	0.4999999999999138	1	1	80	146	0	1	+CATTAG
H3_BC87_191109_LF_LIB_consensus_vsearch	925	A	A	225	2	0.87%	2	2	93	93	0.24944812362040697	1	1	79	146	1	1	G
H3_BC87_191109_LF_LIB_consensus_vsearch	926	T	T	226	1	0.44%	2	1	93	93	0.4999999999999138	1	1	79	147	1	0	+C
H3_BC87_191109_LF_LIB_consensus_vsearch	927	C	*/-A	206	18	7.86%	2	2	93	93	2.6734324964115575E-6	1	1	76	130	2	16	-A
H3_BC87_191109_LF_LIB_consensus_vsearch	928	A	A	201	3	1.44%	2	2	93	93	0.12407862407864012	1	1	76	125	1	2	G
H3_BC87_191109_LF_LIB_consensus_vsearch	929	A	*/-G	199	18	7.96%	2	1	93	93	2.641658197446781E-6	1	1	77	122	0	18	-G
H3_BC87_191109_LF_LIB_consensus_vsearch	930	G	G	205	1	0.48%	2	1	93	93	0.5000000000001412	1	1	79	126	0	1	+T
H3_BC87_191109_LF_LIB_consensus_vsearch	931	C	C	213	2	0.88%	2	1	93	93	0.249417249417318	1	1	73	140	0	2	+A
H3_BC87_191109_LF_LIB_consensus_vsearch	932	A	A	220	2	0.89%	2	1	93	93	0.2494356659142869	1	1	75	145	0	2	-CG
H3_BC87_191109_LF_LIB_consensus_vsearch	933	C	Y	207	10	4.44%	2	2	93	93	8.783305527122537E-4	1	1	73	134	3	7	T
H3_BC87_191109_LF_LIB_consensus_vsearch	934	G	G	219	3	1.32%	2	1	93	93	0.12415349887135622	1	1	77	142	0	3	T
H3_BC87_191109_LF_LIB_consensus_vsearch	935	A	A	218	2	0.89%	2	1	93	93	0.24943052391823226	1	1	75	143	2	0	+GA
H3_BC87_191109_LF_LIB_consensus_vsearch	936	A	*/-G	210	9	3.98%	2	2	93	93	0.0017960807336148846	1	1	74	136	4	5	-G
H3_BC87_191109_LF_LIB_consensus_vsearch	937	G	G	213	3	1.37%	2	1	93	93	0.12412993039444345	1	1	71	142	3	0	+A
H3_BC87_191109_LF_LIB_consensus_vsearch	938	G	G	225	2	0.88%	2	1	93	93	0.24944812362040697	1	1	79	146	0	2	T
H3_BC87_191109_LF_LIB_consensus_vsearch	939	G	G	225	1	0.44%	2	1	93	93	0.5000000000003686	1	1	78	147	0	1	+C
H3_BC87_191109_LF_LIB_consensus_vsearch	940	T	*/-G	106	87	38.16%	2	2	93	93	2.0307930320628565E-32	1	1	42	64	19	68	-G
H3_BC87_191109_LF_LIB_consensus_vsearch	941	G	G	115	1	0.85%	2	1	93	93	0.4999999999999138	1	1	41	74	1	0	+A
H3_BC87_191109_LF_LIB_consensus_vsearch	942	G	G	200	1	0.49%	2	1	93	93	0.4999999999999138	1	1	58	142	0	1	+T
H3_BC87_191109_LF_LIB_consensus_vsearch	943	G	G	224	3	1.32%	2	2	93	93	0.12417218543044797	1	1	78	146	2	1	A
H3_BC87_191109_LF_LIB_consensus_vsearch	944	G	G	227	1	0.44%	2	1	93	93	0.4999999999999138	1	1	79	148	0	1	+A
H3_BC87_191109_LF_LIB_consensus_vsearch	945	G	*/-AG	216	7	3.06%	2	2	93	93	0.007447971960236055	1	1	72	144	4	3	-AG
H3_BC87_191109_LF_LIB_consensus_vsearch	946	A	A	211	3	1.38%	2	2	93	93	0.12412177985949331	1	1	69	142	2	1	G
H3_BC87_191109_LF_LIB_consensus_vsearch	947	G	*/+T	186	16	7.31%	2	1	93	93	1.1203138488426297E-5	1	1	75	111	0	16	+T
H3_BC87_191109_LF_LIB_consensus_vsearch	948	C	*/-A	163	21	9.86%	2	2	93	93	2.6047553881865885E-7	1	1	69	94	8	13	-A
H3_BC87_191109_LF_LIB_consensus_vsearch	949	A	A	190	3	1.53%	2	1	93	93	0.12402597402595401	1	1	71	119	0	3	+G
H3_BC87_191109_LF_LIB_consensus_vsearch	950	A	A	222	2	0.88%	2	1	93	93	0.24944071588395061	1	1	75	147	2	0	G
H3_BC87_191109_LF_LIB_consensus_vsearch	951	A	A	221	3	1.32%	2	2	93	93	0.12416107382546236	1	1	76	145	2	1	G
H3_BC87_191109_LF_LIB_consensus_vsearch	952	G	G	221	1	0.44%	2	1	93	93	0.4999999999999138	1	1	76	145	1	0	+A
H3_BC87_191109_LF_LIB_consensus_vsearch	953	A	A	221	2	0.88%	2	1	93	93	0.24943820224728358	1	1	77	144	0	2	-CGA
H3_BC87_191109_LF_LIB_consensus_vsearch	954	C	Y	219	8	3.52%	2	1	93	93	0.0036688013849068284	1	1	80	139	0	8	T
H3_BC87_191109_LF_LIB_consensus_vsearch	955	G	G	225	1	0.44%	2	1	93	93	0.5000000000003686	1	1	79	146	0	1	-ATT
H3_BC87_191109_LF_LIB_consensus_vsearch	956	A	A	219	5	2.21%	2	1	93	93	0.030553251388732716	1	1	78	141	0	5	-T
H3_BC87_191109_LF_LIB_consensus_vsearch	957	T	T	222	1	0.45%	2	1	93	93	0.4999999999999138	1	1	79	143	1	0	+G
H3_BC87_191109_LF_LIB_consensus_vsearch	958	T	*/+G	211	9	3.95%	2	2	93	93	0.0017967787753331713	1	1	71	140	7	2	+G
H3_BC87_191109_LF_LIB_consensus_vsearch	959	A	*/-G	207	9	3.96%	2	2	93	93	0.001793948723227531	1	1	70	137	8	1	-G
H3_BC87_191109_LF_LIB_consensus_vsearch	960	G	G	219	1	0.45%	2	1	93	93	0.4999999999999138	1	1	72	147	0	1	+TG
H3_BC87_191109_LF_LIB_consensus_vsearch	961	A	A	224	4	1.75%	2	2	93	93	0.06167673386217682	1	1	78	146	2	2	G
H3_BC87_191109_LF_LIB_consensus_vsearch	962	C	C	219	4	1.75%	2	2	93	93	0.06165825449566743	1	1	74	145	2	2	T
H3_BC87_191109_LF_LIB_consensus_vsearch	963	A	A	219	4	1.77%	2	2	93	93	0.06165825449566743	1	1	74	145	2	2	-C
H3_BC87_191109_LF_LIB_consensus_vsearch	964	C	C	219	2	0.9%	2	1	93	93	0.24943310657599216	1	1	76	143	0	2	+T
H3_BC87_191109_LF_LIB_consensus_vsearch	965	C	Y	208	17	7.46%	2	1	93	93	5.574528228215115E-6	1	1	78	130	0	17	T
H3_BC87_191109_LF_LIB_consensus_vsearch	966	G	G	224	1	0.44%	2	1	93	93	0.4999999999999138	1	1	79	145	0	1	-T
H3_BC87_191109_LF_LIB_consensus_vsearch	967	T	Y	205	18	8.04%	2	1	93	93	2.6689977897177195E-6	1	1	79	126	0	18	C
H3_BC87_191109_LF_LIB_consensus_vsearch	968	T	T	220	3	1.33%	2	1	93	93	0.12415730337075404	1	1	76	144	3	0	-GT
H3_BC87_191109_LF_LIB_consensus_vsearch	969	G	G	217	3	1.34%	2	2	93	93	0.12414578587710072	1	1	74	143	1	2	+C
H3_BC87_191109_LF_LIB_consensus_vsearch	970	T	T	213	5	2.23%	2	1	93	93	0.030534097847134272	1	1	76	137	0	5	-A
H3_BC87_191109_LF_LIB_consensus_vsearch	971	A	A	219	2	0.9%	2	1	93	93	0.24943310657599216	1	1	79	140	0	2	G
H3_BC87_191109_LF_LIB_consensus_vsearch	972	G	G	226	2	0.88%	2	1	93	93	0.24945054945064127	1	1	79	147	0	2	A
H3_BC87_191109_LF_LIB_consensus_vsearch	973	T	*/-C	216	7	3.07%	2	2	93	93	0.007447971960236055	1	1	73	143	5	2	-C
H3_BC87_191109_LF_LIB_consensus_vsearch	974	C	C	221	0	0%	2	0	93	0	1.0	1	0	74	147	0	0	
H3_BC87_191109_LF_LIB_consensus_vsearch	975	C	C	226	1	0.44%	2	1	93	93	0.4999999999999138	1	1	77	149	1	0	+A
H3_BC87_191109_LF_LIB_consensus_vsearch	976	C	*/-A	214	7	3.07%	2	1	93	93	0.007444703667648697	1	1	70	144	7	0	-A
H3_BC87_191109_LF_LIB_consensus_vsearch	977	A	A	213	2	0.9%	2	1	93	93	0.249417249417318	1	1	69	144	0	2	+T
H3_BC87_191109_LF_LIB_consensus_vsearch	978	C	S	214	7	3.08%	2	1	93	93	0.007444703667648697	1	1	70	144	7	0	G
H3_BC87_191109_LF_LIB_consensus_vsearch	979	C	C	227	1	0.44%	2	1	93	93	0.4999999999999138	1	1	79	148	0	1	T
H3_BC87_191109_LF_LIB_consensus_vsearch	980	A	A	222	3	1.31%	2	1	93	93	0.12416481069040536	1	1	77	145	3	0	G
H3_BC87_191109_LF_LIB_consensus_vsearch	981	G	G	227	1	0.44%	2	1	93	93	0.4999999999999138	1	1	80	147	0	1	-T
H3_BC87_191109_LF_LIB_consensus_vsearch	982	T	*/+A	208	8	3.51%	2	2	93	93	0.0036568954742723925	1	1	74	134	3	5	+A
H3_BC87_191109_LF_LIB_consensus_vsearch	983	A	A	225	1	0.44%	2	1	93	93	0.5000000000003686	1	1	78	147	0	1	C
H3_BC87_191109_LF_LIB_consensus_vsearch	984	A	A	227	2	0.87%	2	1	93	93	0.24945295404843976	1	1	80	147	0	2	G
H3_BC87_191109_LF_LIB_consensus_vsearch	985	A	A	223	3	1.31%	2	2	93	93	0.12416851441234596	1	1	77	146	1	2	G
H3_BC87_191109_LF_LIB_consensus_vsearch	986	C	C	223	2	0.88%	2	1	93	93	0.24944320712692292	1	1	77	146	0	2	T
H3_BC87_191109_LF_LIB_consensus_vsearch	987	G	G	219	5	2.2%	2	1	93	93	0.030553251388732716	1	1	72	147	5	0	-A
H3_BC87_191109_LF_LIB_consensus_vsearch	988	A	A	221	1	0.45%	2	1	93	93	0.4999999999999138	1	1	73	148	0	1	+GA
H3_BC87_191109_LF_LIB_consensus_vsearch	989	T	T	223	4	1.75%	2	1	93	93	0.061673103185009646	1	1	78	145	0	4	C
H3_BC87_191109_LF_LIB_consensus_vsearch	990	G	G	227	1	0.44%	2	1	93	93	0.4999999999999138	1	1	79	148	0	1	-TCG
H3_BC87_191109_LF_LIB_consensus_vsearch	991	T	T	226	2	0.88%	2	1	93	93	0.24945054945064127	1	1	80	146	0	2	C
H3_BC87_191109_LF_LIB_consensus_vsearch	992	C	C	225	1	0.44%	2	1	93	93	0.5000000000003686	1	1	77	148	1	0	+T
H3_BC87_191109_LF_LIB_consensus_vsearch	993	G	G	224	3	1.32%	2	1	93	93	0.12417218543044797	1	1	79	145	0	3	+TG
H3_BC87_191109_LF_LIB_consensus_vsearch	994	A	A	225	1	0.44%	2	1	93	93	0.5000000000003686	1	1	79	146	0	1	+C
H3_BC87_191109_LF_LIB_consensus_vsearch	995	C	C	226	2	0.88%	2	1	93	93	0.24945054945064127	1	1	79	147	0	2	T
H3_BC87_191109_LF_LIB_consensus_vsearch	996	G	G	224	3	1.31%	2	2	93	93	0.12417218543044797	1	1	78	146	2	1	A
H3_BC87_191109_LF_LIB_consensus_vsearch	997	C	C	227	1	0.44%	2	1	93	93	0.4999999999999138	1	1	80	147	0	1	+TG
H3_BC87_191109_LF_LIB_consensus_vsearch	998	G	G	223	3	1.31%	2	1	93	93	0.12416851441234596	1	1	77	146	3	0	-A
H3_BC87_191109_LF_LIB_consensus_vsearch	999	A	A	220	2	0.88%	2	2	93	93	0.2494356659142869	1	1	76	144	1	1	G
H3_BC87_191109_LF_LIB_consensus_vsearch	1000	T	T	221	2	0.88%	2	1	93	93	0.24943820224728358	1	1	76	145	2	0	+G
H3_BC87_191109_LF_LIB_consensus_vsearch	1001	C	C	218	3	1.33%	2	2	93	93	0.12414965986396012	1	1	75	143	2	1	-A
H3_BC87_191109_LF_LIB_consensus_vsearch	1002	A	A	212	4	1.81%	2	2	93	93	0.061630944461591126	1	1	71	141	2	2	G
H3_BC87_191109_LF_LIB_consensus_vsearch	1003	C	C	207	6	2.69%	2	2	93	93	0.015077437453979417	1	1	72	135	4	2	-G
H3_BC87_191109_LF_LIB_consensus_vsearch	1004	G	G	206	4	1.83%	2	2	93	93	0.06160608506034647	1	1	65	141	3	1	A
H3_BC87_191109_LF_LIB_consensus_vsearch	1005	G	R	212	7	3.08%	2	2	93	93	0.00744137624879223	1	1	70	142	5	2	A
H3_BC87_191109_LF_LIB_consensus_vsearch	1006	G	G	219	3	1.32%	2	1	93	93	0.12415349887135622	1	1	76	143	3	0	T
H3_BC87_191109_LF_LIB_consensus_vsearch	1007	T	T	215	5	2.19%	2	1	93	93	0.03054059830172664	1	1	79	136	0	5	A
H3_BC87_191109_LF_LIB_consensus_vsearch	1008	G	*/+T	212	7	3.08%	2	1	93	93	0.00744137624879223	1	1	80	132	0	7	+T
H3_BC87_191109_LF_LIB_consensus_vsearch	1009	T	T	217	4	1.76%	2	2	93	93	0.0616506283607095	1	1	79	138	1	3	C
H3_BC87_191109_LF_LIB_consensus_vsearch	1010	C	C	222	2	0.88%	2	2	93	93	0.24944071588395061	1	1	79	143	1	1	-T
H3_BC87_191109_LF_LIB_consensus_vsearch	1011	T	W	201	10	4.46%	2	1	93	93	8.756254095238223E-4	1	1	78	123	0	10	A
H3_BC87_191109_LF_LIB_consensus_vsearch	1012	G	*/-T	207	9	4%	2	1	93	93	0.001793948723227531	1	1	79	128	0	9	-T
H3_BC87_191109_LF_LIB_consensus_vsearch	1013	T	T	202	5	2.33%	2	1	93	93	0.030496102932097202	1	1	80	122	0	5	A
H3_BC87_191109_LF_LIB_consensus_vsearch	1014	G	G	210	5	2.25%	2	1	93	93	0.0305241206880699	1	1	77	133	0	5	-T
H3_BC87_191109_LF_LIB_consensus_vsearch	1015	T	T	208	4	1.83%	2	1	93	93	0.06161452805712106	1	1	80	128	0	4	G
H3_BC87_191109_LF_LIB_consensus_vsearch	1016	T	Y	212	8	3.52%	2	1	93	93	0.003661360523321731	1	1	76	136	0	8	C
H3_BC87_191109_LF_LIB_consensus_vsearch	1017	A	A	217	3	1.34%	2	2	93	93	0.12414578587710072	1	1	76	141	1	2	+G
H3_BC87_191109_LF_LIB_consensus_vsearch	1018	G	G	222	2	0.89%	2	2	93	93	0.24944071588395061	1	1	77	145	1	1	A
H3_BC87_191109_LF_LIB_consensus_vsearch	1019	C	C	218	2	0.88%	2	1	93	93	0.24943052391823226	1	1	75	143	2	0	-A
H3_BC87_191109_LF_LIB_consensus_vsearch	1020	A	R	213	8	3.57%	2	2	93	93	0.0036624519192641563	1	1	67	146	7	1	G
H3_BC87_191109_LF_LIB_consensus_vsearch	1021	G	G	224	0	0%	2	0	93	0	1.0	1	0	76	148	0	0	
H3_BC87_191109_LF_LIB_consensus_vsearch	1022	C	C	216	2	0.88%	2	1	93	93	0.249425287356441	1	1	71	145	2	0	-GC
H3_BC87_191109_LF_LIB_consensus_vsearch	1023	G	G	219	2	0.89%	2	1	93	93	0.24943310657599216	1	1	75	144	0	2	+C
H3_BC87_191109_LF_LIB_consensus_vsearch	1024	C	C	214	4	1.79%	2	1	93	93	0.061638926495252586	1	1	75	139	0	4	-T
H3_BC87_191109_LF_LIB_consensus_vsearch	1025	T	T	211	4	1.79%	2	1	93	93	0.06162689769249	1	1	73	138	4	0	+C
H3_BC87_191109_LF_LIB_consensus_vsearch	1026	C	*/-G	191	13	5.83%	2	2	93	93	1.0021782040526559E-4	1	1	70	121	4	9	-G
H3_BC87_191109_LF_LIB_consensus_vsearch	1027	G	G	205	2	0.96%	2	1	93	93	0.24939467312372118	1	1	76	129	0	2	T
H3_BC87_191109_LF_LIB_consensus_vsearch	1028	G	G	221	2	0.9%	2	2	93	93	0.24943820224728358	1	1	79	142	1	1	A
H3_BC87_191109_LF_LIB_consensus_vsearch	1029	G	*/-A	212	11	4.82%	2	1	93	93	4.303452996410444E-4	1	1	67	145	11	0	-A
H3_BC87_191109_LF_LIB_consensus_vsearch	1030	A	A	212	1	0.47%	2	1	93	93	0.5000000000001412	1	1	66	146	1	0	+G
H3_BC87_191109_LF_LIB_consensus_vsearch	1031	G	G	219	3	1.33%	2	1	93	93	0.12415349887135622	1	1	79	140	0	3	+T
H3_BC87_191109_LF_LIB_consensus_vsearch	1032	C	C	215	5	2.2%	2	1	93	93	0.03054059830172664	1	1	78	137	0	5	T
H3_BC87_191109_LF_LIB_consensus_vsearch	1033	G	G	218	4	1.75%	2	1	93	93	0.061654458623218986	1	1	77	141	0	4	-T
H3_BC87_191109_LF_LIB_consensus_vsearch	1034	T	T	212	3	1.36%	2	1	93	93	0.1241258741259166	1	1	77	135	0	3	C
H3_BC87_191109_LF_LIB_consensus_vsearch	1035	A	A	216	3	1.34%	2	1	93	93	0.12414187643025615	1	1	77	139	0	3	G
H3_BC87_191109_LF_LIB_consensus_vsearch	1036	T	T	211	3	1.36%	2	2	93	93	0.12412177985949331	1	1	73	138	1	2	G
H3_BC87_191109_LF_LIB_consensus_vsearch	1037	A	A	211	5	2.23%	2	1	93	93	0.030527477163211258	1	1	69	142	0	5	+TA
H3_BC87_191109_LF_LIB_consensus_vsearch	1038	G	*/-A	200	21	9.38%	2	2	93	93	2.896747146375421E-7	1	1	55	145	18	3	-A
H3_BC87_191109_LF_LIB_consensus_vsearch	1039	A	A	197	3	1.49%	2	2	93	93	0.1240601503759118	1	1	53	144	1	2	G
H3_BC87_191109_LF_LIB_consensus_vsearch	1040	A	A	222	1	0.44%	2	1	93	93	0.4999999999999138	1	1	75	147	0	1	+C
H3_BC87_191109_LF_LIB_consensus_vsearch	1041	A	*/-T	212	11	4.8%	2	1	93	93	4.303452996410444E-4	1	1	67	145	11	0	-T
H3_BC87_191109_LF_LIB_consensus_vsearch	1042	T	K	204	10	4.61%	2	1	93	93	8.769963348909129E-4	1	1	56	148	10	0	G
H3_BC87_191109_LF_LIB_consensus_vsearch	1043	T	K	209	7	3.07%	2	1	93	93	0.007436270701269745	1	1	68	141	7	0	G
H3_BC87_191109_LF_LIB_consensus_vsearch	1044	A	*/-G	163	26	11.45%	2	1	93	93	5.9218545529083794E-9	1	1	46	117	26	0	-G
H3_BC87_191109_LF_LIB_consensus_vsearch	1045	G	G	198	3	1.48%	2	1	93	93	0.12406483790525294	1	1	50	148	3	0	-AG
H3_BC87_191109_LF_LIB_consensus_vsearch	1046	A	A	223	1	0.44%	2	1	93	93	0.5000000000003686	1	1	74	149	1	0	-G
H3_BC87_191109_LF_LIB_consensus_vsearch	1047	G	G	222	2	0.89%	2	1	93	93	0.24944071588395061	1	1	74	148	2	0	A
H3_BC87_191109_LF_LIB_consensus_vsearch	1048	T	T	228	0	0%	2	0	93	0	1.0	1	0	80	148	0	0	
H3_BC87_191109_LF_LIB_consensus_vsearch	1049	C	*/-T	198	25	10.92%	2	1	93	93	1.46207594320913E-8	1	1	78	120	0	25	-T
H3_BC87_191109_LF_LIB_consensus_vsearch	1050	T	T	200	1	0.5%	2	1	93	93	0.4999999999999138	1	1	79	121	1	0	+A
H3_BC87_191109_LF_LIB_consensus_vsearch	1051	T	T	226	1	0.44%	2	1	93	93	0.4999999999999138	1	1	80	146	0	1	C
H3_BC87_191109_LF_LIB_consensus_vsearch	1052	T	*/-G	177	50	21.83%	2	2	93	93	4.265496838716597E-17	1	1	79	98	1	49	-G
H3_BC87_191109_LF_LIB_consensus_vsearch	1053	G	G	178	1	0.56%	2	1	93	93	0.4999999999999138	1	1	79	99	0	1	T
H3_BC87_191109_LF_LIB_consensus_vsearch	1054	G	G	228	1	0.44%	2	1	93	93	0.4999999999999138	1	1	79	149	1	0	A
H3_BC87_191109_LF_LIB_consensus_vsearch	1055	A	A	226	3	1.31%	2	1	93	93	0.12417943107231426	1	1	80	146	0	3	+C
H3_BC87_191109_LF_LIB_consensus_vsearch	1056	C	*/-T	213	12	5.24%	2	1	93	93	2.1002241192895544E-4	1	1	79	134	0	12	-T
H3_BC87_191109_LF_LIB_consensus_vsearch	1057	T	T	210	3	1.4%	2	1	93	93	0.1241176470588473	1	1	79	131	0	3	-C
H3_BC87_191109_LF_LIB_consensus_vsearch	1058	C	C	222	1	0.45%	2	1	93	93	0.4999999999999138	1	1	80	142	0	1	+T
H3_BC87_191109_LF_LIB_consensus_vsearch	1059	T	*/-G	147	37	16.3%	2	2	93	93	9.71855532935342E-13	1	1	54	93	10	27	-G
H3_BC87_191109_LF_LIB_consensus_vsearch	1060	G	G	177	1	0.56%	2	1	93	93	0.4999999999999138	1	1	64	113	0	1	T
H3_BC87_191109_LF_LIB_consensus_vsearch	1061	G	G	212	2	0.93%	2	1	93	93	0.24941451990645544	1	1	73	139	0	2	T
H3_BC87_191109_LF_LIB_consensus_vsearch	1062	G	G	226	1	0.44%	2	1	93	93	0.4999999999999138	1	1	78	148	0	1	+A
H3_BC87_191109_LF_LIB_consensus_vsearch	1063	G	G	228	1	0.44%	2	1	93	93	0.4999999999999138	1	1	80	148	0	1	A
H3_BC87_191109_LF_LIB_consensus_vsearch	1064	G	*/+A	205	10	4.37%	2	1	93	93	8.774450793915666E-4	1	1	60	145	10	0	+A
H3_BC87_191109_LF_LIB_consensus_vsearch	1065	A	A	221	1	0.45%	2	1	93	93	0.4999999999999138	1	1	74	147	1	0	-G
H3_BC87_191109_LF_LIB_consensus_vsearch	1066	G	R	209	10	4.46%	2	2	93	93	8.792003591123169E-4	1	1	65	144	9	1	A
H3_BC87_191109_LF_LIB_consensus_vsearch	1067	T	T	224	2	0.87%	2	1	93	93	0.24944567627499675	1	1	77	147	0	2	C
H3_BC87_191109_LF_LIB_consensus_vsearch	1068	A	A	223	3	1.32%	2	2	93	93	0.12416851441234596	1	1	76	147	2	1	G
H3_BC87_191109_LF_LIB_consensus_vsearch	1069	T	T	220	2	0.88%	2	1	93	93	0.2494356659142869	1	1	75	145	0	2	+AT
H3_BC87_191109_LF_LIB_consensus_vsearch	1070	G	G	223	1	0.44%	2	1	93	93	0.5000000000003686	1	1	77	146	0	1	+AA
H3_BC87_191109_LF_LIB_consensus_vsearch	1071	G	G	222	2	0.88%	2	1	93	93	0.24944071588395061	1	1	78	144	0	2	+C
H3_BC87_191109_LF_LIB_consensus_vsearch	1072	T	T	219	5	2.2%	2	2	93	93	0.030553251388732716	1	1	77	142	2	3	-C
H3_BC87_191109_LF_LIB_consensus_vsearch	1073	C	C	215	4	1.79%	2	2	93	93	0.06164286277914926	1	1	74	141	3	1	+A
H3_BC87_191109_LF_LIB_consensus_vsearch	1074	G	G	216	5	2.21%	2	2	93	93	0.030543804461782422	1	1	73	143	2	3	A
H3_BC87_191109_LF_LIB_consensus_vsearch	1075	C	C	213	6	2.65%	2	2	93	93	0.0150923687299321	1	1	74	139	2	4	+A
H3_BC87_191109_LF_LIB_consensus_vsearch	1076	A	A	224	1	0.44%	2	1	93	93	0.4999999999999138	1	1	77	147	0	1	+CA
H3_BC87_191109_LF_LIB_consensus_vsearch	1077	A	A	224	3	1.31%	2	2	93	93	0.12417218543044797	1	1	76	148	2	1	G
H3_BC87_191109_LF_LIB_consensus_vsearch	1078	G	G	225	1	0.44%	2	1	93	93	0.5000000000003686	1	1	77	148	1	0	+A
H3_BC87_191109_LF_LIB_consensus_vsearch	1079	T	T	224	2	0.88%	2	1	93	93	0.24944567627499675	1	1	76	148	2	0	C
H3_BC87_191109_LF_LIB_consensus_vsearch	1080	C	C	223	2	0.88%	2	1	93	93	0.24944320712692292	1	1	76	147	2	0	-T
H3_BC87_191109_LF_LIB_consensus_vsearch	1081	T	T	213	5	2.22%	2	2	93	93	0.030534097847134272	1	1	71	142	3	2	+G
H3_BC87_191109_LF_LIB_consensus_vsearch	1082	G	G	218	4	1.76%	2	2	93	93	0.061654458623218986	1	1	77	141	3	1	C
H3_BC87_191109_LF_LIB_consensus_vsearch	1083	A	A	225	0	0%	2	0	93	0	1.0	1	0	80	145	0	0	
H3_BC87_191109_LF_LIB_consensus_vsearch	1084	A	A	228	1	0.44%	2	1	93	93	0.4999999999999138	1	1	80	148	0	1	G
H3_BC87_191109_LF_LIB_consensus_vsearch	1085	A	A	224	4	1.75%	2	2	93	93	0.06167673386217682	1	1	76	148	3	1	G
H3_BC87_191109_LF_LIB_consensus_vsearch	1086	C	*/+T	213	7	3.06%	2	1	93	93	0.007443047448823043	1	1	78	135	0	7	+T
H3_BC87_191109_LF_LIB_consensus_vsearch	1087	T	T	220	1	0.45%	2	1	93	93	0.4999999999999138	1	1	78	142	1	0	A
H3_BC87_191109_LF_LIB_consensus_vsearch	1088	T	T	203	5	2.2%	2	2	93	93	0.030499722862415764	1	1	67	136	4	1	+A
H3_BC87_191109_LF_LIB_consensus_vsearch	1089	A	A	218	3	1.35%	2	2	93	93	0.12414965986396012	1	1	72	146	2	1	C
H3_BC87_191109_LF_LIB_consensus_vsearch	1090	A	A	225	1	0.44%	2	1	93	93	0.5000000000003686	1	1	78	147	1	0	+G
H3_BC87_191109_LF_LIB_consensus_vsearch	1091	A	A	223	3	1.32%	2	2	93	93	0.12416851441234596	1	1	78	145	2	1	+G
H3_BC87_191109_LF_LIB_consensus_vsearch	1092	G	G	225	1	0.44%	2	1	93	93	0.5000000000003686	1	1	79	146	1	0	+AGAG
H3_BC87_191109_LF_LIB_consensus_vsearch	1093	G	*/-A	217	9	3.93%	2	2	93	93	0.0018008401619304512	1	1	71	146	8	1	-A
H3_BC87_191109_LF_LIB_consensus_vsearch	1094	A	A	218	2	0.91%	2	1	93	93	0.24943052391823226	1	1	70	148	2	0	G
H3_BC87_191109_LF_LIB_consensus_vsearch	1095	A	R	217	9	3.93%	2	1	93	93	0.0018008401619304512	1	1	69	148	9	0	G
H3_BC87_191109_LF_LIB_consensus_vsearch	1096	T	K	213	8	3.52%	2	1	93	93	0.0036624519192641563	1	1	70	143	8	0	G
H3_BC87_191109_LF_LIB_consensus_vsearch	1097	T	T	220	5	2.18%	2	1	93	93	0.03055634444922604	1	1	79	141	0	5	+G
H3_BC87_191109_LF_LIB_consensus_vsearch	1098	G	G	229	0	0%	2	0	93	0	1.0	1	0	80	149	0	0	
H3_BC87_191109_LF_LIB_consensus_vsearch	1099	A	A	220	6	2.62%	2	2	93	93	0.015108791157819889	1	1	75	145	5	1	G
H3_BC87_191109_LF_LIB_consensus_vsearch	1100	C	C	212	6	2.63%	2	2	93	93	0.015089936987088519	1	1	78	134	1	5	+G
H3_BC87_191109_LF_LIB_consensus_vsearch	1101	G	G	222	0	0%	2	0	93	0	1.0	1	0	79	143	0	0	
H3_BC87_191109_LF_LIB_consensus_vsearch	1102	G	G	220	3	1.32%	2	1	93	93	0.12415730337075404	1	1	75	145	3	0	+A
H3_BC87_191109_LF_LIB_consensus_vsearch	1103	A	A	225	1	0.44%	2	1	93	93	0.5000000000003686	1	1	78	147	1	0	C
H3_BC87_191109_LF_LIB_consensus_vsearch	1104	A	*/-G	202	17	7.46%	2	2	93	93	5.524923410580334E-6	1	1	74	128	1	16	-G
H3_BC87_191109_LF_LIB_consensus_vsearch	1105	G	G	200	5	2.4%	2	1	93	93	0.03048875726138147	1	1	71	129	5	0	+A
H3_BC87_191109_LF_LIB_consensus_vsearch	1106	G	*/+A	215	8	3.56%	2	2	93	93	0.0036646057936482192	1	1	71	144	7	1	+A
H3_BC87_191109_LF_LIB_consensus_vsearch	1107	G	G	223	2	0.88%	2	2	93	93	0.24944320712692292	1	1	79	144	1	1	A
H3_BC87_191109_LF_LIB_consensus_vsearch	1108	C	*/+A	197	22	9.69%	2	1	93	93	1.3688763025838974E-7	1	1	75	122	0	22	+A
H3_BC87_191109_LF_LIB_consensus_vsearch	1109	A	A	218	2	0.88%	2	1	93	93	0.24943052391823226	1	1	74	144	2	0	G
H3_BC87_191109_LF_LIB_consensus_vsearch	1110	C	Y	189	23	10.22%	2	2	93	93	6.346030588413567E-8	1	1	74	115	1	22	T
H3_BC87_191109_LF_LIB_consensus_vsearch	1111	A	A	212	2	0.93%	2	1	93	93	0.24941451990645544	1	1	76	136	2	0	T
H3_BC87_191109_LF_LIB_consensus_vsearch	1112	A	A	212	5	2.22%	2	2	93	93	0.030530802741347875	1	1	74	138	4	1	G
H3_BC87_191109_LF_LIB_consensus_vsearch	1113	C	C	217	4	1.79%	2	2	93	93	0.0616506283607095	1	1	75	142	3	1	G
H3_BC87_191109_LF_LIB_consensus_vsearch	1114	C	Y	203	22	9.69%	2	2	93	93	1.390331579072304E-7	1	1	77	126	1	21	T
H3_BC87_191109_LF_LIB_consensus_vsearch	1115	A	A	220	4	1.76%	2	1	93	93	0.061662016439223415	1	1	77	143	0	4	+G
H3_BC87_191109_LF_LIB_consensus_vsearch	1116	G	G	226	1	0.44%	2	1	93	93	0.4999999999999138	1	1	80	146	0	1	+AA
H3_BC87_191109_LF_LIB_consensus_vsearch	1117	G	G	225	3	1.31%	2	1	93	93	0.12417582417582212	1	1	79	146	0	3	-CG
H3_BC87_191109_LF_LIB_consensus_vsearch	1118	C	C	221	1	0.44%	2	1	93	93	0.4999999999999138	1	1	78	143	1	0	+G
H3_BC87_191109_LF_LIB_consensus_vsearch	1119	G	*/-TG	200	22	9.87%	2	1	93	93	1.3797147807810935E-7	1	1	79	121	0	22	-TG
H3_BC87_191109_LF_LIB_consensus_vsearch	1120	T	*/+G	184	10	4.9%	2	1	93	93	8.670842550026666E-4	1	1	74	110	0	10	+G
H3_BC87_191109_LF_LIB_consensus_vsearch	1121	G	G	195	3	1.51%	2	1	93	93	0.12405063291138052	1	1	75	120	3	0	A
H3_BC87_191109_LF_LIB_consensus_vsearch	1122	G	G	223	3	1.32%	2	1	93	93	0.12416851441234596	1	1	77	146	3	0	-A
H3_BC87_191109_LF_LIB_consensus_vsearch	1123	A	A	217	4	1.79%	2	2	93	93	0.0616506283607095	1	1	71	146	3	1	-G
H3_BC87_191109_LF_LIB_consensus_vsearch	1124	G	G	218	3	1.35%	2	2	93	93	0.12414965986396012	1	1	75	143	2	1	-C
H3_BC87_191109_LF_LIB_consensus_vsearch	1125	C	C	216	3	1.33%	2	1	93	93	0.12414187643025615	1	1	74	142	0	3	+T
H3_BC87_191109_LF_LIB_consensus_vsearch	1126	C	C	220	3	1.32%	2	2	93	93	0.12415730337075404	1	1	78	142	1	2	-T
H3_BC87_191109_LF_LIB_consensus_vsearch	1127	T	Y	210	7	3.11%	2	2	93	93	0.007437988084800957	1	1	78	132	1	6	C
H3_BC87_191109_LF_LIB_consensus_vsearch	1128	G	G	221	2	0.88%	2	1	93	93	0.24943820224728358	1	1	78	143	0	2	-C
H3_BC87_191109_LF_LIB_consensus_vsearch	1129	C	C	210	5	2.22%	2	1	93	93	0.0305241206880699	1	1	78	132	0	5	T
H3_BC87_191109_LF_LIB_consensus_vsearch	1130	G	R	215	7	3.1%	2	2	93	93	0.007446345105805389	1	1	72	143	6	1	A
H3_BC87_191109_LF_LIB_consensus_vsearch	1131	G	G	226	1	0.44%	2	1	93	93	0.4999999999999138	1	1	79	147	0	1	+TGG
H3_BC87_191109_LF_LIB_consensus_vsearch	1132	C	*/-TT	184	28	12.28%	2	1	93	93	1.4348194500451993E-9	1	1	49	135	28	0	-TT
H3_BC87_191109_LF_LIB_consensus_vsearch	1133	T	T	193	1	0.51%	2	1	93	93	0.4999999999999138	1	1	47	146	1	0	A
H3_BC87_191109_LF_LIB_consensus_vsearch	1134	T	T	184	4	2%	2	2	93	93	0.06150134048256699	1	1	41	143	2	2	-A
H3_BC87_191109_LF_LIB_consensus_vsearch	1135	A	A	218	1	0.45%	2	1	93	93	0.5000000000003686	1	1	72	146	1	0	+CT
H3_BC87_191109_LF_LIB_consensus_vsearch	1136	A	A	210	6	2.67%	2	2	93	93	0.01508500627971554	1	1	70	140	5	1	-T
H3_BC87_191109_LF_LIB_consensus_vsearch	1137	T	T	215	6	2.7%	2	2	93	93	0.01509716650743782	1	1	70	145	5	1	G
H3_BC87_191109_LF_LIB_consensus_vsearch	1138	T	T	218	5	2.19%	2	1	93	93	0.030550130621104243	1	1	72	146	5	0	G
H3_BC87_191109_LF_LIB_consensus_vsearch	1139	T	T	226	2	0.87%	2	1	93	93	0.24945054945064127	1	1	79	147	0	2	C
H3_BC87_191109_LF_LIB_consensus_vsearch	1140	G	G	226	2	0.87%	2	2	93	93	0.24945054945064127	1	1	78	148	1	1	C
H3_BC87_191109_LF_LIB_consensus_vsearch	1141	A	A	222	4	1.75%	2	1	93	93	0.061669440342892484	1	1	77	145	0	4	+C
H3_BC87_191109_LF_LIB_consensus_vsearch	1142	C	C	225	2	0.88%	2	2	93	93	0.24944812362040697	1	1	77	148	1	1	+T
H3_BC87_191109_LF_LIB_consensus_vsearch	1143	T	T	221	4	1.75%	2	2	93	93	0.06166574490670126	1	1	78	143	1	3	+C
H3_BC87_191109_LF_LIB_consensus_vsearch	1144	C	C	219	2	0.88%	2	1	93	93	0.24943310657599216	1	1	77	142	0	2	+A
H3_BC87_191109_LF_LIB_consensus_vsearch	1145	A	A	226	0	0%	2	0	93	0	1.0	1	0	77	149	0	0	
H3_BC87_191109_LF_LIB_consensus_vsearch	1146	A	A	220	3	1.33%	2	1	93	93	0.12415730337075404	1	1	74	146	3	0	G
H3_BC87_191109_LF_LIB_consensus_vsearch	1147	C	C	222	1	0.44%	2	1	93	93	0.4999999999999138	1	1	75	147	1	0	+T
H3_BC87_191109_LF_LIB_consensus_vsearch	1148	A	R	210	8	3.54%	2	1	93	93	0.0036591481612605	1	1	63	147	8	0	G
H3_BC87_191109_LF_LIB_consensus_vsearch	1149	C	*/-G	157	43	19.28%	2	2	93	93	9.039427924693884E-15	1	1	35	122	24	19	-G
H3_BC87_191109_LF_LIB_consensus_vsearch	1150	G	K	163	8	4.49%	2	2	93	93	0.0035925563072326206	1	1	39	124	5	3	T
H3_BC87_191109_LF_LIB_consensus_vsearch	1151	G	G	219	3	1.35%	2	2	93	93	0.12415349887135622	1	1	74	145	2	1	C
H3_BC87_191109_LF_LIB_consensus_vsearch	1152	G	G	223	2	0.88%	2	1	93	93	0.24944320712692292	1	1	76	147	2	0	T
H3_BC87_191109_LF_LIB_consensus_vsearch	1153	G	G	225	3	1.31%	2	2	93	93	0.12417582417582212	1	1	78	147	2	1	-A
H3_BC87_191109_LF_LIB_consensus_vsearch	1154	A	A	221	3	1.33%	2	1	93	93	0.12416107382546236	1	1	75	146	3	0	+G
H3_BC87_191109_LF_LIB_consensus_vsearch	1155	A	A	226	1	0.44%	2	1	93	93	0.4999999999999138	1	1	79	147	0	1	+G
H3_BC87_191109_LF_LIB_consensus_vsearch	1156	G	G	212	6	2.63%	2	1	93	93	0.015089936987088519	1	1	74	138	0	6	+C
H3_BC87_191109_LF_LIB_consensus_vsearch	1157	C	C	221	3	1.32%	2	1	93	93	0.12416107382546236	1	1	79	142	0	3	-T
H3_BC87_191109_LF_LIB_consensus_vsearch	1158	T	T	213	6	2.65%	2	1	93	93	0.0150923687299321	1	1	77	136	0	6	-C
H3_BC87_191109_LF_LIB_consensus_vsearch	1159	C	C	219	2	0.9%	2	2	93	93	0.24943310657599216	1	1	79	140	1	1	+T
H3_BC87_191109_LF_LIB_consensus_vsearch	1160	A	A	215	5	2.18%	2	2	93	93	0.03054059830172664	1	1	72	143	3	2	-C
H3_BC87_191109_LF_LIB_consensus_vsearch	1161	C	C	213	4	1.79%	2	1	93	93	0.06163495389099757	1	1	76	137	0	4	+T
H3_BC87_191109_LF_LIB_consensus_vsearch	1162	C	C	216	5	2.19%	2	1	93	93	0.030543804461782422	1	1	78	138	0	5	T
H3_BC87_191109_LF_LIB_consensus_vsearch	1163	A	*/-G	205	11	4.87%	2	1	93	93	4.285433624407098E-4	1	1	78	127	0	11	-G
H3_BC87_191109_LF_LIB_consensus_vsearch	1164	G	G	210	3	1.4%	2	1	93	93	0.1241176470588473	1	1	79	131	0	3	+T
H3_BC87_191109_LF_LIB_consensus_vsearch	1165	G	G	221	3	1.33%	2	1	93	93	0.12416107382546236	1	1	77	144	3	0	+A
H3_BC87_191109_LF_LIB_consensus_vsearch	1166	G	G	224	2	0.87%	2	1	93	93	0.24944567627499675	1	1	80	144	0	2	-CA
H3_BC87_191109_LF_LIB_consensus_vsearch	1167	C	C	222	2	0.89%	2	1	93	93	0.24944071588395061	1	1	79	143	0	2	T
H3_BC87_191109_LF_LIB_consensus_vsearch	1168	A	R	212	9	3.98%	2	2	93	93	0.00179747064240055	1	1	71	141	8	1	G
H3_BC87_191109_LF_LIB_consensus_vsearch	1169	G	G	220	4	1.76%	2	1	93	93	0.061662016439223415	1	1	80	140	0	4	+T
H3_BC87_191109_LF_LIB_consensus_vsearch	1170	G	G	228	1	0.44%	2	1	93	93	0.4999999999999138	1	1	80	148	0	1	+TG
H3_BC87_191109_LF_LIB_consensus_vsearch	1171	A	A	226	2	0.87%	2	2	93	93	0.24945054945064127	1	1	79	147	1	1	G
H3_BC87_191109_LF_LIB_consensus_vsearch	1172	C	C	225	1	0.44%	2	1	93	93	0.5000000000003686	1	1	78	147	1	0	+G
H3_BC87_191109_LF_LIB_consensus_vsearch	1173	A	A	224	2	0.88%	2	1	93	93	0.24944567627499675	1	1	77	147	2	0	-T
H3_BC87_191109_LF_LIB_consensus_vsearch	1174	T	T	222	3	1.32%	2	2	93	93	0.12416481069040536	1	1	77	145	1	2	C
H3_BC87_191109_LF_LIB_consensus_vsearch	1175	G	G	221	3	1.32%	2	1	93	93	0.12416107382546236	1	1	77	144	3	0	-A
H3_BC87_191109_LF_LIB_consensus_vsearch	1176	A	A	221	1	0.45%	2	1	93	93	0.4999999999999138	1	1	76	145	0	1	+T
H3_BC87_191109_LF_LIB_consensus_vsearch	1177	T	T	225	1	0.44%	2	1	93	93	0.5000000000003686	1	1	80	145	0	1	C
H3_BC87_191109_LF_LIB_consensus_vsearch	1178	T	T	224	2	0.87%	2	1	93	93	0.24944567627499675	1	1	76	148	2	0	-A
H3_BC87_191109_LF_LIB_consensus_vsearch	1179	A	*/-G	171	40	17.7%	2	1	93	93	1.1792367462179064E-13	1	1	77	94	0	40	-G
H3_BC87_191109_LF_LIB_consensus_vsearch	1180	G	G	182	5	2.66%	2	1	93	93	0.030415585729470396	1	1	73	109	5	0	A
H3_BC87_191109_LF_LIB_consensus_vsearch	1181	G	*/-A	222	7	3.06%	2	2	93	93	0.007457437428309682	1	1	74	148	6	1	-A
H3_BC87_191109_LF_LIB_consensus_vsearch	1182	A	A	220	2	0.9%	2	1	93	93	0.2494356659142869	1	1	72	148	2	0	-T
H3_BC87_191109_LF_LIB_consensus_vsearch	1183	T	T	224	2	0.88%	2	1	93	93	0.24944567627499675	1	1	78	146	0	2	C
H3_BC87_191109_LF_LIB_consensus_vsearch	1184	T	T	223	2	0.87%	2	1	93	93	0.24944320712692292	1	1	78	145	0	2	+G
H3_BC87_191109_LF_LIB_consensus_vsearch	1185	G	G	227	1	0.44%	2	1	93	93	0.4999999999999138	1	1	79	148	1	0	C
H3_BC87_191109_LF_LIB_consensus_vsearch	1186	A	A	222	3	1.31%	2	2	93	93	0.12416481069040536	1	1	79	143	1	2	G
H3_BC87_191109_LF_LIB_consensus_vsearch	1187	C	C	218	5	2.21%	2	2	93	93	0.030550130621104243	1	1	76	142	1	4	T
H3_BC87_191109_LF_LIB_consensus_vsearch	1188	A	A	220	4	1.75%	2	2	93	93	0.061662016439223415	1	1	75	145	1	3	T
H3_BC87_191109_LF_LIB_consensus_vsearch	1189	G	G	225	1	0.44%	2	1	93	93	0.5000000000003686	1	1	77	148	1	0	+A
H3_BC87_191109_LF_LIB_consensus_vsearch	1190	A	A	222	3	1.31%	2	2	93	93	0.12416481069040536	1	1	77	145	1	2	G
H3_BC87_191109_LF_LIB_consensus_vsearch	1191	C	C	223	2	0.87%	2	1	93	93	0.24944320712692292	1	1	75	148	2	0	+G
H3_BC87_191109_LF_LIB_consensus_vsearch	1192	A	A	216	5	2.2%	2	2	93	93	0.030543804461782422	1	1	72	144	2	3	-T
H3_BC87_191109_LF_LIB_consensus_vsearch	1193	T	T	218	4	1.79%	2	2	93	93	0.061654458623218986	1	1	75	143	2	2	C
H3_BC87_191109_LF_LIB_consensus_vsearch	1194	G	G	226	2	0.87%	2	2	93	93	0.24945054945064127	1	1	78	148	1	1	C
H3_BC87_191109_LF_LIB_consensus_vsearch	1195	A	A	221	3	1.32%	2	1	93	93	0.12416107382546236	1	1	74	147	3	0	+C
H3_BC87_191109_LF_LIB_consensus_vsearch	1196	C	C	224	2	0.87%	2	1	93	93	0.24944567627499675	1	1	76	148	2	0	+G
H3_BC87_191109_LF_LIB_consensus_vsearch	1197	A	A	225	2	0.87%	2	1	93	93	0.24944812362040697	1	1	78	147	2	0	-G
H3_BC87_191109_LF_LIB_consensus_vsearch	1198	G	G	226	1	0.44%	2	1	93	93	0.4999999999999138	1	1	77	149	1	0	-A
H3_BC87_191109_LF_LIB_consensus_vsearch	1199	A	A	220	4	1.75%	2	1	93	93	0.061662016439223415	1	1	77	143	0	4	+T
H3_BC87_191109_LF_LIB_consensus_vsearch	1200	T	T	222	3	1.32%	2	1	93	93	0.12416481069040536	1	1	80	142	0	3	C
H3_BC87_191109_LF_LIB_consensus_vsearch	1201	C	*/-T	198	20	8.85%	2	1	93	93	6.042413578071823E-7	1	1	77	121	0	20	-T
H3_BC87_191109_LF_LIB_consensus_vsearch	1202	T	T	200	5	2.43%	2	2	93	93	0.03048875726138147	1	1	79	121	1	4	C
H3_BC87_191109_LF_LIB_consensus_vsearch	1203	T	T	223	2	0.88%	2	2	93	93	0.24944320712692292	1	1	79	144	1	1	C
H3_BC87_191109_LF_LIB_consensus_vsearch	1204	T	T	226	1	0.44%	2	1	93	93	0.4999999999999138	1	1	79	147	1	0	+C
H3_BC87_191109_LF_LIB_consensus_vsearch	1205	C	C	223	2	0.87%	2	1	93	93	0.24944320712692292	1	1	76	147	2	0	+T
H3_BC87_191109_LF_LIB_consensus_vsearch	1206	A	A	220	2	0.88%	2	1	93	93	0.2494356659142869	1	1	75	145	0	2	-T
H3_BC87_191109_LF_LIB_consensus_vsearch	1207	T	T	220	2	0.88%	2	2	93	93	0.2494356659142869	1	1	79	141	1	1	C
H3_BC87_191109_LF_LIB_consensus_vsearch	1208	G	G	224	1	0.44%	2	1	93	93	0.4999999999999138	1	1	79	145	0	1	+CG
H3_BC87_191109_LF_LIB_consensus_vsearch	1209	A	A	226	1	0.44%	2	1	93	93	0.4999999999999138	1	1	79	147	0	1	G
H3_BC87_191109_LF_LIB_consensus_vsearch	1210	T	T	224	2	0.88%	2	1	93	93	0.24944567627499675	1	1	80	144	0	2	+C
H3_BC87_191109_LF_LIB_consensus_vsearch	1211	C	C	215	6	2.63%	2	1	93	93	0.01509716650743782	1	1	78	137	0	6	-T
H3_BC87_191109_LF_LIB_consensus_vsearch	1212	T	T	215	2	0.91%	2	2	93	93	0.2494226327944578	1	1	77	138	1	1	+C
H3_BC87_191109_LF_LIB_consensus_vsearch	1213	C	C	220	2	0.89%	2	1	93	93	0.2494356659142869	1	1	76	144	0	2	-A
H3_BC87_191109_LF_LIB_consensus_vsearch	1214	A	A	219	3	1.33%	2	1	93	93	0.12415349887135622	1	1	80	139	0	3	-T
H3_BC87_191109_LF_LIB_consensus_vsearch	1215	T	T	215	5	2.22%	2	2	93	93	0.03054059830172664	1	1	78	137	2	3	-G
H3_BC87_191109_LF_LIB_consensus_vsearch	1216	G	G	213	4	1.79%	2	2	93	93	0.06163495389099757	1	1	74	139	3	1	A
H3_BC87_191109_LF_LIB_consensus_vsearch	1217	G	G	224	3	1.31%	2	1	93	93	0.12417218543044797	1	1	77	147	3	0	+A
H3_BC87_191109_LF_LIB_consensus_vsearch	1218	G	G	228	0	0%	2	0	93	0	1.0	1	0	80	148	0	0	
H3_BC87_191109_LF_LIB_consensus_vsearch	1219	T	T	221	4	1.75%	2	2	93	93	0.06166574490670126	1	1	78	143	1	3	-G
H3_BC87_191109_LF_LIB_consensus_vsearch	1220	G	G	218	6	2.67%	2	2	93	93	0.015104203282490625	1	1	74	144	4	2	A
H3_BC87_191109_LF_LIB_consensus_vsearch	1221	G	G	224	3	1.31%	2	2	93	93	0.12417218543044797	1	1	77	147	2	1	A
H3_BC87_191109_LF_LIB_consensus_vsearch	1222	T	T	215	5	2.19%	2	2	93	93	0.03054059830172664	1	1	73	142	1	4	-GGT
H3_BC87_191109_LF_LIB_consensus_vsearch	1223	G	G	214	3	1.37%	2	1	93	93	0.12413394919162732	1	1	72	142	3	0	A
H3_BC87_191109_LF_LIB_consensus_vsearch	1224	G	*/-TG	212	10	4.5%	2	1	93	93	8.804765900705064E-4	1	1	77	135	0	10	-TG
H3_BC87_191109_LF_LIB_consensus_vsearch	1225	T	T	203	4	1.88%	2	2	93	93	0.06159311429633927	1	1	73	130	1	3	C
H3_BC87_191109_LF_LIB_consensus_vsearch	1226	G	G	208	5	2.34%	2	2	93	93	0.03051731330830772	1	1	73	135	3	2	A
H3_BC87_191109_LF_LIB_consensus_vsearch	1227	C	C	218	3	1.33%	2	1	93	93	0.12414965986396012	1	1	77	141	0	3	T
H3_BC87_191109_LF_LIB_consensus_vsearch	1228	A	A	213	5	2.19%	2	1	93	93	0.030534097847134272	1	1	75	138	0	5	-T
H3_BC87_191109_LF_LIB_consensus_vsearch	1229	T	T	212	5	2.25%	2	2	93	93	0.030530802741347875	1	1	77	135	1	4	-G
H3_BC87_191109_LF_LIB_consensus_vsearch	1230	G	R	207	10	4.5%	2	1	93	93	8.783305527122537E-4	1	1	68	139	10	0	A
H3_BC87_191109_LF_LIB_consensus_vsearch	1231	G	G	217	3	1.32%	2	1	93	93	0.12414578587710072	1	1	72	145	3	0	A
H3_BC87_191109_LF_LIB_consensus_vsearch	1232	C	C	216	6	2.67%	2	2	93	93	0.015099533131216845	1	1	76	140	1	5	T
H3_BC87_191109_LF_LIB_consensus_vsearch	1233	C	Y	213	8	3.52%	2	2	93	93	0.0036624519192641563	1	1	77	136	1	7	T
H3_BC87_191109_LF_LIB_consensus_vsearch	1234	G	G	217	3	1.32%	2	1	93	93	0.12414578587710072	1	1	73	144	3	0	+T
H3_BC87_191109_LF_LIB_consensus_vsearch	1235	T	T	223	3	1.32%	2	1	93	93	0.12416851441234596	1	1	80	143	0	3	C
H3_BC87_191109_LF_LIB_consensus_vsearch	1236	T	T	223	5	2.18%	2	1	93	93	0.03056546102900896	1	1	80	143	0	5	C
H3_BC87_191109_LF_LIB_consensus_vsearch	1237	C	C	219	6	2.63%	2	2	93	93	0.015106507368173285	1	1	79	140	1	5	-T
H3_BC87_191109_LF_LIB_consensus_vsearch	1238	T	T	220	2	0.9%	2	2	93	93	0.2494356659142869	1	1	77	143	1	1	C
H3_BC87_191109_LF_LIB_consensus_vsearch	1239	T	T	221	6	2.62%	2	2	93	93	0.015111054918444918	1	1	78	143	1	5	-A
H3_BC87_191109_LF_LIB_consensus_vsearch	1240	A	A	218	4	1.79%	2	2	93	93	0.061654458623218986	1	1	76	142	2	2	G
H3_BC87_191109_LF_LIB_consensus_vsearch	1241	G	G	229	0	0%	2	0	93	0	1.0	1	0	80	149	0	0	
H3_BC87_191109_LF_LIB_consensus_vsearch	1242	T	*/+C	219	7	3.06%	2	2	93	93	0.007452766938834958	1	1	78	141	1	6	+C
H3_BC87_191109_LF_LIB_consensus_vsearch	1243	T	T	222	5	2.18%	2	1	93	93	0.030562448911634975	1	1	78	144	0	5	-C
H3_BC87_191109_LF_LIB_consensus_vsearch	1244	C	C	216	4	1.79%	2	1	93	93	0.061646763238677425	1	1	76	140	4	0	+A
H3_BC87_191109_LF_LIB_consensus_vsearch	1245	G	G	221	4	1.75%	2	1	93	93	0.06166574490670126	1	1	74	147	4	0	T
H3_BC87_191109_LF_LIB_consensus_vsearch	1246	T	*/-G	187	31	13.66%	2	2	93	93	1.477681402091444E-10	1	1	75	112	1	30	-G
H3_BC87_191109_LF_LIB_consensus_vsearch	1247	G	G	187	3	1.57%	2	2	93	93	0.12401055408976878	1	1	76	111	2	1	A
H3_BC87_191109_LF_LIB_consensus_vsearch	1248	G	R	213	9	4.04%	2	2	93	93	0.0017981564163397133	1	1	78	135	2	7	A
H3_BC87_191109_LF_LIB_consensus_vsearch	1249	G	*/+A	209	8	3.57%	2	1	93	93	0.003658026926953576	1	1	70	139	8	0	+A
H3_BC87_191109_LF_LIB_consensus_vsearch	1250	G	G	219	3	1.32%	2	1	93	93	0.12415349887135622	1	1	78	141	0	3	A
H3_BC87_191109_LF_LIB_consensus_vsearch	1251	T	T	217	4	1.76%	2	2	93	93	0.0616506283607095	1	1	78	139	1	3	C
H3_BC87_191109_LF_LIB_consensus_vsearch	1252	G	G	224	1	0.44%	2	1	93	93	0.4999999999999138	1	1	79	145	0	1	+TG
H3_BC87_191109_LF_LIB_consensus_vsearch	1253	A	A	224	2	0.87%	2	2	93	93	0.24944567627499675	1	1	79	145	1	1	-C
H3_BC87_191109_LF_LIB_consensus_vsearch	1254	C	C	220	2	0.88%	2	1	93	93	0.2494356659142869	1	1	79	141	0	2	+T
H3_BC87_191109_LF_LIB_consensus_vsearch	1255	T	T	224	2	0.88%	2	1	93	93	0.24944567627499675	1	1	79	145	0	2	C
H3_BC87_191109_LF_LIB_consensus_vsearch	1256	T	T	221	3	1.31%	2	1	93	93	0.12416107382546236	1	1	80	141	0	3	+G
H3_BC87_191109_LF_LIB_consensus_vsearch	1257	G	G	223	3	1.32%	2	1	93	93	0.12416851441234596	1	1	79	144	0	3	+T
H3_BC87_191109_LF_LIB_consensus_vsearch	1258	T	T	227	0	0%	2	0	93	0	1.0	1	0	79	148	0	0	
H3_BC87_191109_LF_LIB_consensus_vsearch	1259	C	C	224	3	1.31%	2	1	93	93	0.12417218543044797	1	1	80	144	0	3	-T
H3_BC87_191109_LF_LIB_consensus_vsearch	1260	T	*/-G	216	7	3.1%	2	2	93	93	0.007447971960236055	1	1	77	139	1	6	-G
H3_BC87_191109_LF_LIB_consensus_vsearch	1261	G	G	217	4	1.8%	2	2	93	93	0.0616506283607095	1	1	75	142	3	1	A
H3_BC87_191109_LF_LIB_consensus_vsearch	1262	G	G	223	1	0.44%	2	1	93	93	0.5000000000003686	1	1	76	147	1	0	+A
H3_BC87_191109_LF_LIB_consensus_vsearch	1263	T	Y	218	9	3.96%	2	1	93	93	0.001801496644156972	1	1	78	140	0	9	C
H3_BC87_191109_LF_LIB_consensus_vsearch	1264	T	T	222	3	1.32%	2	2	93	93	0.12416481069040536	1	1	77	145	2	1	C
H3_BC87_191109_LF_LIB_consensus_vsearch	1265	G	G	227	1	0.44%	2	1	93	93	0.4999999999999138	1	1	78	149	1	0	+TTG
H3_BC87_191109_LF_LIB_consensus_vsearch	1266	A	A	227	1	0.44%	2	1	93	93	0.4999999999999138	1	1	80	147	0	1	+T
H3_BC87_191109_LF_LIB_consensus_vsearch	1267	T	T	227	1	0.44%	2	1	93	93	0.4999999999999138	1	1	80	147	0	1	+C
H3_BC87_191109_LF_LIB_consensus_vsearch	1268	T	*/-C	214	14	6.11%	2	2	93	93	4.968826086820383E-5	1	1	76	138	3	11	-C
H3_BC87_191109_LF_LIB_consensus_vsearch	1269	C	C	215	0	0%	2	0	93	0	1.0	1	0	77	138	0	0	
H3_BC87_191109_LF_LIB_consensus_vsearch	1270	C	*/+G	215	8	3.49%	2	1	93	93	0.0036646057936482192	1	1	80	135	0	8	+G
H3_BC87_191109_LF_LIB_consensus_vsearch	1271	G	G	227	1	0.44%	2	1	93	93	0.4999999999999138	1	1	79	148	1	0	-A
H3_BC87_191109_LF_LIB_consensus_vsearch	1272	A	A	227	1	0.44%	2	1	93	93	0.4999999999999138	1	1	78	149	1	0	G
H3_BC87_191109_LF_LIB_consensus_vsearch	1273	T	T	228	1	0.44%	2	1	93	93	0.4999999999999138	1	1	80	148	0	1	+A
H3_BC87_191109_LF_LIB_consensus_vsearch	1274	A	A	227	2	0.87%	2	2	93	93	0.24945295404843976	1	1	79	148	1	1	G
H3_BC87_191109_LF_LIB_consensus_vsearch	1275	A	A	226	2	0.87%	2	1	93	93	0.24945054945064127	1	1	78	148	2	0	G
H3_BC87_191109_LF_LIB_consensus_vsearch	1276	C	*/+A	217	8	3.49%	2	2	93	93	0.0036667219549938834	1	1	70	147	7	1	+A
H3_BC87_191109_LF_LIB_consensus_vsearch	1277	G	*/-A	214	9	3.93%	2	2	93	93	0.0017988361772468277	1	1	69	145	8	1	-A
H3_BC87_191109_LF_LIB_consensus_vsearch	1278	A	A	212	3	1.37%	2	1	93	93	0.1241258741259166	1	1	69	143	0	3	-G
H3_BC87_191109_LF_LIB_consensus_vsearch	1279	G	G	222	1	0.44%	2	1	93	93	0.4999999999999138	1	1	79	143	0	1	-C
H3_BC87_191109_LF_LIB_consensus_vsearch	1280	C	*/-G	211	7	3.08%	2	2	93	93	0.007439689863414905	1	1	70	141	5	2	-G
H3_BC87_191109_LF_LIB_consensus_vsearch	1281	G	G	218	1	0.45%	2	1	93	93	0.5000000000003686	1	1	74	144	0	1	+AAG
H3_BC87_191109_LF_LIB_consensus_vsearch	1282	A	A	224	2	0.88%	2	1	93	93	0.24944567627499675	1	1	76	148	2	0	G
H3_BC87_191109_LF_LIB_consensus_vsearch	1283	G	G	224	1	0.44%	2	1	93	93	0.4999999999999138	1	1	79	145	0	1	+C
H3_BC87_191109_LF_LIB_consensus_vsearch	1284	A	A	224	2	0.87%	2	1	93	93	0.24944567627499675	1	1	79	145	0	2	+C
H3_BC87_191109_LF_LIB_consensus_vsearch	1285	C	C	224	2	0.88%	2	1	93	93	0.24944567627499675	1	1	79	145	0	2	+T
H3_BC87_191109_LF_LIB_consensus_vsearch	1286	C	Y	208	11	4.8%	2	2	93	93	4.293291473235971E-4	1	1	75	133	1	10	T
H3_BC87_191109_LF_LIB_consensus_vsearch	1287	G	G	227	1	0.44%	2	1	93	93	0.4999999999999138	1	1	79	148	0	1	+T
H3_BC87_191109_LF_LIB_consensus_vsearch	1288	A	R	219	7	3.07%	2	2	93	93	0.007452766938834958	1	1	76	143	3	4	G
H3_BC87_191109_LF_LIB_consensus_vsearch	1289	G	G	225	1	0.44%	2	1	93	93	0.5000000000003686	1	1	80	145	0	1	+T
H3_BC87_191109_LF_LIB_consensus_vsearch	1290	A	*/-C	198	23	10.13%	2	2	93	93	6.520220361141492E-8	1	1	67	131	9	14	-C
H3_BC87_191109_LF_LIB_consensus_vsearch	1291	C	C	197	4	1.96%	2	1	93	93	0.06156600978754844	1	1	69	128	0	4	+T
H3_BC87_191109_LF_LIB_consensus_vsearch	1292	C	C	223	2	0.88%	2	1	93	93	0.24944320712692292	1	1	78	145	0	2	+TG
H3_BC87_191109_LF_LIB_consensus_vsearch	1293	C	*/-AA	177	15	6.55%	2	2	93	93	2.2967098326715997E-5	1	1	59	118	1	14	-AA
H3_BC87_191109_LF_LIB_consensus_vsearch	1294	A	A	187	4	2.06%	2	2	93	93	0.06151704651694607	1	1	64	123	2	2	G
H3_BC87_191109_LF_LIB_consensus_vsearch	1295	A	A	194	4	1.93%	2	1	93	93	0.061551840757540194	1	1	74	120	0	4	G
H3_BC87_191109_LF_LIB_consensus_vsearch	1296	G	K	202	12	5.48%	2	1	93	93	2.0835870377678545E-4	1	1	78	124	0	12	T
H3_BC87_191109_LF_LIB_consensus_vsearch	1297	G	G	227	1	0.44%	2	1	93	93	0.4999999999999138	1	1	78	149	1	0	-T
H3_BC87_191109_LF_LIB_consensus_vsearch	1298	T	Y	206	21	9.21%	2	1	93	93	2.937021083806429E-7	1	1	78	128	0	21	C
H3_BC87_191109_LF_LIB_consensus_vsearch	1299	T	T	216	6	2.62%	2	2	93	93	0.015099533131216845	1	1	76	140	4	2	-G
H3_BC87_191109_LF_LIB_consensus_vsearch	1300	G	G	214	6	2.71%	2	2	93	93	0.015094778470947015	1	1	71	143	4	2	A
H3_BC87_191109_LF_LIB_consensus_vsearch	1301	G	G	224	2	0.88%	2	2	93	93	0.24944567627499675	1	1	79	145	1	1	A
H3_BC87_191109_LF_LIB_consensus_vsearch	1302	C	C	217	4	1.76%	2	2	93	93	0.0616506283607095	1	1	75	142	3	1	+T
H3_BC87_191109_LF_LIB_consensus_vsearch	1303	G	G	219	3	1.32%	2	2	93	93	0.12415349887135622	1	1	74	145	2	1	A
H3_BC87_191109_LF_LIB_consensus_vsearch	1304	C	C	224	0	0%	2	0	93	0	1.0	1	0	78	146	0	0	
H3_BC87_191109_LF_LIB_consensus_vsearch	1305	C	Y	209	14	6.17%	2	1	93	93	4.9452447660699634E-5	1	1	78	131	0	14	T
H3_BC87_191109_LF_LIB_consensus_vsearch	1306	G	G	216	6	2.67%	2	2	93	93	0.015099533131216845	1	1	75	141	2	4	A
H3_BC87_191109_LF_LIB_consensus_vsearch	1307	T	T	219	6	2.67%	2	2	93	93	0.015106507368173285	1	1	79	140	1	5	C
H3_BC87_191109_LF_LIB_consensus_vsearch	1308	T	T	225	1	0.44%	2	1	93	93	0.5000000000003686	1	1	80	145	0	1	A
H3_BC87_191109_LF_LIB_consensus_vsearch	1309	T	*/-CCCT	140	41	17.98%	2	1	93	93	3.524825635434911E-14	1	1	74	66	0	41	-CCCT
H3_BC87_191109_LF_LIB_consensus_vsearch	1310	C	C	140	1	0.7%	2	1	93	93	0.4999999999999138	1	1	73	67	1	0	+A
H3_BC87_191109_LF_LIB_consensus_vsearch	1311	C	C	175	3	1.67%	2	2	93	93	0.12394366197182968	1	1	77	98	1	2	+T
H3_BC87_191109_LF_LIB_consensus_vsearch	1312	C	*/-T	158	17	9.19%	2	2	93	93	5.0735812454419365E-6	1	1	78	80	1	16	-T
H3_BC87_191109_LF_LIB_consensus_vsearch	1313	T	T	150	4	2.48%	2	2	93	93	0.061280504085009145	1	1	75	75	2	2	C
H3_BC87_191109_LF_LIB_consensus_vsearch	1314	C	C	209	1	0.46%	2	1	93	93	0.4999999999999138	1	1	76	133	1	0	+GCTC
H3_BC87_191109_LF_LIB_consensus_vsearch	1315	A	A	224	3	1.32%	2	2	93	93	0.12417218543044797	1	1	78	146	1	2	G
H3_BC87_191109_LF_LIB_consensus_vsearch	1316	T	T	222	2	0.88%	2	1	93	93	0.24944071588395061	1	1	78	144	0	2	C
H3_BC87_191109_LF_LIB_consensus_vsearch	1317	G	G	221	3	1.32%	2	1	93	93	0.12416107382546236	1	1	76	145	0	3	-T
H3_BC87_191109_LF_LIB_consensus_vsearch	1318	T	T	223	2	0.88%	2	1	93	93	0.24944320712692292	1	1	80	143	0	2	C
H3_BC87_191109_LF_LIB_consensus_vsearch	1319	T	T	226	1	0.44%	2	1	93	93	0.4999999999999138	1	1	78	148	1	0	-CTT
H3_BC87_191109_LF_LIB_consensus_vsearch	1320	C	*/-T	114	70	30.7%	2	2	93	93	2.408900375647962E-25	1	1	48	66	6	64	-T
H3_BC87_191109_LF_LIB_consensus_vsearch	1321	T	T	146	1	0.68%	2	1	93	93	0.5000000000001412	1	1	72	74	0	1	C
H3_BC87_191109_LF_LIB_consensus_vsearch	1322	T	T	216	1	0.46%	2	1	93	93	0.4999999999999138	1	1	78	138	0	1	+C
H3_BC87_191109_LF_LIB_consensus_vsearch	1323	T	T	223	1	0.44%	2	1	93	93	0.5000000000003686	1	1	79	144	0	1	+G
H3_BC87_191109_LF_LIB_consensus_vsearch	1324	T	*/-GG	181	29	12.66%	2	1	93	93	6.597097303356845E-10	1	1	77	104	0	29	-GG
H3_BC87_191109_LF_LIB_consensus_vsearch	1325	G	G	179	4	2.15%	2	1	93	93	0.061474017887485174	1	1	74	105	4	0	A
H3_BC87_191109_LF_LIB_consensus_vsearch	1326	G	G	191	4	2.01%	2	2	93	93	0.06153723520852315	1	1	76	115	3	1	A
H3_BC87_191109_LF_LIB_consensus_vsearch	1327	G	G	223	4	1.75%	2	1	93	93	0.061673103185009646	1	1	79	144	0	4	-C
H3_BC87_191109_LF_LIB_consensus_vsearch	1328	C	Y	197	13	5.8%	2	1	93	93	1.0080182645455998E-4	1	1	78	119	0	13	T
H3_BC87_191109_LF_LIB_consensus_vsearch	1329	T	T	215	4	1.82%	2	2	93	93	0.06164286277914926	1	1	76	139	2	2	C
H3_BC87_191109_LF_LIB_consensus_vsearch	1330	T	*/-C	212	7	3.12%	2	1	93	93	0.00744137624879223	1	1	76	136	0	7	-C
H3_BC87_191109_LF_LIB_consensus_vsearch	1331	C	C	211	3	1.35%	2	1	93	93	0.12412177985949331	1	1	78	133	0	3	+G
H3_BC87_191109_LF_LIB_consensus_vsearch	1332	G	G	219	6	2.63%	2	1	93	93	0.015106507368173285	1	1	71	148	6	0	-AG
H3_BC87_191109_LF_LIB_consensus_vsearch	1333	A	*/-G	207	7	3.17%	2	2	93	93	0.007432788253078562	1	1	63	144	6	1	-G
H3_BC87_191109_LF_LIB_consensus_vsearch	1334	G	G	209	1	0.47%	2	1	93	93	0.4999999999999138	1	1	65	144	0	1	+T
H3_BC87_191109_LF_LIB_consensus_vsearch	1335	G	G	226	0	0%	2	0	93	0	1.0	1	0	78	148	0	0	
H3_BC87_191109_LF_LIB_consensus_vsearch	1336	G	G	225	1	0.44%	2	1	93	93	0.5000000000003686	1	1	77	148	1	0	+AG
H3_BC87_191109_LF_LIB_consensus_vsearch	1337	C	*/-GGC	213	7	3.08%	2	2	93	93	0.007443047448823043	1	1	75	138	4	3	-GGC
H3_BC87_191109_LF_LIB_consensus_vsearch	1338	G	G	212	6	2.74%	2	2	93	93	0.015089936987088519	1	1	71	141	5	1	A
H3_BC87_191109_LF_LIB_consensus_vsearch	1339	G	G	220	1	0.45%	2	1	93	93	0.4999999999999138	1	1	76	144	0	1	+TAG
H3_BC87_191109_LF_LIB_consensus_vsearch	1340	C	C	212	5	2.25%	2	1	93	93	0.030530802741347875	1	1	68	144	5	0	-GC
H3_BC87_191109_LF_LIB_consensus_vsearch	1341	G	*/+C	212	7	3.17%	2	1	93	93	0.00744137624879223	1	1	71	141	0	7	+C
H3_BC87_191109_LF_LIB_consensus_vsearch	1342	C	C	205	6	2.69%	2	1	93	93	0.015072272591959035	1	1	71	134	0	6	+GC
H3_BC87_191109_LF_LIB_consensus_vsearch	1343	T	T	213	4	1.78%	2	1	93	93	0.06163495389099757	1	1	77	136	0	4	-C
H3_BC87_191109_LF_LIB_consensus_vsearch	1344	C	*/-T	205	12	5.41%	2	2	93	93	2.0882828978061456E-4	1	1	78	127	1	11	-T
H3_BC87_191109_LF_LIB_consensus_vsearch	1345	T	T	211	2	0.94%	2	2	93	93	0.24941176470603904	1	1	77	134	1	1	C
H3_BC87_191109_LF_LIB_consensus_vsearch	1346	T	T	218	3	1.32%	2	1	93	93	0.12414965986396012	1	1	75	143	0	3	-CTT
H3_BC87_191109_LF_LIB_consensus_vsearch	1347	C	*/-T	197	15	6.73%	2	1	93	93	2.361399232959602E-5	1	1	75	122	0	15	-T
H3_BC87_191109_LF_LIB_consensus_vsearch	1348	T	T	198	3	1.45%	2	1	93	93	0.12406483790525294	1	1	73	125	0	3	+C
H3_BC87_191109_LF_LIB_consensus_vsearch	1349	T	T	213	4	1.79%	2	2	93	93	0.06163495389099757	1	1	74	139	3	1	C
H3_BC87_191109_LF_LIB_consensus_vsearch	1350	G	G	223	3	1.32%	2	1	93	93	0.12416851441234596	1	1	76	147	3	0	A
H3_BC87_191109_LF_LIB_consensus_vsearch	1351	C	C	217	4	1.76%	2	2	93	93	0.0616506283607095	1	1	74	143	2	2	-GC
H3_BC87_191109_LF_LIB_consensus_vsearch	1352	G	G	212	4	1.81%	2	1	93	93	0.061630944461591126	1	1	67	145	4	0	-C
H3_BC87_191109_LF_LIB_consensus_vsearch	1353	C	C	217	1	0.45%	2	1	93	93	0.4999999999999138	1	1	72	145	1	0	+A
H3_BC87_191109_LF_LIB_consensus_vsearch	1354	C	*/-T	209	10	4.39%	2	2	93	93	8.792003591123169E-4	1	1	69	140	2	8	-T
H3_BC87_191109_LF_LIB_consensus_vsearch	1355	T	T	207	4	1.88%	2	2	93	93	0.06161032658914256	1	1	67	140	3	1	C
H3_BC87_191109_LF_LIB_consensus_vsearch	1356	T	*/-G	173	14	6.28%	2	2	93	93	4.7416220807620975E-5	1	1	62	111	5	9	-G
H3_BC87_191109_LF_LIB_consensus_vsearch	1357	G	R	165	24	12%	2	2	93	93	2.73468879763707E-8	1	1	56	109	8	16	A
H3_BC87_191109_LF_LIB_consensus_vsearch	1358	G	R	200	14	6.51%	2	2	93	93	4.9002433333818565E-5	1	1	69	131	9	5	A
H3_BC87_191109_LF_LIB_consensus_vsearch	1359	G	R	214	13	5.73%	2	1	93	93	1.0229936061105097E-4	1	1	79	135	0	13	A
H3_BC87_191109_LF_LIB_consensus_vsearch	1360	G	G	220	4	1.75%	2	1	93	93	0.061662016439223415	1	1	78	142	0	4	A
H3_BC87_191109_LF_LIB_consensus_vsearch	1361	A	A	218	4	1.75%	2	2	93	93	0.061654458623218986	1	1	73	145	3	1	-C
H3_BC87_191109_LF_LIB_consensus_vsearch	1362	C	C	220	3	1.35%	2	1	93	93	0.12415730337075404	1	1	76	144	0	3	T
H3_BC87_191109_LF_LIB_consensus_vsearch	1363	C	Y	214	7	3.08%	2	2	93	93	0.007444703667648697	1	1	75	139	1	6	T
H3_BC87_191109_LF_LIB_consensus_vsearch	1364	G	R	211	11	4.89%	2	2	93	93	4.300945555177922E-4	1	1	68	143	9	2	A
H3_BC87_191109_LF_LIB_consensus_vsearch	1365	G	G	222	5	2.19%	2	2	93	93	0.030562448911634975	1	1	74	148	4	1	A
H3_BC87_191109_LF_LIB_consensus_vsearch	1366	C	C	223	2	0.88%	2	1	93	93	0.24944320712692292	1	1	76	147	0	2	T
H3_BC87_191109_LF_LIB_consensus_vsearch	1367	G	G	217	6	2.62%	2	2	93	93	0.015101878629034914	1	1	71	146	4	2	-C
H3_BC87_191109_LF_LIB_consensus_vsearch	1368	C	C	213	3	1.36%	2	2	93	93	0.12412993039444345	1	1	70	143	1	2	T
H3_BC87_191109_LF_LIB_consensus_vsearch	1369	C	C	225	1	0.44%	2	1	93	93	0.5000000000003686	1	1	76	149	1	0	T
H3_BC87_191109_LF_LIB_consensus_vsearch	1370	C	C	220	4	1.75%	2	2	93	93	0.061662016439223415	1	1	76	144	2	2	T
H3_BC87_191109_LF_LIB_consensus_vsearch	1371	G	R	213	10	4.41%	2	2	93	93	8.808946039600796E-4	1	1	68	145	9	1	A
H3_BC87_191109_LF_LIB_consensus_vsearch	1372	G	G	222	3	1.31%	2	1	93	93	0.12416481069040536	1	1	74	148	3	0	-T
H3_BC87_191109_LF_LIB_consensus_vsearch	1373	T	T	222	1	0.44%	2	1	93	93	0.4999999999999138	1	1	75	147	1	0	+GG
H3_BC87_191109_LF_LIB_consensus_vsearch	1374	T	*/-A	193	23	10.09%	2	2	93	93	6.424757004919106E-8	1	1	59	134	17	6	-A
H3_BC87_191109_LF_LIB_consensus_vsearch	1375	A	R	188	8	3.98%	2	2	93	93	0.0036318839680821967	1	1	54	134	5	3	G
H3_BC87_191109_LF_LIB_consensus_vsearch	1376	A	*/-G	199	10	4.46%	2	2	93	93	8.746903119674215E-4	1	1	69	130	4	6	-G
H3_BC87_191109_LF_LIB_consensus_vsearch	1377	G	G	205	6	2.75%	2	1	93	93	0.015072272591959035	1	1	69	136	6	0	+A
H3_BC87_191109_LF_LIB_consensus_vsearch	1378	G	*/+A	207	11	4.82%	2	1	93	93	4.2906952287648286E-4	1	1	60	147	11	0	+A
H3_BC87_191109_LF_LIB_consensus_vsearch	1379	G	G	223	5	2.18%	2	2	93	93	0.03056546102900896	1	1	75	148	4	1	A
H3_BC87_191109_LF_LIB_consensus_vsearch	1380	C	C	227	1	0.44%	2	1	93	93	0.4999999999999138	1	1	80	147	0	1	+G
H3_BC87_191109_LF_LIB_consensus_vsearch	1381	G	*/-TG	211	11	4.8%	2	1	93	93	4.300945555177922E-4	1	1	77	134	0	11	-TG
H3_BC87_191109_LF_LIB_consensus_vsearch	1382	T	T	206	5	2.33%	2	1	93	93	0.030510377042941562	1	1	79	127	0	5	-G
H3_BC87_191109_LF_LIB_consensus_vsearch	1383	G	G	207	2	0.94%	2	2	93	93	0.24940047961641743	1	1	77	130	1	1	+A
H3_BC87_191109_LF_LIB_consensus_vsearch	1384	G	G	222	2	0.88%	2	2	93	93	0.24944071588395061	1	1	76	146	1	1	-A
H3_BC87_191109_LF_LIB_consensus_vsearch	1385	A	A	210	5	2.23%	2	2	93	93	0.0305241206880699	1	1	69	141	4	1	+G
H3_BC87_191109_LF_LIB_consensus_vsearch	1386	G	G	219	1	0.45%	2	1	93	93	0.4999999999999138	1	1	74	145	1	0	+A
H3_BC87_191109_LF_LIB_consensus_vsearch	1387	G	G	224	2	0.88%	2	1	93	93	0.24944567627499675	1	1	79	145	0	2	+A
H3_BC87_191109_LF_LIB_consensus_vsearch	1388	T	T	221	3	1.31%	2	2	93	93	0.12416107382546236	1	1	78	143	1	2	-GC
H3_BC87_191109_LF_LIB_consensus_vsearch	1389	G	*/-CT	208	9	3.98%	2	1	93	93	0.0017946657928001688	1	1	64	144	9	0	-CT
H3_BC87_191109_LF_LIB_consensus_vsearch	1390	C	*/-T	186	11	5.21%	2	2	93	93	4.2303631514374124E-4	1	1	58	128	6	5	-T
H3_BC87_191109_LF_LIB_consensus_vsearch	1391	T	T	198	2	0.98%	2	1	93	93	0.24937343358388336	1	1	55	143	2	0	+A
H3_BC87_191109_LF_LIB_consensus_vsearch	1392	T	T	207	5	2.23%	2	1	93	93	0.030513861513988962	1	1	67	140	5	0	C
H3_BC87_191109_LF_LIB_consensus_vsearch	1393	G	R	203	15	6.79%	2	1	93	93	2.37871086741396E-5	1	1	58	145	15	0	A
H3_BC87_191109_LF_LIB_consensus_vsearch	1394	G	G	221	3	1.32%	2	2	93	93	0.12416107382546236	1	1	75	146	2	1	A
H3_BC87_191109_LF_LIB_consensus_vsearch	1395	C	*/-A	200	21	9.29%	2	2	93	93	2.896747146375421E-7	1	1	74	126	3	18	-A
H3_BC87_191109_LF_LIB_consensus_vsearch	1396	A	A	202	1	0.48%	2	1	93	93	0.4999999999999138	1	1	74	128	0	1	+C
H3_BC87_191109_LF_LIB_consensus_vsearch	1397	A	*/-TAA	209	10	4.39%	2	2	93	93	8.792003591123169E-4	1	1	75	134	1	9	-TAA
H3_BC87_191109_LF_LIB_consensus_vsearch	1398	T	Y	190	19	8.88%	2	2	93	93	1.2429986855259503E-6	1	1	73	117	2	17	C
H3_BC87_191109_LF_LIB_consensus_vsearch	1399	A	A	210	3	1.4%	2	1	93	93	0.1241176470588473	1	1	75	135	0	3	C
H3_BC87_191109_LF_LIB_consensus_vsearch	1400	A	A	209	6	2.74%	2	1	93	93	0.015082506692930204	1	1	72	137	6	0	G
H3_BC87_191109_LF_LIB_consensus_vsearch	1401	C	C	216	6	2.63%	2	2	93	93	0.015099533131216845	1	1	74	142	1	5	T
H3_BC87_191109_LF_LIB_consensus_vsearch	1402	A	R	205	15	6.61%	2	1	93	93	2.384291138391124E-5	1	1	62	143	15	0	G
H3_BC87_191109_LF_LIB_consensus_vsearch	1403	G	G	222	2	0.89%	2	1	93	93	0.24944071588395061	1	1	78	144	2	0	+A
H3_BC87_191109_LF_LIB_consensus_vsearch	1404	G	G	221	2	0.88%	2	1	93	93	0.24943820224728358	1	1	78	143	0	2	+T
H3_BC87_191109_LF_LIB_consensus_vsearch	1405	T	T	220	3	1.31%	2	1	93	93	0.12415730337075404	1	1	77	143	0	3	-C
H3_BC87_191109_LF_LIB_consensus_vsearch	1406	C	C	216	5	2.23%	2	2	93	93	0.030543804461782422	1	1	76	140	1	4	-T
H3_BC87_191109_LF_LIB_consensus_vsearch	1407	T	T	212	3	1.36%	2	1	93	93	0.1241258741259166	1	1	76	136	0	3	A
H3_BC87_191109_LF_LIB_consensus_vsearch	1408	G	G	215	5	2.2%	2	1	93	93	0.03054059830172664	1	1	77	138	0	5	C
H3_BC87_191109_LF_LIB_consensus_vsearch	1409	T	W	208	8	3.6%	2	1	93	93	0.0036568954742723925	1	1	76	132	0	8	A
H3_BC87_191109_LF_LIB_consensus_vsearch	1410	G	G	217	2	0.89%	2	2	93	93	0.24942791762028085	1	1	75	142	1	1	-A
H3_BC87_191109_LF_LIB_consensus_vsearch	1411	A	A	221	2	0.89%	2	1	93	93	0.24943820224728358	1	1	78	143	0	2	G
H3_BC87_191109_LF_LIB_consensus_vsearch	1412	T	T	220	3	1.33%	2	2	93	93	0.12415730337075404	1	1	78	142	1	2	C
H3_BC87_191109_LF_LIB_consensus_vsearch	1413	G	*/-C	214	7	3.11%	2	2	93	93	0.007444703667648697	1	1	77	137	2	5	-C
H3_BC87_191109_LF_LIB_consensus_vsearch	1414	C	C	215	2	0.92%	2	1	93	93	0.2494226327944578	1	1	76	139	0	2	+T
H3_BC87_191109_LF_LIB_consensus_vsearch	1415	C	C	219	3	1.32%	2	1	93	93	0.12415349887135622	1	1	75	144	3	0	+G
H3_BC87_191109_LF_LIB_consensus_vsearch	1416	C	*/+T	200	12	5.26%	2	1	93	93	2.0803866112796158E-4	1	1	75	125	0	12	+T
H3_BC87_191109_LF_LIB_consensus_vsearch	1417	T	T	212	3	1.4%	2	1	93	93	0.1241258741259166	1	1	75	137	0	3	C
H3_BC87_191109_LF_LIB_consensus_vsearch	1418	T	Y	215	9	3.98%	2	2	93	93	0.0017995100038167202	1	1	75	140	2	7	C
H3_BC87_191109_LF_LIB_consensus_vsearch	1419	A	A	218	4	1.76%	2	2	93	93	0.061654458623218986	1	1	76	142	1	3	+G
H3_BC87_191109_LF_LIB_consensus_vsearch	1420	G	G	226	1	0.44%	2	1	93	93	0.4999999999999138	1	1	78	148	1	0	+TA
H3_BC87_191109_LF_LIB_consensus_vsearch	1421	A	A	226	1	0.44%	2	1	93	93	0.4999999999999138	1	1	79	147	0	1	G
H3_BC87_191109_LF_LIB_consensus_vsearch	1422	T	T	229	0	0%	2	0	93	0	1.0	1	0	80	149	0	0	
H3_BC87_191109_LF_LIB_consensus_vsearch	1423	G	G	229	0	0%	2	0	93	0	1.0	1	0	80	149	0	0	
H3_BC87_191109_LF_LIB_consensus_vsearch	1424	T	*/-C	218	9	3.93%	2	2	93	93	0.001801496644156972	1	1	71	147	8	1	-C
H3_BC87_191109_LF_LIB_consensus_vsearch	1425	C	C	217	2	0.91%	2	1	93	93	0.24942791762028085	1	1	71	146	0	2	T
H3_BC87_191109_LF_LIB_consensus_vsearch	1426	C	C	221	3	1.31%	2	1	93	93	0.12416107382546236	1	1	79	142	0	3	-TG
H3_BC87_191109_LF_LIB_consensus_vsearch	1427	T	*/-G	211	10	4.44%	2	2	93	93	8.800549103686053E-4	1	1	79	132	1	9	-G
H3_BC87_191109_LF_LIB_consensus_vsearch	1428	G	G	212	1	0.47%	2	1	93	93	0.5000000000001412	1	1	79	133	0	1	+TG
H3_BC87_191109_LF_LIB_consensus_vsearch	1429	G	G	225	2	0.88%	2	1	93	93	0.24944812362040697	1	1	78	147	2	0	+A
H3_BC87_191109_LF_LIB_consensus_vsearch	1430	G	G	217	5	2.18%	2	2	93	93	0.03054698177238809	1	1	76	141	3	2	-C
H3_BC87_191109_LF_LIB_consensus_vsearch	1431	C	Y	213	9	4.02%	2	1	93	93	0.0017981564163397133	1	1	77	136	0	9	T
H3_BC87_191109_LF_LIB_consensus_vsearch	1432	C	Y	210	11	4.8%	2	1	93	93	4.298416344617859E-4	1	1	78	132	0	11	T
H3_BC87_191109_LF_LIB_consensus_vsearch	1433	G	G	220	4	1.78%	2	2	93	93	0.061662016439223415	1	1	75	145	3	1	A
H3_BC87_191109_LF_LIB_consensus_vsearch	1434	C	Y	209	8	3.54%	2	1	93	93	0.003658026926953576	1	1	75	134	0	8	T
H3_BC87_191109_LF_LIB_consensus_vsearch	1435	A	A	209	6	2.69%	2	1	93	93	0.015082506692930204	1	1	75	134	0	6	+T
H3_BC87_191109_LF_LIB_consensus_vsearch	1436	C	C	205	4	1.83%	2	2	93	93	0.06160180289502593	1	1	76	129	1	3	+G
H3_BC87_191109_LF_LIB_consensus_vsearch	1437	G	G	215	5	2.22%	2	2	93	93	0.03054059830172664	1	1	78	137	1	4	-C
H3_BC87_191109_LF_LIB_consensus_vsearch	1438	C	*/-GCGC	196	9	4.07%	2	2	93	93	0.001785610469261078	1	1	70	126	6	3	-GCGC
H3_BC87_191109_LF_LIB_consensus_vsearch	1439	G	G	198	5	2.33%	2	1	93	93	0.03048126704040718	1	1	71	127	0	5	-C
H3_BC87_191109_LF_LIB_consensus_vsearch	1440	C	*/-GC	132	45	21.84%	2	2	93	93	1.1472209557960056E-15	1	1	47	85	23	22	-GC
H3_BC87_191109_LF_LIB_consensus_vsearch	1441	G	G	146	6	3.7%	2	2	93	93	0.014859186004156795	1	1	46	100	1	5	A
H3_BC87_191109_LF_LIB_consensus_vsearch	1442	C	C	145	6	3.61%	2	2	93	93	0.014854149333417863	1	1	42	103	1	5	T
H3_BC87_191109_LF_LIB_consensus_vsearch	1443	T	Y	201	11	5.09%	2	1	93	93	4.274625226161483E-4	1	1	76	125	0	11	C
H3_BC87_191109_LF_LIB_consensus_vsearch	1444	A	R	210	7	3.15%	2	2	93	93	0.007437988084800957	1	1	71	139	5	2	G
H3_BC87_191109_LF_LIB_consensus_vsearch	1445	C	C	217	5	2.22%	2	2	93	93	0.03054698177238809	1	1	73	144	4	1	-AC
H3_BC87_191109_LF_LIB_consensus_vsearch	1446	A	A	223	1	0.45%	2	1	93	93	0.5000000000003686	1	1	76	147	0	1	+C
H3_BC87_191109_LF_LIB_consensus_vsearch	1447	C	C	219	3	1.34%	2	1	93	93	0.12415349887135622	1	1	76	143	0	3	T
H3_BC87_191109_LF_LIB_consensus_vsearch	1448	T	*/+G	212	13	5.68%	2	1	93	93	1.0213418662308634E-4	1	1	79	133	0	13	+G
H3_BC87_191109_LF_LIB_consensus_vsearch	1449	G	G	227	1	0.44%	2	1	93	93	0.4999999999999138	1	1	79	148	0	1	+CC
H3_BC87_191109_LF_LIB_consensus_vsearch	1450	A	A	227	1	0.44%	2	1	93	93	0.4999999999999138	1	1	79	148	0	1	-T
H3_BC87_191109_LF_LIB_consensus_vsearch	1451	T	T	225	2	0.88%	2	1	93	93	0.24944812362040697	1	1	79	146	0	2	+G
H3_BC87_191109_LF_LIB_consensus_vsearch	1452	G	R	218	7	3.06%	2	2	93	93	0.007451182688346346	1	1	73	145	6	1	A
H3_BC87_191109_LF_LIB_consensus_vsearch	1453	C	C	221	6	2.64%	2	1	93	93	0.015111054918444918	1	1	74	147	6	0	+G
H3_BC87_191109_LF_LIB_consensus_vsearch	1454	A	A	217	6	2.64%	2	1	93	93	0.015101878629034914	1	1	71	146	6	0	-G
H3_BC87_191109_LF_LIB_consensus_vsearch	1455	G	G	221	1	0.45%	2	1	93	93	0.4999999999999138	1	1	74	147	0	1	-AC
H3_BC87_191109_LF_LIB_consensus_vsearch	1456	A	A	221	2	0.88%	2	1	93	93	0.24943820224728358	1	1	76	145	2	0	+C
H3_BC87_191109_LF_LIB_consensus_vsearch	1457	C	C	221	4	1.75%	2	2	93	93	0.06166574490670126	1	1	78	143	1	3	-A
H3_BC87_191109_LF_LIB_consensus_vsearch	1458	A	A	222	1	0.45%	2	1	93	93	0.4999999999999138	1	1	78	144	1	0	G
H3_BC87_191109_LF_LIB_consensus_vsearch	1459	A	A	223	2	0.88%	2	2	93	93	0.24944320712692292	1	1	79	144	1	1	-TG
H3_BC87_191109_LF_LIB_consensus_vsearch	1460	T	*/-G	208	13	5.78%	2	2	93	93	1.0179544238135389E-4	1	1	76	132	3	10	-G
H3_BC87_191109_LF_LIB_consensus_vsearch	1461	G	G	210	2	0.93%	2	1	93	93	0.24940898345148782	1	1	76	134	0	2	C
H3_BC87_191109_LF_LIB_consensus_vsearch	1462	G	G	225	1	0.44%	2	1	93	93	0.5000000000003686	1	1	78	147	1	0	+A
H3_BC87_191109_LF_LIB_consensus_vsearch	1463	G	G	227	1	0.44%	2	1	93	93	0.4999999999999138	1	1	78	149	1	0	+A
H3_BC87_191109_LF_LIB_consensus_vsearch	1464	C	C	224	2	0.87%	2	1	93	93	0.24944567627499675	1	1	77	147	0	2	T
H3_BC87_191109_LF_LIB_consensus_vsearch	1465	A	A	222	3	1.32%	2	2	93	93	0.12416481069040536	1	1	76	146	2	1	G
H3_BC87_191109_LF_LIB_consensus_vsearch	1466	T	T	222	2	0.88%	2	1	93	93	0.24944071588395061	1	1	78	144	0	2	+C
H3_BC87_191109_LF_LIB_consensus_vsearch	1467	T	T	219	4	1.75%	2	1	93	93	0.06165825449566743	1	1	76	143	0	4	C
H3_BC87_191109_LF_LIB_consensus_vsearch	1468	C	C	223	2	0.88%	2	1	93	93	0.24944320712692292	1	1	76	147	2	0	T
H3_BC87_191109_LF_LIB_consensus_vsearch	1469	A	A	223	2	0.88%	2	2	93	93	0.24944320712692292	1	1	77	146	1	1	G
H3_BC87_191109_LF_LIB_consensus_vsearch	1470	C	C	219	4	1.77%	2	1	93	93	0.06165825449566743	1	1	77	142	0	4	+T
H3_BC87_191109_LF_LIB_consensus_vsearch	1471	C	C	216	6	2.64%	2	1	93	93	0.015099533131216845	1	1	76	140	0	6	-T
H3_BC87_191109_LF_LIB_consensus_vsearch	1472	T	Y	204	14	6.36%	2	1	93	93	4.920666598282105E-5	1	1	77	127	0	14	C
H3_BC87_191109_LF_LIB_consensus_vsearch	1473	A	A	220	4	1.77%	2	2	93	93	0.061662016439223415	1	1	74	146	2	2	G
H3_BC87_191109_LF_LIB_consensus_vsearch	1474	T	T	215	4	1.76%	2	2	93	93	0.06164286277914926	1	1	69	146	2	2	+C
H3_BC87_191109_LF_LIB_consensus_vsearch	1475	C	C	221	1	0.45%	2	1	93	93	0.4999999999999138	1	1	73	148	1	0	+A
H3_BC87_191109_LF_LIB_consensus_vsearch	1476	C	C	220	4	1.79%	2	1	93	93	0.061662016439223415	1	1	75	145	0	4	+T
H3_BC87_191109_LF_LIB_consensus_vsearch	1477	C	Y	171	25	10.92%	2	1	93	93	1.3166237659877573E-8	1	1	70	101	0	25	T
H3_BC87_191109_LF_LIB_consensus_vsearch	1478	G	*/-A	215	7	3.1%	2	2	93	93	0.007446345105805389	1	1	69	146	6	1	-A
H3_BC87_191109_LF_LIB_consensus_vsearch	1479	A	*/-G	196	21	9.46%	2	1	93	93	2.868926012059276E-7	1	1	51	145	21	0	-G
H3_BC87_191109_LF_LIB_consensus_vsearch	1480	G	*/-AG	194	8	3.85%	2	1	93	93	0.003639898683792886	1	1	55	139	0	8	-AG
H3_BC87_191109_LF_LIB_consensus_vsearch	1481	A	*/-G	205	9	4.17%	2	2	93	93	0.0017924949478988227	1	1	67	138	8	1	-G
H3_BC87_191109_LF_LIB_consensus_vsearch	1482	G	G	204	3	1.43%	2	1	93	93	0.12409200968526074	1	1	66	138	3	0	A
H3_BC87_191109_LF_LIB_consensus_vsearch	1483	G	*/+A	218	7	3.08%	2	1	93	93	0.007451182688346346	1	1	69	149	7	0	+A
H3_BC87_191109_LF_LIB_consensus_vsearch	1484	G	G	221	3	1.32%	2	1	93	93	0.12416107382546236	1	1	74	147	3	0	A
H3_BC87_191109_LF_LIB_consensus_vsearch	1485	C	C	223	1	0.44%	2	1	93	93	0.5000000000003686	1	1	79	144	1	0	+A
H3_BC87_191109_LF_LIB_consensus_vsearch	1486	T	T	212	6	2.63%	2	1	93	93	0.015089936987088519	1	1	75	137	0	6	-GG
H3_BC87_191109_LF_LIB_consensus_vsearch	1487	G	R	207	7	3.2%	2	1	93	93	0.007432788253078562	1	1	68	139	7	0	A
H3_BC87_191109_LF_LIB_consensus_vsearch	1488	G	*/+A	207	7	3.14%	2	1	93	93	0.007432788253078562	1	1	67	140	7	0	+A
H3_BC87_191109_LF_LIB_consensus_vsearch	1489	G	G	226	1	0.44%	2	1	93	93	0.4999999999999138	1	1	79	147	0	1	+A
H3_BC87_191109_LF_LIB_consensus_vsearch	1490	T	Y	214	8	3.51%	2	1	93	93	0.003663533633296164	1	1	76	138	0	8	C
H3_BC87_191109_LF_LIB_consensus_vsearch	1491	A	A	223	2	0.88%	2	1	93	93	0.24944320712692292	1	1	76	147	2	0	G
H3_BC87_191109_LF_LIB_consensus_vsearch	1492	A	A	221	4	1.75%	2	1	93	93	0.06166574490670126	1	1	78	143	0	4	-T
H3_BC87_191109_LF_LIB_consensus_vsearch	1493	T	T	210	5	2.25%	2	2	93	93	0.0305241206880699	1	1	71	139	1	4	+C
H3_BC87_191109_LF_LIB_consensus_vsearch	1494	C	C	220	1	0.45%	2	1	93	93	0.4999999999999138	1	1	73	147	0	1	T
H3_BC87_191109_LF_LIB_consensus_vsearch	1495	C	C	220	4	1.75%	2	1	93	93	0.061662016439223415	1	1	78	142	0	4	-T
H3_BC87_191109_LF_LIB_consensus_vsearch	1496	T	Y	193	11	4.93%	2	1	93	93	4.251792957023273E-4	1	1	77	116	0	11	C
H3_BC87_191109_LF_LIB_consensus_vsearch	1497	G	*/-TG	205	10	4.44%	2	2	93	93	8.774450793915666E-4	1	1	69	136	8	2	-TG
H3_BC87_191109_LF_LIB_consensus_vsearch	1498	T	W	199	8	3.74%	2	1	93	93	0.0036462285478980633	1	1	67	132	0	8	A
H3_BC87_191109_LF_LIB_consensus_vsearch	1499	G	G	212	3	1.39%	2	1	93	93	0.1241258741259166	1	1	71	141	0	3	C
H3_BC87_191109_LF_LIB_consensus_vsearch	1500	A	*/-G	213	11	4.82%	2	2	93	93	4.305938947768699E-4	1	1	69	144	7	4	-G
H3_BC87_191109_LF_LIB_consensus_vsearch	1501	G	G	215	1	0.46%	2	1	93	93	0.4999999999999138	1	1	71	144	1	0	+AA
H3_BC87_191109_LF_LIB_consensus_vsearch	1502	G	G	226	1	0.44%	2	1	93	93	0.4999999999999138	1	1	79	147	0	1	+T
H3_BC87_191109_LF_LIB_consensus_vsearch	1503	C	C	224	1	0.44%	2	1	93	93	0.4999999999999138	1	1	78	146	1	0	+T
H3_BC87_191109_LF_LIB_consensus_vsearch	1504	T	T	217	6	2.63%	2	1	93	93	0.015101878629034914	1	1	78	139	0	6	C
H3_BC87_191109_LF_LIB_consensus_vsearch	1505	G	G	223	2	0.88%	2	2	93	93	0.24944320712692292	1	1	77	146	1	1	C
H3_BC87_191109_LF_LIB_consensus_vsearch	1506	C	C	224	3	1.32%	2	1	93	93	0.12417218543044797	1	1	78	146	0	3	T
H3_BC87_191109_LF_LIB_consensus_vsearch	1507	A	*/-T	219	7	3.06%	2	1	93	93	0.007452766938834958	1	1	80	139	0	7	-T
H3_BC87_191109_LF_LIB_consensus_vsearch	1508	T	T	214	2	0.9%	2	2	93	93	0.24941995359642635	1	1	77	137	1	1	-C
H3_BC87_191109_LF_LIB_consensus_vsearch	1509	C	C	224	1	0.44%	2	1	93	93	0.4999999999999138	1	1	79	145	0	1	+A
H3_BC87_191109_LF_LIB_consensus_vsearch	1510	G	*/-TG	215	8	3.51%	2	1	93	93	0.0036646057936482192	1	1	79	136	0	8	-TG
H3_BC87_191109_LF_LIB_consensus_vsearch	1511	T	T	212	3	1.36%	2	1	93	93	0.1241258741259166	1	1	79	133	0	3	A
H3_BC87_191109_LF_LIB_consensus_vsearch	1512	G	*/-C	206	10	4.57%	2	1	93	93	8.778898007284436E-4	1	1	80	126	0	10	-C
H3_BC87_191109_LF_LIB_consensus_vsearch	1513	C	Y	206	8	3.7%	2	1	93	93	0.0036546013500883302	1	1	79	127	0	8	T
H3_BC87_191109_LF_LIB_consensus_vsearch	1514	T	*/-G	180	42	18.5%	2	2	93	93	2.6673270674157487E-14	1	1	52	128	25	17	-G
H3_BC87_191109_LF_LIB_consensus_vsearch	1515	G	K	173	9	4.86%	2	1	93	93	0.001765008337317725	1	1	52	121	0	9	T
H3_BC87_191109_LF_LIB_consensus_vsearch	1516	G	G	222	3	1.32%	2	1	93	93	0.12416481069040536	1	1	76	146	3	0	A
H3_BC87_191109_LF_LIB_consensus_vsearch	1517	G	R	205	22	9.61%	2	2	93	93	1.3972894763610762E-7	1	1	59	146	21	1	A
H3_BC87_191109_LF_LIB_consensus_vsearch	1518	G	G	223	4	1.75%	2	1	93	93	0.061673103185009646	1	1	74	149	4	0	A
H3_BC87_191109_LF_LIB_consensus_vsearch	1519	A	A	226	1	0.44%	2	1	93	93	0.4999999999999138	1	1	78	148	0	1	+C
H3_BC87_191109_LF_LIB_consensus_vsearch	1520	T	T	224	3	1.31%	2	1	93	93	0.12417218543044797	1	1	75	149	3	0	+C
H3_BC87_191109_LF_LIB_consensus_vsearch	1521	C	C	215	6	2.62%	2	1	93	93	0.01509716650743782	1	1	75	140	0	6	+G
H3_BC87_191109_LF_LIB_consensus_vsearch	1522	G	G	220	4	1.77%	2	2	93	93	0.061662016439223415	1	1	74	146	3	1	-A
H3_BC87_191109_LF_LIB_consensus_vsearch	1523	A	A	220	2	0.89%	2	2	93	93	0.2494356659142869	1	1	74	146	1	1	-G
H3_BC87_191109_LF_LIB_consensus_vsearch	1524	G	G	225	1	0.44%	2	1	93	93	0.5000000000003686	1	1	79	146	0	1	+TT
H3_BC87_191109_LF_LIB_consensus_vsearch	1525	C	C	227	1	0.44%	2	1	93	93	0.4999999999999138	1	1	79	148	1	0	+TC
H3_BC87_191109_LF_LIB_consensus_vsearch	1526	A	A	225	2	0.87%	2	2	93	93	0.24944812362040697	1	1	78	147	1	1	G
H3_BC87_191109_LF_LIB_consensus_vsearch	1527	C	C	226	1	0.44%	2	1	93	93	0.4999999999999138	1	1	78	148	0	1	-T
H3_BC87_191109_LF_LIB_consensus_vsearch	1528	T	*/-G	202	19	8.33%	2	1	93	93	1.273549938699874E-6	1	1	79	123	0	19	-G
H3_BC87_191109_LF_LIB_consensus_vsearch	1529	G	G	208	1	0.48%	2	1	93	93	0.5000000000001412	1	1	79	129	1	0	A
H3_BC87_191109_LF_LIB_consensus_vsearch	1530	G	G	226	1	0.44%	2	1	93	93	0.4999999999999138	1	1	80	146	0	1	+C
H3_BC87_191109_LF_LIB_consensus_vsearch	1531	A	A	224	2	0.88%	2	1	93	93	0.24944567627499675	1	1	77	147	2	0	G
H3_BC87_191109_LF_LIB_consensus_vsearch	1532	A	A	228	0	0%	2	0	93	0	1.0	1	0	80	148	0	0	
H3_BC87_191109_LF_LIB_consensus_vsearch	1533	C	C	224	1	0.44%	2	1	93	93	0.4999999999999138	1	1	79	145	0	1	+T
H3_BC87_191109_LF_LIB_consensus_vsearch	1534	T	T	218	6	2.64%	2	1	93	93	0.015104203282490625	1	1	80	138	0	6	C
H3_BC87_191109_LF_LIB_consensus_vsearch	1535	G	G	220	3	1.32%	2	2	93	93	0.12415730337075404	1	1	78	142	1	2	-TG
H3_BC87_191109_LF_LIB_consensus_vsearch	1536	T	T	218	3	1.34%	2	1	93	93	0.12414965986396012	1	1	77	141	0	3	A
H3_BC87_191109_LF_LIB_consensus_vsearch	1537	G	G	218	3	1.35%	2	1	93	93	0.12414965986396012	1	1	78	140	0	3	+C
H3_BC87_191109_LF_LIB_consensus_vsearch	1538	C	C	223	1	0.44%	2	1	93	93	0.5000000000003686	1	1	77	146	0	1	+T
H3_BC87_191109_LF_LIB_consensus_vsearch	1539	T	T	218	6	2.65%	2	1	93	93	0.015104203282490625	1	1	78	140	0	6	C
H3_BC87_191109_LF_LIB_consensus_vsearch	1540	C	*/-G	215	7	3.1%	2	1	93	93	0.007446345105805389	1	1	77	138	0	7	-G
H3_BC87_191109_LF_LIB_consensus_vsearch	1541	G	G	216	2	0.9%	2	1	93	93	0.249425287356441	1	1	78	138	0	2	-TG
H3_BC87_191109_LF_LIB_consensus_vsearch	1542	T	W	215	8	3.54%	2	1	93	93	0.0036646057936482192	1	1	79	136	0	8	A
H3_BC87_191109_LF_LIB_consensus_vsearch	1543	G	G	224	1	0.44%	2	1	93	93	0.4999999999999138	1	1	77	147	1	0	-A
H3_BC87_191109_LF_LIB_consensus_vsearch	1544	A	A	224	2	0.88%	2	1	93	93	0.24944567627499675	1	1	75	149	2	0	G
H3_BC87_191109_LF_LIB_consensus_vsearch	1545	A	R	218	8	3.51%	2	2	93	93	0.003667766201363899	1	1	75	143	4	4	G
H3_BC87_191109_LF_LIB_consensus_vsearch	1546	C	C	222	2	0.88%	2	2	93	93	0.24944071588395061	1	1	77	145	1	1	-AT
H3_BC87_191109_LF_LIB_consensus_vsearch	1547	A	A	219	3	1.34%	2	1	93	93	0.12415349887135622	1	1	75	144	0	3	-T
H3_BC87_191109_LF_LIB_consensus_vsearch	1548	T	T	214	5	2.24%	2	1	93	93	0.030537362897492103	1	1	70	144	5	0	+G
H3_BC87_191109_LF_LIB_consensus_vsearch	1549	G	G	221	3	1.33%	2	1	93	93	0.12416107382546236	1	1	74	147	3	0	A
H3_BC87_191109_LF_LIB_consensus_vsearch	1550	G	G	214	6	2.63%	2	2	93	93	0.015094778470947015	1	1	70	144	4	2	-A
H3_BC87_191109_LF_LIB_consensus_vsearch	1551	A	A	212	3	1.37%	2	1	93	93	0.1241258741259166	1	1	68	144	3	0	+G
H3_BC87_191109_LF_LIB_consensus_vsearch	1552	A	A	222	2	0.89%	2	1	93	93	0.24944071588395061	1	1	77	145	0	2	G
H3_BC87_191109_LF_LIB_consensus_vsearch	1553	T	T	216	5	2.2%	2	1	93	93	0.030543804461782422	1	1	76	140	0	5	C
H3_BC87_191109_LF_LIB_consensus_vsearch	1554	G	G	208	6	2.65%	2	2	93	93	0.015079983859610983	1	1	71	137	2	4	-C
H3_BC87_191109_LF_LIB_consensus_vsearch	1555	C	C	208	4	1.8%	2	1	93	93	0.06161452805712106	1	1	77	131	0	4	+T
H3_BC87_191109_LF_LIB_consensus_vsearch	1556	C	Y	208	10	4.37%	2	1	93	93	8.787673881990181E-4	1	1	79	129	0	10	T
H3_BC87_191109_LF_LIB_consensus_vsearch	1557	T	T	221	2	0.88%	2	2	93	93	0.24943820224728358	1	1	78	143	1	1	A
H3_BC87_191109_LF_LIB_consensus_vsearch	1558	T	T	220	3	1.31%	2	2	93	93	0.12415730337075404	1	1	78	142	2	1	C
H3_BC87_191109_LF_LIB_consensus_vsearch	1559	G	G	221	4	1.75%	2	2	93	93	0.06166574490670126	1	1	77	144	1	3	-T
H3_BC87_191109_LF_LIB_consensus_vsearch	1560	T	T	212	5	2.22%	2	2	93	93	0.030530802741347875	1	1	76	136	3	2	-A
H3_BC87_191109_LF_LIB_consensus_vsearch	1561	A	A	220	2	0.89%	2	1	93	93	0.2494356659142869	1	1	77	143	0	2	G
H3_BC87_191109_LF_LIB_consensus_vsearch	1562	A	A	219	3	1.31%	2	1	93	93	0.12415349887135622	1	1	78	141	0	3	-T
H3_BC87_191109_LF_LIB_consensus_vsearch	1563	T	T	220	4	1.77%	2	2	93	93	0.061662016439223415	1	1	78	142	1	3	C
H3_BC87_191109_LF_LIB_consensus_vsearch	1564	C	C	221	2	0.88%	2	2	93	93	0.24943820224728358	1	1	75	146	1	1	+A
H3_BC87_191109_LF_LIB_consensus_vsearch	1565	G	*/-TG	215	8	3.52%	2	1	93	93	0.0036646057936482192	1	1	77	138	0	8	-TG
H3_BC87_191109_LF_LIB_consensus_vsearch	1566	T	T	205	5	2.3%	2	1	93	93	0.03050685942891605	1	1	71	134	5	0	-G
H3_BC87_191109_LF_LIB_consensus_vsearch	1567	G	G	208	4	1.88%	2	1	93	93	0.06161452805712106	1	1	67	141	4	0	-A
H3_BC87_191109_LF_LIB_consensus_vsearch	1568	A	A	218	3	1.34%	2	2	93	93	0.12414965986396012	1	1	72	146	1	2	G
H3_BC87_191109_LF_LIB_consensus_vsearch	1569	G	G	223	1	0.44%	2	1	93	93	0.5000000000003686	1	1	76	147	0	1	+AA
H3_BC87_191109_LF_LIB_consensus_vsearch	1570	T	T	223	1	0.44%	2	1	93	93	0.5000000000003686	1	1	75	148	1	0	+C
H3_BC87_191109_LF_LIB_consensus_vsearch	1571	C	C	227	0	0%	2	0	93	0	1.0	1	0	78	149	0	0	
H3_BC87_191109_LF_LIB_consensus_vsearch	1572	A	A	221	3	1.32%	2	1	93	93	0.12416107382546236	1	1	76	145	0	3	-TCA
H3_BC87_191109_LF_LIB_consensus_vsearch	1573	T	T	223	2	0.89%	2	2	93	93	0.24944320712692292	1	1	78	145	1	1	-C
H3_BC87_191109_LF_LIB_consensus_vsearch	1574	C	C	219	4	1.79%	2	2	93	93	0.06165825449566743	1	1	75	144	3	1	-A
H3_BC87_191109_LF_LIB_consensus_vsearch	1575	A	A	217	3	1.36%	2	2	93	93	0.12414578587710072	1	1	74	143	2	1	G
H3_BC87_191109_LF_LIB_consensus_vsearch	1576	A	A	215	6	2.63%	2	2	93	93	0.01509716650743782	1	1	74	141	5	1	G
H3_BC87_191109_LF_LIB_consensus_vsearch	1577	C	C	220	5	2.22%	2	1	93	93	0.03055634444922604	1	1	79	141	0	5	-T
H3_BC87_191109_LF_LIB_consensus_vsearch	1578	T	T	215	4	1.79%	2	1	93	93	0.06164286277914926	1	1	79	136	0	4	C
H3_BC87_191109_LF_LIB_consensus_vsearch	1579	C	C	215	3	1.33%	2	1	93	93	0.12413793103441495	1	1	73	142	3	0	+TC
H3_BC87_191109_LF_LIB_consensus_vsearch	1580	A	A	223	2	0.88%	2	2	93	93	0.24944320712692292	1	1	75	148	1	1	G
H3_BC87_191109_LF_LIB_consensus_vsearch	1581	C	C	217	5	2.21%	2	1	93	93	0.03054698177238809	1	1	76	141	0	5	T
H3_BC87_191109_LF_LIB_consensus_vsearch	1582	G	G	225	2	0.87%	2	1	93	93	0.24944812362040697	1	1	78	147	2	0	-A
H3_BC87_191109_LF_LIB_consensus_vsearch	1583	A	A	224	1	0.44%	2	1	93	93	0.4999999999999138	1	1	77	147	0	1	+C
H3_BC87_191109_LF_LIB_consensus_vsearch	1584	T	T	221	3	1.31%	2	1	93	93	0.12416107382546236	1	1	74	147	3	0	+G
H3_BC87_191109_LF_LIB_consensus_vsearch	1585	G	G	219	4	1.75%	2	2	93	93	0.06165825449566743	1	1	75	144	3	1	-A
H3_BC87_191109_LF_LIB_consensus_vsearch	1586	A	A	219	2	0.9%	2	1	93	93	0.24943310657599216	1	1	73	146	2	0	G
H3_BC87_191109_LF_LIB_consensus_vsearch	1587	A	A	223	2	0.88%	2	2	93	93	0.24944320712692292	1	1	77	146	1	1	G
H3_BC87_191109_LF_LIB_consensus_vsearch	1588	T	T	214	4	1.75%	2	2	93	93	0.061638926495252586	1	1	74	140	2	2	C
H3_BC87_191109_LF_LIB_consensus_vsearch	1589	A	A	214	5	2.21%	2	1	93	93	0.030537362897492103	1	1	68	146	5	0	+C
H3_BC87_191109_LF_LIB_consensus_vsearch	1590	C	C	216	5	2.21%	2	1	93	93	0.030543804461782422	1	1	75	141	0	5	T
H3_BC87_191109_LF_LIB_consensus_vsearch	1591	G	R	209	12	5.24%	2	1	93	93	2.0943559915765036E-4	1	1	64	145	12	0	A
H3_BC87_191109_LF_LIB_consensus_vsearch	1592	T	*/-C	175	35	15.42%	2	2	93	93	6.205002718756778E-12	1	1	41	134	29	6	-C
H3_BC87_191109_LF_LIB_consensus_vsearch	1593	C	C	191	1	0.52%	2	1	93	93	0.5000000000001412	1	1	48	143	1	0	+AT
H3_BC87_191109_LF_LIB_consensus_vsearch	1594	C	C	218	6	2.64%	2	2	93	93	0.015104203282490625	1	1	74	144	1	5	+T
H3_BC87_191109_LF_LIB_consensus_vsearch	1595	C	*/-T	219	7	3.06%	2	2	93	93	0.007452766938834958	1	1	76	143	3	4	-T
H3_BC87_191109_LF_LIB_consensus_vsearch	1596	T	Y	205	12	5.41%	2	1	93	93	2.0882828978061456E-4	1	1	76	129	0	12	C
H3_BC87_191109_LF_LIB_consensus_vsearch	1597	G	*/-C	206	7	3.07%	2	2	93	93	0.007431022745174962	1	1	72	134	3	4	-C
H3_BC87_191109_LF_LIB_consensus_vsearch	1598	C	C	209	6	2.71%	2	1	93	93	0.015082506692930204	1	1	76	133	0	6	+T
H3_BC87_191109_LF_LIB_consensus_vsearch	1599	C	C	214	6	2.63%	2	1	93	93	0.015094778470947015	1	1	78	136	0	6	+T
H3_BC87_191109_LF_LIB_consensus_vsearch	1600	C	*/-T	143	77	33.62%	2	2	93	93	1.988670454378156E-27	1	1	75	68	1	76	-T
H3_BC87_191109_LF_LIB_consensus_vsearch	1601	T	T	138	5	3.38%	2	1	93	93	0.030159320562882234	1	1	75	63	0	5	C
H3_BC87_191109_LF_LIB_consensus_vsearch	1602	T	T	219	4	1.78%	2	2	93	93	0.06165825449566743	1	1	73	146	3	1	C
H3_BC87_191109_LF_LIB_consensus_vsearch	1603	T	T	224	3	1.31%	2	1	93	93	0.12417218543044797	1	1	79	145	0	3	C
H3_BC87_191109_LF_LIB_consensus_vsearch	1604	G	G	220	2	0.88%	2	1	93	93	0.2494356659142869	1	1	77	143	0	2	+CAA
H3_BC87_191109_LF_LIB_consensus_vsearch	1605	T	Y	215	10	4.41%	2	2	93	93	8.817198236951184E-4	1	1	79	136	1	9	C
H3_BC87_191109_LF_LIB_consensus_vsearch	1606	A	A	220	3	1.32%	2	1	93	93	0.12415730337075404	1	1	75	145	3	0	T
H3_BC87_191109_LF_LIB_consensus_vsearch	1607	C	C	221	3	1.32%	2	2	93	93	0.12416107382546236	1	1	75	146	2	1	T
H3_BC87_191109_LF_LIB_consensus_vsearch	1608	A	A	219	3	1.33%	2	1	93	93	0.12415349887135622	1	1	77	142	0	3	G
H3_BC87_191109_LF_LIB_consensus_vsearch	1609	C	*/-AC	187	34	14.91%	2	2	93	93	1.4719290601018672E-11	1	1	53	134	23	11	-AC
H3_BC87_191109_LF_LIB_consensus_vsearch	1610	A	A	187	3	1.56%	2	1	93	93	0.12401055408976878	1	1	53	134	0	3	+C
H3_BC87_191109_LF_LIB_consensus_vsearch	1611	C	C	185	3	1.55%	2	2	93	93	0.12399999999998497	1	1	53	132	1	2	+AC
H3_BC87_191109_LF_LIB_consensus_vsearch	1612	C	Y	191	35	15.35%	2	2	93	93	6.987313257985683E-12	1	1	78	113	1	34	T
H3_BC87_191109_LF_LIB_consensus_vsearch	1613	G	*/-C	217	9	3.95%	2	2	93	93	0.0018008401619304512	1	1	70	147	8	1	-C
H3_BC87_191109_LF_LIB_consensus_vsearch	1614	C	C	215	1	0.46%	2	1	93	93	0.4999999999999138	1	1	70	145	0	1	+T
H3_BC87_191109_LF_LIB_consensus_vsearch	1615	C	C	226	2	0.88%	2	1	93	93	0.24945054945064127	1	1	77	149	2	0	+A
H3_BC87_191109_LF_LIB_consensus_vsearch	1616	C	Y	203	19	8.3%	2	1	93	93	1.2759715939998704E-6	1	1	77	126	0	19	T
H3_BC87_191109_LF_LIB_consensus_vsearch	1617	G	R	219	7	3.08%	2	2	93	93	0.007452766938834958	1	1	75	144	5	2	A
H3_BC87_191109_LF_LIB_consensus_vsearch	1618	T	T	221	3	1.31%	2	1	93	93	0.12416107382546236	1	1	79	142	0	3	A
H3_BC87_191109_LF_LIB_consensus_vsearch	1619	C	C	223	1	0.44%	2	1	93	93	0.5000000000003686	1	1	78	145	1	0	+AC
H3_BC87_191109_LF_LIB_consensus_vsearch	1620	G	G	225	1	0.44%	2	1	93	93	0.5000000000003686	1	1	80	145	0	1	-TT
H3_BC87_191109_LF_LIB_consensus_vsearch	1621	T	T	222	1	0.44%	2	1	93	93	0.4999999999999138	1	1	79	143	0	1	+CGT
H3_BC87_191109_LF_LIB_consensus_vsearch	1622	T	T	225	1	0.44%	2	1	93	93	0.5000000000003686	1	1	79	146	0	1	+G
H3_BC87_191109_LF_LIB_consensus_vsearch	1623	A	*/-T	212	11	4.8%	2	1	93	93	4.303452996410444E-4	1	1	77	135	0	11	-T
H3_BC87_191109_LF_LIB_consensus_vsearch	1624	T	T	208	5	2.31%	2	2	93	93	0.03051731330830772	1	1	77	131	1	4	C
H3_BC87_191109_LF_LIB_consensus_vsearch	1625	T	Y	218	9	3.96%	2	2	93	93	0.001801496644156972	1	1	78	140	1	8	C
H3_BC87_191109_LF_LIB_consensus_vsearch	1626	T	*/-C	211	11	4.8%	2	2	93	93	4.300945555177922E-4	1	1	73	138	4	7	-C
H3_BC87_191109_LF_LIB_consensus_vsearch	1627	C	C	216	1	0.46%	2	1	93	93	0.4999999999999138	1	1	74	142	1	0	+A
H3_BC87_191109_LF_LIB_consensus_vsearch	1628	C	*/+G	203	10	4.37%	2	1	93	93	8.765435124402236E-4	1	1	79	124	0	10	+G
H3_BC87_191109_LF_LIB_consensus_vsearch	1629	G	G	225	2	0.87%	2	2	93	93	0.24944812362040697	1	1	78	147	1	1	+A
H3_BC87_191109_LF_LIB_consensus_vsearch	1630	A	A	227	1	0.44%	2	1	93	93	0.4999999999999138	1	1	79	148	0	1	G
H3_BC87_191109_LF_LIB_consensus_vsearch	1631	T	T	229	0	0%	2	0	93	0	1.0	1	0	80	149	0	0	
H3_BC87_191109_LF_LIB_consensus_vsearch	1632	C	C	221	5	2.18%	2	1	93	93	0.03055941016990272	1	1	75	146	5	0	+A
H3_BC87_191109_LF_LIB_consensus_vsearch	1633	G	*/-A	221	7	3.06%	2	2	93	93	0.007455894130096957	1	1	76	145	4	3	-A
H3_BC87_191109_LF_LIB_consensus_vsearch	1634	A	A	219	1	0.45%	2	1	93	93	0.4999999999999138	1	1	73	146	1	0	+CT
H3_BC87_191109_LF_LIB_consensus_vsearch	1635	A	A	223	2	0.87%	2	1	93	93	0.24944320712692292	1	1	79	144	0	2	-T
H3_BC87_191109_LF_LIB_consensus_vsearch	1636	T	T	214	6	2.64%	2	2	93	93	0.015094778470947015	1	1	77	137	2	4	-G
H3_BC87_191109_LF_LIB_consensus_vsearch	1637	G	G	221	1	0.45%	2	1	93	93	0.4999999999999138	1	1	77	144	1	0	A
H3_BC87_191109_LF_LIB_consensus_vsearch	1638	G	*/+C	211	9	3.93%	2	1	93	93	0.0017967787753331713	1	1	77	134	0	9	+C
H3_BC87_191109_LF_LIB_consensus_vsearch	1639	C	C	211	4	1.79%	2	2	93	93	0.06162689769249	1	1	75	136	2	2	-T
H3_BC87_191109_LF_LIB_consensus_vsearch	1640	T	*/-C	199	9	4.02%	2	1	93	93	0.0017879699024036485	1	1	70	129	0	9	-C
H3_BC87_191109_LF_LIB_consensus_vsearch	1641	C	C	212	4	1.83%	2	1	93	93	0.061630944461591126	1	1	80	132	0	4	-G
H3_BC87_191109_LF_LIB_consensus_vsearch	1642	G	G	217	5	2.24%	2	2	93	93	0.03054698177238809	1	1	78	139	2	3	A
H3_BC87_191109_LF_LIB_consensus_vsearch	1643	G	G	222	2	0.88%	2	1	93	93	0.24944071588395061	1	1	79	143	0	2	-T
H3_BC87_191109_LF_LIB_consensus_vsearch	1644	T	T	216	3	1.33%	2	2	93	93	0.12414187643025615	1	1	74	142	1	2	C
H3_BC87_191109_LF_LIB_consensus_vsearch	1645	G	G	219	4	1.76%	2	2	93	93	0.06165825449566743	1	1	76	143	2	2	-A
H3_BC87_191109_LF_LIB_consensus_vsearch	1646	A	*/+G	95	88	39.46%	2	2	93	93	2.739533622702579E-33	1	1	34	61	21	67	+G
H3_BC87_191109_LF_LIB_consensus_vsearch	1647	G	G	188	1	0.52%	2	1	93	93	0.5000000000001412	1	1	59	129	1	0	+A
H3_BC87_191109_LF_LIB_consensus_vsearch	1648	G	G	216	2	0.9%	2	2	93	93	0.249425287356441	1	1	75	141	1	1	A
H3_BC87_191109_LF_LIB_consensus_vsearch	1649	G	G	222	3	1.32%	2	2	93	93	0.12416481069040536	1	1	77	145	2	1	A
H3_BC87_191109_LF_LIB_consensus_vsearch	1650	G	G	224	2	0.87%	2	1	93	93	0.24944567627499675	1	1	78	146	2	0	-T
H3_BC87_191109_LF_LIB_consensus_vsearch	1651	T	Y	208	10	4.46%	2	2	93	93	8.787673881990181E-4	1	1	74	134	1	9	C
H3_BC87_191109_LF_LIB_consensus_vsearch	1652	A	*/-G	189	28	12.61%	2	2	93	93	1.4689480604716706E-9	1	1	72	117	7	21	-G
H3_BC87_191109_LF_LIB_consensus_vsearch	1653	G	G	192	2	1.02%	2	1	93	93	0.2493540051679821	1	1	68	124	2	0	+TG
H3_BC87_191109_LF_LIB_consensus_vsearch	1654	G	G	222	5	2.19%	2	2	93	93	0.030562448911634975	1	1	76	146	4	1	-A
H3_BC87_191109_LF_LIB_consensus_vsearch	1655	A	A	218	2	0.9%	2	2	93	93	0.24943052391823226	1	1	74	144	1	1	-GCA
H3_BC87_191109_LF_LIB_consensus_vsearch	1656	G	G	222	3	1.33%	2	1	93	93	0.12416481069040536	1	1	75	147	3	0	A
H3_BC87_191109_LF_LIB_consensus_vsearch	1657	C	*/-A	213	7	3.11%	2	2	93	93	0.007443047448823043	1	1	76	137	1	6	-A
H3_BC87_191109_LF_LIB_consensus_vsearch	1658	A	A	216	1	0.46%	2	1	93	93	0.4999999999999138	1	1	75	141	1	0	+C
H3_BC87_191109_LF_LIB_consensus_vsearch	1659	A	A	220	4	1.75%	2	1	93	93	0.061662016439223415	1	1	74	146	4	0	G
H3_BC87_191109_LF_LIB_consensus_vsearch	1660	C	C	214	4	1.78%	2	1	93	93	0.061638926495252586	1	1	75	139	0	4	-G
H3_BC87_191109_LF_LIB_consensus_vsearch	1661	G	G	218	1	0.45%	2	1	93	93	0.5000000000003686	1	1	75	143	0	1	-CACG
H3_BC87_191109_LF_LIB_consensus_vsearch	1662	C	C	214	6	2.68%	2	1	93	93	0.015094778470947015	1	1	69	145	6	0	-AC
H3_BC87_191109_LF_LIB_consensus_vsearch	1663	A	A	217	2	0.9%	2	1	93	93	0.24942791762028085	1	1	71	146	0	2	+T
H3_BC87_191109_LF_LIB_consensus_vsearch	1664	C	C	216	2	0.9%	2	2	93	93	0.249425287356441	1	1	71	145	1	1	-G
H3_BC87_191109_LF_LIB_consensus_vsearch	1665	G	*/-TG	195	26	11.61%	2	1	93	93	6.825326034146069E-9	1	1	75	120	0	26	-TG
H3_BC87_191109_LF_LIB_consensus_vsearch	1666	T	T	198	3	1.49%	2	1	93	93	0.12406483790525294	1	1	78	120	0	3	C
H3_BC87_191109_LF_LIB_consensus_vsearch	1667	G	G	196	3	1.49%	2	2	93	93	0.12405541561711925	1	1	76	120	1	2	A
H3_BC87_191109_LF_LIB_consensus_vsearch	1668	C	C	225	1	0.44%	2	1	93	93	0.5000000000003686	1	1	77	148	1	0	+T
H3_BC87_191109_LF_LIB_consensus_vsearch	1669	C	*/+G	203	12	5.24%	2	1	93	93	2.0851661109317314E-4	1	1	76	127	0	12	+G
H3_BC87_191109_LF_LIB_consensus_vsearch	1670	G	G	218	3	1.35%	2	1	93	93	0.12414965986396012	1	1	76	142	3	0	A
H3_BC87_191109_LF_LIB_consensus_vsearch	1671	G	G	220	6	2.62%	2	1	93	93	0.015108791157819889	1	1	80	140	0	6	-C
H3_BC87_191109_LF_LIB_consensus_vsearch	1672	C	Y	202	11	4.95%	2	1	93	93	4.2773637746469634E-4	1	1	78	124	0	11	T
H3_BC87_191109_LF_LIB_consensus_vsearch	1673	T	T	224	1	0.44%	2	1	93	93	0.4999999999999138	1	1	79	145	1	0	+GT
H3_BC87_191109_LF_LIB_consensus_vsearch	1674	T	T	218	4	1.75%	2	1	93	93	0.061654458623218986	1	1	79	139	0	4	+G
H3_BC87_191109_LF_LIB_consensus_vsearch	1675	G	G	221	4	1.75%	2	1	93	93	0.06166574490670126	1	1	78	143	0	4	A
H3_BC87_191109_LF_LIB_consensus_vsearch	1676	C	C	215	6	2.64%	2	1	93	93	0.01509716650743782	1	1	78	137	0	6	T
H3_BC87_191109_LF_LIB_consensus_vsearch	1677	T	T	220	3	1.33%	2	1	93	93	0.12415730337075404	1	1	79	141	0	3	+G
H3_BC87_191109_LF_LIB_consensus_vsearch	1678	G	G	222	1	0.45%	2	1	93	93	0.4999999999999138	1	1	78	144	1	0	+AC
H3_BC87_191109_LF_LIB_consensus_vsearch	1679	G	G	224	2	0.88%	2	1	93	93	0.24944567627499675	1	1	79	145	0	2	-C
H3_BC87_191109_LF_LIB_consensus_vsearch	1680	C	C	224	1	0.44%	2	1	93	93	0.4999999999999138	1	1	79	145	1	0	+TG
H3_BC87_191109_LF_LIB_consensus_vsearch	1681	G	G	217	6	2.63%	2	2	93	93	0.015101878629034914	1	1	76	141	1	5	-CG
H3_BC87_191109_LF_LIB_consensus_vsearch	1682	C	C	215	3	1.36%	2	2	93	93	0.12413793103441495	1	1	76	139	1	2	T
H3_BC87_191109_LF_LIB_consensus_vsearch	1683	G	G	209	4	1.81%	2	2	93	93	0.061618690029214815	1	1	73	136	3	1	-A
H3_BC87_191109_LF_LIB_consensus_vsearch	1684	A	A	216	3	1.35%	2	2	93	93	0.12414187643025615	1	1	73	143	1	2	G
H3_BC87_191109_LF_LIB_consensus_vsearch	1685	A	A	222	3	1.33%	2	1	93	93	0.12416481069040536	1	1	74	148	3	0	G
H3_BC87_191109_LF_LIB_consensus_vsearch	1686	G	G	219	3	1.33%	2	1	93	93	0.12415349887135622	1	1	73	146	3	0	+C
H3_BC87_191109_LF_LIB_consensus_vsearch	1687	C	*/-G	209	13	5.8%	2	2	93	93	1.0188120004185222E-4	1	1	71	138	6	7	-G
H3_BC87_191109_LF_LIB_consensus_vsearch	1688	G	R	189	17	8.02%	2	1	93	93	5.408873197496746E-6	1	1	51	138	17	0	A
H3_BC87_191109_LF_LIB_consensus_vsearch	1689	G	G	213	6	2.64%	2	1	93	93	0.0150923687299321	1	1	65	148	6	0	+A
H3_BC87_191109_LF_LIB_consensus_vsearch	1690	A	A	214	3	1.34%	2	2	93	93	0.12413394919162732	1	1	70	144	1	2	-G
H3_BC87_191109_LF_LIB_consensus_vsearch	1691	G	R	195	27	12.11%	2	1	93	93	3.212371282433204E-9	1	1	51	144	27	0	A
H3_BC87_191109_LF_LIB_consensus_vsearch	1692	C	C	216	5	2.21%	2	1	93	93	0.030543804461782422	1	1	78	138	0	5	+A
H3_BC87_191109_LF_LIB_consensus_vsearch	1693	A	A	223	1	0.44%	2	1	93	93	0.5000000000003686	1	1	78	145	1	0	+G
H3_BC87_191109_LF_LIB_consensus_vsearch	1694	A	A	228	1	0.44%	2	1	93	93	0.4999999999999138	1	1	80	148	0	1	+GT
H3_BC87_191109_LF_LIB_consensus_vsearch	1695	A	A	223	4	1.75%	2	2	93	93	0.061673103185009646	1	1	77	146	3	1	G
H3_BC87_191109_LF_LIB_consensus_vsearch	1696	C	C	227	1	0.44%	2	1	93	93	0.4999999999999138	1	1	80	147	0	1	+A
H3_BC87_191109_LF_LIB_consensus_vsearch	1697	A	*/-C	213	7	3.06%	2	1	93	93	0.007443047448823043	1	1	74	139	0	7	-C
H3_BC87_191109_LF_LIB_consensus_vsearch	1698	C	C	217	2	0.9%	2	1	93	93	0.24942791762028085	1	1	79	138	0	2	A
H3_BC87_191109_LF_LIB_consensus_vsearch	1699	C	*/-T	207	19	8.3%	2	2	93	93	1.2854787932019895E-6	1	1	78	129	1	18	-T
H3_BC87_191109_LF_LIB_consensus_vsearch	1700	T	T	205	2	0.96%	2	2	93	93	0.24939467312372118	1	1	78	127	1	1	A
H3_BC87_191109_LF_LIB_consensus_vsearch	1701	T	*/-C	215	8	3.52%	2	1	93	93	0.0036646057936482192	1	1	78	137	0	8	-C
H3_BC87_191109_LF_LIB_consensus_vsearch	1702	C	C	207	3	1.37%	2	1	93	93	0.12410501193315207	1	1	78	129	0	3	-G
H3_BC87_191109_LF_LIB_consensus_vsearch	1703	G	G	223	1	0.44%	2	1	93	93	0.5000000000003686	1	1	77	146	1	0	+A
H3_BC87_191109_LF_LIB_consensus_vsearch	1704	A	A	226	1	0.44%	2	1	93	93	0.4999999999999138	1	1	78	148	0	1	T
H3_BC87_191109_LF_LIB_consensus_vsearch	1705	A	A	223	1	0.44%	2	1	93	93	0.5000000000003686	1	1	78	145	0	1	+C
H3_BC87_191109_LF_LIB_consensus_vsearch	1706	C	C	223	4	1.75%	2	1	93	93	0.061673103185009646	1	1	79	144	0	4	-T
H3_BC87_191109_LF_LIB_consensus_vsearch	1707	T	T	215	4	1.79%	2	1	93	93	0.06164286277914926	1	1	77	138	0	4	-C
H3_BC87_191109_LF_LIB_consensus_vsearch	1708	C	C	215	4	1.78%	2	1	93	93	0.06164286277914926	1	1	78	137	0	4	-G
H3_BC87_191109_LF_LIB_consensus_vsearch	1709	G	G	217	5	2.24%	2	2	93	93	0.03054698177238809	1	1	77	140	3	2	A
H3_BC87_191109_LF_LIB_consensus_vsearch	1710	G	G	226	1	0.44%	2	1	93	93	0.4999999999999138	1	1	80	146	0	1	-C
H3_BC87_191109_LF_LIB_consensus_vsearch	1711	C	C	225	2	0.88%	2	1	93	93	0.24944812362040697	1	1	80	145	0	2	T
H3_BC87_191109_LF_LIB_consensus_vsearch	1712	C	C	227	2	0.87%	2	1	93	93	0.24945295404843976	1	1	80	147	0	2	-AT
H3_BC87_191109_LF_LIB_consensus_vsearch	1713	A	*/+T	202	15	6.61%	2	2	93	93	2.375885795125084E-5	1	1	60	142	14	1	+T
H3_BC87_191109_LF_LIB_consensus_vsearch	1714	T	T	216	1	0.46%	2	1	93	93	0.4999999999999138	1	1	74	142	0	1	C
H3_BC87_191109_LF_LIB_consensus_vsearch	1715	T	T	225	1	0.44%	2	1	93	93	0.5000000000003686	1	1	80	145	0	1	A
H3_BC87_191109_LF_LIB_consensus_vsearch	1716	T	T	216	4	1.75%	2	1	93	93	0.061646763238677425	1	1	71	145	4	0	-A
H3_BC87_191109_LF_LIB_consensus_vsearch	1717	A	*/+G	196	17	7.66%	2	1	93	93	5.472889986979232E-6	1	1	70	126	0	17	+G
H3_BC87_191109_LF_LIB_consensus_vsearch	1718	G	G	220	2	0.9%	2	2	93	93	0.2494356659142869	1	1	74	146	1	1	-A
H3_BC87_191109_LF_LIB_consensus_vsearch	1719	A	*/-G	202	11	4.91%	2	2	93	93	4.2773637746469634E-4	1	1	64	138	8	3	-G
H3_BC87_191109_LF_LIB_consensus_vsearch	1720	G	G	210	1	0.47%	2	1	93	93	0.4999999999999138	1	1	67	143	1	0	+A
H3_BC87_191109_LF_LIB_consensus_vsearch	1721	G	G	216	5	2.22%	2	1	93	93	0.030543804461782422	1	1	69	147	5	0	+A
H3_BC87_191109_LF_LIB_consensus_vsearch	1722	A	A	221	2	0.89%	2	1	93	93	0.24943820224728358	1	1	72	149	2	0	+G
H3_BC87_191109_LF_LIB_consensus_vsearch	1723	A	A	227	1	0.44%	2	1	93	93	0.4999999999999138	1	1	78	149	1	0	+G
H3_BC87_191109_LF_LIB_consensus_vsearch	1724	G	*/-TA	206	8	3.51%	2	1	93	93	0.0036546013500883302	1	1	67	139	0	8	-TA
H3_BC87_191109_LF_LIB_consensus_vsearch	1725	T	T	212	6	2.71%	2	2	93	93	0.015089936987088519	1	1	78	134	2	4	C
H3_BC87_191109_LF_LIB_consensus_vsearch	1726	A	A	213	3	1.37%	2	2	93	93	0.12412993039444345	1	1	77	136	1	2	G
H3_BC87_191109_LF_LIB_consensus_vsearch	1727	C	*/+A	206	8	3.56%	2	1	93	93	0.0036546013500883302	1	1	67	139	8	0	+A
H3_BC87_191109_LF_LIB_consensus_vsearch	1728	A	*/+G	212	7	3.17%	2	1	93	93	0.00744137624879223	1	1	73	139	7	0	+G
H3_BC87_191109_LF_LIB_consensus_vsearch	1729	A	W	213	7	3.12%	2	1	93	93	0.007443047448823043	1	1	80	133	0	7	T
H3_BC87_191109_LF_LIB_consensus_vsearch	1730	G	G	221	6	2.63%	2	1	93	93	0.015111054918444918	1	1	74	147	6	0	A
H3_BC87_191109_LF_LIB_consensus_vsearch	1731	T	T	225	1	0.44%	2	1	93	93	0.5000000000003686	1	1	79	146	1	0	-C
H3_BC87_191109_LF_LIB_consensus_vsearch	1732	C	C	214	6	2.63%	2	2	93	93	0.015094778470947015	1	1	75	139	1	5	-G
H3_BC87_191109_LF_LIB_consensus_vsearch	1733	G	R	210	7	3.18%	2	1	93	93	0.007437988084800957	1	1	71	139	7	0	A
H3_BC87_191109_LF_LIB_consensus_vsearch	1734	T	T	206	6	2.68%	2	2	93	93	0.015074867144143777	1	1	75	131	2	4	-A
H3_BC87_191109_LF_LIB_consensus_vsearch	1735	A	A	214	2	0.91%	2	2	93	93	0.24941995359642635	1	1	74	140	1	1	C
H3_BC87_191109_LF_LIB_consensus_vsearch	1736	A	A	211	5	2.21%	2	2	93	93	0.030527477163211258	1	1	72	139	1	4	T
H3_BC87_191109_LF_LIB_consensus_vsearch	1737	C	Y	197	10	4.44%	2	1	93	93	8.737377439902802E-4	1	1	71	126	0	10	T
H3_BC87_191109_LF_LIB_consensus_vsearch	1738	A	A	211	6	2.76%	2	2	93	93	0.015087482939793164	1	1	76	135	2	4	G
H3_BC87_191109_LF_LIB_consensus_vsearch	1739	A	A	216	3	1.35%	2	2	93	93	0.12414187643025615	1	1	77	139	1	2	-G
H3_BC87_191109_LF_LIB_consensus_vsearch	1740	G	G	216	5	2.24%	2	1	93	93	0.030543804461782422	1	1	78	138	0	5	T
H3_BC87_191109_LF_LIB_consensus_vsearch	1741	G	G	216	6	2.62%	2	2	93	93	0.015099533131216845	1	1	75	141	3	3	-T
H3_BC87_191109_LF_LIB_consensus_vsearch	1742	T	T	220	1	0.45%	2	1	93	93	0.4999999999999138	1	1	77	143	0	1	+A
H3_BC87_191109_LF_LIB_consensus_vsearch	1743	T	T	220	5	2.2%	2	1	93	93	0.03055634444922604	1	1	80	140	0	5	C
H3_BC87_191109_LF_LIB_consensus_vsearch	1744	T	*/-C	203	17	7.42%	2	1	93	93	5.533354906074952E-6	1	1	76	127	0	17	-C
H3_BC87_191109_LF_LIB_consensus_vsearch	1745	C	C	209	1	0.48%	2	1	93	93	0.4999999999999138	1	1	80	129	0	1	G
H3_BC87_191109_LF_LIB_consensus_vsearch	1746	C	C	218	2	0.88%	2	2	93	93	0.24943052391823226	1	1	76	142	1	1	+A
H3_BC87_191109_LF_LIB_consensus_vsearch	1747	G	G	221	1	0.44%	2	1	93	93	0.4999999999999138	1	1	77	144	1	0	+CC
H3_BC87_191109_LF_LIB_consensus_vsearch	1748	T	Y	211	8	3.56%	2	1	93	93	0.0036602593149509337	1	1	73	138	0	8	C
H3_BC87_191109_LF_LIB_consensus_vsearch	1749	A	*/-G	206	8	3.54%	2	2	93	93	0.0036546013500883302	1	1	71	135	5	3	-G
H3_BC87_191109_LF_LIB_consensus_vsearch	1750	G	G	206	4	1.87%	2	2	93	93	0.06160608506034647	1	1	69	137	3	1	A
H3_BC87_191109_LF_LIB_consensus_vsearch	1751	G	G	217	4	1.8%	2	1	93	93	0.0616506283607095	1	1	74	143	4	0	T
H3_BC87_191109_LF_LIB_consensus_vsearch	1752	T	T	219	2	0.9%	2	2	93	93	0.24943310657599216	1	1	78	141	1	1	C
H3_BC87_191109_LF_LIB_consensus_vsearch	1753	G	G	222	3	1.32%	2	1	93	93	0.12416481069040536	1	1	78	144	0	3	+A
H3_BC87_191109_LF_LIB_consensus_vsearch	1754	A	A	226	1	0.44%	2	1	93	93	0.4999999999999138	1	1	78	148	0	1	+G
H3_BC87_191109_LF_LIB_consensus_vsearch	1755	A	*/-C	219	8	3.49%	2	2	93	93	0.0036688013849068284	1	1	78	141	1	7	-C
H3_BC87_191109_LF_LIB_consensus_vsearch	1756	C	C	217	4	1.81%	2	1	93	93	0.0616506283607095	1	1	79	138	0	4	+T
H3_BC87_191109_LF_LIB_consensus_vsearch	1757	C	C	221	4	1.75%	2	2	93	93	0.06166574490670126	1	1	78	143	1	3	-T
H3_BC87_191109_LF_LIB_consensus_vsearch	1758	T	T	218	3	1.33%	2	1	93	93	0.12414965986396012	1	1	79	139	0	3	+G
H3_BC87_191109_LF_LIB_consensus_vsearch	1759	G	G	218	3	1.32%	2	1	93	93	0.12414965986396012	1	1	77	141	0	3	-C
H3_BC87_191109_LF_LIB_consensus_vsearch	1760	C	*/-G	199	7	3.11%	2	1	93	93	0.007418189114685095	1	1	78	121	0	7	-G
H3_BC87_191109_LF_LIB_consensus_vsearch	1761	G	G	213	4	1.82%	2	1	93	93	0.06163495389099757	1	1	80	133	0	4	+T
H3_BC87_191109_LF_LIB_consensus_vsearch	1762	G	G	221	2	0.88%	2	2	93	93	0.24943820224728358	1	1	77	144	1	1	+A
H3_BC87_191109_LF_LIB_consensus_vsearch	1763	A	A	223	1	0.45%	2	1	93	93	0.5000000000003686	1	1	78	145	0	1	C
H3_BC87_191109_LF_LIB_consensus_vsearch	1764	A	A	222	3	1.32%	2	1	93	93	0.12416481069040536	1	1	79	143	0	3	-G
H3_BC87_191109_LF_LIB_consensus_vsearch	1765	G	G	220	1	0.44%	2	1	93	93	0.4999999999999138	1	1	80	140	0	1	+C
H3_BC87_191109_LF_LIB_consensus_vsearch	1766	G	G	227	1	0.44%	2	1	93	93	0.4999999999999138	1	1	79	148	1	0	-A
H3_BC87_191109_LF_LIB_consensus_vsearch	1767	A	A	224	2	0.88%	2	2	93	93	0.24944567627499675	1	1	78	146	1	1	+T
H3_BC87_191109_LF_LIB_consensus_vsearch	1768	T	T	224	2	0.87%	2	1	93	93	0.24944567627499675	1	1	78	146	0	2	C
H3_BC87_191109_LF_LIB_consensus_vsearch	1769	C	C	219	3	1.32%	2	2	93	93	0.12415349887135622	1	1	74	145	2	1	+G
H3_BC87_191109_LF_LIB_consensus_vsearch	1770	A	A	218	3	1.33%	2	2	93	93	0.12414965986396012	1	1	74	144	2	1	-T
H3_BC87_191109_LF_LIB_consensus_vsearch	1771	T	T	213	2	0.9%	2	1	93	93	0.249417249417318	1	1	73	140	0	2	+CAT
H3_BC87_191109_LF_LIB_consensus_vsearch	1772	A	*/-GTA	198	15	6.67%	2	2	93	93	2.3643457204170923E-5	1	1	69	129	6	9	-GTA
H3_BC87_191109_LF_LIB_consensus_vsearch	1773	G	G	202	5	2.37%	2	1	93	93	0.030496102932097202	1	1	69	133	0	5	-T
H3_BC87_191109_LF_LIB_consensus_vsearch	1774	T	T	194	5	2.39%	2	1	93	93	0.030465835538688944	1	1	69	125	0	5	C
H3_BC87_191109_LF_LIB_consensus_vsearch	1775	A	A	204	5	2.38%	2	1	93	93	0.030503308196835104	1	1	69	135	0	5	C
H3_BC87_191109_LF_LIB_consensus_vsearch	1776	A	*/-T	210	8	3.51%	2	1	93	93	0.0036591481612605	1	1	76	134	0	8	-T
H3_BC87_191109_LF_LIB_consensus_vsearch	1777	T	T	210	5	2.27%	2	1	93	93	0.0305241206880699	1	1	78	132	0	5	C
H3_BC87_191109_LF_LIB_consensus_vsearch	1778	C	C	219	2	0.89%	2	1	93	93	0.24943310657599216	1	1	77	142	0	2	T
H3_BC87_191109_LF_LIB_consensus_vsearch	1779	G	G	218	4	1.75%	2	2	93	93	0.061654458623218986	1	1	76	142	3	1	A
H3_BC87_191109_LF_LIB_consensus_vsearch	1780	T	T	221	3	1.33%	2	2	93	93	0.12416107382546236	1	1	78	143	1	2	C
H3_BC87_191109_LF_LIB_consensus_vsearch	1781	C	*/-T	205	16	7.02%	2	2	93	93	1.1515964001761286E-5	1	1	77	128	1	15	-T
H3_BC87_191109_LF_LIB_consensus_vsearch	1782	T	T	202	3	1.43%	2	1	93	93	0.12408312958435573	1	1	76	126	0	3	+C
H3_BC87_191109_LF_LIB_consensus_vsearch	1783	T	T	219	6	2.65%	2	2	93	93	0.015106507368173285	1	1	77	142	1	5	C
H3_BC87_191109_LF_LIB_consensus_vsearch	1784	T	T	219	5	2.2%	2	1	93	93	0.030553251388732716	1	1	78	141	0	5	C
H3_BC87_191109_LF_LIB_consensus_vsearch	1785	G	G	223	1	0.44%	2	1	93	93	0.5000000000003686	1	1	78	145	1	0	-A
H3_BC87_191109_LF_LIB_consensus_vsearch	1786	A	A	222	4	1.77%	2	2	93	93	0.061669440342892484	1	1	76	146	2	2	G
H3_BC87_191109_LF_LIB_consensus_vsearch	1787	C	C	221	3	1.32%	2	1	93	93	0.12416107382546236	1	1	75	146	3	0	+A
H3_BC87_191109_LF_LIB_consensus_vsearch	1788	G	G	217	6	2.64%	2	1	93	93	0.015101878629034914	1	1	76	141	0	6	-TG
H3_BC87_191109_LF_LIB_consensus_vsearch	1789	T	*/-GC	198	21	9.46%	2	1	93	93	2.882936455442224E-7	1	1	78	120	0	21	-GC
H3_BC87_191109_LF_LIB_consensus_vsearch	1790	G	G	194	3	1.49%	2	1	93	93	0.1240458015267009	1	1	76	118	3	0	A
H3_BC87_191109_LF_LIB_consensus_vsearch	1791	C	Y	161	42	20.39%	2	2	93	93	2.131327578028376E-14	1	1	79	82	1	41	T
H3_BC87_191109_LF_LIB_consensus_vsearch	1792	T	T	217	3	1.33%	2	1	93	93	0.12414578587710072	1	1	78	139	0	3	C
H3_BC87_191109_LF_LIB_consensus_vsearch	1793	G	*/-T	213	9	3.95%	2	1	93	93	0.0017981564163397133	1	1	79	134	0	9	-T
H3_BC87_191109_LF_LIB_consensus_vsearch	1794	T	Y	205	10	4.63%	2	2	93	93	8.774450793915666E-4	1	1	77	128	2	8	C
H3_BC87_191109_LF_LIB_consensus_vsearch	1795	T	Y	214	9	3.98%	2	1	93	93	0.0017988361772468277	1	1	79	135	0	9	C
H3_BC87_191109_LF_LIB_consensus_vsearch	1796	T	*/-C	205	10	4.41%	2	1	93	93	8.774450793915666E-4	1	1	71	134	0	10	-C
H3_BC87_191109_LF_LIB_consensus_vsearch	1797	C	C	210	2	0.93%	2	1	93	93	0.24940898345148782	1	1	77	133	2	0	+A
H3_BC87_191109_LF_LIB_consensus_vsearch	1798	C	Y	209	7	3.1%	2	1	93	93	0.007436270701269745	1	1	75	134	0	7	T
H3_BC87_191109_LF_LIB_consensus_vsearch	1799	G	G	220	3	1.35%	2	1	93	93	0.12415730337075404	1	1	76	144	3	0	A
H3_BC87_191109_LF_LIB_consensus_vsearch	1800	T	Y	214	9	3.98%	2	1	93	93	0.0017988361772468277	1	1	78	136	0	9	C
H3_BC87_191109_LF_LIB_consensus_vsearch	1801	C	C	224	2	0.88%	2	2	93	93	0.24944567627499675	1	1	77	147	1	1	+A
H3_BC87_191109_LF_LIB_consensus_vsearch	1802	G	G	225	1	0.44%	2	1	93	93	0.5000000000003686	1	1	76	149	1	0	A
H3_BC87_191109_LF_LIB_consensus_vsearch	1803	T	T	221	3	1.32%	2	2	93	93	0.12416107382546236	1	1	75	146	2	1	-C
H3_BC87_191109_LF_LIB_consensus_vsearch	1804	C	C	222	1	0.45%	2	1	93	93	0.4999999999999138	1	1	74	148	1	0	+T
H3_BC87_191109_LF_LIB_consensus_vsearch	1805	C	*/-T	205	16	7.08%	2	2	93	93	1.1515964001761286E-5	1	1	75	130	2	14	-T
H3_BC87_191109_LF_LIB_consensus_vsearch	1806	T	T	196	5	2.42%	2	1	93	93	0.03047362796017546	1	1	67	129	5	0	+C
H3_BC87_191109_LF_LIB_consensus_vsearch	1807	C	*/-GG	179	31	13.84%	2	1	93	93	1.409491967626089E-10	1	1	77	102	0	31	-GG
H3_BC87_191109_LF_LIB_consensus_vsearch	1808	G	R	166	13	7.07%	2	1	93	93	9.739634822135725E-5	1	1	65	101	13	0	A
H3_BC87_191109_LF_LIB_consensus_vsearch	1809	G	G	196	1	0.51%	2	1	93	93	0.5000000000001412	1	1	80	116	0	1	T
H3_BC87_191109_LF_LIB_consensus_vsearch	1810	G	G	225	2	0.87%	2	2	93	93	0.24944812362040697	1	1	79	146	1	1	-A
H3_BC87_191109_LF_LIB_consensus_vsearch	1811	A	A	225	1	0.44%	2	1	93	93	0.5000000000003686	1	1	78	147	1	0	-CG
H3_BC87_191109_LF_LIB_consensus_vsearch	1812	C	C	227	0	0%	2	0	93	0	1.0	1	0	79	148	0	0	
H3_BC87_191109_LF_LIB_consensus_vsearch	1813	G	G	224	2	0.88%	2	1	93	93	0.24944567627499675	1	1	77	147	2	0	A
H3_BC87_191109_LF_LIB_consensus_vsearch	1814	T	T	226	1	0.44%	2	1	93	93	0.4999999999999138	1	1	80	146	0	1	+AG
H3_BC87_191109_LF_LIB_consensus_vsearch	1815	T	*/-A	216	11	4.82%	2	2	93	93	4.313270586514381E-4	1	1	74	142	6	5	-A
H3_BC87_191109_LF_LIB_consensus_vsearch	1816	A	A	212	1	0.46%	2	1	93	93	0.5000000000001412	1	1	72	140	1	0	+CCC
H3_BC87_191109_LF_LIB_consensus_vsearch	1817	A	A	219	3	1.32%	2	2	93	93	0.12415349887135622	1	1	78	141	1	2	G
H3_BC87_191109_LF_LIB_consensus_vsearch	1818	G	G	224	1	0.44%	2	1	93	93	0.4999999999999138	1	1	80	144	0	1	T
H3_BC87_191109_LF_LIB_consensus_vsearch	1819	G	G	225	1	0.44%	2	1	93	93	0.5000000000003686	1	1	80	145	0	1	-CGC
H3_BC87_191109_LF_LIB_consensus_vsearch	1820	C	C	217	6	2.64%	2	1	93	93	0.015101878629034914	1	1	78	139	0	6	-GC
H3_BC87_191109_LF_LIB_consensus_vsearch	1821	G	G	211	3	1.38%	2	1	93	93	0.12412177985949331	1	1	78	133	0	3	-C
H3_BC87_191109_LF_LIB_consensus_vsearch	1822	C	C	208	2	0.92%	2	1	93	93	0.24940334128888852	1	1	77	131	0	2	+GC
H3_BC87_191109_LF_LIB_consensus_vsearch	1823	T	T	217	3	1.33%	2	1	93	93	0.12414578587710072	1	1	77	140	0	3	-C
H3_BC87_191109_LF_LIB_consensus_vsearch	1824	C	C	216	3	1.35%	2	1	93	93	0.12414187643025615	1	1	78	138	0	3	+T
H3_BC87_191109_LF_LIB_consensus_vsearch	1825	T	*/-G	211	10	4.46%	2	1	93	93	8.800549103686053E-4	1	1	77	134	0	10	-G
H3_BC87_191109_LF_LIB_consensus_vsearch	1826	G	G	215	1	0.46%	2	1	93	93	0.4999999999999138	1	1	80	135	0	1	T
H3_BC87_191109_LF_LIB_consensus_vsearch	1827	G	G	224	1	0.44%	2	1	93	93	0.4999999999999138	1	1	80	144	0	1	-T
H3_BC87_191109_LF_LIB_consensus_vsearch	1828	T	T	222	2	0.88%	2	1	93	93	0.24944071588395061	1	1	80	142	0	2	C
H3_BC87_191109_LF_LIB_consensus_vsearch	1829	C	C	224	1	0.44%	2	1	93	93	0.4999999999999138	1	1	79	145	1	0	-G
H3_BC87_191109_LF_LIB_consensus_vsearch	1830	G	*/-AG	218	7	3.08%	2	1	93	93	0.007451182688346346	1	1	72	146	7	0	-AG
H3_BC87_191109_LF_LIB_consensus_vsearch	1831	A	*/-G	205	8	3.64%	2	1	93	93	0.0036534383902297935	1	1	64	141	8	0	-G
H3_BC87_191109_LF_LIB_consensus_vsearch	1832	G	G	208	1	0.48%	2	1	93	93	0.5000000000001412	1	1	65	143	0	1	+T
H3_BC87_191109_LF_LIB_consensus_vsearch	1833	G	G	224	2	0.88%	2	2	93	93	0.24944567627499675	1	1	79	145	1	1	A
H3_BC87_191109_LF_LIB_consensus_vsearch	1834	A	A	223	1	0.44%	2	1	93	93	0.5000000000003686	1	1	78	145	1	0	+G
H3_BC87_191109_LF_LIB_consensus_vsearch	1835	T	*/+A	207	12	5.24%	2	1	93	93	2.091345729349345E-4	1	1	77	130	0	12	+A
H3_BC87_191109_LF_LIB_consensus_vsearch	1836	A	A	220	1	0.45%	2	1	93	93	0.4999999999999138	1	1	78	142	0	1	+CA
H3_BC87_191109_LF_LIB_consensus_vsearch	1837	A	A	226	1	0.44%	2	1	93	93	0.4999999999999138	1	1	78	148	1	0	C
H3_BC87_191109_LF_LIB_consensus_vsearch	1838	A	A	223	5	2.18%	2	2	93	93	0.03056546102900896	1	1	76	147	4	1	G
H3_BC87_191109_LF_LIB_consensus_vsearch	1839	C	C	218	3	1.31%	2	1	93	93	0.12414965986396012	1	1	74	144	3	0	+A
H3_BC87_191109_LF_LIB_consensus_vsearch	1840	G	*/-A	214	8	3.54%	2	1	93	93	0.003663533633296164	1	1	70	144	8	0	-A
H3_BC87_191109_LF_LIB_consensus_vsearch	1841	A	*/-C	101	91	41.74%	2	2	93	93	2.7990930164621936E-34	1	1	57	44	3	88	-C
H3_BC87_191109_LF_LIB_consensus_vsearch	1842	C	C	119	4	3.15%	2	1	93	93	0.060972537163008836	1	1	69	50	4	0	G
H3_BC87_191109_LF_LIB_consensus_vsearch	1843	C	C	217	2	0.91%	2	1	93	93	0.24942791762028085	1	1	78	139	2	0	G
H3_BC87_191109_LF_LIB_consensus_vsearch	1844	C	C	221	2	0.89%	2	1	93	93	0.24943820224728358	1	1	78	143	2	0	+A
H3_BC87_191109_LF_LIB_consensus_vsearch	1845	C	C	221	2	0.88%	2	2	93	93	0.24943820224728358	1	1	79	142	1	1	-T
H3_BC87_191109_LF_LIB_consensus_vsearch	1846	T	T	210	6	2.68%	2	1	93	93	0.01508500627971554	1	1	77	133	0	6	-CT
H3_BC87_191109_LF_LIB_consensus_vsearch	1847	C	C	212	2	0.92%	2	2	93	93	0.24941451990645544	1	1	79	133	1	1	-T
H3_BC87_191109_LF_LIB_consensus_vsearch	1848	T	T	202	6	2.76%	2	1	93	93	0.015064340002589747	1	1	79	123	0	6	+G
H3_BC87_191109_LF_LIB_consensus_vsearch	1849	G	G	222	2	0.88%	2	1	93	93	0.24944071588395061	1	1	79	143	0	2	C
H3_BC87_191109_LF_LIB_consensus_vsearch	1850	A	A	221	2	0.88%	2	2	93	93	0.24943820224728358	1	1	78	143	1	1	+G
H3_BC87_191109_LF_LIB_consensus_vsearch	1851	C	C	216	4	1.75%	2	1	93	93	0.061646763238677425	1	1	70	146	4	0	+G
H3_BC87_191109_LF_LIB_consensus_vsearch	1852	A	A	219	4	1.77%	2	1	93	93	0.06165825449566743	1	1	73	146	4	0	-G
H3_BC87_191109_LF_LIB_consensus_vsearch	1853	G	G	215	4	1.78%	2	1	93	93	0.06164286277914926	1	1	68	147	4	0	+A
H3_BC87_191109_LF_LIB_consensus_vsearch	1854	A	*/-G	213	7	3.14%	2	1	93	93	0.007443047448823043	1	1	68	145	7	0	-G
H3_BC87_191109_LF_LIB_consensus_vsearch	1855	G	*/+A	193	14	6.42%	2	1	93	93	4.862760706844154E-5	1	1	50	143	14	0	+A
H3_BC87_191109_LF_LIB_consensus_vsearch	1856	G	G	220	3	1.32%	2	2	93	93	0.12415730337075404	1	1	74	146	2	1	A
H3_BC87_191109_LF_LIB_consensus_vsearch	1857	T	*/-A	182	22	9.73%	2	2	93	93	1.3111161759501132E-7	1	1	65	117	7	15	-A
H3_BC87_191109_LF_LIB_consensus_vsearch	1858	A	A	190	2	1.02%	2	1	93	93	0.2493472584856949	1	1	69	121	0	2	T
H3_BC87_191109_LF_LIB_consensus_vsearch	1859	A	A	219	1	0.45%	2	1	93	93	0.4999999999999138	1	1	79	140	1	0	C
H3_BC87_191109_LF_LIB_consensus_vsearch	1860	A	A	221	2	0.88%	2	1	93	93	0.24943820224728358	1	1	78	143	0	2	T
H3_BC87_191109_LF_LIB_consensus_vsearch	1861	G	G	220	3	1.32%	2	1	93	93	0.12415730337075404	1	1	74	146	3	0	A
H3_BC87_191109_LF_LIB_consensus_vsearch	1862	C	C	219	6	2.65%	2	2	93	93	0.015106507368173285	1	1	78	141	1	5	T
H3_BC87_191109_LF_LIB_consensus_vsearch	1863	C	Y	205	19	8.37%	2	2	93	93	1.2807606843266436E-6	1	1	76	129	2	17	T
H3_BC87_191109_LF_LIB_consensus_vsearch	1864	G	G	223	4	1.76%	2	2	93	93	0.061673103185009646	1	1	78	145	2	2	A
H3_BC87_191109_LF_LIB_consensus_vsearch	1865	T	*/+C	207	11	4.82%	2	2	93	93	4.2906952287648286E-4	1	1	66	141	7	4	+C
H3_BC87_191109_LF_LIB_consensus_vsearch	1866	C	C	221	1	0.45%	2	1	93	93	0.4999999999999138	1	1	73	148	1	0	+T
H3_BC87_191109_LF_LIB_consensus_vsearch	1867	C	C	224	2	0.88%	2	1	93	93	0.24944567627499675	1	1	79	145	0	2	-T
H3_BC87_191109_LF_LIB_consensus_vsearch	1868	T	Y	206	9	4%	2	2	93	93	0.001793225137980622	1	1	77	129	1	8	C
H3_BC87_191109_LF_LIB_consensus_vsearch	1869	G	G	219	4	1.77%	2	1	93	93	0.06165825449566743	1	1	77	142	0	4	-T
H3_BC87_191109_LF_LIB_consensus_vsearch	1870	T	T	210	6	2.69%	2	2	93	93	0.01508500627971554	1	1	75	135	2	4	C
H3_BC87_191109_LF_LIB_consensus_vsearch	1871	G	G	219	2	0.89%	2	1	93	93	0.24943310657599216	1	1	74	145	2	0	A
H3_BC87_191109_LF_LIB_consensus_vsearch	1872	T	Y	216	7	3.12%	2	2	93	93	0.007447971960236055	1	1	77	139	1	6	C
H3_BC87_191109_LF_LIB_consensus_vsearch	1873	T	T	225	2	0.87%	2	1	93	93	0.24944812362040697	1	1	80	145	0	2	C
H3_BC87_191109_LF_LIB_consensus_vsearch	1874	A	A	217	3	1.32%	2	2	93	93	0.12414578587710072	1	1	74	143	2	1	+C
H3_BC87_191109_LF_LIB_consensus_vsearch	1875	C	C	217	6	2.67%	2	1	93	93	0.015101878629034914	1	1	77	140	0	6	+T
H3_BC87_191109_LF_LIB_consensus_vsearch	1876	C	*/+T	211	8	3.51%	2	1	93	93	0.0036602593149509337	1	1	78	133	0	8	+T
H3_BC87_191109_LF_LIB_consensus_vsearch	1877	T	T	211	4	1.79%	2	1	93	93	0.06162689769249	1	1	78	133	0	4	-CTT
H3_BC87_191109_LF_LIB_consensus_vsearch	1878	C	*/-T	159	56	25.11%	2	2	93	93	2.237922258457574E-19	1	1	73	86	2	54	-T
H3_BC87_191109_LF_LIB_consensus_vsearch	1879	T	T	158	3	1.82%	2	2	93	93	0.12383177570092072	1	1	75	83	1	2	+CT
H3_BC87_191109_LF_LIB_consensus_vsearch	1880	T	T	223	0	0%	2	0	93	0	1.0	1	0	79	144	0	0	
H3_BC87_191109_LF_LIB_consensus_vsearch	1881	T	T	227	1	0.44%	2	1	93	93	0.4999999999999138	1	1	79	148	0	1	-G
H3_BC87_191109_LF_LIB_consensus_vsearch	1882	G	G	225	2	0.88%	2	1	93	93	0.24944812362040697	1	1	77	148	2	0	-C
H3_BC87_191109_LF_LIB_consensus_vsearch	1883	C	C	223	1	0.44%	2	1	93	93	0.5000000000003686	1	1	78	145	0	1	+A
H3_BC87_191109_LF_LIB_consensus_vsearch	1884	C	C	219	4	1.75%	2	2	93	93	0.06165825449566743	1	1	76	143	1	3	+G
H3_BC87_191109_LF_LIB_consensus_vsearch	1885	G	*/-A	210	10	4.42%	2	2	93	93	8.796295164637225E-4	1	1	66	144	9	1	-A
H3_BC87_191109_LF_LIB_consensus_vsearch	1886	A	A	208	6	2.78%	2	2	93	93	0.015079983859610983	1	1	63	145	4	2	-G
H3_BC87_191109_LF_LIB_consensus_vsearch	1887	G	G	216	2	0.91%	2	1	93	93	0.249425287356441	1	1	74	142	0	2	+T
H3_BC87_191109_LF_LIB_consensus_vsearch	1888	G	G	222	2	0.88%	2	1	93	93	0.24944071588395061	1	1	79	143	0	2	-C
H3_BC87_191109_LF_LIB_consensus_vsearch	1889	C	*/+A	210	9	3.98%	2	1	93	93	0.0017960807336148846	1	1	75	135	0	9	+A
H3_BC87_191109_LF_LIB_consensus_vsearch	1890	A	A	219	3	1.33%	2	2	93	93	0.12415349887135622	1	1	77	142	1	2	G
H3_BC87_191109_LF_LIB_consensus_vsearch	1891	C	*/-AC	196	12	5.33%	2	2	93	93	2.0738112718811548E-4	1	1	68	128	9	3	-AC
H3_BC87_191109_LF_LIB_consensus_vsearch	1892	A	A	212	1	0.47%	2	1	93	93	0.5000000000001412	1	1	69	143	0	1	-CGTTA
H3_BC87_191109_LF_LIB_consensus_vsearch	1893	C	C	202	5	2.35%	2	1	93	93	0.030496102932097202	1	1	68	134	0	5	T
H3_BC87_191109_LF_LIB_consensus_vsearch	1894	G	G	223	1	0.44%	2	1	93	93	0.5000000000003686	1	1	78	145	1	0	+A
H3_BC87_191109_LF_LIB_consensus_vsearch	1895	T	T	222	4	1.77%	2	1	93	93	0.061669440342892484	1	1	80	142	0	4	C
H3_BC87_191109_LF_LIB_consensus_vsearch	1896	T	*/-A	207	9	3.95%	2	1	93	93	0.001793948723227531	1	1	62	145	9	0	-A
H3_BC87_191109_LF_LIB_consensus_vsearch	1897	A	A	212	3	1.39%	2	2	93	93	0.1241258741259166	1	1	66	146	2	1	G
H3_BC87_191109_LF_LIB_consensus_vsearch	1898	A	A	224	1	0.44%	2	1	93	93	0.4999999999999138	1	1	75	149	1	0	+G
H3_BC87_191109_LF_LIB_consensus_vsearch	1899	A	A	226	2	0.87%	2	1	93	93	0.24945054945064127	1	1	78	148	2	0	-G
H3_BC87_191109_LF_LIB_consensus_vsearch	1900	G	G	224	1	0.44%	2	1	93	93	0.4999999999999138	1	1	76	148	1	0	-A
H3_BC87_191109_LF_LIB_consensus_vsearch	1901	A	A	223	3	1.32%	2	1	93	93	0.12416851441234596	1	1	79	144	0	3	-T
H3_BC87_191109_LF_LIB_consensus_vsearch	1902	T	T	223	2	0.88%	2	2	93	93	0.24944320712692292	1	1	79	144	1	1	C
H3_BC87_191109_LF_LIB_consensus_vsearch	1903	C	C	226	1	0.44%	2	1	93	93	0.4999999999999138	1	1	79	147	1	0	+A
H3_BC87_191109_LF_LIB_consensus_vsearch	1904	G	G	220	4	1.75%	2	2	93	93	0.061662016439223415	1	1	75	145	1	3	-T
H3_BC87_191109_LF_LIB_consensus_vsearch	1905	T	T	221	2	0.89%	2	1	93	93	0.24943820224728358	1	1	79	142	0	2	C
H3_BC87_191109_LF_LIB_consensus_vsearch	1906	T	*/-C	211	10	4.37%	2	2	93	93	8.800549103686053E-4	1	1	69	142	6	4	-C
H3_BC87_191109_LF_LIB_consensus_vsearch	1907	C	C	219	0	0%	2	0	93	0	1.0	1	0	74	145	0	0	
H3_BC87_191109_LF_LIB_consensus_vsearch	1908	C	C	225	1	0.44%	2	1	93	93	0.5000000000003686	1	1	80	145	0	1	+AAG
H3_BC87_191109_LF_LIB_consensus_vsearch	1909	G	R	217	8	3.49%	2	2	93	93	0.0036667219549938834	1	1	76	141	4	4	A
H3_BC87_191109_LF_LIB_consensus_vsearch	1910	C	C	215	6	2.64%	2	1	93	93	0.01509716650743782	1	1	80	135	0	6	T
H3_BC87_191109_LF_LIB_consensus_vsearch	1911	G	G	220	2	0.89%	2	1	93	93	0.2494356659142869	1	1	79	141	0	2	-T
H3_BC87_191109_LF_LIB_consensus_vsearch	1912	T	T	223	2	0.88%	2	1	93	93	0.24944320712692292	1	1	79	144	0	2	C
H3_BC87_191109_LF_LIB_consensus_vsearch	1913	T	*/-G	212	9	3.93%	2	1	93	93	0.00179747064240055	1	1	78	134	0	9	-G
H3_BC87_191109_LF_LIB_consensus_vsearch	1914	G	G	208	3	1.36%	2	1	93	93	0.12410926365791558	1	1	77	131	0	3	-T
H3_BC87_191109_LF_LIB_consensus_vsearch	1915	T	W	187	13	5.8%	2	2	93	93	9.981039688765196E-5	1	1	72	115	1	12	A
H3_BC87_191109_LF_LIB_consensus_vsearch	1916	G	*/-A	205	7	3.17%	2	2	93	93	0.0074292407456773525	1	1	70	135	5	2	-A
H3_BC87_191109_LF_LIB_consensus_vsearch	1917	A	A	210	5	2.27%	2	1	93	93	0.0305241206880699	1	1	75	135	0	5	-G
H3_BC87_191109_LF_LIB_consensus_vsearch	1918	G	G	213	2	0.9%	2	1	93	93	0.249417249417318	1	1	77	136	0	2	+C
H3_BC87_191109_LF_LIB_consensus_vsearch	1919	T	Y	217	8	3.51%	2	2	93	93	0.0036667219549938834	1	1	76	141	2	6	C
H3_BC87_191109_LF_LIB_consensus_vsearch	1920	C	C	223	4	1.75%	2	1	93	93	0.061673103185009646	1	1	79	144	0	4	+T
H3_BC87_191109_LF_LIB_consensus_vsearch	1921	T	Y	214	10	4.39%	2	2	93	93	8.813089995913842E-4	1	1	78	136	1	9	C
H3_BC87_191109_LF_LIB_consensus_vsearch	1922	A	A	222	2	0.89%	2	1	93	93	0.24944071588395061	1	1	76	146	2	0	G
H3_BC87_191109_LF_LIB_consensus_vsearch	1923	A	A	221	3	1.32%	2	1	93	93	0.12416107382546236	1	1	79	142	0	3	C
H3_BC87_191109_LF_LIB_consensus_vsearch	1924	C	C	219	3	1.33%	2	1	93	93	0.12415349887135622	1	1	78	141	0	3	+A
H3_BC87_191109_LF_LIB_consensus_vsearch	1925	A	A	218	4	1.75%	2	2	93	93	0.061654458623218986	1	1	75	143	1	3	G
H3_BC87_191109_LF_LIB_consensus_vsearch	1926	C	C	219	4	1.77%	2	1	93	93	0.06165825449566743	1	1	78	141	0	4	T
H3_BC87_191109_LF_LIB_consensus_vsearch	1927	C	C	222	3	1.32%	2	1	93	93	0.12416481069040536	1	1	79	143	0	3	-A
H3_BC87_191109_LF_LIB_consensus_vsearch	1928	A	A	218	4	1.78%	2	2	93	93	0.061654458623218986	1	1	75	143	3	1	G
H3_BC87_191109_LF_LIB_consensus_vsearch	1929	G	G	222	2	0.88%	2	1	93	93	0.24944071588395061	1	1	76	146	2	0	+A
H3_BC87_191109_LF_LIB_consensus_vsearch	1930	T	Y	212	14	6.17%	2	1	93	93	4.9595092839070994E-5	1	1	79	133	0	14	C
H3_BC87_191109_LF_LIB_consensus_vsearch	1931	T	T	222	1	0.44%	2	1	93	93	0.4999999999999138	1	1	77	145	1	0	+AC
H3_BC87_191109_LF_LIB_consensus_vsearch	1932	G	G	220	2	0.88%	2	1	93	93	0.2494356659142869	1	1	72	148	2	0	+CT
H3_BC87_191109_LF_LIB_consensus_vsearch	1933	T	Y	214	9	3.98%	2	2	93	93	0.0017988361772468277	1	1	74	140	3	6	C
H3_BC87_191109_LF_LIB_consensus_vsearch	1934	A	A	222	2	0.89%	2	2	93	93	0.24944071588395061	1	1	76	146	1	1	G
H3_BC87_191109_LF_LIB_consensus_vsearch	1935	A	A	225	1	0.44%	2	1	93	93	0.5000000000003686	1	1	77	148	0	1	+T
H3_BC87_191109_LF_LIB_consensus_vsearch	1936	C	C	226	1	0.44%	2	1	93	93	0.4999999999999138	1	1	79	147	0	1	-ACTT
H3_BC87_191109_LF_LIB_consensus_vsearch	1937	A	R	220	7	3.07%	2	1	93	93	0.007454337359329176	1	1	73	147	7	0	G
H3_BC87_191109_LF_LIB_consensus_vsearch	1938	C	*/-T	145	53	23.25%	2	2	93	93	1.978482750999745E-18	1	1	69	76	5	48	-T
H3_BC87_191109_LF_LIB_consensus_vsearch	1939	T	T	156	3	1.85%	2	2	93	93	0.12381703470030796	1	1	72	84	1	2	C
H3_BC87_191109_LF_LIB_consensus_vsearch	1940	T	T	209	4	1.86%	2	2	93	93	0.061618690029214815	1	1	77	132	1	3	C
H3_BC87_191109_LF_LIB_consensus_vsearch	1941	T	T	225	2	0.88%	2	1	93	93	0.24944812362040697	1	1	77	148	2	0	A
H3_BC87_191109_LF_LIB_consensus_vsearch	1942	T	T	226	2	0.87%	2	1	93	93	0.24945054945064127	1	1	78	148	2	0	C
H3_BC87_191109_LF_LIB_consensus_vsearch	1943	A	A	222	6	2.62%	2	2	93	93	0.015113298912360445	1	1	76	146	4	2	G
H3_BC87_191109_LF_LIB_consensus_vsearch	1944	C	C	222	4	1.75%	2	1	93	93	0.061669440342892484	1	1	78	144	0	4	+A
H3_BC87_191109_LF_LIB_consensus_vsearch	1945	A	A	228	0	0%	2	0	93	0	1.0	1	0	79	149	0	0	
H3_BC87_191109_LF_LIB_consensus_vsearch	1946	A	A	224	2	0.87%	2	1	93	93	0.24944567627499675	1	1	77	147	2	0	-C
H3_BC87_191109_LF_LIB_consensus_vsearch	1947	C	C	225	2	0.88%	2	2	93	93	0.24944812362040697	1	1	77	148	1	1	T
H3_BC87_191109_LF_LIB_consensus_vsearch	1948	C	C	218	6	2.62%	2	2	93	93	0.015104203282490625	1	1	78	140	1	5	T
H3_BC87_191109_LF_LIB_consensus_vsearch	1949	G	G	222	1	0.44%	2	1	93	93	0.4999999999999138	1	1	77	145	1	0	+A
H3_BC87_191109_LF_LIB_consensus_vsearch	1950	G	G	225	1	0.44%	2	1	93	93	0.5000000000003686	1	1	77	148	1	0	-T
H3_BC87_191109_LF_LIB_consensus_vsearch	1951	T	T	215	6	2.65%	2	1	93	93	0.01509716650743782	1	1	77	138	0	6	C
H3_BC87_191109_LF_LIB_consensus_vsearch	1952	A	A	222	1	0.44%	2	1	93	93	0.4999999999999138	1	1	78	144	0	1	+TG
H3_BC87_191109_LF_LIB_consensus_vsearch	1953	G	G	220	3	1.33%	2	1	93	93	0.12415730337075404	1	1	77	143	0	3	-CG
H3_BC87_191109_LF_LIB_consensus_vsearch	1954	C	C	216	5	2.24%	2	1	93	93	0.030543804461782422	1	1	80	136	0	5	-GC
H3_BC87_191109_LF_LIB_consensus_vsearch	1955	G	*/-C	208	11	5.02%	2	1	93	93	4.293291473235971E-4	1	1	80	128	0	11	-C
H3_BC87_191109_LF_LIB_consensus_vsearch	1956	C	Y	199	7	3.32%	2	1	93	93	0.007418189114685095	1	1	79	120	0	7	T
H3_BC87_191109_LF_LIB_consensus_vsearch	1957	T	*/-G	205	15	6.58%	2	1	93	93	2.384291138391124E-5	1	1	79	126	0	15	-G
H3_BC87_191109_LF_LIB_consensus_vsearch	1958	G	K	198	12	5.63%	2	1	93	93	2.077128545125299E-4	1	1	79	119	0	12	T
H3_BC87_191109_LF_LIB_consensus_vsearch	1959	G	G	224	4	1.75%	2	1	93	93	0.06167673386217682	1	1	76	148	4	0	A
H3_BC87_191109_LF_LIB_consensus_vsearch	1960	A	A	227	1	0.44%	2	1	93	93	0.4999999999999138	1	1	79	148	1	0	+G
H3_BC87_191109_LF_LIB_consensus_vsearch	1961	T	*/-C	188	36	15.79%	2	2	93	93	3.1536535804628482E-12	1	1	62	126	16	20	-C
H3_BC87_191109_LF_LIB_consensus_vsearch	1962	C	C	189	1	0.52%	2	1	93	93	0.5000000000001412	1	1	63	126	0	1	+T
H3_BC87_191109_LF_LIB_consensus_vsearch	1963	C	C	215	5	2.19%	2	1	93	93	0.03054059830172664	1	1	70	145	5	0	A
H3_BC87_191109_LF_LIB_consensus_vsearch	1964	C	*/+T	189	14	6.14%	2	1	93	93	4.840279700124344E-5	1	1	75	114	0	14	+T
H3_BC87_191109_LF_LIB_consensus_vsearch	1965	T	T	211	1	0.47%	2	1	93	93	0.5000000000001412	1	1	74	137	1	0	A
H3_BC87_191109_LF_LIB_consensus_vsearch	1966	T	T	206	5	2.21%	2	1	93	93	0.030510377042941562	1	1	74	132	0	5	G
H3_BC87_191109_LF_LIB_consensus_vsearch	1967	G	G	221	2	0.89%	2	1	93	93	0.24943820224728358	1	1	79	142	0	2	A
H3_BC87_191109_LF_LIB_consensus_vsearch	1968	G	G	224	3	1.32%	2	1	93	93	0.12417218543044797	1	1	79	145	0	3	A
H3_BC87_191109_LF_LIB_consensus_vsearch	1969	C	*/-AC	194	24	10.53%	2	2	93	93	3.0516921928395854E-8	1	1	55	139	23	1	-AC
H3_BC87_191109_LF_LIB_consensus_vsearch	1970	A	A	199	1	0.49%	2	1	93	93	0.5000000000001412	1	1	55	144	0	1	+C
H3_BC87_191109_LF_LIB_consensus_vsearch	1971	C	C	197	5	2.46%	2	1	93	93	0.030477466383663308	1	1	56	141	0	5	T
H3_BC87_191109_LF_LIB_consensus_vsearch	1972	G	G	225	1	0.44%	2	1	93	93	0.5000000000003686	1	1	78	147	1	0	-T
H3_BC87_191109_LF_LIB_consensus_vsearch	1973	T	T	226	1	0.44%	2	1	93	93	0.4999999999999138	1	1	78	148	1	0	C
H3_BC87_191109_LF_LIB_consensus_vsearch	1974	C	C	229	0	0%	2	0	93	0	1.0	1	0	80	149	0	0	
H3_BC87_191109_LF_LIB_consensus_vsearch	1975	A	A	220	5	2.18%	2	2	93	93	0.03055634444922604	1	1	76	144	2	3	G
H3_BC87_191109_LF_LIB_consensus_vsearch	1976	T	T	225	2	0.88%	2	1	93	93	0.24944812362040697	1	1	80	145	0	2	C
H3_BC87_191109_LF_LIB_consensus_vsearch	1977	T	T	223	3	1.31%	2	2	93	93	0.12416851441234596	1	1	79	144	1	2	C
H3_BC87_191109_LF_LIB_consensus_vsearch	1978	C	C	223	2	0.88%	2	1	93	93	0.24944320712692292	1	1	79	144	0	2	+G
H3_BC87_191109_LF_LIB_consensus_vsearch	1979	G	G	224	2	0.88%	2	1	93	93	0.24944567627499675	1	1	78	146	2	0	-A
H3_BC87_191109_LF_LIB_consensus_vsearch	1980	A	A	223	2	0.88%	2	1	93	93	0.24944320712692292	1	1	76	147	2	0	G
H3_BC87_191109_LF_LIB_consensus_vsearch	1981	T	T	219	4	1.75%	2	2	93	93	0.06165825449566743	1	1	74	145	2	2	+A
H3_BC87_191109_LF_LIB_consensus_vsearch	1982	G	G	223	3	1.32%	2	2	93	93	0.12416851441234596	1	1	76	147	1	2	A
H3_BC87_191109_LF_LIB_consensus_vsearch	1983	A	A	226	1	0.44%	2	1	93	93	0.4999999999999138	1	1	78	148	1	0	C
H3_BC87_191109_LF_LIB_consensus_vsearch	1984	A	A	224	1	0.44%	2	1	93	93	0.4999999999999138	1	1	76	148	1	0	-G
H3_BC87_191109_LF_LIB_consensus_vsearch	1985	G	G	221	1	0.44%	2	1	93	93	0.4999999999999138	1	1	76	145	0	1	+A
H3_BC87_191109_LF_LIB_consensus_vsearch	1986	A	A	221	1	0.44%	2	1	93	93	0.4999999999999138	1	1	78	143	0	1	+T
H3_BC87_191109_LF_LIB_consensus_vsearch	1987	C	C	220	3	1.33%	2	2	93	93	0.12415730337075404	1	1	77	143	1	2	+T
H3_BC87_191109_LF_LIB_consensus_vsearch	1988	C	Y	186	31	13.66%	2	1	93	93	1.4692824062237276E-10	1	1	75	111	0	31	T
H3_BC87_191109_LF_LIB_consensus_vsearch	1989	G	G	221	2	0.88%	2	2	93	93	0.24943820224728358	1	1	74	147	1	1	+C
H3_BC87_191109_LF_LIB_consensus_vsearch	1990	T	Y	207	19	8.41%	2	2	93	93	1.2854787932019895E-6	1	1	75	132	2	17	C
H3_BC87_191109_LF_LIB_consensus_vsearch	1991	T	T	221	1	0.44%	2	1	93	93	0.4999999999999138	1	1	77	144	1	0	+AC
H3_BC87_191109_LF_LIB_consensus_vsearch	1992	G	G	223	2	0.88%	2	1	93	93	0.24944320712692292	1	1	76	147	2	0	+C
H3_BC87_191109_LF_LIB_consensus_vsearch	1993	C	*/-A	203	10	4.41%	2	2	93	93	8.765435124402236E-4	1	1	76	127	3	7	-A
H3_BC87_191109_LF_LIB_consensus_vsearch	1994	A	A	215	1	0.46%	2	1	93	93	0.4999999999999138	1	1	76	139	0	1	+C
H3_BC87_191109_LF_LIB_consensus_vsearch	1995	A	A	225	2	0.87%	2	1	93	93	0.24944812362040697	1	1	79	146	0	2	+C
H3_BC87_191109_LF_LIB_consensus_vsearch	1996	A	A	226	1	0.44%	2	1	93	93	0.4999999999999138	1	1	80	146	0	1	+T
H3_BC87_191109_LF_LIB_consensus_vsearch	1997	T	T	219	6	2.63%	2	2	93	93	0.015106507368173285	1	1	76	143	4	2	G
H3_BC87_191109_LF_LIB_consensus_vsearch	1998	T	T	222	3	1.32%	2	1	93	93	0.12416481069040536	1	1	80	142	0	3	+G
H3_BC87_191109_LF_LIB_consensus_vsearch	1999	G	G	221	3	1.31%	2	1	93	93	0.12416107382546236	1	1	76	145	3	0	A
H3_BC87_191109_LF_LIB_consensus_vsearch	2000	C	C	215	6	2.67%	2	1	93	93	0.01509716650743782	1	1	77	138	0	6	T
H3_BC87_191109_LF_LIB_consensus_vsearch	2001	G	G	219	3	1.33%	2	1	93	93	0.12415349887135622	1	1	76	143	3	0	-A
H3_BC87_191109_LF_LIB_consensus_vsearch	2002	A	A	223	1	0.44%	2	1	93	93	0.5000000000003686	1	1	76	147	1	0	+C
H3_BC87_191109_LF_LIB_consensus_vsearch	2003	T	T	207	6	2.63%	2	2	93	93	0.015077437453979417	1	1	68	139	5	1	+A
H3_BC87_191109_LF_LIB_consensus_vsearch	2004	A	A	213	4	1.83%	2	2	93	93	0.06163495389099757	1	1	71	142	2	2	G
H3_BC87_191109_LF_LIB_consensus_vsearch	2005	A	A	222	1	0.45%	2	1	93	93	0.4999999999999138	1	1	78	144	1	0	+GAAGA
H3_BC87_191109_LF_LIB_consensus_vsearch	2006	A	A	224	2	0.88%	2	1	93	93	0.24944567627499675	1	1	77	147	2	0	C
H3_BC87_191109_LF_LIB_consensus_vsearch	2007	G	G	226	1	0.44%	2	1	93	93	0.4999999999999138	1	1	79	147	1	0	+A
H3_BC87_191109_LF_LIB_consensus_vsearch	2008	T	Y	216	8	3.52%	2	2	93	93	0.003665668526289429	1	1	78	138	1	7	C
H3_BC87_191109_LF_LIB_consensus_vsearch	2009	G	G	224	1	0.44%	2	1	93	93	0.4999999999999138	1	1	78	146	1	0	-ATG
H3_BC87_191109_LF_LIB_consensus_vsearch	2010	A	A	225	3	1.32%	2	2	93	93	0.12417582417582212	1	1	78	147	1	2	G
H3_BC87_191109_LF_LIB_consensus_vsearch	2011	T	T	224	3	1.32%	2	1	93	93	0.12417218543044797	1	1	78	146	0	3	C
H3_BC87_191109_LF_LIB_consensus_vsearch	2012	G	*/-TG	207	14	6.14%	2	2	93	93	4.93553660030744E-5	1	1	78	129	1	13	-TG
H3_BC87_191109_LF_LIB_consensus_vsearch	2013	T	T	201	3	1.44%	2	1	93	93	0.12407862407864012	1	1	78	123	0	3	+G
H3_BC87_191109_LF_LIB_consensus_vsearch	2014	G	G	209	1	0.47%	2	1	93	93	0.4999999999999138	1	1	79	130	0	1	+TG
H3_BC87_191109_LF_LIB_consensus_vsearch	2015	A	A	219	2	0.88%	2	1	93	93	0.24943310657599216	1	1	78	141	0	2	-T
H3_BC87_191109_LF_LIB_consensus_vsearch	2016	T	T	221	0	0%	2	0	93	0	1.0	1	0	80	141	0	0	
H3_BC87_191109_LF_LIB_consensus_vsearch	2017	G	G	217	3	1.34%	2	1	93	93	0.12414578587710072	1	1	76	141	3	0	A
H3_BC87_191109_LF_LIB_consensus_vsearch	2018	C	*/-GC	203	8	3.56%	2	2	93	93	0.0036510799339400076	1	1	69	134	3	5	-GC
H3_BC87_191109_LF_LIB_consensus_vsearch	2019	G	G	199	4	1.83%	2	1	93	93	0.061575222865550984	1	1	66	133	0	4	-CAAG
H3_BC87_191109_LF_LIB_consensus_vsearch	2020	C	Y	200	7	3.27%	2	2	93	93	0.007420075094973923	1	1	70	130	3	4	T
H3_BC87_191109_LF_LIB_consensus_vsearch	2021	A	A	217	1	0.45%	2	1	93	93	0.4999999999999138	1	1	76	141	1	0	C
H3_BC87_191109_LF_LIB_consensus_vsearch	2022	A	A	220	2	0.89%	2	1	93	93	0.2494356659142869	1	1	80	140	0	2	T
H3_BC87_191109_LF_LIB_consensus_vsearch	2023	G	G	220	2	0.9%	2	1	93	93	0.2494356659142869	1	1	79	141	0	2	+C
H3_BC87_191109_LF_LIB_consensus_vsearch	2024	T	*/-C	215	9	3.95%	2	2	93	93	0.0017995100038167202	1	1	71	144	7	2	-C
H3_BC87_191109_LF_LIB_consensus_vsearch	2025	C	C	218	2	0.91%	2	1	93	93	0.24943052391823226	1	1	73	145	0	2	T
H3_BC87_191109_LF_LIB_consensus_vsearch	2026	C	C	223	2	0.87%	2	1	93	93	0.24944320712692292	1	1	77	146	2	0	T
H3_BC87_191109_LF_LIB_consensus_vsearch	2027	A	A	222	2	0.88%	2	1	93	93	0.24944071588395061	1	1	75	147	2	0	-C
H3_BC87_191109_LF_LIB_consensus_vsearch	2028	C	C	220	2	0.9%	2	1	93	93	0.2494356659142869	1	1	76	144	0	2	+T
H3_BC87_191109_LF_LIB_consensus_vsearch	2029	C	C	218	3	1.33%	2	1	93	93	0.12414965986396012	1	1	77	141	0	3	+A
H3_BC87_191109_LF_LIB_consensus_vsearch	2030	A	R	204	16	7.21%	2	1	93	93	1.1500698432241858E-5	1	1	59	145	16	0	G
H3_BC87_191109_LF_LIB_consensus_vsearch	2031	C	*/-T	206	9	4.02%	2	2	93	93	0.001793225137980622	1	1	65	141	8	1	-T
H3_BC87_191109_LF_LIB_consensus_vsearch	2032	T	T	203	5	2.34%	2	2	93	93	0.030499722862415764	1	1	62	141	3	2	C
H3_BC87_191109_LF_LIB_consensus_vsearch	2033	T	T	212	4	1.77%	2	1	93	93	0.061630944461591126	1	1	69	143	4	0	C
H3_BC87_191109_LF_LIB_consensus_vsearch	2034	A	A	217	4	1.77%	2	1	93	93	0.0616506283607095	1	1	72	145	4	0	C
H3_BC87_191109_LF_LIB_consensus_vsearch	2035	T	T	219	4	1.77%	2	2	93	93	0.06165825449566743	1	1	73	146	3	1	G
H3_BC87_191109_LF_LIB_consensus_vsearch	2036	A	R	213	8	3.49%	2	2	93	93	0.0036624519192641563	1	1	68	145	6	2	G
H3_BC87_191109_LF_LIB_consensus_vsearch	2037	C	C	225	2	0.88%	2	1	93	93	0.24944812362040697	1	1	78	147	0	2	T
H3_BC87_191109_LF_LIB_consensus_vsearch	2038	G	G	220	3	1.31%	2	1	93	93	0.12415730337075404	1	1	76	144	0	3	-TG
H3_BC87_191109_LF_LIB_consensus_vsearch	2039	T	T	222	3	1.33%	2	1	93	93	0.12416481069040536	1	1	80	142	0	3	C
H3_BC87_191109_LF_LIB_consensus_vsearch	2040	G	G	225	1	0.44%	2	1	93	93	0.5000000000003686	1	1	79	146	1	0	T
H3_BC87_191109_LF_LIB_consensus_vsearch	2041	A	A	228	1	0.44%	2	1	93	93	0.4999999999999138	1	1	80	148	0	1	G
H3_BC87_191109_LF_LIB_consensus_vsearch	2042	A	A	229	0	0%	2	0	93	0	1.0	1	0	80	149	0	0	
H3_BC87_191109_LF_LIB_consensus_vsearch	2043	T	T	229	0	0%	2	0	93	0	1.0	1	0	80	149	0	0	
H3_BC87_191109_LF_LIB_consensus_vsearch	2044	C	C	227	1	0.44%	2	1	93	93	0.4999999999999138	1	1	80	147	0	1	+GTC
H3_BC87_191109_LF_LIB_consensus_vsearch	2045	A	A	226	1	0.44%	2	1	93	93	0.4999999999999138	1	1	79	147	0	1	+C
H3_BC87_191109_LF_LIB_consensus_vsearch	2046	T	T	222	2	0.88%	2	1	93	93	0.24944071588395061	1	1	77	145	2	0	+CC
H3_BC87_191109_LF_LIB_consensus_vsearch	2047	C	C	220	5	2.21%	2	2	93	93	0.03055634444922604	1	1	75	145	4	1	-G
H3_BC87_191109_LF_LIB_consensus_vsearch	2048	G	G	214	5	2.23%	2	1	93	93	0.030537362897492103	1	1	70	144	5	0	-A
H3_BC87_191109_LF_LIB_consensus_vsearch	2049	A	A	218	1	0.45%	2	1	93	93	0.5000000000003686	1	1	74	144	1	0	+G
H3_BC87_191109_LF_LIB_consensus_vsearch	2050	G	G	222	1	0.44%	2	1	93	93	0.4999999999999138	1	1	79	143	1	0	+A
H3_BC87_191109_LF_LIB_consensus_vsearch	2051	T	Y	212	15	6.58%	2	1	93	93	2.4031176331551327E-5	1	1	80	132	0	15	C
H3_BC87_191109_LF_LIB_consensus_vsearch	2052	T	T	226	1	0.44%	2	1	93	93	0.4999999999999138	1	1	80	146	0	1	+A
H3_BC87_191109_LF_LIB_consensus_vsearch	2053	G	G	225	1	0.44%	2	1	93	93	0.5000000000003686	1	1	78	147	0	1	+C
H3_BC87_191109_LF_LIB_consensus_vsearch	2054	T	Y	219	7	3.07%	2	1	93	93	0.007452766938834958	1	1	79	140	0	7	C
H3_BC87_191109_LF_LIB_consensus_vsearch	2055	T	T	213	6	2.63%	2	2	93	93	0.0150923687299321	1	1	72	141	5	1	+A
H3_BC87_191109_LF_LIB_consensus_vsearch	2056	G	G	217	5	2.22%	2	2	93	93	0.03054698177238809	1	1	75	142	3	2	-A
H3_BC87_191109_LF_LIB_consensus_vsearch	2057	A	A	217	2	0.9%	2	2	93	93	0.24942791762028085	1	1	73	144	1	1	C
H3_BC87_191109_LF_LIB_consensus_vsearch	2058	A	A	218	3	1.32%	2	2	93	93	0.12414965986396012	1	1	75	143	2	1	-C
H3_BC87_191109_LF_LIB_consensus_vsearch	2059	C	C	210	4	1.79%	2	1	93	93	0.06162281305968737	1	1	73	137	0	4	T
H3_BC87_191109_LF_LIB_consensus_vsearch	2060	G	G	214	2	0.89%	2	1	93	93	0.24941995359642635	1	1	70	144	2	0	A
H3_BC87_191109_LF_LIB_consensus_vsearch	2061	C	C	204	6	2.68%	2	2	93	93	0.015069653452839263	1	1	70	134	1	5	T
H3_BC87_191109_LF_LIB_consensus_vsearch	2062	A	A	217	3	1.33%	2	1	93	93	0.12414578587710072	1	1	73	144	3	0	G
H3_BC87_191109_LF_LIB_consensus_vsearch	2063	C	C	214	6	2.65%	2	2	93	93	0.015094778470947015	1	1	74	140	1	5	T
H3_BC87_191109_LF_LIB_consensus_vsearch	2064	T	Y	208	13	5.8%	2	1	93	93	1.0179544238135389E-4	1	1	78	130	0	13	C
H3_BC87_191109_LF_LIB_consensus_vsearch	2065	G	G	226	1	0.44%	2	1	93	93	0.4999999999999138	1	1	79	147	0	1	A
H3_BC87_191109_LF_LIB_consensus_vsearch	2066	C	C	221	3	1.32%	2	1	93	93	0.12416107382546236	1	1	75	146	3	0	-AC
H3_BC87_191109_LF_LIB_consensus_vsearch	2067	A	A	222	1	0.44%	2	1	93	93	0.4999999999999138	1	1	75	147	0	1	+C
H3_BC87_191109_LF_LIB_consensus_vsearch	2068	C	C	218	3	1.34%	2	2	93	93	0.12414965986396012	1	1	74	144	1	2	T
H3_BC87_191109_LF_LIB_consensus_vsearch	2069	C	C	223	3	1.31%	2	2	93	93	0.12416851441234596	1	1	79	144	1	2	T
H3_BC87_191109_LF_LIB_consensus_vsearch	2070	G	G	228	0	0%	2	0	93	0	1.0	1	0	80	148	0	0	
H3_BC87_191109_LF_LIB_consensus_vsearch	2071	C	C	225	2	0.87%	2	2	93	93	0.24944812362040697	1	1	79	146	1	1	-G
H3_BC87_191109_LF_LIB_consensus_vsearch	2072	G	*/-C	185	26	11.5%	2	1	93	93	6.561390566155701E-9	1	1	44	141	26	0	-C
H3_BC87_191109_LF_LIB_consensus_vsearch	2073	C	C	199	1	0.5%	2	1	93	93	0.5000000000001412	1	1	52	147	0	1	T
H3_BC87_191109_LF_LIB_consensus_vsearch	2074	C	C	224	1	0.44%	2	1	93	93	0.4999999999999138	1	1	78	146	0	1	+GCC
H3_BC87_191109_LF_LIB_consensus_vsearch	2075	C	C	218	6	2.63%	2	1	93	93	0.015104203282490625	1	1	79	139	0	6	+T
H3_BC87_191109_LF_LIB_consensus_vsearch	2076	T	*/-A	213	7	3.12%	2	2	93	93	0.007443047448823043	1	1	76	137	1	6	-A
H3_BC87_191109_LF_LIB_consensus_vsearch	2077	A	A	219	1	0.45%	2	1	93	93	0.4999999999999138	1	1	78	141	0	1	C
H3_BC87_191109_LF_LIB_consensus_vsearch	2078	A	A	222	4	1.75%	2	1	93	93	0.061669440342892484	1	1	79	143	0	4	-T
H3_BC87_191109_LF_LIB_consensus_vsearch	2079	T	T	216	5	2.24%	2	1	93	93	0.030543804461782422	1	1	73	143	5	0	-C
H3_BC87_191109_LF_LIB_consensus_vsearch	2080	C	C	220	2	0.9%	2	1	93	93	0.2494356659142869	1	1	74	146	0	2	T
H3_BC87_191109_LF_LIB_consensus_vsearch	2081	C	*/-G	210	7	3.08%	2	2	93	93	0.007437988084800957	1	1	77	133	1	6	-G
H3_BC87_191109_LF_LIB_consensus_vsearch	2082	G	G	217	2	0.91%	2	1	93	93	0.24942791762028085	1	1	75	142	2	0	A
H3_BC87_191109_LF_LIB_consensus_vsearch	2083	G	G	226	0	0%	2	0	93	0	1.0	1	0	78	148	0	0	
H3_BC87_191109_LF_LIB_consensus_vsearch	2084	C	C	220	2	0.88%	2	1	93	93	0.2494356659142869	1	1	76	144	0	2	+TT
H3_BC87_191109_LF_LIB_consensus_vsearch	2085	T	Y	213	11	4.89%	2	1	93	93	4.305938947768699E-4	1	1	77	136	0	11	C
H3_BC87_191109_LF_LIB_consensus_vsearch	2086	G	G	224	2	0.88%	2	2	93	93	0.24944567627499675	1	1	76	148	1	1	-C
H3_BC87_191109_LF_LIB_consensus_vsearch	2087	C	C	222	2	0.88%	2	1	93	93	0.24944071588395061	1	1	79	143	0	2	-G
H3_BC87_191109_LF_LIB_consensus_vsearch	2088	G	R	212	10	4.42%	2	2	93	93	8.804765900705064E-4	1	1	70	142	8	2	A
H3_BC87_191109_LF_LIB_consensus_vsearch	2089	G	G	222	2	0.88%	2	1	93	93	0.24944071588395061	1	1	80	142	0	2	+CG
H3_BC87_191109_LF_LIB_consensus_vsearch	2090	T	Y	211	9	4%	2	1	93	93	0.0017967787753331713	1	1	78	133	0	9	C
H3_BC87_191109_LF_LIB_consensus_vsearch	2091	A	A	221	2	0.88%	2	2	93	93	0.24943820224728358	1	1	79	142	1	1	-T
H3_BC87_191109_LF_LIB_consensus_vsearch	2092	T	T	214	5	2.21%	2	2	93	93	0.030537362897492103	1	1	76	138	1	4	C
H3_BC87_191109_LF_LIB_consensus_vsearch	2093	G	*/+C	86	111	49.33%	2	2	93	93	9.571004248060979E-44	1	1	25	61	42	69	+C
H3_BC87_191109_LF_LIB_consensus_vsearch	2094	C	C	206	1	0.47%	2	1	93	93	0.5000000000001412	1	1	65	141	1	0	+A
H3_BC87_191109_LF_LIB_consensus_vsearch	2095	C	C	214	6	2.64%	2	1	93	93	0.015094778470947015	1	1	67	147	6	0	G
H3_BC87_191109_LF_LIB_consensus_vsearch	2096	C	*/-T	191	16	6.99%	2	2	93	93	1.1290379746411729E-5	1	1	60	131	1	15	-T
H3_BC87_191109_LF_LIB_consensus_vsearch	2097	T	Y	154	37	18.88%	2	2	93	93	1.054785445505795E-12	1	1	55	99	4	33	C
H3_BC87_191109_LF_LIB_consensus_vsearch	2098	T	Y	201	10	4.72%	2	2	93	93	8.756254095238223E-4	1	1	57	144	6	4	C
H3_BC87_191109_LF_LIB_consensus_vsearch	2099	T	T	222	1	0.44%	2	1	93	93	0.4999999999999138	1	1	74	148	1	0	+A
H3_BC87_191109_LF_LIB_consensus_vsearch	2100	G	G	224	2	0.87%	2	2	93	93	0.24944567627499675	1	1	78	146	1	1	-A
H3_BC87_191109_LF_LIB_consensus_vsearch	2101	A	*/-G	211	10	4.42%	2	2	93	93	8.800549103686053E-4	1	1	70	141	6	4	-G
H3_BC87_191109_LF_LIB_consensus_vsearch	2102	G	G	208	4	1.84%	2	1	93	93	0.06161452805712106	1	1	73	135	0	4	+T
H3_BC87_191109_LF_LIB_consensus_vsearch	2103	C	Y	205	15	6.64%	2	1	93	93	2.384291138391124E-5	1	1	79	126	0	15	T
H3_BC87_191109_LF_LIB_consensus_vsearch	2104	G	G	223	2	0.88%	2	1	93	93	0.24944320712692292	1	1	78	145	0	2	+TT
H3_BC87_191109_LF_LIB_consensus_vsearch	2105	T	T	221	3	1.32%	2	2	93	93	0.12416107382546236	1	1	77	144	1	2	C
H3_BC87_191109_LF_LIB_consensus_vsearch	2106	C	C	223	1	0.44%	2	1	93	93	0.5000000000003686	1	1	77	146	1	0	-A
H3_BC87_191109_LF_LIB_consensus_vsearch	2107	A	A	217	3	1.33%	2	2	93	93	0.12414578587710072	1	1	75	142	1	2	G
H3_BC87_191109_LF_LIB_consensus_vsearch	2108	T	T	221	3	1.33%	2	1	93	93	0.12416107382546236	1	1	78	143	0	3	C
H3_BC87_191109_LF_LIB_consensus_vsearch	2109	T	T	218	2	0.88%	2	1	93	93	0.24943052391823226	1	1	76	142	2	0	+A
H3_BC87_191109_LF_LIB_consensus_vsearch	2110	G	G	223	1	0.44%	2	1	93	93	0.5000000000003686	1	1	78	145	0	1	-T
H3_BC87_191109_LF_LIB_consensus_vsearch	2111	T	T	218	2	0.89%	2	1	93	93	0.24943052391823226	1	1	78	140	0	2	-AT
H3_BC87_191109_LF_LIB_consensus_vsearch	2112	A	A	217	5	2.22%	2	2	93	93	0.03054698177238809	1	1	78	139	1	4	G
H3_BC87_191109_LF_LIB_consensus_vsearch	2113	T	*/-C	189	29	12.83%	2	2	93	93	6.871975409334308E-10	1	1	56	133	21	8	-C
H3_BC87_191109_LF_LIB_consensus_vsearch	2114	C	C	197	1	0.51%	2	1	93	93	0.5000000000001412	1	1	58	139	0	1	T
H3_BC87_191109_LF_LIB_consensus_vsearch	2115	C	C	217	5	2.19%	2	2	93	93	0.03054698177238809	1	1	75	142	1	4	+T
H3_BC87_191109_LF_LIB_consensus_vsearch	2116	C	*/-T	217	7	3.07%	2	2	93	93	0.007449584424390529	1	1	78	139	1	6	-T
H3_BC87_191109_LF_LIB_consensus_vsearch	2117	T	T	218	3	1.36%	2	1	93	93	0.12414965986396012	1	1	79	139	0	3	+CT
H3_BC87_191109_LF_LIB_consensus_vsearch	2118	T	T	221	4	1.75%	2	1	93	93	0.06166574490670126	1	1	74	147	4	0	+C
H3_BC87_191109_LF_LIB_consensus_vsearch	2119	C	*/-G	162	28	12.28%	2	2	93	93	1.2734331030666902E-9	1	1	50	112	18	10	-G
H3_BC87_191109_LF_LIB_consensus_vsearch	2120	G	R	160	9	5.14%	2	1	93	93	0.001750956793192828	1	1	46	114	9	0	A
H3_BC87_191109_LF_LIB_consensus_vsearch	2121	G	R	193	7	3.45%	2	1	93	93	0.007406481321433913	1	1	66	127	7	0	A
H3_BC87_191109_LF_LIB_consensus_vsearch	2122	G	R	204	11	4.89%	2	2	93	93	4.2827676494109035E-4	1	1	64	140	10	1	A
H3_BC87_191109_LF_LIB_consensus_vsearch	2123	A	A	217	4	1.79%	2	1	93	93	0.0616506283607095	1	1	72	145	4	0	-G
H3_BC87_191109_LF_LIB_consensus_vsearch	2124	G	G	206	6	2.69%	2	1	93	93	0.015074867144143777	1	1	69	137	0	6	+T
H3_BC87_191109_LF_LIB_consensus_vsearch	2125	T	T	213	6	2.65%	2	1	93	93	0.0150923687299321	1	1	79	134	0	6	-CTTT
H3_BC87_191109_LF_LIB_consensus_vsearch	2126	C	*/+T	126	42	19.27%	2	2	93	93	1.2100562465943808E-14	1	1	62	64	3	39	+T
H3_BC87_191109_LF_LIB_consensus_vsearch	2127	T	T	184	2	1.07%	2	2	93	93	0.24932614555250343	1	1	65	119	1	1	C
H3_BC87_191109_LF_LIB_consensus_vsearch	2128	T	T	213	2	0.93%	2	2	93	93	0.249417249417318	1	1	78	135	1	1	C
H3_BC87_191109_LF_LIB_consensus_vsearch	2129	T	T	216	2	0.91%	2	2	93	93	0.249425287356441	1	1	78	138	1	1	C
H3_BC87_191109_LF_LIB_consensus_vsearch	2130	T	T	222	2	0.87%	2	2	93	93	0.24944071588395061	1	1	76	146	1	1	-C
H3_BC87_191109_LF_LIB_consensus_vsearch	2131	C	C	213	4	1.77%	2	1	93	93	0.06163495389099757	1	1	77	136	0	4	+T
H3_BC87_191109_LF_LIB_consensus_vsearch	2132	G	G	227	1	0.44%	2	1	93	93	0.4999999999999138	1	1	80	147	0	1	A
H3_BC87_191109_LF_LIB_consensus_vsearch	2133	T	T	228	1	0.44%	2	1	93	93	0.4999999999999138	1	1	79	149	1	0	G
H3_BC87_191109_LF_LIB_consensus_vsearch	2134	T	T	225	4	1.75%	2	2	93	93	0.06168033279637854	1	1	77	148	3	1	-A
H3_BC87_191109_LF_LIB_consensus_vsearch	2135	A	A	221	2	0.89%	2	2	93	93	0.24943820224728358	1	1	74	147	1	1	C
H3_BC87_191109_LF_LIB_consensus_vsearch	2136	A	A	225	3	1.31%	2	1	93	93	0.12417582417582212	1	1	77	148	3	0	G
H3_BC87_191109_LF_LIB_consensus_vsearch	2137	G	G	227	2	0.87%	2	1	93	93	0.24945295404843976	1	1	80	147	0	2	C
H3_BC87_191109_LF_LIB_consensus_vsearch	2138	A	A	224	3	1.31%	2	1	93	93	0.12417218543044797	1	1	75	149	3	0	-C
H3_BC87_191109_LF_LIB_consensus_vsearch	2139	C	C	220	3	1.33%	2	1	93	93	0.12415730337075404	1	1	76	144	0	3	T
H3_BC87_191109_LF_LIB_consensus_vsearch	2140	C	*/+T	218	8	3.49%	2	1	93	93	0.003667766201363899	1	1	80	138	0	8	+T
H3_BC87_191109_LF_LIB_consensus_vsearch	2141	C	Y	197	23	10.04%	2	2	93	93	6.501382894958495E-8	1	1	74	123	2	21	T
H3_BC87_191109_LF_LIB_consensus_vsearch	2142	G	G	218	6	2.65%	2	2	93	93	0.015104203282490625	1	1	72	146	5	1	-A
H3_BC87_191109_LF_LIB_consensus_vsearch	2143	A	A	220	1	0.45%	2	1	93	93	0.4999999999999138	1	1	74	146	1	0	+G
H3_BC87_191109_LF_LIB_consensus_vsearch	2144	G	G	223	2	0.88%	2	1	93	93	0.24944320712692292	1	1	77	146	0	2	-T
H3_BC87_191109_LF_LIB_consensus_vsearch	2145	T	*/+C	217	9	3.96%	2	1	93	93	0.0018008401619304512	1	1	79	138	0	9	+C
H3_BC87_191109_LF_LIB_consensus_vsearch	2146	T	*/-C	205	11	4.8%	2	2	93	93	4.285433624407098E-4	1	1	67	138	1	10	-C
H3_BC87_191109_LF_LIB_consensus_vsearch	2147	C	*/-G	155	57	26.15%	2	2	93	93	8.865726911142699E-20	1	1	67	88	8	49	-G
H3_BC87_191109_LF_LIB_consensus_vsearch	2148	G	R	151	15	8.88%	2	2	93	93	2.192176748292141E-5	1	1	55	96	14	1	A
H3_BC87_191109_LF_LIB_consensus_vsearch	2149	G	*/-A	210	14	6.19%	2	2	93	93	4.950038813942507E-5	1	1	65	145	13	1	-A
H3_BC87_191109_LF_LIB_consensus_vsearch	2150	A	A	212	2	0.93%	2	2	93	93	0.24941451990645544	1	1	65	147	1	1	T
H3_BC87_191109_LF_LIB_consensus_vsearch	2151	G	G	224	2	0.88%	2	2	93	93	0.24944567627499675	1	1	77	147	1	1	C
H3_BC87_191109_LF_LIB_consensus_vsearch	2152	T	T	220	4	1.75%	2	2	93	93	0.061662016439223415	1	1	77	143	1	3	-C
H3_BC87_191109_LF_LIB_consensus_vsearch	2153	C	C	220	3	1.35%	2	1	93	93	0.12415730337075404	1	1	74	146	3	0	+A
H3_BC87_191109_LF_LIB_consensus_vsearch	2154	C	*/-T	216	7	3.08%	2	1	93	93	0.007447971960236055	1	1	77	139	0	7	-T
H3_BC87_191109_LF_LIB_consensus_vsearch	2155	T	T	205	6	2.75%	2	2	93	93	0.015072272591959035	1	1	71	134	5	1	+C
H3_BC87_191109_LF_LIB_consensus_vsearch	2156	C	C	220	3	1.33%	2	1	93	93	0.12415730337075404	1	1	80	140	0	3	-G
H3_BC87_191109_LF_LIB_consensus_vsearch	2157	G	G	220	2	0.88%	2	1	93	93	0.2494356659142869	1	1	77	143	2	0	A
H3_BC87_191109_LF_LIB_consensus_vsearch	2158	G	G	223	3	1.31%	2	2	93	93	0.12416851441234596	1	1	78	145	1	2	-T
H3_BC87_191109_LF_LIB_consensus_vsearch	2159	T	T	220	3	1.33%	2	2	93	93	0.12415730337075404	1	1	76	144	2	1	C
H3_BC87_191109_LF_LIB_consensus_vsearch	2160	C	*/-T	201	17	7.42%	2	1	93	93	5.516424489829313E-6	1	1	80	121	0	17	-T
H3_BC87_191109_LF_LIB_consensus_vsearch	2161	T	T	201	5	2.4%	2	2	93	93	0.03049244790271922	1	1	79	122	1	4	C
H3_BC87_191109_LF_LIB_consensus_vsearch	2162	T	T	222	2	0.89%	2	1	93	93	0.24944071588395061	1	1	79	143	0	2	C
H3_BC87_191109_LF_LIB_consensus_vsearch	2163	T	*/-G	176	52	22.71%	2	1	93	93	8.29662571926394E-18	1	1	80	96	0	52	-G
H3_BC87_191109_LF_LIB_consensus_vsearch	2164	G	G	172	4	2.26%	2	1	93	93	0.06143315455637365	1	1	80	92	0	4	T
H3_BC87_191109_LF_LIB_consensus_vsearch	2165	G	G	224	5	2.18%	2	2	93	93	0.03056844687042959	1	1	78	146	2	3	A
H3_BC87_191109_LF_LIB_consensus_vsearch	2166	A	A	228	1	0.44%	2	1	93	93	0.4999999999999138	1	1	80	148	0	1	T
H3_BC87_191109_LF_LIB_consensus_vsearch	2167	T	T	229	0	0%	2	0	93	0	1.0	1	0	80	149	0	0	
H3_BC87_191109_LF_LIB_consensus_vsearch	2168	C	C	227	1	0.44%	2	1	93	93	0.4999999999999138	1	1	79	148	1	0	+A
H3_BC87_191109_LF_LIB_consensus_vsearch	2169	G	G	222	4	1.75%	2	2	93	93	0.061669440342892484	1	1	77	145	3	1	A
H3_BC87_191109_LF_LIB_consensus_vsearch	2170	T	T	217	4	1.75%	2	2	93	93	0.0616506283607095	1	1	78	139	1	3	-GT
H3_BC87_191109_LF_LIB_consensus_vsearch	2171	G	G	217	2	0.9%	2	1	93	93	0.24942791762028085	1	1	78	139	0	2	+C
H3_BC87_191109_LF_LIB_consensus_vsearch	2172	T	T	212	4	1.81%	2	1	93	93	0.061630944461591126	1	1	79	133	0	4	+C
H3_BC87_191109_LF_LIB_consensus_vsearch	2173	T	T	211	5	2.2%	2	1	93	93	0.030527477163211258	1	1	80	131	0	5	-C
H3_BC87_191109_LF_LIB_consensus_vsearch	2174	C	C	218	2	0.9%	2	1	93	93	0.24943052391823226	1	1	80	138	0	2	-T
H3_BC87_191109_LF_LIB_consensus_vsearch	2175	T	*/-C	182	27	11.95%	2	1	93	93	3.0375645825338665E-9	1	1	76	106	0	27	-C
H3_BC87_191109_LF_LIB_consensus_vsearch	2176	C	*/-T	161	15	7.94%	2	2	93	93	2.2356045059508273E-5	1	1	78	83	1	14	-T
H3_BC87_191109_LF_LIB_consensus_vsearch	2177	T	T	195	3	1.51%	2	2	93	93	0.12405063291138052	1	1	76	119	2	1	C
H3_BC87_191109_LF_LIB_consensus_vsearch	2178	T	T	216	3	1.33%	2	1	93	93	0.12414187643025615	1	1	79	137	0	3	+G
H3_BC87_191109_LF_LIB_consensus_vsearch	2179	A	A	217	4	1.76%	2	1	93	93	0.0616506283607095	1	1	77	140	0	4	T
H3_BC87_191109_LF_LIB_consensus_vsearch	2180	G	G	225	1	0.44%	2	1	93	93	0.5000000000003686	1	1	79	146	1	0	+T
H3_BC87_191109_LF_LIB_consensus_vsearch	2181	A	A	220	6	2.64%	2	2	93	93	0.015108791157819889	1	1	75	145	4	2	G
H3_BC87_191109_LF_LIB_consensus_vsearch	2182	T	T	226	2	0.87%	2	1	93	93	0.24945054945064127	1	1	80	146	0	2	C
H3_BC87_191109_LF_LIB_consensus_vsearch	2183	G	G	221	4	1.75%	2	2	93	93	0.06166574490670126	1	1	77	144	1	3	-CG
H3_BC87_191109_LF_LIB_consensus_vsearch	2184	C	C	222	1	0.44%	2	1	93	93	0.4999999999999138	1	1	78	144	0	1	+A
H3_BC87_191109_LF_LIB_consensus_vsearch	2185	G	G	217	4	1.78%	2	2	93	93	0.0616506283607095	1	1	76	141	3	1	A
H3_BC87_191109_LF_LIB_consensus_vsearch	2186	T	T	223	3	1.31%	2	1	93	93	0.12416851441234596	1	1	75	148	3	0	+C
H3_BC87_191109_LF_LIB_consensus_vsearch	2187	C	C	223	2	0.88%	2	1	93	93	0.24944320712692292	1	1	78	145	0	2	+A
H3_BC87_191109_LF_LIB_consensus_vsearch	2188	G	G	224	1	0.44%	2	1	93	93	0.4999999999999138	1	1	80	144	0	1	+C
H3_BC87_191109_LF_LIB_consensus_vsearch	2189	C	C	217	6	2.64%	2	2	93	93	0.015101878629034914	1	1	75	142	5	1	-GC
H3_BC87_191109_LF_LIB_consensus_vsearch	2190	G	G	219	1	0.45%	2	1	93	93	0.4999999999999138	1	1	74	145	1	0	+C
H3_BC87_191109_LF_LIB_consensus_vsearch	2191	C	C	220	1	0.45%	2	1	93	93	0.4999999999999138	1	1	75	145	0	1	+T
H3_BC87_191109_LF_LIB_consensus_vsearch	2192	C	C	218	5	2.18%	2	2	93	93	0.030550130621104243	1	1	77	141	1	4	T
H3_BC87_191109_LF_LIB_consensus_vsearch	2193	G	G	224	1	0.44%	2	1	93	93	0.4999999999999138	1	1	77	147	0	1	+A
H3_BC87_191109_LF_LIB_consensus_vsearch	2194	A	A	219	5	2.2%	2	2	93	93	0.030553251388732716	1	1	77	142	1	4	-T
H3_BC87_191109_LF_LIB_consensus_vsearch	2195	T	T	217	2	0.9%	2	1	93	93	0.24942791762028085	1	1	78	139	0	2	-C
H3_BC87_191109_LF_LIB_consensus_vsearch	2196	C	*/+A	208	10	4.42%	2	1	93	93	8.787673881990181E-4	1	1	77	131	0	10	+A
H3_BC87_191109_LF_LIB_consensus_vsearch	2197	G	G	197	6	2.65%	2	1	93	93	0.015050600683290578	1	1	70	127	0	6	+A
H3_BC87_191109_LF_LIB_consensus_vsearch	2198	C	Y	199	13	5.83%	2	1	93	93	1.0098964132434686E-4	1	1	73	126	0	13	T
H3_BC87_191109_LF_LIB_consensus_vsearch	2199	C	C	213	5	2.21%	2	1	93	93	0.030534097847134272	1	1	75	138	0	5	T
H3_BC87_191109_LF_LIB_consensus_vsearch	2200	T	T	207	6	2.68%	2	2	93	93	0.015077437453979417	1	1	78	129	1	5	+C
H3_BC87_191109_LF_LIB_consensus_vsearch	2201	G	G	225	1	0.44%	2	1	93	93	0.5000000000003686	1	1	78	147	0	1	+CG
H3_BC87_191109_LF_LIB_consensus_vsearch	2202	A	A	225	1	0.44%	2	1	93	93	0.5000000000003686	1	1	77	148	1	0	-TG
H3_BC87_191109_LF_LIB_consensus_vsearch	2203	T	T	222	2	0.88%	2	2	93	93	0.24944071588395061	1	1	78	144	1	1	-G
H3_BC87_191109_LF_LIB_consensus_vsearch	2204	G	G	219	4	1.78%	2	2	93	93	0.06165825449566743	1	1	75	144	3	1	A
H3_BC87_191109_LF_LIB_consensus_vsearch	2205	G	G	220	4	1.75%	2	1	93	93	0.061662016439223415	1	1	72	148	4	0	A
H3_BC87_191109_LF_LIB_consensus_vsearch	2206	G	G	226	2	0.88%	2	2	93	93	0.24945054945064127	1	1	79	147	1	1	A
H3_BC87_191109_LF_LIB_consensus_vsearch	2207	T	T	223	3	1.32%	2	2	93	93	0.12416851441234596	1	1	78	145	2	1	-C
H3_BC87_191109_LF_LIB_consensus_vsearch	2208	C	C	222	2	0.89%	2	1	93	93	0.24944071588395061	1	1	75	147	2	0	-AC
H3_BC87_191109_LF_LIB_consensus_vsearch	2209	A	A	222	2	0.89%	2	1	93	93	0.24944071588395061	1	1	74	148	2	0	G
H3_BC87_191109_LF_LIB_consensus_vsearch	2210	C	*/-T	206	16	7.11%	2	1	93	93	1.1531106955580906E-5	1	1	77	129	0	16	-T
H3_BC87_191109_LF_LIB_consensus_vsearch	2211	T	T	207	3	1.42%	2	1	93	93	0.12410501193315207	1	1	79	128	0	3	-C
H3_BC87_191109_LF_LIB_consensus_vsearch	2212	C	C	209	6	2.68%	2	2	93	93	0.015082506692930204	1	1	74	135	1	5	-T
H3_BC87_191109_LF_LIB_consensus_vsearch	2213	T	T	210	3	1.38%	2	1	93	93	0.1241176470588473	1	1	74	136	0	3	-A
H3_BC87_191109_LF_LIB_consensus_vsearch	2214	A	A	218	2	0.9%	2	1	93	93	0.24943052391823226	1	1	75	143	2	0	G
H3_BC87_191109_LF_LIB_consensus_vsearch	2215	A	A	224	2	0.88%	2	2	93	93	0.24944567627499675	1	1	78	146	1	1	G
H3_BC87_191109_LF_LIB_consensus_vsearch	2216	T	T	220	4	1.75%	2	2	93	93	0.061662016439223415	1	1	79	141	1	3	C
H3_BC87_191109_LF_LIB_consensus_vsearch	2217	G	G	219	3	1.32%	2	2	93	93	0.12415349887135622	1	1	76	143	1	2	+C
H3_BC87_191109_LF_LIB_consensus_vsearch	2218	C	C	220	3	1.33%	2	1	93	93	0.12415730337075404	1	1	77	143	0	3	+T
H3_BC87_191109_LF_LIB_consensus_vsearch	2219	C	C	225	3	1.32%	2	1	93	93	0.12417582417582212	1	1	80	145	0	3	-T
H3_BC87_191109_LF_LIB_consensus_vsearch	2220	T	Y	208	9	4%	2	1	93	93	0.0017946657928001688	1	1	77	131	0	9	C
H3_BC87_191109_LF_LIB_consensus_vsearch	2221	G	G	222	4	1.75%	2	1	93	93	0.061669440342892484	1	1	75	147	4	0	-A
H3_BC87_191109_LF_LIB_consensus_vsearch	2222	A	A	219	3	1.34%	2	2	93	93	0.12415349887135622	1	1	72	147	2	1	-G
H3_BC87_191109_LF_LIB_consensus_vsearch	2223	G	G	223	1	0.44%	2	1	93	93	0.5000000000003686	1	1	78	145	0	1	-CGTGGAG
H3_BC87_191109_LF_LIB_consensus_vsearch	2224	C	C	222	2	0.88%	2	1	93	93	0.24944071588395061	1	1	77	145	2	0	+A
H3_BC87_191109_LF_LIB_consensus_vsearch	2225	G	G	219	4	1.77%	2	1	93	93	0.06165825449566743	1	1	78	141	0	4	-TG
H3_BC87_191109_LF_LIB_consensus_vsearch	2226	T	T	213	4	1.8%	2	2	93	93	0.06163495389099757	1	1	77	136	1	3	-G
H3_BC87_191109_LF_LIB_consensus_vsearch	2227	G	G	209	4	1.84%	2	1	93	93	0.061618690029214815	1	1	74	135	4	0	A
H3_BC87_191109_LF_LIB_consensus_vsearch	2228	G	G	214	4	1.78%	2	1	93	93	0.061638926495252586	1	1	71	143	4	0	+A
H3_BC87_191109_LF_LIB_consensus_vsearch	2229	A	A	217	1	0.45%	2	1	93	93	0.4999999999999138	1	1	74	143	1	0	+G
H3_BC87_191109_LF_LIB_consensus_vsearch	2230	G	G	222	1	0.44%	2	1	93	93	0.4999999999999138	1	1	80	142	0	1	+C
H3_BC87_191109_LF_LIB_consensus_vsearch	2231	T	*/-C	171	51	22.67%	2	2	93	93	1.7234718595681516E-17	1	1	62	109	17	34	-C
H3_BC87_191109_LF_LIB_consensus_vsearch	2232	C	C	171	1	0.57%	2	1	93	93	0.4999999999999138	1	1	61	110	1	0	+TC
H3_BC87_191109_LF_LIB_consensus_vsearch	2233	C	C	221	3	1.33%	2	1	93	93	0.12416107382546236	1	1	76	145	3	0	+T
H3_BC87_191109_LF_LIB_consensus_vsearch	2234	C	*/-T	200	22	9.69%	2	2	93	93	1.3797147807810935E-7	1	1	77	123	3	19	-T
H3_BC87_191109_LF_LIB_consensus_vsearch	2235	T	T	192	5	2.46%	2	1	93	93	0.030457885112232918	1	1	72	120	5	0	+C
H3_BC87_191109_LF_LIB_consensus_vsearch	2236	C	*/-G	184	30	13.51%	2	1	93	93	3.12315858966848E-10	1	1	80	104	0	30	-G
H3_BC87_191109_LF_LIB_consensus_vsearch	2237	G	G	193	1	0.51%	2	1	93	93	0.4999999999999138	1	1	79	114	0	1	+TG
H3_BC87_191109_LF_LIB_consensus_vsearch	2238	G	*/-A	218	9	3.95%	2	1	93	93	0.001801496644156972	1	1	70	148	9	0	-A
H3_BC87_191109_LF_LIB_consensus_vsearch	2239	A	A	216	2	0.91%	2	2	93	93	0.249425287356441	1	1	70	146	1	1	G
H3_BC87_191109_LF_LIB_consensus_vsearch	2240	G	G	226	1	0.44%	2	1	93	93	0.4999999999999138	1	1	80	146	0	1	+C
H3_BC87_191109_LF_LIB_consensus_vsearch	2241	C	C	225	3	1.32%	2	1	93	93	0.12417582417582212	1	1	80	145	0	3	-T
H3_BC87_191109_LF_LIB_consensus_vsearch	2242	T	Y	205	16	7.08%	2	1	93	93	1.1515964001761286E-5	1	1	79	126	0	16	C
H3_BC87_191109_LF_LIB_consensus_vsearch	2243	G	G	223	2	0.87%	2	1	93	93	0.24944320712692292	1	1	76	147	2	0	-A
H3_BC87_191109_LF_LIB_consensus_vsearch	2244	A	A	219	4	1.77%	2	1	93	93	0.06165825449566743	1	1	72	147	4	0	-G
H3_BC87_191109_LF_LIB_consensus_vsearch	2245	G	G	221	1	0.45%	2	1	93	93	0.4999999999999138	1	1	74	147	1	0	+A
H3_BC87_191109_LF_LIB_consensus_vsearch	2246	A	A	220	4	1.77%	2	1	93	93	0.061662016439223415	1	1	78	142	0	4	+GA
H3_BC87_191109_LF_LIB_consensus_vsearch	2247	C	C	224	1	0.44%	2	1	93	93	0.4999999999999138	1	1	77	147	0	1	+A
H3_BC87_191109_LF_LIB_consensus_vsearch	2248	G	G	226	0	0%	2	0	93	0	1.0	1	0	78	148	0	0	
H3_BC87_191109_LF_LIB_consensus_vsearch	2249	C	*/-GC	198	24	10.53%	2	2	93	93	3.090849381129373E-8	1	1	60	138	15	9	-GC
H3_BC87_191109_LF_LIB_consensus_vsearch	2250	G	G	197	1	0.5%	2	1	93	93	0.5000000000001412	1	1	62	135	0	1	+C
H3_BC87_191109_LF_LIB_consensus_vsearch	2251	C	*/-T	185	7	3.45%	2	2	93	93	0.007389745092191117	1	1	58	127	2	5	-T
H3_BC87_191109_LF_LIB_consensus_vsearch	2252	T	T	214	2	0.92%	2	1	93	93	0.24941995359642635	1	1	71	143	2	0	A
H3_BC87_191109_LF_LIB_consensus_vsearch	2253	T	T	214	4	1.78%	2	1	93	93	0.061638926495252586	1	1	76	138	0	4	+CT
H3_BC87_191109_LF_LIB_consensus_vsearch	2254	G	G	226	1	0.44%	2	1	93	93	0.4999999999999138	1	1	79	147	0	1	C
H3_BC87_191109_LF_LIB_consensus_vsearch	2255	A	A	220	4	1.75%	2	2	93	93	0.061662016439223415	1	1	75	145	3	1	-C
H3_BC87_191109_LF_LIB_consensus_vsearch	2256	C	C	223	2	0.89%	2	1	93	93	0.24944320712692292	1	1	77	146	0	2	T
H3_BC87_191109_LF_LIB_consensus_vsearch	2257	C	*/-G	170	33	14.41%	2	1	93	93	2.826779484050005E-11	1	1	41	129	33	0	-G
H3_BC87_191109_LF_LIB_consensus_vsearch	2258	G	*/+A	178	8	4.08%	2	2	93	93	0.0036173981471315664	1	1	32	146	7	1	+A
H3_BC87_191109_LF_LIB_consensus_vsearch	2259	A	A	224	2	0.88%	2	2	93	93	0.24944567627499675	1	1	78	146	1	1	+G
H3_BC87_191109_LF_LIB_consensus_vsearch	2260	G	*/-T	211	12	5.29%	2	2	93	93	2.0973150235371546E-4	1	1	76	135	1	11	-T
H3_BC87_191109_LF_LIB_consensus_vsearch	2261	T	T	204	5	2.31%	2	1	93	93	0.030503308196835104	1	1	78	126	0	5	+AA
H3_BC87_191109_LF_LIB_consensus_vsearch	2262	G	G	217	3	1.32%	2	1	93	93	0.12414578587710072	1	1	77	140	0	3	+CG
H3_BC87_191109_LF_LIB_consensus_vsearch	2263	T	Y	211	10	4.44%	2	1	93	93	8.800549103686053E-4	1	1	76	135	0	10	C
H3_BC87_191109_LF_LIB_consensus_vsearch	2264	T	T	216	3	1.32%	2	2	93	93	0.12414187643025615	1	1	76	140	1	2	-G
H3_BC87_191109_LF_LIB_consensus_vsearch	2265	G	G	220	3	1.33%	2	1	93	93	0.12415730337075404	1	1	77	143	0	3	-A
H3_BC87_191109_LF_LIB_consensus_vsearch	2266	A	A	220	3	1.33%	2	2	93	93	0.12415730337075404	1	1	78	142	1	2	-G
H3_BC87_191109_LF_LIB_consensus_vsearch	2267	G	*/+C	191	31	13.72%	2	1	93	93	1.510924593676463E-10	1	1	79	112	0	31	+C
H3_BC87_191109_LF_LIB_consensus_vsearch	2268	C	C	212	5	2.2%	2	1	93	93	0.030530802741347875	1	1	79	133	0	5	+T
H3_BC87_191109_LF_LIB_consensus_vsearch	2269	T	*/-C	192	26	11.56%	2	1	93	93	6.747777093771561E-9	1	1	79	113	0	26	-C
H3_BC87_191109_LF_LIB_consensus_vsearch	2270	C	C	196	2	0.99%	2	2	93	93	0.24936708860772178	1	1	77	119	1	1	-GC
H3_BC87_191109_LF_LIB_consensus_vsearch	2271	G	G	219	3	1.33%	2	1	93	93	0.12415349887135622	1	1	75	144	3	0	-CG
H3_BC87_191109_LF_LIB_consensus_vsearch	2272	C	C	218	4	1.79%	2	1	93	93	0.061654458623218986	1	1	76	142	0	4	T
H3_BC87_191109_LF_LIB_consensus_vsearch	2273	G	G	219	3	1.33%	2	2	93	93	0.12415349887135622	1	1	74	145	2	1	A
H3_BC87_191109_LF_LIB_consensus_vsearch	2274	T	T	226	1	0.44%	2	1	93	93	0.4999999999999138	1	1	79	147	0	1	A
H3_BC87_191109_LF_LIB_consensus_vsearch	2275	C	C	225	1	0.44%	2	1	93	93	0.5000000000003686	1	1	78	147	1	0	+AT
H3_BC87_191109_LF_LIB_consensus_vsearch	2276	G	G	221	3	1.32%	2	2	93	93	0.12416107382546236	1	1	75	146	1	2	-C
H3_BC87_191109_LF_LIB_consensus_vsearch	2277	C	C	221	1	0.44%	2	1	93	93	0.4999999999999138	1	1	75	146	1	0	+AC
H3_BC87_191109_LF_LIB_consensus_vsearch	2278	C	C	221	2	0.88%	2	2	93	93	0.24943820224728358	1	1	77	144	1	1	-AA
H3_BC87_191109_LF_LIB_consensus_vsearch	2279	A	*/+G	210	12	5.31%	2	1	93	93	2.0958418294317403E-4	1	1	66	144	12	0	+G
H3_BC87_191109_LF_LIB_consensus_vsearch	2280	A	A	224	3	1.32%	2	1	93	93	0.12417218543044797	1	1	76	148	3	0	-G
H3_BC87_191109_LF_LIB_consensus_vsearch	2281	G	R	217	8	3.54%	2	1	93	93	0.0036667219549938834	1	1	68	149	8	0	A
H3_BC87_191109_LF_LIB_consensus_vsearch	2282	T	*/-C	213	12	5.24%	2	1	93	93	2.1002241192895544E-4	1	1	64	149	12	0	-C
H3_BC87_191109_LF_LIB_consensus_vsearch	2283	C	C	214	1	0.46%	2	1	93	93	0.5000000000001412	1	1	65	149	1	0	+A
H3_BC87_191109_LF_LIB_consensus_vsearch	2284	C	*/+GG	200	17	7.46%	2	1	93	93	5.507857341679661E-6	1	1	74	126	0	17	+GG
H3_BC87_191109_LF_LIB_consensus_vsearch	2285	G	R	209	9	4.02%	2	1	93	93	0.0017953764342624938	1	1	64	145	9	0	A
H3_BC87_191109_LF_LIB_consensus_vsearch	2286	C	C	214	5	2.24%	2	1	93	93	0.030537362897492103	1	1	71	143	5	0	-AC
H3_BC87_191109_LF_LIB_consensus_vsearch	2287	A	*/+T	198	17	7.62%	2	1	93	93	5.490515091509853E-6	1	1	73	125	0	17	+T
H3_BC87_191109_LF_LIB_consensus_vsearch	2288	C	C	211	2	0.9%	2	1	93	93	0.24941176470603904	1	1	74	137	0	2	+G
H3_BC87_191109_LF_LIB_consensus_vsearch	2289	G	*/+T	195	21	9.25%	2	1	93	93	2.8618445754659307E-7	1	1	78	117	0	21	+T
H3_BC87_191109_LF_LIB_consensus_vsearch	2290	T	T	205	5	2.21%	2	2	93	93	0.03050685942891605	1	1	76	129	2	3	-CT
H3_BC87_191109_LF_LIB_consensus_vsearch	2291	C	*/-T	187	21	9.59%	2	2	93	93	2.8032918471012836E-7	1	1	76	111	1	20	-T
H3_BC87_191109_LF_LIB_consensus_vsearch	2292	T	T	188	5	2.5%	2	1	93	93	0.030441490624263247	1	1	74	114	0	5	C
H3_BC87_191109_LF_LIB_consensus_vsearch	2293	T	*/-G	184	23	10.18%	2	2	93	93	6.244544295921632E-8	1	1	74	110	1	22	-G
H3_BC87_191109_LF_LIB_consensus_vsearch	2294	G	G	199	3	1.46%	2	2	93	93	0.12406947890824477	1	1	78	121	1	2	A
H3_BC87_191109_LF_LIB_consensus_vsearch	2295	G	G	226	2	0.87%	2	1	93	93	0.24945054945064127	1	1	79	147	0	2	A
H3_BC87_191109_LF_LIB_consensus_vsearch	2296	A	A	224	2	0.88%	2	1	93	93	0.24944567627499675	1	1	76	148	2	0	-CG
H3_BC87_191109_LF_LIB_consensus_vsearch	2297	C	C	223	2	0.88%	2	1	93	93	0.24944320712692292	1	1	76	147	2	0	-G
H3_BC87_191109_LF_LIB_consensus_vsearch	2298	G	G	221	3	1.33%	2	1	93	93	0.12416107382546236	1	1	76	145	0	3	+C
H3_BC87_191109_LF_LIB_consensus_vsearch	2299	T	T	223	1	0.44%	2	1	93	93	0.5000000000003686	1	1	79	144	0	1	+C
H3_BC87_191109_LF_LIB_consensus_vsearch	2300	C	C	220	4	1.75%	2	1	93	93	0.061662016439223415	1	1	77	143	0	4	-G
H3_BC87_191109_LF_LIB_consensus_vsearch	2301	G	G	219	4	1.78%	2	2	93	93	0.06165825449566743	1	1	77	142	3	1	A
H3_BC87_191109_LF_LIB_consensus_vsearch	2302	G	G	226	1	0.44%	2	1	93	93	0.4999999999999138	1	1	79	147	1	0	-T
H3_BC87_191109_LF_LIB_consensus_vsearch	2303	T	*/-C	215	7	3.08%	2	1	93	93	0.007446345105805389	1	1	67	148	7	0	-C
H3_BC87_191109_LF_LIB_consensus_vsearch	2304	C	C	217	4	1.81%	2	1	93	93	0.0616506283607095	1	1	69	148	4	0	+A
H3_BC87_191109_LF_LIB_consensus_vsearch	2305	C	*/-T	215	11	4.82%	2	2	93	93	4.3108474750487954E-4	1	1	74	141	6	5	-T
H3_BC87_191109_LF_LIB_consensus_vsearch	2306	T	T	209	6	2.78%	2	2	93	93	0.015082506692930204	1	1	71	138	2	4	C
H3_BC87_191109_LF_LIB_consensus_vsearch	2307	A	A	220	4	1.77%	2	2	93	93	0.061662016439223415	1	1	75	145	2	2	G
H3_BC87_191109_LF_LIB_consensus_vsearch	2308	C	C	217	3	1.32%	2	1	93	93	0.12414578587710072	1	1	74	143	0	3	+A
H3_BC87_191109_LF_LIB_consensus_vsearch	2309	A	A	224	1	0.44%	2	1	93	93	0.4999999999999138	1	1	76	148	1	0	+C
H3_BC87_191109_LF_LIB_consensus_vsearch	2310	A	A	224	1	0.44%	2	1	93	93	0.4999999999999138	1	1	76	148	1	0	+C
H3_BC87_191109_LF_LIB_consensus_vsearch	2311	C	*/-GC	206	17	7.46%	2	1	93	93	5.5582526785826E-6	1	1	60	146	17	0	-GC
H3_BC87_191109_LF_LIB_consensus_vsearch	2312	G	R	198	8	3.77%	2	2	93	93	0.0036449867501809376	1	1	54	144	7	1	A
H3_BC87_191109_LF_LIB_consensus_vsearch	2313	C	C	201	4	1.92%	2	2	93	93	0.061584255960787086	1	1	61	140	1	3	T
H3_BC87_191109_LF_LIB_consensus_vsearch	2314	A	A	215	2	0.89%	2	1	93	93	0.2494226327944578	1	1	72	143	2	0	G
H3_BC87_191109_LF_LIB_consensus_vsearch	2315	T	T	218	5	2.23%	2	2	93	93	0.030550130621104243	1	1	77	141	1	4	C
H3_BC87_191109_LF_LIB_consensus_vsearch	2316	G	G	224	1	0.44%	2	1	93	93	0.4999999999999138	1	1	77	147	1	0	-A
H3_BC87_191109_LF_LIB_consensus_vsearch	2317	A	A	217	6	2.63%	2	1	93	93	0.015101878629034914	1	1	78	139	0	6	+C
H3_BC87_191109_LF_LIB_consensus_vsearch	2318	C	C	226	1	0.44%	2	1	93	93	0.4999999999999138	1	1	80	146	0	1	+A
H3_BC87_191109_LF_LIB_consensus_vsearch	2319	C	*/-TC	214	13	5.68%	2	2	93	93	1.0229936061105097E-4	1	1	78	136	1	12	-TC
H3_BC87_191109_LF_LIB_consensus_vsearch	2320	T	T	210	4	1.85%	2	2	93	93	0.06162281305968737	1	1	78	132	1	3	C
H3_BC87_191109_LF_LIB_consensus_vsearch	2321	C	C	206	5	2.33%	2	1	93	93	0.030510377042941562	1	1	72	134	5	0	-A
H3_BC87_191109_LF_LIB_consensus_vsearch	2322	A	A	217	3	1.34%	2	2	93	93	0.12414578587710072	1	1	73	144	2	1	-T
H3_BC87_191109_LF_LIB_consensus_vsearch	2323	T	T	216	5	2.25%	2	1	93	93	0.030543804461782422	1	1	73	143	5	0	G
H3_BC87_191109_LF_LIB_consensus_vsearch	2324	T	*/-G	156	30	13.33%	2	2	93	93	2.611149801760859E-10	1	1	68	88	5	25	-G
H3_BC87_191109_LF_LIB_consensus_vsearch	2325	G	G	168	6	3.39%	2	2	93	93	0.014955435339687276	1	1	68	100	4	2	A
H3_BC87_191109_LF_LIB_consensus_vsearch	2326	G	G	202	5	2.42%	2	2	93	93	0.030496102932097202	1	1	77	125	2	3	A
H3_BC87_191109_LF_LIB_consensus_vsearch	2327	G	R	206	13	5.86%	2	2	93	93	1.016217291023551E-4	1	1	74	132	4	9	A
H3_BC87_191109_LF_LIB_consensus_vsearch	2328	G	G	221	2	0.88%	2	2	93	93	0.24943820224728358	1	1	78	143	1	1	A
H3_BC87_191109_LF_LIB_consensus_vsearch	2329	T	Y	211	9	3.98%	2	2	93	93	0.0017967787753331713	1	1	77	134	1	8	C
H3_BC87_191109_LF_LIB_consensus_vsearch	2330	A	*/+G	188	24	10.76%	2	1	93	93	2.9910218982788557E-8	1	1	79	109	0	24	+G
H3_BC87_191109_LF_LIB_consensus_vsearch	2331	G	G	214	2	0.91%	2	1	93	93	0.24941995359642635	1	1	78	136	2	0	+AG
H3_BC87_191109_LF_LIB_consensus_vsearch	2332	G	G	229	0	0%	2	0	93	0	1.0	1	0	80	149	0	0	
H3_BC87_191109_LF_LIB_consensus_vsearch	2333	A	A	226	1	0.44%	2	1	93	93	0.4999999999999138	1	1	78	148	1	0	-CA
H3_BC87_191109_LF_LIB_consensus_vsearch	2334	C	*/+A	218	8	3.51%	2	1	93	93	0.003667766201363899	1	1	78	140	0	8	+A
H3_BC87_191109_LF_LIB_consensus_vsearch	2335	A	A	226	1	0.44%	2	1	93	93	0.4999999999999138	1	1	77	149	1	0	+G
H3_BC87_191109_LF_LIB_consensus_vsearch	2336	A	*/-C	203	12	5.26%	2	2	93	93	2.0851661109317314E-4	1	1	62	141	6	6	-C
H3_BC87_191109_LF_LIB_consensus_vsearch	2337	C	*/+T	201	7	3.27%	2	1	93	93	0.007421943123229272	1	1	70	131	0	7	+T
H3_BC87_191109_LF_LIB_consensus_vsearch	2338	C	C	223	1	0.44%	2	1	93	93	0.5000000000003686	1	1	79	144	1	0	+A
H3_BC87_191109_LF_LIB_consensus_vsearch	2339	C	Y	202	15	6.58%	2	2	93	93	2.375885795125084E-5	1	1	75	127	1	14	T
H3_BC87_191109_LF_LIB_consensus_vsearch	2340	G	G	213	2	0.9%	2	2	93	93	0.249417249417318	1	1	74	139	1	1	-CT
H3_BC87_191109_LF_LIB_consensus_vsearch	2341	C	C	215	3	1.36%	2	1	93	93	0.12413793103441495	1	1	75	140	0	3	-T
H3_BC87_191109_LF_LIB_consensus_vsearch	2342	T	Y	170	36	16.22%	2	2	93	93	2.72353599514503E-12	1	1	72	98	2	34	C
H3_BC87_191109_LF_LIB_consensus_vsearch	2343	A	*/+G	197	8	3.65%	2	1	93	93	0.003643733038795537	1	1	72	125	0	8	+G
H3_BC87_191109_LF_LIB_consensus_vsearch	2344	G	G	217	1	0.45%	2	1	93	93	0.4999999999999138	1	1	74	143	0	1	+CGG
H3_BC87_191109_LF_LIB_consensus_vsearch	2345	A	A	217	5	2.23%	2	2	93	93	0.03054698177238809	1	1	74	143	3	2	G
H3_BC87_191109_LF_LIB_consensus_vsearch	2346	C	C	217	4	1.77%	2	2	93	93	0.0616506283607095	1	1	75	142	2	2	-T
H3_BC87_191109_LF_LIB_consensus_vsearch	2347	T	T	218	3	1.35%	2	1	93	93	0.12414965986396012	1	1	76	142	0	3	+C
H3_BC87_191109_LF_LIB_consensus_vsearch	2348	T	*/-A	208	10	4.42%	2	2	93	93	8.787673881990181E-4	1	1	75	133	1	9	-A
H3_BC87_191109_LF_LIB_consensus_vsearch	2349	A	A	208	5	2.34%	2	1	93	93	0.03051731330830772	1	1	78	130	0	5	G
H3_BC87_191109_LF_LIB_consensus_vsearch	2350	A	R	209	9	4%	2	2	93	93	0.0017953764342624938	1	1	78	131	1	8	G
H3_BC87_191109_LF_LIB_consensus_vsearch	2351	G	G	217	2	0.9%	2	1	93	93	0.24942791762028085	1	1	77	140	2	0	A
H3_BC87_191109_LF_LIB_consensus_vsearch	2352	C	C	215	5	2.19%	2	2	93	93	0.03054059830172664	1	1	77	138	1	4	-A
H3_BC87_191109_LF_LIB_consensus_vsearch	2353	A	A	218	2	0.9%	2	1	93	93	0.24943052391823226	1	1	78	140	0	2	+T
H3_BC87_191109_LF_LIB_consensus_vsearch	2354	T	T	221	2	0.88%	2	1	93	93	0.24943820224728358	1	1	77	144	0	2	-AT
H3_BC87_191109_LF_LIB_consensus_vsearch	2355	A	A	220	2	0.89%	2	2	93	93	0.2494356659142869	1	1	76	144	1	1	G
H3_BC87_191109_LF_LIB_consensus_vsearch	2356	T	T	222	1	0.44%	2	1	93	93	0.4999999999999138	1	1	77	145	1	0	+G
H3_BC87_191109_LF_LIB_consensus_vsearch	2357	T	T	225	2	0.88%	2	1	93	93	0.24944812362040697	1	1	77	148	2	0	-A
H3_BC87_191109_LF_LIB_consensus_vsearch	2358	A	A	224	1	0.44%	2	1	93	93	0.4999999999999138	1	1	77	147	0	1	+G
H3_BC87_191109_LF_LIB_consensus_vsearch	2359	A	A	226	1	0.44%	2	1	93	93	0.4999999999999138	1	1	78	148	0	1	+C
H3_BC87_191109_LF_LIB_consensus_vsearch	2360	T	T	223	3	1.32%	2	2	93	93	0.12416851441234596	1	1	77	146	1	2	C
H3_BC87_191109_LF_LIB_consensus_vsearch	2361	C	C	222	1	0.44%	2	1	93	93	0.4999999999999138	1	1	75	147	1	0	+G
H3_BC87_191109_LF_LIB_consensus_vsearch	2362	A	A	221	2	0.88%	2	1	93	93	0.24943820224728358	1	1	77	144	0	2	-G
H3_BC87_191109_LF_LIB_consensus_vsearch	2363	G	G	222	1	0.45%	2	1	93	93	0.4999999999999138	1	1	76	146	1	0	A
H3_BC87_191109_LF_LIB_consensus_vsearch	2364	C	C	207	6	2.65%	2	1	93	93	0.015077437453979417	1	1	77	130	0	6	+G
H3_BC87_191109_LF_LIB_consensus_vsearch	2365	G	G	217	2	0.9%	2	1	93	93	0.24942791762028085	1	1	79	138	0	2	T
H3_BC87_191109_LF_LIB_consensus_vsearch	2366	G	G	225	1	0.44%	2	1	93	93	0.5000000000003686	1	1	79	146	0	1	+A
H3_BC87_191109_LF_LIB_consensus_vsearch	2367	A	*/-G	208	10	4.42%	2	2	93	93	8.787673881990181E-4	1	1	69	139	6	4	-G
H3_BC87_191109_LF_LIB_consensus_vsearch	2368	G	G	208	3	1.4%	2	1	93	93	0.12410926365791558	1	1	71	137	0	3	+T
H3_BC87_191109_LF_LIB_consensus_vsearch	2369	G	*/-A	177	30	13.33%	2	2	93	93	3.0011207809689923E-10	1	1	51	126	16	14	-A
H3_BC87_191109_LF_LIB_consensus_vsearch	2370	A	A	190	2	1.04%	2	2	93	93	0.2493472584856949	1	1	60	130	1	1	G
H3_BC87_191109_LF_LIB_consensus_vsearch	2371	A	A	223	2	0.88%	2	2	93	93	0.24944320712692292	1	1	78	145	1	1	G
H3_BC87_191109_LF_LIB_consensus_vsearch	2372	A	A	227	1	0.44%	2	1	93	93	0.4999999999999138	1	1	80	147	0	1	+G
H3_BC87_191109_LF_LIB_consensus_vsearch	2373	A	A	220	3	1.31%	2	2	93	93	0.12415730337075404	1	1	73	147	2	1	-G
H3_BC87_191109_LF_LIB_consensus_vsearch	2374	G	*/+A	207	9	4.07%	2	1	93	93	0.001793948723227531	1	1	74	133	0	9	+A
H3_BC87_191109_LF_LIB_consensus_vsearch	2375	A	A	218	1	0.45%	2	1	93	93	0.5000000000003686	1	1	75	143	1	0	+G
H3_BC87_191109_LF_LIB_consensus_vsearch	2376	A	A	224	2	0.88%	2	1	93	93	0.24944567627499675	1	1	76	148	2	0	+G
H3_BC87_191109_LF_LIB_consensus_vsearch	2377	A	R	206	8	3.52%	2	2	93	93	0.0036546013500883302	1	1	63	143	7	1	G
H3_BC87_191109_LF_LIB_consensus_vsearch	2378	C	*/-T	211	8	3.59%	2	2	93	93	0.0036602593149509337	1	1	67	144	5	3	-T
H3_BC87_191109_LF_LIB_consensus_vsearch	2379	T	Y	204	13	5.91%	2	2	93	93	1.0144502228683225E-4	1	1	71	133	3	10	C
H3_BC87_191109_LF_LIB_consensus_vsearch	2380	A	A	228	0	0%	2	0	93	0	1.0	1	0	79	149	0	0	
H3_BC87_191109_LF_LIB_consensus_vsearch	2381	A	A	220	5	2.19%	2	1	93	93	0.03055634444922604	1	1	73	147	5	0	-C
H3_BC87_191109_LF_LIB_consensus_vsearch	2382	C	C	222	1	0.45%	2	1	93	93	0.4999999999999138	1	1	74	148	0	1	T
H3_BC87_191109_LF_LIB_consensus_vsearch	2383	C	C	222	2	0.88%	2	1	93	93	0.24944071588395061	1	1	77	145	2	0	-A
H3_BC87_191109_LF_LIB_consensus_vsearch	2384	A	*/-G	192	32	14.16%	2	1	93	93	7.068964565499317E-11	1	1	77	115	0	32	-G
H3_BC87_191109_LF_LIB_consensus_vsearch	2385	G	G	192	2	1.02%	2	1	93	93	0.2493540051679821	1	1	78	114	2	0	A
H3_BC87_191109_LF_LIB_consensus_vsearch	2386	G	G	225	3	1.31%	2	1	93	93	0.12417582417582212	1	1	76	149	3	0	-A
H3_BC87_191109_LF_LIB_consensus_vsearch	2387	A	A	216	6	2.65%	2	2	93	93	0.015099533131216845	1	1	76	140	1	5	-T
H3_BC87_191109_LF_LIB_consensus_vsearch	2388	T	T	215	4	1.81%	2	1	93	93	0.06164286277914926	1	1	79	136	0	4	C
H3_BC87_191109_LF_LIB_consensus_vsearch	2389	T	*/-C	175	42	18.5%	2	2	93	93	2.5250925906038973E-14	1	1	75	100	5	37	-C
H3_BC87_191109_LF_LIB_consensus_vsearch	2390	C	C	179	0	0%	2	0	93	0	1.0	1	0	75	104	0	0	
H3_BC87_191109_LF_LIB_consensus_vsearch	2391	C	C	221	1	0.45%	2	1	93	93	0.4999999999999138	1	1	80	141	0	1	+TC
H3_BC87_191109_LF_LIB_consensus_vsearch	2392	C	*/-T	204	17	7.49%	2	2	93	93	5.541719766097385E-6	1	1	76	128	4	13	-T
H3_BC87_191109_LF_LIB_consensus_vsearch	2393	T	T	204	2	0.95%	2	1	93	93	0.2493917274938698	1	1	74	130	2	0	+C
H3_BC87_191109_LF_LIB_consensus_vsearch	2394	C	C	217	3	1.34%	2	1	93	93	0.12414578587710072	1	1	76	141	3	0	+G
H3_BC87_191109_LF_LIB_consensus_vsearch	2395	A	A	217	6	2.65%	2	2	93	93	0.015101878629034914	1	1	76	141	4	2	G
H3_BC87_191109_LF_LIB_consensus_vsearch	2396	G	G	226	1	0.44%	2	1	93	93	0.4999999999999138	1	1	79	147	1	0	+C
H3_BC87_191109_LF_LIB_consensus_vsearch	2397	T	Y	218	8	3.51%	2	2	93	93	0.003667766201363899	1	1	79	139	1	7	C
H3_BC87_191109_LF_LIB_consensus_vsearch	2398	A	A	226	0	0%	2	0	93	0	1.0	1	0	80	146	0	0	
H3_BC87_191109_LF_LIB_consensus_vsearch	2399	A	A	223	3	1.32%	2	1	93	93	0.12416851441234596	1	1	77	146	3	0	G
H3_BC87_191109_LF_LIB_consensus_vsearch	2400	C	C	217	4	1.76%	2	2	93	93	0.0616506283607095	1	1	75	142	1	3	-T
H3_BC87_191109_LF_LIB_consensus_vsearch	2401	T	Y	214	8	3.6%	2	2	93	93	0.003663533633296164	1	1	77	137	1	7	C
H3_BC87_191109_LF_LIB_consensus_vsearch	2402	G	G	221	2	0.88%	2	2	93	93	0.24943820224728358	1	1	77	144	1	1	T
H3_BC87_191109_LF_LIB_consensus_vsearch	2403	C	*/-G	196	9	3.98%	2	1	93	93	0.001785610469261078	1	1	61	135	9	0	-G
H3_BC87_191109_LF_LIB_consensus_vsearch	2404	G	G	204	5	2.29%	2	1	93	93	0.030503308196835104	1	1	61	143	5	0	-A
H3_BC87_191109_LF_LIB_consensus_vsearch	2405	A	A	218	2	0.9%	2	1	93	93	0.24943052391823226	1	1	71	147	2	0	+G
H3_BC87_191109_LF_LIB_consensus_vsearch	2406	G	*/-T	207	12	5.31%	2	1	93	93	2.091345729349345E-4	1	1	79	128	0	12	-T
H3_BC87_191109_LF_LIB_consensus_vsearch	2407	T	T	208	2	0.93%	2	1	93	93	0.24940334128888852	1	1	78	130	0	2	A
H3_BC87_191109_LF_LIB_consensus_vsearch	2408	G	G	219	2	0.89%	2	1	93	93	0.24943310657599216	1	1	76	143	2	0	-A
H3_BC87_191109_LF_LIB_consensus_vsearch	2409	A	A	222	2	0.89%	2	2	93	93	0.24944071588395061	1	1	76	146	1	1	G
H3_BC87_191109_LF_LIB_consensus_vsearch	2410	A	A	224	1	0.44%	2	1	93	93	0.4999999999999138	1	1	77	147	1	0	-G
H3_BC87_191109_LF_LIB_consensus_vsearch	2411	G	*/-CG	190	26	11.5%	2	1	93	93	6.695310633512329E-9	1	1	79	111	0	26	-CG
H3_BC87_191109_LF_LIB_consensus_vsearch	2412	C	*/-G	154	29	15.1%	2	2	93	93	5.58558430316331E-10	1	1	76	78	4	25	-G
H3_BC87_191109_LF_LIB_consensus_vsearch	2413	G	G	149	6	3.77%	2	2	93	93	0.014873908758495069	1	1	73	76	1	5	T
H3_BC87_191109_LF_LIB_consensus_vsearch	2414	G	K	205	8	3.74%	2	1	93	93	0.0036534383902297935	1	1	79	126	0	8	T
H3_BC87_191109_LF_LIB_consensus_vsearch	2415	G	G	224	1	0.44%	2	1	93	93	0.4999999999999138	1	1	79	145	0	1	+CAG
H3_BC87_191109_LF_LIB_consensus_vsearch	2416	A	A	220	2	0.88%	2	1	93	93	0.2494356659142869	1	1	78	142	0	2	-T
H3_BC87_191109_LF_LIB_consensus_vsearch	2417	T	T	221	2	0.88%	2	1	93	93	0.24943820224728358	1	1	78	143	2	0	+C
H3_BC87_191109_LF_LIB_consensus_vsearch	2418	C	C	218	5	2.2%	2	2	93	93	0.030550130621104243	1	1	78	140	1	4	-G
H3_BC87_191109_LF_LIB_consensus_vsearch	2419	G	R	209	8	3.62%	2	2	93	93	0.003658026926953576	1	1	72	137	6	2	A
H3_BC87_191109_LF_LIB_consensus_vsearch	2420	G	G	211	6	2.65%	2	2	93	93	0.015087482939793164	1	1	75	136	1	5	A
H3_BC87_191109_LF_LIB_consensus_vsearch	2421	C	C	211	6	2.69%	2	1	93	93	0.015087482939793164	1	1	74	137	0	6	T
H3_BC87_191109_LF_LIB_consensus_vsearch	2422	T	*/+C	204	8	3.59%	2	1	93	93	0.0036522646351654408	1	1	66	138	8	0	+C
H3_BC87_191109_LF_LIB_consensus_vsearch	2423	C	*/-A	211	8	3.62%	2	1	93	93	0.0036602593149509337	1	1	77	134	0	8	-A
H3_BC87_191109_LF_LIB_consensus_vsearch	2424	A	A	218	1	0.46%	2	1	93	93	0.5000000000003686	1	1	80	138	0	1	C
H3_BC87_191109_LF_LIB_consensus_vsearch	2425	A	A	226	1	0.44%	2	1	93	93	0.4999999999999138	1	1	79	147	1	0	G
H3_BC87_191109_LF_LIB_consensus_vsearch	2426	T	Y	218	8	3.51%	2	1	93	93	0.003667766201363899	1	1	79	139	0	8	C
H3_BC87_191109_LF_LIB_consensus_vsearch	2427	G	G	223	4	1.75%	2	2	93	93	0.061673103185009646	1	1	77	146	3	1	A
H3_BC87_191109_LF_LIB_consensus_vsearch	2428	T	T	222	2	0.88%	2	1	93	93	0.24944071588395061	1	1	78	144	2	0	-G
H3_BC87_191109_LF_LIB_consensus_vsearch	2429	G	*/-TG	194	30	13.33%	2	2	93	93	3.29085769337718E-10	1	1	65	129	13	17	-TG
H3_BC87_191109_LF_LIB_consensus_vsearch	2430	T	T	187	5	2.55%	2	2	93	93	0.030437285417662132	1	1	63	124	1	4	C
H3_BC87_191109_LF_LIB_consensus_vsearch	2431	G	G	186	3	1.53%	2	2	93	93	0.1240053050397967	1	1	61	125	1	2	+TG
H3_BC87_191109_LF_LIB_consensus_vsearch	2432	A	A	223	1	0.44%	2	1	93	93	0.5000000000003686	1	1	77	146	1	0	+G
H3_BC87_191109_LF_LIB_consensus_vsearch	2433	A	A	227	1	0.44%	2	1	93	93	0.4999999999999138	1	1	78	149	1	0	G
H3_BC87_191109_LF_LIB_consensus_vsearch	2434	T	T	223	3	1.31%	2	1	93	93	0.12416851441234596	1	1	78	145	0	3	C
H3_BC87_191109_LF_LIB_consensus_vsearch	2435	C	C	224	1	0.44%	2	1	93	93	0.4999999999999138	1	1	79	145	0	1	+TT
H3_BC87_191109_LF_LIB_consensus_vsearch	2436	T	T	222	5	2.19%	2	2	93	93	0.030562448911634975	1	1	78	144	2	3	-G
H3_BC87_191109_LF_LIB_consensus_vsearch	2437	G	G	222	1	0.45%	2	1	93	93	0.4999999999999138	1	1	78	144	0	1	A
H3_BC87_191109_LF_LIB_consensus_vsearch	2438	G	G	217	5	2.18%	2	2	93	93	0.03054698177238809	1	1	79	138	1	4	-C
H3_BC87_191109_LF_LIB_consensus_vsearch	2439	C	*/-TT	196	12	5.48%	2	1	93	93	2.0738112718811548E-4	1	1	64	132	12	0	-TT
H3_BC87_191109_LF_LIB_consensus_vsearch	2440	T	T	205	1	0.48%	2	1	93	93	0.5000000000001412	1	1	66	139	0	1	A
H3_BC87_191109_LF_LIB_consensus_vsearch	2441	T	*/-G	172	29	13.49%	2	2	93	93	6.274620066497112E-10	1	1	59	113	7	22	-G
H3_BC87_191109_LF_LIB_consensus_vsearch	2442	G	R	173	18	9.14%	2	2	93	93	2.5066513464433235E-6	1	1	53	120	17	1	A
H3_BC87_191109_LF_LIB_consensus_vsearch	2443	G	G	216	6	2.63%	2	2	93	93	0.015099533131216845	1	1	75	141	4	2	A
H3_BC87_191109_LF_LIB_consensus_vsearch	2444	G	R	218	7	3.07%	2	2	93	93	0.007451182688346346	1	1	76	142	1	6	A
H3_BC87_191109_LF_LIB_consensus_vsearch	2445	G	G	228	1	0.44%	2	1	93	93	0.4999999999999138	1	1	79	149	1	0	-T
H3_BC87_191109_LF_LIB_consensus_vsearch	2446	T	T	218	4	1.75%	2	1	93	93	0.061654458623218986	1	1	78	140	0	4	C
H3_BC87_191109_LF_LIB_consensus_vsearch	2447	A	R	215	9	3.98%	2	2	93	93	0.0017995100038167202	1	1	70	145	8	1	G
H3_BC87_191109_LF_LIB_consensus_vsearch	2448	G	G	216	3	1.33%	2	1	93	93	0.12414187643025615	1	1	72	144	3	0	+T
H3_BC87_191109_LF_LIB_consensus_vsearch	2449	T	T	222	3	1.33%	2	2	93	93	0.12416481069040536	1	1	78	144	2	1	C
H3_BC87_191109_LF_LIB_consensus_vsearch	2450	T	*/-C	170	48	20.96%	2	2	93	93	1.9339221142501194E-16	1	1	50	120	28	20	-C
H3_BC87_191109_LF_LIB_consensus_vsearch	2451	C	C	177	1	0.56%	2	1	93	93	0.4999999999999138	1	1	50	127	1	0	T
H3_BC87_191109_LF_LIB_consensus_vsearch	2452	C	C	220	4	1.77%	2	1	93	93	0.061662016439223415	1	1	79	141	0	4	T
H3_BC87_191109_LF_LIB_consensus_vsearch	2453	C	*/-T	207	16	6.99%	2	1	93	93	1.1546128752618848E-5	1	1	80	127	0	16	-T
H3_BC87_191109_LF_LIB_consensus_vsearch	2454	T	*/-G	187	16	7.55%	2	1	93	93	1.1220889549609521E-5	1	1	80	107	0	16	-G
H3_BC87_191109_LF_LIB_consensus_vsearch	2455	G	G	206	3	1.42%	2	1	93	93	0.1241007194244273	1	1	80	126	0	3	T
H3_BC87_191109_LF_LIB_consensus_vsearch	2456	G	G	227	1	0.44%	2	1	93	93	0.4999999999999138	1	1	79	148	1	0	-TC
H3_BC87_191109_LF_LIB_consensus_vsearch	2457	T	*/-C	200	26	11.45%	2	1	93	93	6.95158232557866E-9	1	1	53	147	26	0	-C
H3_BC87_191109_LF_LIB_consensus_vsearch	2458	C	C	196	2	0.99%	2	1	93	93	0.24936708860772178	1	1	49	147	2	0	+A
H3_BC87_191109_LF_LIB_consensus_vsearch	2459	C	*/+G	183	27	11.79%	2	2	93	93	3.0514694714635637E-9	1	1	65	118	2	25	+G
H3_BC87_191109_LF_LIB_consensus_vsearch	2460	G	G	216	6	2.65%	2	1	93	93	0.015099533131216845	1	1	69	147	6	0	+A
H3_BC87_191109_LF_LIB_consensus_vsearch	2461	A	A	217	4	1.77%	2	1	93	93	0.0616506283607095	1	1	72	145	4	0	-G
H3_BC87_191109_LF_LIB_consensus_vsearch	2462	G	G	217	1	0.45%	2	1	93	93	0.4999999999999138	1	1	73	144	1	0	+A
H3_BC87_191109_LF_LIB_consensus_vsearch	2463	T	T	223	2	0.88%	2	2	93	93	0.24944320712692292	1	1	78	145	1	1	C
H3_BC87_191109_LF_LIB_consensus_vsearch	2464	T	*/+A	215	7	3.07%	2	1	93	93	0.007446345105805389	1	1	72	143	7	0	+A
H3_BC87_191109_LF_LIB_consensus_vsearch	2465	G	K	214	7	3.07%	2	1	93	93	0.007444703667648697	1	1	70	144	7	0	T
H3_BC87_191109_LF_LIB_consensus_vsearch	2466	T	Y	209	9	4.05%	2	2	93	93	0.0017953764342624938	1	1	75	134	1	8	C
H3_BC87_191109_LF_LIB_consensus_vsearch	2467	G	G	220	2	0.89%	2	1	93	93	0.2494356659142869	1	1	77	143	2	0	A
H3_BC87_191109_LF_LIB_consensus_vsearch	2468	C	*/+A	210	10	4.39%	2	1	93	93	8.796295164637225E-4	1	1	77	133	0	10	+A
H3_BC87_191109_LF_LIB_consensus_vsearch	2469	A	A	221	3	1.33%	2	1	93	93	0.12416107382546236	1	1	75	146	3	0	G
H3_BC87_191109_LF_LIB_consensus_vsearch	2470	C	Y	209	12	5.26%	2	1	93	93	2.0943559915765036E-4	1	1	75	134	0	12	T
H3_BC87_191109_LF_LIB_consensus_vsearch	2471	T	T	210	5	2.2%	2	2	93	93	0.0305241206880699	1	1	74	136	1	4	+C
H3_BC87_191109_LF_LIB_consensus_vsearch	2472	A	A	216	6	2.69%	2	2	93	93	0.015099533131216845	1	1	75	141	1	5	G
H3_BC87_191109_LF_LIB_consensus_vsearch	2473	T	T	220	2	0.89%	2	1	93	93	0.2494356659142869	1	1	76	144	0	2	-G
H3_BC87_191109_LF_LIB_consensus_vsearch	2474	G	G	226	1	0.44%	2	1	93	93	0.4999999999999138	1	1	80	146	0	1	+C
H3_BC87_191109_LF_LIB_consensus_vsearch	2475	G	G	225	2	0.87%	2	1	93	93	0.24944812362040697	1	1	80	145	0	2	-A
H3_BC87_191109_LF_LIB_consensus_vsearch	2476	A	A	223	4	1.76%	2	2	93	93	0.061673103185009646	1	1	78	145	2	2	G
H3_BC87_191109_LF_LIB_consensus_vsearch	2477	C	C	226	1	0.44%	2	1	93	93	0.4999999999999138	1	1	80	146	0	1	+G
H3_BC87_191109_LF_LIB_consensus_vsearch	2478	G	G	218	6	2.63%	2	1	93	93	0.015104203282490625	1	1	72	146	6	0	+T
H3_BC87_191109_LF_LIB_consensus_vsearch	2479	T	T	224	2	0.88%	2	2	93	93	0.24944567627499675	1	1	78	146	1	1	C
H3_BC87_191109_LF_LIB_consensus_vsearch	2480	T	T	227	2	0.87%	2	2	93	93	0.24945295404843976	1	1	79	148	1	1	C
H3_BC87_191109_LF_LIB_consensus_vsearch	2481	T	T	220	5	2.18%	2	1	93	93	0.03055634444922604	1	1	78	142	0	5	+C
H3_BC87_191109_LF_LIB_consensus_vsearch	2482	C	*/+T	207	11	4.85%	2	1	93	93	4.2906952287648286E-4	1	1	77	130	0	11	+T
H3_BC87_191109_LF_LIB_consensus_vsearch	2483	G	G	223	3	1.32%	2	1	93	93	0.12416851441234596	1	1	80	143	0	3	+T
H3_BC87_191109_LF_LIB_consensus_vsearch	2484	T	T	225	1	0.44%	2	1	93	93	0.5000000000003686	1	1	79	146	1	0	+G
H3_BC87_191109_LF_LIB_consensus_vsearch	2485	C	C	222	3	1.32%	2	1	93	93	0.12416481069040536	1	1	79	143	0	3	-T
H3_BC87_191109_LF_LIB_consensus_vsearch	2486	T	T	220	1	0.44%	2	1	93	93	0.4999999999999138	1	1	78	142	0	1	+C
H3_BC87_191109_LF_LIB_consensus_vsearch	2487	G	G	227	1	0.44%	2	1	93	93	0.4999999999999138	1	1	78	149	1	0	-CG
H3_BC87_191109_LF_LIB_consensus_vsearch	2488	C	C	221	5	2.19%	2	2	93	93	0.03055941016990272	1	1	78	143	1	4	T
H3_BC87_191109_LF_LIB_consensus_vsearch	2489	G	*/+T	209	9	3.98%	2	1	93	93	0.0017953764342624938	1	1	65	144	9	0	+T
H3_BC87_191109_LF_LIB_consensus_vsearch	2490	T	T	219	2	0.9%	2	1	93	93	0.24943310657599216	1	1	77	142	0	2	C
H3_BC87_191109_LF_LIB_consensus_vsearch	2491	T	T	225	3	1.31%	2	1	93	93	0.12417582417582212	1	1	79	146	0	3	C
H3_BC87_191109_LF_LIB_consensus_vsearch	2492	T	T	223	2	0.87%	2	2	93	93	0.24944320712692292	1	1	77	146	1	1	-GT
H3_BC87_191109_LF_LIB_consensus_vsearch	2493	G	G	221	3	1.33%	2	1	93	93	0.12416107382546236	1	1	74	147	3	0	A
H3_BC87_191109_LF_LIB_consensus_vsearch	2494	T	T	214	5	2.21%	2	2	93	93	0.030537362897492103	1	1	72	142	1	4	-A
H3_BC87_191109_LF_LIB_consensus_vsearch	2495	A	A	220	2	0.9%	2	2	93	93	0.2494356659142869	1	1	76	144	1	1	G
H3_BC87_191109_LF_LIB_consensus_vsearch	2496	A	A	220	3	1.32%	2	2	93	93	0.12415730337075404	1	1	74	146	2	1	G
H3_BC87_191109_LF_LIB_consensus_vsearch	2497	T	T	220	3	1.33%	2	1	93	93	0.12415730337075404	1	1	77	143	0	3	C
H3_BC87_191109_LF_LIB_consensus_vsearch	2498	G	G	224	1	0.44%	2	1	93	93	0.4999999999999138	1	1	78	146	0	1	+A
H3_BC87_191109_LF_LIB_consensus_vsearch	2499	G	G	224	3	1.31%	2	2	93	93	0.12417218543044797	1	1	79	145	1	2	-CGG
H3_BC87_191109_LF_LIB_consensus_vsearch	2500	C	C	214	4	1.78%	2	1	93	93	0.061638926495252586	1	1	78	136	0	4	-G
H3_BC87_191109_LF_LIB_consensus_vsearch	2501	G	R	214	7	3.15%	2	1	93	93	0.007444703667648697	1	1	72	142	7	0	A
H3_BC87_191109_LF_LIB_consensus_vsearch	2502	G	G	219	2	0.88%	2	1	93	93	0.24943310657599216	1	1	77	142	0	2	-TGG
H3_BC87_191109_LF_LIB_consensus_vsearch	2503	T	*/-G	203	15	6.64%	2	2	93	93	2.37871086741396E-5	1	1	72	131	7	8	-G
H3_BC87_191109_LF_LIB_consensus_vsearch	2504	G	G	205	1	0.48%	2	1	93	93	0.5000000000001412	1	1	73	132	0	1	+CG
H3_BC87_191109_LF_LIB_consensus_vsearch	2505	G	G	214	2	0.9%	2	2	93	93	0.24941995359642635	1	1	78	136	1	1	-A
H3_BC87_191109_LF_LIB_consensus_vsearch	2506	A	A	219	2	0.9%	2	1	93	93	0.24943310657599216	1	1	77	142	2	0	G
H3_BC87_191109_LF_LIB_consensus_vsearch	2507	A	A	225	3	1.32%	2	2	93	93	0.12417582417582212	1	1	78	147	2	1	G
H3_BC87_191109_LF_LIB_consensus_vsearch	2508	G	G	223	1	0.44%	2	1	93	93	0.5000000000003686	1	1	77	146	1	0	+A
H3_BC87_191109_LF_LIB_consensus_vsearch	2509	T	T	216	6	2.63%	2	1	93	93	0.015099533131216845	1	1	70	146	6	0	-C
H3_BC87_191109_LF_LIB_consensus_vsearch	2510	C	C	219	1	0.45%	2	1	93	93	0.4999999999999138	1	1	73	146	1	0	A
H3_BC87_191109_LF_LIB_consensus_vsearch	2511	C	C	219	1	0.44%	2	1	93	93	0.4999999999999138	1	1	78	141	0	1	+A
H3_BC87_191109_LF_LIB_consensus_vsearch	2512	G	G	216	4	1.75%	2	1	93	93	0.061646763238677425	1	1	77	139	0	4	+C
H3_BC87_191109_LF_LIB_consensus_vsearch	2513	T	Y	209	13	5.8%	2	1	93	93	1.0188120004185222E-4	1	1	77	132	0	13	C
H3_BC87_191109_LF_LIB_consensus_vsearch	2514	T	T	212	5	2.21%	2	2	93	93	0.030530802741347875	1	1	77	135	1	4	G
H3_BC87_191109_LF_LIB_consensus_vsearch	2515	G	G	211	4	1.79%	2	2	93	93	0.06162689769249	1	1	77	134	1	3	+T
H3_BC87_191109_LF_LIB_consensus_vsearch	2516	A	A	219	5	2.22%	2	1	93	93	0.030553251388732716	1	1	79	140	0	5	G
H3_BC87_191109_LF_LIB_consensus_vsearch	2517	A	A	225	1	0.44%	2	1	93	93	0.5000000000003686	1	1	76	149	1	0	+G
H3_BC87_191109_LF_LIB_consensus_vsearch	2518	A	A	222	4	1.75%	2	2	93	93	0.061669440342892484	1	1	75	147	3	1	G
H3_BC87_191109_LF_LIB_consensus_vsearch	2519	C	C	226	1	0.44%	2	1	93	93	0.4999999999999138	1	1	79	147	0	1	+G
H3_BC87_191109_LF_LIB_consensus_vsearch	2520	A	A	223	3	1.32%	2	1	93	93	0.12416851441234596	1	1	76	147	3	0	G
H3_BC87_191109_LF_LIB_consensus_vsearch	2521	C	C	218	2	0.88%	2	2	93	93	0.24943052391823226	1	1	74	144	1	1	-G
H3_BC87_191109_LF_LIB_consensus_vsearch	2522	G	G	225	1	0.44%	2	1	93	93	0.5000000000003686	1	1	77	148	1	0	A
H3_BC87_191109_LF_LIB_consensus_vsearch	2523	G	G	224	2	0.87%	2	2	93	93	0.24944567627499675	1	1	78	146	1	1	A
H3_BC87_191109_LF_LIB_consensus_vsearch	2524	C	C	225	2	0.87%	2	1	93	93	0.24944812362040697	1	1	77	148	2	0	A
H3_BC87_191109_LF_LIB_consensus_vsearch	2525	A	A	218	3	1.32%	2	1	93	93	0.12414965986396012	1	1	77	141	0	3	+C
H3_BC87_191109_LF_LIB_consensus_vsearch	2526	C	C	222	2	0.89%	2	1	93	93	0.24944071588395061	1	1	77	145	2	0	+A
H3_BC87_191109_LF_LIB_consensus_vsearch	2527	C	*/-TC	211	12	5.24%	2	1	93	93	2.0973150235371546E-4	1	1	80	131	0	12	-TC
H3_BC87_191109_LF_LIB_consensus_vsearch	2528	T	T	203	5	2.31%	2	2	93	93	0.030499722862415764	1	1	73	130	4	1	+C
H3_BC87_191109_LF_LIB_consensus_vsearch	2529	C	C	214	1	0.47%	2	1	93	93	0.5000000000001412	1	1	77	137	1	0	-A
H3_BC87_191109_LF_LIB_consensus_vsearch	2530	A	A	220	4	1.76%	2	2	93	93	0.061662016439223415	1	1	76	144	1	3	+G
H3_BC87_191109_LF_LIB_consensus_vsearch	2531	G	G	225	1	0.44%	2	1	93	93	0.5000000000003686	1	1	78	147	1	0	+A
H3_BC87_191109_LF_LIB_consensus_vsearch	2532	A	*/-G	179	46	20.26%	2	2	93	93	1.0940352779367907E-15	1	1	46	133	33	13	-G
H3_BC87_191109_LF_LIB_consensus_vsearch	2533	G	G	172	4	2.21%	2	1	93	93	0.06143315455637365	1	1	42	130	0	4	+T
H3_BC87_191109_LF_LIB_consensus_vsearch	2534	G	G	226	1	0.44%	2	1	93	93	0.4999999999999138	1	1	78	148	1	0	+AG
H3_BC87_191109_LF_LIB_consensus_vsearch	2535	G	G	222	4	1.75%	2	1	93	93	0.061669440342892484	1	1	79	143	0	4	+C
H3_BC87_191109_LF_LIB_consensus_vsearch	2536	T	T	223	4	1.75%	2	2	93	93	0.061673103185009646	1	1	78	145	2	2	-C
H3_BC87_191109_LF_LIB_consensus_vsearch	2537	C	C	218	1	0.45%	2	1	93	93	0.5000000000003686	1	1	75	143	0	1	+AAT
H3_BC87_191109_LF_LIB_consensus_vsearch	2538	A	W	197	23	10.18%	2	2	93	93	6.501382894958495E-8	1	1	53	144	22	1	T
H3_BC87_191109_LF_LIB_consensus_vsearch	2539	C	S	201	24	10.57%	2	2	93	93	3.1195657998345904E-8	1	1	54	147	23	1	G
H3_BC87_191109_LF_LIB_consensus_vsearch	2540	A	*/-G	198	23	10.09%	2	1	93	93	6.520220361141492E-8	1	1	52	146	23	0	-G
H3_BC87_191109_LF_LIB_consensus_vsearch	2541	G	G	201	2	0.98%	2	1	93	93	0.2493827160493913	1	1	56	145	0	2	A
H3_BC87_191109_LF_LIB_consensus_vsearch	2542	T	*/+C	212	7	3.08%	2	2	93	93	0.00744137624879223	1	1	70	142	4	3	+C
H3_BC87_191109_LF_LIB_consensus_vsearch	2543	C	C	222	0	0%	2	0	93	0	1.0	1	0	74	148	0	0	
H3_BC87_191109_LF_LIB_consensus_vsearch	2544	C	C	225	1	0.44%	2	1	93	93	0.5000000000003686	1	1	80	145	0	1	+T
H3_BC87_191109_LF_LIB_consensus_vsearch	2545	T	T	219	4	1.76%	2	1	93	93	0.06165825449566743	1	1	79	140	0	4	C
H3_BC87_191109_LF_LIB_consensus_vsearch	2546	G	G	223	2	0.88%	2	1	93	93	0.24944320712692292	1	1	77	146	0	2	-T
H3_BC87_191109_LF_LIB_consensus_vsearch	2547	T	T	222	5	2.2%	2	2	93	93	0.030562448911634975	1	1	79	143	1	4	C
H3_BC87_191109_LF_LIB_consensus_vsearch	2548	A	A	220	3	1.31%	2	2	93	93	0.12415730337075404	1	1	75	145	1	2	-C
H3_BC87_191109_LF_LIB_consensus_vsearch	2549	C	C	215	4	1.79%	2	1	93	93	0.06164286277914926	1	1	77	138	0	4	+T
H3_BC87_191109_LF_LIB_consensus_vsearch	2550	C	C	224	1	0.44%	2	1	93	93	0.4999999999999138	1	1	77	147	1	0	-ACC
H3_BC87_191109_LF_LIB_consensus_vsearch	2551	A	A	222	2	0.88%	2	1	93	93	0.24944071588395061	1	1	77	145	0	2	+C
H3_BC87_191109_LF_LIB_consensus_vsearch	2552	C	C	219	4	1.77%	2	1	93	93	0.06165825449566743	1	1	77	142	0	4	+T
H3_BC87_191109_LF_LIB_consensus_vsearch	2553	C	C	220	4	1.76%	2	1	93	93	0.061662016439223415	1	1	78	142	0	4	-T
H3_BC87_191109_LF_LIB_consensus_vsearch	2554	T	Y	174	44	19.64%	2	1	93	93	5.079209233972406E-15	1	1	79	95	0	44	C
H3_BC87_191109_LF_LIB_consensus_vsearch	2555	G	G	221	3	1.32%	2	2	93	93	0.12416107382546236	1	1	76	145	2	1	-CCTG
H3_BC87_191109_LF_LIB_consensus_vsearch	2556	C	C	219	2	0.9%	2	1	93	93	0.24943310657599216	1	1	77	142	0	2	T
H3_BC87_191109_LF_LIB_consensus_vsearch	2557	C	C	220	2	0.88%	2	1	93	93	0.2494356659142869	1	1	77	143	0	2	-T
H3_BC87_191109_LF_LIB_consensus_vsearch	2558	T	Y	177	41	18.55%	2	1	93	93	5.698466356698017E-14	1	1	76	101	0	41	C
H3_BC87_191109_LF_LIB_consensus_vsearch	2559	G	G	220	2	0.9%	2	2	93	93	0.2494356659142869	1	1	76	144	1	1	A
H3_BC87_191109_LF_LIB_consensus_vsearch	2560	C	Y	215	7	3.07%	2	1	93	93	0.007446345105805389	1	1	77	138	0	7	T
H3_BC87_191109_LF_LIB_consensus_vsearch	2561	A	A	218	3	1.34%	2	1	93	93	0.12414965986396012	1	1	78	140	0	3	+C
H3_BC87_191109_LF_LIB_consensus_vsearch	2562	C	*/-T	213	8	3.54%	2	1	93	93	0.0036624519192641563	1	1	79	134	0	8	-T
H3_BC87_191109_LF_LIB_consensus_vsearch	2563	T	T	212	4	1.81%	2	1	93	93	0.061630944461591126	1	1	80	132	0	4	-C
H3_BC87_191109_LF_LIB_consensus_vsearch	2564	C	C	217	3	1.33%	2	1	93	93	0.12414578587710072	1	1	79	138	0	3	+TC
H3_BC87_191109_LF_LIB_consensus_vsearch	2565	G	G	226	1	0.44%	2	1	93	93	0.4999999999999138	1	1	79	147	0	1	-C
H3_BC87_191109_LF_LIB_consensus_vsearch	2566	C	C	216	5	2.19%	2	2	93	93	0.030543804461782422	1	1	76	140	2	3	-GC
H3_BC87_191109_LF_LIB_consensus_vsearch	2567	G	G	217	4	1.79%	2	2	93	93	0.0616506283607095	1	1	75	142	1	3	-C
H3_BC87_191109_LF_LIB_consensus_vsearch	2568	C	C	217	3	1.36%	2	2	93	93	0.12414578587710072	1	1	76	141	1	2	T
H3_BC87_191109_LF_LIB_consensus_vsearch	2569	C	*/-A	143	80	34.93%	2	1	93	93	1.3904194724366718E-28	1	1	79	64	0	80	-A
H3_BC87_191109_LF_LIB_consensus_vsearch	2570	A	A	135	5	3.38%	2	1	93	93	0.030135993685544572	1	1	79	56	0	5	+C
H3_BC87_191109_LF_LIB_consensus_vsearch	2571	A	A	218	4	1.75%	2	2	93	93	0.061654458623218986	1	1	78	140	1	3	-T
H3_BC87_191109_LF_LIB_consensus_vsearch	2572	T	Y	136	54	24.11%	2	2	93	93	6.797168606910165E-19	1	1	76	60	2	52	C
H3_BC87_191109_LF_LIB_consensus_vsearch	2573	G	G	224	2	0.88%	2	1	93	93	0.24944567627499675	1	1	78	146	2	0	-A
H3_BC87_191109_LF_LIB_consensus_vsearch	2574	A	A	222	1	0.44%	2	1	93	93	0.4999999999999138	1	1	78	144	0	1	-C
H3_BC87_191109_LF_LIB_consensus_vsearch	2575	C	C	213	6	2.65%	2	2	93	93	0.0150923687299321	1	1	77	136	2	4	-A
H3_BC87_191109_LF_LIB_consensus_vsearch	2576	A	A	212	2	0.92%	2	2	93	93	0.24941451990645544	1	1	77	135	1	1	C
H3_BC87_191109_LF_LIB_consensus_vsearch	2577	A	A	219	2	0.89%	2	1	93	93	0.24943310657599216	1	1	79	140	0	2	T
H3_BC87_191109_LF_LIB_consensus_vsearch	2578	G	G	219	4	1.75%	2	1	93	93	0.06165825449566743	1	1	79	140	0	4	-C
H3_BC87_191109_LF_LIB_consensus_vsearch	2579	C	C	218	2	0.89%	2	1	93	93	0.24943052391823226	1	1	78	140	0	2	+A
H3_BC87_191109_LF_LIB_consensus_vsearch	2580	G	G	226	1	0.44%	2	1	93	93	0.4999999999999138	1	1	79	147	0	1	+AG
H3_BC87_191109_LF_LIB_consensus_vsearch	2581	C	*/-T	185	29	12.78%	2	2	93	93	6.735893390690761E-10	1	1	78	107	1	28	-T
H3_BC87_191109_LF_LIB_consensus_vsearch	2582	T	T	179	3	1.6%	2	1	93	93	0.12396694214879515	1	1	77	102	0	3	-CCT
H3_BC87_191109_LF_LIB_consensus_vsearch	2583	C	C	210	1	0.47%	2	1	93	93	0.4999999999999138	1	1	78	132	0	1	+T
H3_BC87_191109_LF_LIB_consensus_vsearch	2584	C	*/-TC	213	11	4.87%	2	1	93	93	4.305938947768699E-4	1	1	80	133	0	11	-TC
H3_BC87_191109_LF_LIB_consensus_vsearch	2585	T	T	210	3	1.4%	2	1	93	93	0.1241176470588473	1	1	77	133	3	0	+C
H3_BC87_191109_LF_LIB_consensus_vsearch	2586	C	*/+G	203	8	3.69%	2	2	93	93	0.0036510799339400076	1	1	75	128	1	7	+G
H3_BC87_191109_LF_LIB_consensus_vsearch	2587	G	G	221	3	1.32%	2	2	93	93	0.12416107382546236	1	1	75	146	2	1	-A
H3_BC87_191109_LF_LIB_consensus_vsearch	2588	A	A	215	3	1.33%	2	1	93	93	0.12413793103441495	1	1	70	145	3	0	+G
H3_BC87_191109_LF_LIB_consensus_vsearch	2589	G	G	219	2	0.89%	2	1	93	93	0.24943310657599216	1	1	75	144	2	0	+AG
H3_BC87_191109_LF_LIB_consensus_vsearch	2590	T	T	223	2	0.88%	2	1	93	93	0.24944320712692292	1	1	79	144	0	2	C
H3_BC87_191109_LF_LIB_consensus_vsearch	2591	C	C	224	2	0.88%	2	2	93	93	0.24944567627499675	1	1	78	146	1	1	+A
H3_BC87_191109_LF_LIB_consensus_vsearch	2592	G	G	224	2	0.88%	2	2	93	93	0.24944567627499675	1	1	78	146	1	1	-CG
H3_BC87_191109_LF_LIB_consensus_vsearch	2593	C	C	224	2	0.88%	2	1	93	93	0.24944567627499675	1	1	78	146	0	2	T
H3_BC87_191109_LF_LIB_consensus_vsearch	2594	G	G	226	1	0.44%	2	1	93	93	0.4999999999999138	1	1	78	148	1	0	+C
H3_BC87_191109_LF_LIB_consensus_vsearch	2595	T	T	221	3	1.31%	2	1	93	93	0.12416107382546236	1	1	79	142	0	3	-A
H3_BC87_191109_LF_LIB_consensus_vsearch	2596	A	A	221	3	1.33%	2	2	93	93	0.12416107382546236	1	1	78	143	2	1	G
H3_BC87_191109_LF_LIB_consensus_vsearch	2597	G	*/+T	199	13	5.73%	2	2	93	93	1.0098964132434686E-4	1	1	57	142	12	1	+T
H3_BC87_191109_LF_LIB_consensus_vsearch	2598	T	T	209	4	1.85%	2	1	93	93	0.061618690029214815	1	1	71	138	0	4	C
H3_BC87_191109_LF_LIB_consensus_vsearch	2599	T	T	227	1	0.44%	2	1	93	93	0.4999999999999138	1	1	80	147	0	1	C
H3_BC87_191109_LF_LIB_consensus_vsearch	2600	T	T	226	2	0.87%	2	1	93	93	0.24945054945064127	1	1	79	147	0	2	+C
H3_BC87_191109_LF_LIB_consensus_vsearch	2601	T	*/-GT	217	7	3.06%	2	1	93	93	0.007449584424390529	1	1	76	141	0	7	-GT
H3_BC87_191109_LF_LIB_consensus_vsearch	2602	G	G	212	3	1.37%	2	2	93	93	0.1241258741259166	1	1	73	139	1	2	-T
H3_BC87_191109_LF_LIB_consensus_vsearch	2603	T	T	208	6	2.74%	2	2	93	93	0.015079983859610983	1	1	74	134	2	4	-A
H3_BC87_191109_LF_LIB_consensus_vsearch	2604	A	A	216	3	1.36%	2	2	93	93	0.12414187643025615	1	1	73	143	2	1	C
H3_BC87_191109_LF_LIB_consensus_vsearch	2605	A	A	222	2	0.88%	2	1	93	93	0.24944071588395061	1	1	75	147	2	0	-TG
H3_BC87_191109_LF_LIB_consensus_vsearch	2606	T	T	215	3	1.35%	2	1	93	93	0.12413793103441495	1	1	73	142	3	0	-G
H3_BC87_191109_LF_LIB_consensus_vsearch	2607	G	G	217	2	0.9%	2	2	93	93	0.24942791762028085	1	1	73	144	1	1	A
H3_BC87_191109_LF_LIB_consensus_vsearch	2608	C	C	221	3	1.32%	2	1	93	93	0.12416107382546236	1	1	78	143	0	3	T
H3_BC87_191109_LF_LIB_consensus_vsearch	2609	T	Y	217	7	3.11%	2	2	93	93	0.007449584424390529	1	1	76	141	2	5	C
H3_BC87_191109_LF_LIB_consensus_vsearch	2610	G	G	223	2	0.88%	2	1	93	93	0.24944320712692292	1	1	78	145	0	2	+T
H3_BC87_191109_LF_LIB_consensus_vsearch	2611	C	C	216	4	1.77%	2	1	93	93	0.061646763238677425	1	1	73	143	4	0	-G
H3_BC87_191109_LF_LIB_consensus_vsearch	2612	G	G	214	4	1.8%	2	1	93	93	0.061638926495252586	1	1	72	142	0	4	-C
H3_BC87_191109_LF_LIB_consensus_vsearch	2613	C	C	215	2	0.9%	2	1	93	93	0.2494226327944578	1	1	73	142	2	0	+T
H3_BC87_191109_LF_LIB_consensus_vsearch	2614	C	*/-A	208	9	3.93%	2	2	93	93	0.0017946657928001688	1	1	73	135	2	7	-A
H3_BC87_191109_LF_LIB_consensus_vsearch	2615	A	A	206	4	1.87%	2	2	93	93	0.06160608506034647	1	1	75	131	1	3	T
H3_BC87_191109_LF_LIB_consensus_vsearch	2616	A	*/-G	210	7	3.14%	2	1	93	93	0.007437988084800957	1	1	79	131	0	7	-G
H3_BC87_191109_LF_LIB_consensus_vsearch	2617	G	G	207	6	2.73%	2	1	93	93	0.015077437453979417	1	1	78	129	0	6	-TG
H3_BC87_191109_LF_LIB_consensus_vsearch	2618	T	T	193	6	2.75%	2	2	93	93	0.015039114744282133	1	1	77	116	1	5	+G
H3_BC87_191109_LF_LIB_consensus_vsearch	2619	G	G	209	2	0.94%	2	1	93	93	0.24940617577189375	1	1	76	133	2	0	A
H3_BC87_191109_LF_LIB_consensus_vsearch	2620	G	G	221	2	0.89%	2	2	93	93	0.24943820224728358	1	1	78	143	1	1	+A
H3_BC87_191109_LF_LIB_consensus_vsearch	2621	G	G	222	2	0.87%	2	2	93	93	0.24944071588395061	1	1	77	145	1	1	-AGG
H3_BC87_191109_LF_LIB_consensus_vsearch	2622	A	*/-G	211	10	4.44%	2	2	93	93	8.800549103686053E-4	1	1	68	143	9	1	-G
H3_BC87_191109_LF_LIB_consensus_vsearch	2623	G	G	207	5	2.31%	2	1	93	93	0.030513861513988962	1	1	62	145	5	0	+A
H3_BC87_191109_LF_LIB_consensus_vsearch	2624	G	G	221	2	0.88%	2	1	93	93	0.24943820224728358	1	1	77	144	0	2	A
H3_BC87_191109_LF_LIB_consensus_vsearch	2625	T	Y	217	7	3.07%	2	1	93	93	0.007449584424390529	1	1	77	140	0	7	C
H3_BC87_191109_LF_LIB_consensus_vsearch	2626	A	A	223	2	0.88%	2	2	93	93	0.24944320712692292	1	1	77	146	1	1	+G
H3_BC87_191109_LF_LIB_consensus_vsearch	2627	G	G	222	2	0.88%	2	1	93	93	0.24944071588395061	1	1	78	144	0	2	+T
H3_BC87_191109_LF_LIB_consensus_vsearch	2628	A	A	222	2	0.88%	2	1	93	93	0.24944071588395061	1	1	78	144	2	0	-G
H3_BC87_191109_LF_LIB_consensus_vsearch	2629	G	G	221	1	0.45%	2	1	93	93	0.4999999999999138	1	1	77	144	1	0	-A
H3_BC87_191109_LF_LIB_consensus_vsearch	2630	A	A	213	6	2.67%	2	2	93	93	0.0150923687299321	1	1	74	139	4	2	-C
H3_BC87_191109_LF_LIB_consensus_vsearch	2631	C	C	219	3	1.35%	2	1	93	93	0.12415349887135622	1	1	76	143	0	3	T
H3_BC87_191109_LF_LIB_consensus_vsearch	2632	C	*/-T	207	20	8.77%	2	2	93	93	6.157812320632015E-7	1	1	79	128	1	19	-T
H3_BC87_191109_LF_LIB_consensus_vsearch	2633	T	T	201	4	1.92%	2	1	93	93	0.061584255960787086	1	1	77	124	0	4	+C
H3_BC87_191109_LF_LIB_consensus_vsearch	2634	T	T	216	4	1.75%	2	2	93	93	0.061646763238677425	1	1	73	143	3	1	+C
H3_BC87_191109_LF_LIB_consensus_vsearch	2635	C	*/-T	211	8	3.56%	2	2	93	93	0.0036602593149509337	1	1	78	133	1	7	-T
H3_BC87_191109_LF_LIB_consensus_vsearch	2636	T	*/-A	199	13	5.99%	2	2	93	93	1.0098964132434686E-4	1	1	68	131	8	5	-A
H3_BC87_191109_LF_LIB_consensus_vsearch	2637	A	A	208	3	1.42%	2	2	93	93	0.12410926365791558	1	1	69	139	2	1	G
H3_BC87_191109_LF_LIB_consensus_vsearch	2638	A	A	217	4	1.76%	2	1	93	93	0.0616506283607095	1	1	79	138	0	4	-GG
H3_BC87_191109_LF_LIB_consensus_vsearch	2639	G	G	219	2	0.9%	2	1	93	93	0.24943310657599216	1	1	77	142	2	0	A
H3_BC87_191109_LF_LIB_consensus_vsearch	2640	G	G	220	2	0.89%	2	1	93	93	0.2494356659142869	1	1	76	144	2	0	-C
H3_BC87_191109_LF_LIB_consensus_vsearch	2641	C	C	218	5	2.21%	2	1	93	93	0.030550130621104243	1	1	78	140	0	5	T
H3_BC87_191109_LF_LIB_consensus_vsearch	2642	T	*/-A	206	10	4.42%	2	2	93	93	8.778898007284436E-4	1	1	75	131	2	8	-A
H3_BC87_191109_LF_LIB_consensus_vsearch	2643	A	A	213	2	0.93%	2	1	93	93	0.249417249417318	1	1	78	135	0	2	G
H3_BC87_191109_LF_LIB_consensus_vsearch	2644	A	A	228	1	0.44%	2	1	93	93	0.4999999999999138	1	1	80	148	0	1	G
H3_BC87_191109_LF_LIB_consensus_vsearch	2645	A	A	227	1	0.44%	2	1	93	93	0.4999999999999138	1	1	80	147	0	1	+T
H3_BC87_191109_LF_LIB_consensus_vsearch	2646	T	Y	217	10	4.37%	2	1	93	93	8.825309402840407E-4	1	1	80	137	0	10	C
H3_BC87_191109_LF_LIB_consensus_vsearch	2647	A	A	226	2	0.87%	2	2	93	93	0.24945054945064127	1	1	79	147	1	1	G
H3_BC87_191109_LF_LIB_consensus_vsearch	2648	T	T	224	2	0.87%	2	2	93	93	0.24944567627499675	1	1	79	145	1	1	+AT
H3_BC87_191109_LF_LIB_consensus_vsearch	2649	G	G	227	1	0.44%	2	1	93	93	0.4999999999999138	1	1	80	147	0	1	A
H3_BC87_191109_LF_LIB_consensus_vsearch	2650	A	A	220	5	2.18%	2	2	93	93	0.03055634444922604	1	1	76	144	3	2	-TGA
H3_BC87_191109_LF_LIB_consensus_vsearch	2651	T	T	220	3	1.34%	2	2	93	93	0.12415730337075404	1	1	76	144	1	2	C
H3_BC87_191109_LF_LIB_consensus_vsearch	2652	G	G	222	1	0.45%	2	1	93	93	0.4999999999999138	1	1	76	146	1	0	-ACG
H3_BC87_191109_LF_LIB_consensus_vsearch	2653	A	A	221	1	0.45%	2	1	93	93	0.4999999999999138	1	1	76	145	0	1	-C
H3_BC87_191109_LF_LIB_consensus_vsearch	2654	C	C	226	1	0.44%	2	1	93	93	0.4999999999999138	1	1	79	147	0	1	T
H3_BC87_191109_LF_LIB_consensus_vsearch	2655	G	*/-TG	213	11	4.82%	2	1	93	93	4.305938947768699E-4	1	1	79	134	0	11	-TG
H3_BC87_191109_LF_LIB_consensus_vsearch	2656	T	T	204	5	2.33%	2	2	93	93	0.030503308196835104	1	1	77	127	2	3	C
H3_BC87_191109_LF_LIB_consensus_vsearch	2657	G	G	214	1	0.46%	2	1	93	93	0.5000000000001412	1	1	80	134	0	1	+A
H3_BC87_191109_LF_LIB_consensus_vsearch	2658	A	A	227	2	0.87%	2	1	93	93	0.24945295404843976	1	1	80	147	0	2	G
H3_BC87_191109_LF_LIB_consensus_vsearch	2659	C	C	228	1	0.44%	2	1	93	93	0.4999999999999138	1	1	80	148	0	1	T
H3_BC87_191109_LF_LIB_consensus_vsearch	2660	C	C	218	6	2.62%	2	1	93	93	0.015104203282490625	1	1	79	139	0	6	T
H3_BC87_191109_LF_LIB_consensus_vsearch	2661	G	G	228	0	0%	2	0	93	0	1.0	1	0	79	149	0	0	
H3_BC87_191109_LF_LIB_consensus_vsearch	2662	A	A	227	1	0.44%	2	1	93	93	0.4999999999999138	1	1	79	148	0	1	C
H3_BC87_191109_LF_LIB_consensus_vsearch	2663	T	T	225	1	0.44%	2	1	93	93	0.5000000000003686	1	1	78	147	0	1	+GCC
H3_BC87_191109_LF_LIB_consensus_vsearch	2664	A	A	223	2	0.88%	2	1	93	93	0.24944320712692292	1	1	77	146	0	2	-G
H3_BC87_191109_LF_LIB_consensus_vsearch	2665	G	G	226	0	0%	2	0	93	0	1.0	1	0	79	147	0	0	
H3_BC87_191109_LF_LIB_consensus_vsearch	2666	C	*/+A	218	7	3.06%	2	1	93	93	0.007451182688346346	1	1	78	140	0	7	+A
H3_BC87_191109_LF_LIB_consensus_vsearch	2667	A	A	225	1	0.44%	2	1	93	93	0.5000000000003686	1	1	77	148	1	0	+C
H3_BC87_191109_LF_LIB_consensus_vsearch	2668	C	Y	216	7	3.07%	2	2	93	93	0.007447971960236055	1	1	76	140	1	6	T
H3_BC87_191109_LF_LIB_consensus_vsearch	2669	A	*/-CA	208	15	6.58%	2	2	93	93	2.392491102102212E-5	1	1	76	132	1	14	-CA
H3_BC87_191109_LF_LIB_consensus_vsearch	2670	C	C	207	3	1.4%	2	2	93	93	0.12410501193315207	1	1	75	132	2	1	+A
H3_BC87_191109_LF_LIB_consensus_vsearch	2671	A	A	210	2	0.94%	2	1	93	93	0.24940898345148782	1	1	78	132	0	2	+CA
H3_BC87_191109_LF_LIB_consensus_vsearch	2672	A	A	225	2	0.87%	2	1	93	93	0.24944812362040697	1	1	79	146	0	2	G
H3_BC87_191109_LF_LIB_consensus_vsearch	2673	G	G	224	1	0.44%	2	1	93	93	0.4999999999999138	1	1	76	148	1	0	+TT
H3_BC87_191109_LF_LIB_consensus_vsearch	2674	T	T	219	6	2.64%	2	1	93	93	0.015106507368173285	1	1	79	140	0	6	C
H3_BC87_191109_LF_LIB_consensus_vsearch	2675	A	A	221	4	1.75%	2	1	93	93	0.06166574490670126	1	1	74	147	4	0	-C
H3_BC87_191109_LF_LIB_consensus_vsearch	2676	C	C	218	2	0.9%	2	1	93	93	0.24943052391823226	1	1	75	143	0	2	+A
H3_BC87_191109_LF_LIB_consensus_vsearch	2677	C	C	218	3	1.32%	2	1	93	93	0.12414965986396012	1	1	77	141	0	3	+GG
H3_BC87_191109_LF_LIB_consensus_vsearch	2678	G	R	216	10	4.37%	2	2	93	93	8.821271222096345E-4	1	1	73	143	5	5	A
H3_BC87_191109_LF_LIB_consensus_vsearch	2679	C	Y	213	9	3.95%	2	2	93	93	0.0017981564163397133	1	1	76	137	1	8	T
H3_BC87_191109_LF_LIB_consensus_vsearch	2680	G	G	224	1	0.44%	2	1	93	93	0.4999999999999138	1	1	76	148	1	0	+A
H3_BC87_191109_LF_LIB_consensus_vsearch	2681	A	*/-G	148	56	24.67%	2	2	93	93	1.7260912109110827E-19	1	1	32	116	28	28	-G
H3_BC87_191109_LF_LIB_consensus_vsearch	2682	G	G	160	2	1.21%	2	1	93	93	0.24922600619195118	1	1	44	116	0	2	+T
H3_BC87_191109_LF_LIB_consensus_vsearch	2683	G	G	219	2	0.9%	2	1	93	93	0.24943310657599216	1	1	74	145	0	2	T
H3_BC87_191109_LF_LIB_consensus_vsearch	2684	G	*/-A	205	20	8.73%	2	2	93	93	6.13281842160553E-7	1	1	60	145	18	2	-A
H3_BC87_191109_LF_LIB_consensus_vsearch	2685	A	A	201	5	2.42%	2	2	93	93	0.03049244790271922	1	1	59	142	2	3	G
H3_BC87_191109_LF_LIB_consensus_vsearch	2686	A	A	224	2	0.88%	2	1	93	93	0.24944567627499675	1	1	77	147	2	0	+G
H3_BC87_191109_LF_LIB_consensus_vsearch	2687	A	A	224	2	0.87%	2	1	93	93	0.24944567627499675	1	1	79	145	0	2	-G
H3_BC87_191109_LF_LIB_consensus_vsearch	2688	G	G	225	1	0.44%	2	1	93	93	0.5000000000003686	1	1	80	145	0	1	A
H3_BC87_191109_LF_LIB_consensus_vsearch	2689	G	G	221	2	0.88%	2	2	93	93	0.24943820224728358	1	1	76	145	1	1	+C
H3_BC87_191109_LF_LIB_consensus_vsearch	2690	T	T	219	3	1.32%	2	2	93	93	0.12415349887135622	1	1	75	144	1	2	A
H3_BC87_191109_LF_LIB_consensus_vsearch	2691	G	*/-A	186	24	10.62%	2	2	93	93	2.9702639014527133E-8	1	1	69	117	7	17	-A
H3_BC87_191109_LF_LIB_consensus_vsearch	2692	A	A	196	4	2%	2	1	93	93	0.06156133406567343	1	1	66	130	4	0	+GA
H3_BC87_191109_LF_LIB_consensus_vsearch	2693	A	A	221	2	0.89%	2	1	93	93	0.24943820224728358	1	1	76	145	0	2	G
H3_BC87_191109_LF_LIB_consensus_vsearch	2694	A	A	220	4	1.77%	2	2	93	93	0.061662016439223415	1	1	75	145	3	1	G
H3_BC87_191109_LF_LIB_consensus_vsearch	2695	A	A	223	3	1.32%	2	2	93	93	0.12416851441234596	1	1	76	147	1	2	G
H3_BC87_191109_LF_LIB_consensus_vsearch	2696	G	G	221	3	1.32%	2	1	93	93	0.12416107382546236	1	1	75	146	3	0	A
H3_BC87_191109_LF_LIB_consensus_vsearch	2697	C	C	217	5	2.2%	2	1	93	93	0.03054698177238809	1	1	77	140	0	5	+A
H3_BC87_191109_LF_LIB_consensus_vsearch	2698	A	A	223	3	1.33%	2	2	93	93	0.12416851441234596	1	1	78	145	1	2	G
H3_BC87_191109_LF_LIB_consensus_vsearch	2699	A	A	218	3	1.32%	2	1	93	93	0.12414965986396012	1	1	78	140	0	3	-C
H3_BC87_191109_LF_LIB_consensus_vsearch	2700	C	C	221	1	0.45%	2	1	93	93	0.4999999999999138	1	1	79	142	0	1	A
H3_BC87_191109_LF_LIB_consensus_vsearch	2701	C	C	218	6	2.63%	2	1	93	93	0.015104203282490625	1	1	79	139	0	6	T
H3_BC87_191109_LF_LIB_consensus_vsearch	2702	A	A	219	3	1.33%	2	1	93	93	0.12415349887135622	1	1	76	143	3	0	G
H3_BC87_191109_LF_LIB_consensus_vsearch	2703	T	T	218	3	1.33%	2	2	93	93	0.12414965986396012	1	1	76	142	2	1	C
H3_BC87_191109_LF_LIB_consensus_vsearch	2704	G	*/-A	126	90	39.47%	2	2	93	93	5.8814764233390826E-33	1	1	72	54	7	83	-A
H3_BC87_191109_LF_LIB_consensus_vsearch	2705	A	A	131	4	2.94%	2	2	93	93	0.06110855853975544	1	1	71	60	1	3	G
H3_BC87_191109_LF_LIB_consensus_vsearch	2706	A	A	223	2	0.88%	2	1	93	93	0.24944320712692292	1	1	80	143	0	2	G
H3_BC87_191109_LF_LIB_consensus_vsearch	2707	A	A	226	2	0.88%	2	1	93	93	0.24945054945064127	1	1	80	146	0	2	G
H3_BC87_191109_LF_LIB_consensus_vsearch	2708	A	A	226	3	1.31%	2	2	93	93	0.12417943107231426	1	1	78	148	2	1	G
H3_BC87_191109_LF_LIB_consensus_vsearch	2709	A	A	226	3	1.31%	2	2	93	93	0.12417943107231426	1	1	79	147	1	2	G
H3_BC87_191109_LF_LIB_consensus_vsearch	2710	T	T	217	5	2.18%	2	1	93	93	0.03054698177238809	1	1	80	137	0	5	+G
H3_BC87_191109_LF_LIB_consensus_vsearch	2711	G	G	220	2	0.89%	2	1	93	93	0.2494356659142869	1	1	77	143	2	0	A
H3_BC87_191109_LF_LIB_consensus_vsearch	2712	G	G	218	5	2.19%	2	1	93	93	0.030550130621104243	1	1	71	147	5	0	+A
H3_BC87_191109_LF_LIB_consensus_vsearch	2713	G	G	224	2	0.87%	2	1	93	93	0.24944567627499675	1	1	78	146	0	2	C
H3_BC87_191109_LF_LIB_consensus_vsearch	2714	T	Y	215	14	6.11%	2	1	93	93	4.973428022334695E-5	1	1	80	135	0	14	C
H3_BC87_191109_LF_LIB_consensus_vsearch	2715	T	T	222	4	1.75%	2	1	93	93	0.061669440342892484	1	1	76	146	4	0	+G
H3_BC87_191109_LF_LIB_consensus_vsearch	2716	G	G	217	4	1.75%	2	1	93	93	0.0616506283607095	1	1	78	139	0	4	+A
H3_BC87_191109_LF_LIB_consensus_vsearch	2717	A	A	220	1	0.45%	2	1	93	93	0.4999999999999138	1	1	76	144	1	0	+G
H3_BC87_191109_LF_LIB_consensus_vsearch	2718	A	A	226	0	0%	2	0	93	0	1.0	1	0	78	148	0	0	
H3_BC87_191109_LF_LIB_consensus_vsearch	2719	A	A	223	2	0.87%	2	1	93	93	0.24944320712692292	1	1	78	145	0	2	-C
H3_BC87_191109_LF_LIB_consensus_vsearch	2720	C	C	225	1	0.44%	2	1	93	93	0.5000000000003686	1	1	79	146	1	0	+G
H3_BC87_191109_LF_LIB_consensus_vsearch	2721	A	A	220	6	2.63%	2	2	93	93	0.015108791157819889	1	1	74	146	4	2	G
H3_BC87_191109_LF_LIB_consensus_vsearch	2722	G	G	221	2	0.88%	2	2	93	93	0.24943820224728358	1	1	76	145	1	1	+A
H3_BC87_191109_LF_LIB_consensus_vsearch	2723	T	T	210	5	2.21%	2	1	93	93	0.0305241206880699	1	1	77	133	0	5	C
H3_BC87_191109_LF_LIB_consensus_vsearch	2724	A	A	215	5	2.25%	2	2	93	93	0.03054059830172664	1	1	77	138	2	3	-G
H3_BC87_191109_LF_LIB_consensus_vsearch	2725	G	G	206	4	1.83%	2	1	93	93	0.06160608506034647	1	1	76	130	0	4	-TG
H3_BC87_191109_LF_LIB_consensus_vsearch	2726	T	T	203	3	1.4%	2	1	93	93	0.12408759124090059	1	1	73	130	0	3	A
H3_BC87_191109_LF_LIB_consensus_vsearch	2727	G	G	203	4	1.84%	2	2	93	93	0.06159311429633927	1	1	69	134	1	3	-AA
H3_BC87_191109_LF_LIB_consensus_vsearch	2728	A	A	212	1	0.47%	2	1	93	93	0.5000000000001412	1	1	69	143	1	0	+GA
H3_BC87_191109_LF_LIB_consensus_vsearch	2729	A	A	217	2	0.91%	2	1	93	93	0.24942791762028085	1	1	75	142	0	2	C
H3_BC87_191109_LF_LIB_consensus_vsearch	2730	A	A	220	3	1.34%	2	2	93	93	0.12415730337075404	1	1	74	146	1	2	G
H3_BC87_191109_LF_LIB_consensus_vsearch	2731	G	G	219	6	2.64%	2	1	93	93	0.015106507368173285	1	1	78	141	0	6	-C
H3_BC87_191109_LF_LIB_consensus_vsearch	2732	C	C	214	3	1.35%	2	1	93	93	0.12413394919162732	1	1	73	141	3	0	-G
H3_BC87_191109_LF_LIB_consensus_vsearch	2733	G	G	221	1	0.45%	2	1	93	93	0.4999999999999138	1	1	74	147	0	1	+C
H3_BC87_191109_LF_LIB_consensus_vsearch	2734	C	C	217	4	1.77%	2	1	93	93	0.0616506283607095	1	1	74	143	0	4	+T
H3_BC87_191109_LF_LIB_consensus_vsearch	2735	T	Y	217	9	3.96%	2	1	93	93	0.0018008401619304512	1	1	80	137	0	9	C
H3_BC87_191109_LF_LIB_consensus_vsearch	2736	A	A	218	4	1.75%	2	1	93	93	0.061654458623218986	1	1	75	143	0	4	-C
H3_BC87_191109_LF_LIB_consensus_vsearch	2737	C	C	217	4	1.79%	2	1	93	93	0.0616506283607095	1	1	79	138	0	4	A
H3_BC87_191109_LF_LIB_consensus_vsearch	2738	C	*/-GG	200	11	4.82%	2	1	93	93	4.27186182801716E-4	1	1	76	124	0	11	-GG
H3_BC87_191109_LF_LIB_consensus_vsearch	2739	G	R	201	7	3.32%	2	2	93	93	0.007421943123229272	1	1	71	130	5	2	A
H3_BC87_191109_LF_LIB_consensus_vsearch	2740	G	G	217	1	0.46%	2	1	93	93	0.4999999999999138	1	1	80	137	0	1	T
H3_BC87_191109_LF_LIB_consensus_vsearch	2741	G	G	229	0	0%	2	0	93	0	1.0	1	0	80	149	0	0	
H3_BC87_191109_LF_LIB_consensus_vsearch	2742	A	A	221	3	1.31%	2	1	93	93	0.12416107382546236	1	1	75	146	3	0	G
H3_BC87_191109_LF_LIB_consensus_vsearch	2743	T	T	216	4	1.75%	2	2	93	93	0.061646763238677425	1	1	75	141	1	3	-A
H3_BC87_191109_LF_LIB_consensus_vsearch	2744	A	A	213	5	2.24%	2	1	93	93	0.030534097847134272	1	1	78	135	0	5	+T
H3_BC87_191109_LF_LIB_consensus_vsearch	2745	A	W	192	10	4.41%	2	1	93	93	8.712766047726398E-4	1	1	78	114	0	10	T
H3_BC87_191109_LF_LIB_consensus_vsearch	2746	G	G	205	4	1.85%	2	2	93	93	0.06160180289502593	1	1	74	131	3	1	+A
H3_BC87_191109_LF_LIB_consensus_vsearch	2747	G	G	215	2	0.9%	2	1	93	93	0.2494226327944578	1	1	78	137	2	0	+A
H3_BC87_191109_LF_LIB_consensus_vsearch	2748	G	G	217	5	2.23%	2	2	93	93	0.03054698177238809	1	1	77	140	3	2	A
H3_BC87_191109_LF_LIB_consensus_vsearch	2749	C	Y	211	8	3.51%	2	1	93	93	0.0036602593149509337	1	1	79	132	0	8	T
H3_BC87_191109_LF_LIB_consensus_vsearch	2750	T	T	219	4	1.78%	2	2	93	93	0.06165825449566743	1	1	78	141	2	2	C
H3_BC87_191109_LF_LIB_consensus_vsearch	2751	A	A	224	2	0.87%	2	1	93	93	0.24944567627499675	1	1	80	144	0	2	-T
H3_BC87_191109_LF_LIB_consensus_vsearch	2752	T	T	217	4	1.76%	2	1	93	93	0.0616506283607095	1	1	72	145	4	0	+CC
H3_BC87_191109_LF_LIB_consensus_vsearch	2753	C	*/-G	210	13	5.7%	2	2	93	93	1.0196623731956113E-4	1	1	76	134	2	11	-G
H3_BC87_191109_LF_LIB_consensus_vsearch	2754	G	R	202	9	4.21%	2	2	93	93	0.0017902638323438202	1	1	68	134	7	2	A
H3_BC87_191109_LF_LIB_consensus_vsearch	2755	G	G	217	5	2.2%	2	1	93	93	0.03054698177238809	1	1	77	140	0	5	C
H3_BC87_191109_LF_LIB_consensus_vsearch	2756	G	G	217	4	1.76%	2	1	93	93	0.0616506283607095	1	1	77	140	0	4	-TG
H3_BC87_191109_LF_LIB_consensus_vsearch	2757	T	T	209	6	2.69%	2	2	93	93	0.015082506692930204	1	1	79	130	1	5	C
H3_BC87_191109_LF_LIB_consensus_vsearch	2758	G	G	217	2	0.91%	2	1	93	93	0.24942791762028085	1	1	80	137	0	2	-C
H3_BC87_191109_LF_LIB_consensus_vsearch	2759	C	C	216	2	0.9%	2	1	93	93	0.249425287356441	1	1	79	137	0	2	-TG
H3_BC87_191109_LF_LIB_consensus_vsearch	2760	T	*/-G	200	14	6.17%	2	2	93	93	4.9002433333818565E-5	1	1	72	128	3	11	-G
H3_BC87_191109_LF_LIB_consensus_vsearch	2761	G	G	204	2	0.96%	2	1	93	93	0.2493917274938698	1	1	76	128	0	2	T
H3_BC87_191109_LF_LIB_consensus_vsearch	2762	G	G	221	2	0.89%	2	1	93	93	0.24943820224728358	1	1	79	142	0	2	C
H3_BC87_191109_LF_LIB_consensus_vsearch	2763	G	G	218	5	2.2%	2	2	93	93	0.030550130621104243	1	1	75	143	1	4	A
H3_BC87_191109_LF_LIB_consensus_vsearch	2764	G	G	224	2	0.88%	2	1	93	93	0.24944567627499675	1	1	78	146	2	0	A
H3_BC87_191109_LF_LIB_consensus_vsearch	2765	C	C	220	2	0.88%	2	1	93	93	0.2494356659142869	1	1	79	141	0	2	-TT
H3_BC87_191109_LF_LIB_consensus_vsearch	2766	T	T	222	0	0%	2	0	93	0	1.0	1	0	80	142	0	0	
H3_BC87_191109_LF_LIB_consensus_vsearch	2767	T	*/-C	205	7	3.14%	2	1	93	93	0.0074292407456773525	1	1	74	131	0	7	-C
H3_BC87_191109_LF_LIB_consensus_vsearch	2768	C	*/-TC	167	27	12.39%	2	1	93	93	2.8192427027217997E-9	1	1	77	90	0	27	-TC
H3_BC87_191109_LF_LIB_consensus_vsearch	2769	T	T	166	4	2.23%	2	1	93	93	0.06139544654812379	1	1	73	93	0	4	-C
H3_BC87_191109_LF_LIB_consensus_vsearch	2770	C	*/-G	151	18	10.11%	2	2	93	93	2.3661072156808664E-6	1	1	76	75	1	17	-G
H3_BC87_191109_LF_LIB_consensus_vsearch	2771	G	R	170	16	8.47%	2	2	93	93	1.0896530340644042E-5	1	1	62	108	15	1	A
H3_BC87_191109_LF_LIB_consensus_vsearch	2772	G	S	208	7	3.21%	2	1	93	93	0.007434537497224064	1	1	78	130	0	7	C
H3_BC87_191109_LF_LIB_consensus_vsearch	2773	G	*/-T	214	7	3.12%	2	1	93	93	0.007444703667648697	1	1	78	136	0	7	-T
H3_BC87_191109_LF_LIB_consensus_vsearch	2774	T	Y	207	9	4.15%	2	2	93	93	0.001793948723227531	1	1	79	128	1	8	C
H3_BC87_191109_LF_LIB_consensus_vsearch	2775	G	*/-TG	214	12	5.24%	2	2	93	93	2.1016603336412182E-4	1	1	79	135	1	11	-TG
H3_BC87_191109_LF_LIB_consensus_vsearch	2776	T	T	200	6	2.78%	2	1	93	93	0.01505892390281567	1	1	75	125	0	6	C
H3_BC87_191109_LF_LIB_consensus_vsearch	2777	G	G	205	5	2.36%	2	2	93	93	0.03050685942891605	1	1	76	129	1	4	-CT
H3_BC87_191109_LF_LIB_consensus_vsearch	2778	C	C	209	6	2.71%	2	2	93	93	0.015082506692930204	1	1	74	135	3	3	-T
H3_BC87_191109_LF_LIB_consensus_vsearch	2779	T	T	212	1	0.47%	2	1	93	93	0.5000000000001412	1	1	74	138	0	1	+CT
H3_BC87_191109_LF_LIB_consensus_vsearch	2780	T	T	209	6	2.67%	2	1	93	93	0.015082506692930204	1	1	73	136	0	6	+C
H3_BC87_191109_LF_LIB_consensus_vsearch	2781	C	C	220	2	0.89%	2	1	93	93	0.2494356659142869	1	1	74	146	2	0	+A
H3_BC87_191109_LF_LIB_consensus_vsearch	2782	A	A	218	4	1.77%	2	2	93	93	0.061654458623218986	1	1	75	143	2	2	G
H3_BC87_191109_LF_LIB_consensus_vsearch	2783	G	G	223	2	0.88%	2	1	93	93	0.24944320712692292	1	1	76	147	2	0	T
H3_BC87_191109_LF_LIB_consensus_vsearch	2784	T	T	215	6	2.65%	2	2	93	93	0.01509716650743782	1	1	78	137	1	5	-GC
H3_BC87_191109_LF_LIB_consensus_vsearch	2785	G	G	215	3	1.36%	2	1	93	93	0.12413793103441495	1	1	78	137	0	3	+T
H3_BC87_191109_LF_LIB_consensus_vsearch	2786	C	C	213	4	1.8%	2	1	93	93	0.06163495389099757	1	1	76	137	0	4	-T
H3_BC87_191109_LF_LIB_consensus_vsearch	2787	T	T	217	2	0.89%	2	1	93	93	0.24942791762028085	1	1	78	139	0	2	-AC
H3_BC87_191109_LF_LIB_consensus_vsearch	2788	A	*/-C	196	12	5.31%	2	2	93	93	2.0738112718811548E-4	1	1	68	128	3	9	-C
H3_BC87_191109_LF_LIB_consensus_vsearch	2789	C	C	208	5	2.33%	2	1	93	93	0.03051731330830772	1	1	75	133	0	5	+T
H3_BC87_191109_LF_LIB_consensus_vsearch	2790	C	C	218	6	2.62%	2	1	93	93	0.015104203282490625	1	1	73	145	6	0	+G
H3_BC87_191109_LF_LIB_consensus_vsearch	2791	C	*/-T	199	19	8.3%	2	2	93	93	1.266174101535565E-6	1	1	69	130	5	14	-T
H3_BC87_191109_LF_LIB_consensus_vsearch	2792	T	T	196	4	1.93%	2	1	93	93	0.06156133406567343	1	1	64	132	4	0	A
H3_BC87_191109_LF_LIB_consensus_vsearch	2793	T	Y	206	7	3.1%	2	2	93	93	0.007431022745174962	1	1	63	143	5	2	C
H3_BC87_191109_LF_LIB_consensus_vsearch	2794	G	*/+A	158	60	26.43%	2	2	93	93	7.725326126534591E-21	1	1	74	84	1	59	+A
H3_BC87_191109_LF_LIB_consensus_vsearch	2795	G	*/-A	161	61	26.64%	2	2	93	93	3.598393494597764E-21	1	1	71	90	3	58	-A
H3_BC87_191109_LF_LIB_consensus_vsearch	2796	A	+G/+G	14	140	85.37%	2	2	93	93	3.9587772182322997E-72	1	1	13	1	53	87	+G
H3_BC87_191109_LF_LIB_consensus_vsearch	2797	A	R	212	8	3.56%	2	2	93	93	0.003661360523321731	1	1	66	146	7	1	G
H3_BC87_191109_LF_LIB_consensus_vsearch	2798	C	C	216	4	1.77%	2	1	93	93	0.061646763238677425	1	1	75	141	0	4	-G
H3_BC87_191109_LF_LIB_consensus_vsearch	2799	G	R	204	14	6.28%	2	2	93	93	4.920666598282105E-5	1	1	64	140	13	1	A
H3_BC87_191109_LF_LIB_consensus_vsearch	2800	G	*/-C	203	12	5.26%	2	1	93	93	2.0851661109317314E-4	1	1	59	144	12	0	-C
H3_BC87_191109_LF_LIB_consensus_vsearch	2801	C	*/+T	201	8	3.77%	2	1	93	93	0.003648677074969142	1	1	62	139	0	8	+T
H3_BC87_191109_LF_LIB_consensus_vsearch	2802	C	C	221	2	0.89%	2	2	93	93	0.24943820224728358	1	1	74	147	1	1	T
H3_BC87_191109_LF_LIB_consensus_vsearch	2803	C	C	221	3	1.32%	2	2	93	93	0.12416107382546236	1	1	77	144	1	2	G
H3_BC87_191109_LF_LIB_consensus_vsearch	2804	G	G	223	4	1.75%	2	2	93	93	0.061673103185009646	1	1	78	145	1	3	A
H3_BC87_191109_LF_LIB_consensus_vsearch	2805	C	C	225	3	1.31%	2	1	93	93	0.12417582417582212	1	1	80	145	0	3	T
H3_BC87_191109_LF_LIB_consensus_vsearch	2806	G	*/-TG	199	22	9.61%	2	1	93	93	1.3761269103930465E-7	1	1	78	121	0	22	-TG
H3_BC87_191109_LF_LIB_consensus_vsearch	2807	T	*/-G	181	14	6.97%	2	2	93	93	4.792795003475224E-5	1	1	73	108	3	11	-G
H3_BC87_191109_LF_LIB_consensus_vsearch	2808	G	G	184	2	1.06%	2	2	93	93	0.24932614555250343	1	1	73	111	1	1	+A
H3_BC87_191109_LF_LIB_consensus_vsearch	2809	G	G	218	6	2.67%	2	1	93	93	0.015104203282490625	1	1	72	146	6	0	+A
H3_BC87_191109_LF_LIB_consensus_vsearch	2810	G	G	211	4	1.76%	2	1	93	93	0.06162689769249	1	1	70	141	4	0	-T
H3_BC87_191109_LF_LIB_consensus_vsearch	2811	T	Y	212	10	4.48%	2	1	93	93	8.804765900705064E-4	1	1	74	138	0	10	C
H3_BC87_191109_LF_LIB_consensus_vsearch	2812	T	*/+G	210	7	3.07%	2	2	93	93	0.007437988084800957	1	1	76	134	1	6	+G
H3_BC87_191109_LF_LIB_consensus_vsearch	2813	G	G	226	1	0.44%	2	1	93	93	0.4999999999999138	1	1	78	148	1	0	-A
H3_BC87_191109_LF_LIB_consensus_vsearch	2814	A	A	222	2	0.88%	2	1	93	93	0.24944071588395061	1	1	77	145	0	2	+T
H3_BC87_191109_LF_LIB_consensus_vsearch	2815	T	T	226	1	0.44%	2	1	93	93	0.4999999999999138	1	1	77	149	1	0	G
H3_BC87_191109_LF_LIB_consensus_vsearch	2816	T	*/-G	210	11	4.8%	2	2	93	93	4.298416344617859E-4	1	1	74	136	3	8	-G
H3_BC87_191109_LF_LIB_consensus_vsearch	2817	G	G	209	2	0.93%	2	1	93	93	0.24940617577189375	1	1	74	135	0	2	+T
H3_BC87_191109_LF_LIB_consensus_vsearch	2818	G	G	222	2	0.88%	2	2	93	93	0.24944071588395061	1	1	78	144	1	1	A
H3_BC87_191109_LF_LIB_consensus_vsearch	2819	G	G	220	4	1.75%	2	1	93	93	0.061662016439223415	1	1	79	141	0	4	A
H3_BC87_191109_LF_LIB_consensus_vsearch	2820	G	G	221	3	1.31%	2	2	93	93	0.12416107382546236	1	1	78	143	1	2	-C
H3_BC87_191109_LF_LIB_consensus_vsearch	2821	C	C	220	1	0.45%	2	1	93	93	0.4999999999999138	1	1	78	142	0	1	+A
H3_BC87_191109_LF_LIB_consensus_vsearch	2822	G	G	224	2	0.88%	2	1	93	93	0.24944567627499675	1	1	78	146	0	2	+TG
H3_BC87_191109_LF_LIB_consensus_vsearch	2823	A	A	227	1	0.44%	2	1	93	93	0.4999999999999138	1	1	79	148	0	1	-TAGA
H3_BC87_191109_LF_LIB_consensus_vsearch	2824	T	T	223	2	0.88%	2	2	93	93	0.24944320712692292	1	1	77	146	1	1	C
H3_BC87_191109_LF_LIB_consensus_vsearch	2825	A	*/+G	216	9	3.96%	2	2	93	93	0.0018001779733764346	1	1	79	137	1	8	+G
H3_BC87_191109_LF_LIB_consensus_vsearch	2826	G	G	223	1	0.44%	2	1	93	93	0.5000000000003686	1	1	77	146	0	1	+A
H3_BC87_191109_LF_LIB_consensus_vsearch	2827	A	A	221	3	1.33%	2	2	93	93	0.12416107382546236	1	1	75	146	2	1	-C
H3_BC87_191109_LF_LIB_consensus_vsearch	2828	C	C	222	3	1.33%	2	2	93	93	0.12416481069040536	1	1	76	146	1	2	T
H3_BC87_191109_LF_LIB_consensus_vsearch	2829	G	G	223	1	0.44%	2	1	93	93	0.5000000000003686	1	1	79	144	1	0	+A
H3_BC87_191109_LF_LIB_consensus_vsearch	2830	C	*/-GC	196	26	11.45%	2	2	93	93	6.850873449275763E-9	1	1	59	137	20	6	-GC
H3_BC87_191109_LF_LIB_consensus_vsearch	2831	G	G	194	2	1%	2	1	93	93	0.24936061381078306	1	1	59	135	0	2	+T
H3_BC87_191109_LF_LIB_consensus_vsearch	2832	C	C	189	4	1.98%	2	1	93	93	0.061527245600347336	1	1	59	130	0	4	-TG
H3_BC87_191109_LF_LIB_consensus_vsearch	2833	T	T	212	3	1.35%	2	1	93	93	0.1241258741259166	1	1	78	134	0	3	-GT
H3_BC87_191109_LF_LIB_consensus_vsearch	2834	G	G	204	4	1.83%	2	2	93	93	0.06159747950639958	1	1	76	128	1	3	-T
H3_BC87_191109_LF_LIB_consensus_vsearch	2835	T	Y	200	10	4.65%	2	2	93	93	8.751600144021374E-4	1	1	75	125	2	8	C
H3_BC87_191109_LF_LIB_consensus_vsearch	2836	A	*/-G	158	34	15.38%	2	2	93	93	1.1716573245932937E-11	1	1	54	104	24	10	-G
H3_BC87_191109_LF_LIB_consensus_vsearch	2837	G	G	187	2	1.05%	2	2	93	93	0.24933687002661706	1	1	53	134	1	1	+A
H3_BC87_191109_LF_LIB_consensus_vsearch	2838	G	G	217	4	1.77%	2	2	93	93	0.0616506283607095	1	1	73	144	3	1	-A
H3_BC87_191109_LF_LIB_consensus_vsearch	2839	A	A	218	4	1.79%	2	1	93	93	0.061654458623218986	1	1	75	143	0	4	G
H3_BC87_191109_LF_LIB_consensus_vsearch	2840	A	A	219	3	1.32%	2	2	93	93	0.12415349887135622	1	1	75	144	1	2	-T
H3_BC87_191109_LF_LIB_consensus_vsearch	2841	T	*/+C	203	11	4.87%	2	2	93	93	4.280077806644155E-4	1	1	76	127	1	10	+C
H3_BC87_191109_LF_LIB_consensus_vsearch	2842	T	*/-C	200	20	8.73%	2	1	93	93	6.068719674831118E-7	1	1	77	123	0	20	-C
H3_BC87_191109_LF_LIB_consensus_vsearch	2843	C	C	199	3	1.44%	2	1	93	93	0.12406947890824477	1	1	77	122	0	3	-G
H3_BC87_191109_LF_LIB_consensus_vsearch	2844	G	G	219	4	1.79%	2	1	93	93	0.06165825449566743	1	1	75	144	4	0	A
H3_BC87_191109_LF_LIB_consensus_vsearch	2845	G	G	221	3	1.32%	2	2	93	93	0.12416107382546236	1	1	77	144	1	2	A
H3_BC87_191109_LF_LIB_consensus_vsearch	2846	C	C	218	4	1.77%	2	2	93	93	0.061654458623218986	1	1	77	141	1	3	-T
H3_BC87_191109_LF_LIB_consensus_vsearch	2847	T	Y	203	18	8.07%	2	2	93	93	2.660025487728775E-6	1	1	76	127	2	16	C
H3_BC87_191109_LF_LIB_consensus_vsearch	2848	G	*/-C	215	8	3.54%	2	1	93	93	0.0036646057936482192	1	1	77	138	0	8	-C
H3_BC87_191109_LF_LIB_consensus_vsearch	2849	C	C	213	2	0.92%	2	1	93	93	0.249417249417318	1	1	77	136	2	0	+G
H3_BC87_191109_LF_LIB_consensus_vsearch	2850	C	*/-T	187	30	13.27%	2	2	93	93	3.1742785674556794E-10	1	1	74	113	1	29	-T
H3_BC87_191109_LF_LIB_consensus_vsearch	2851	T	T	194	1	0.51%	2	1	93	93	0.4999999999999138	1	1	76	118	0	1	+C
H3_BC87_191109_LF_LIB_consensus_vsearch	2852	T	*/+C	212	9	3.98%	2	1	93	93	0.00179747064240055	1	1	66	146	9	0	+C
H3_BC87_191109_LF_LIB_consensus_vsearch	2853	C	C	206	6	2.69%	2	1	93	93	0.015074867144143777	1	1	72	134	0	6	-GG
H3_BC87_191109_LF_LIB_consensus_vsearch	2854	G	R	199	15	6.94%	2	2	93	93	2.3672673108116326E-5	1	1	72	127	7	8	A
H3_BC87_191109_LF_LIB_consensus_vsearch	2855	G	R	211	8	3.62%	2	2	93	93	0.0036602593149509337	1	1	76	135	1	7	A
H3_BC87_191109_LF_LIB_consensus_vsearch	2856	G	G	223	3	1.32%	2	2	93	93	0.12416851441234596	1	1	78	145	2	1	A
H3_BC87_191109_LF_LIB_consensus_vsearch	2857	C	C	222	3	1.32%	2	2	93	93	0.12416481069040536	1	1	77	145	2	1	T
H3_BC87_191109_LF_LIB_consensus_vsearch	2858	A	A	224	1	0.44%	2	1	93	93	0.4999999999999138	1	1	79	145	0	1	-G
H3_BC87_191109_LF_LIB_consensus_vsearch	2859	G	G	215	6	2.63%	2	1	93	93	0.01509716650743782	1	1	79	136	0	6	-T
H3_BC87_191109_LF_LIB_consensus_vsearch	2860	T	T	205	4	1.81%	2	1	93	93	0.06160180289502593	1	1	78	127	0	4	C
H3_BC87_191109_LF_LIB_consensus_vsearch	2861	G	G	212	2	0.9%	2	1	93	93	0.24941451990645544	1	1	77	135	0	2	-TT
H3_BC87_191109_LF_LIB_consensus_vsearch	2862	T	Y	196	23	10.45%	2	1	93	93	6.482419029061125E-8	1	1	80	116	0	23	C
H3_BC87_191109_LF_LIB_consensus_vsearch	2863	T	T	209	4	1.79%	2	2	93	93	0.061618690029214815	1	1	73	136	2	2	+A
H3_BC87_191109_LF_LIB_consensus_vsearch	2864	G	*/-T	197	8	3.52%	2	2	93	93	0.003643733038795537	1	1	66	131	1	7	-T
H3_BC87_191109_LF_LIB_consensus_vsearch	2865	T	Y	110	85	39.72%	2	2	93	93	1.8647865812264606E-31	1	1	60	50	16	69	C
H3_BC87_191109_LF_LIB_consensus_vsearch	2866	A	A	193	5	2.38%	2	2	93	93	0.030461880374916768	1	1	75	118	2	3	C
H3_BC87_191109_LF_LIB_consensus_vsearch	2867	G	R	184	14	6.48%	2	2	93	93	4.811012196880537E-5	1	1	61	123	11	3	A
H3_BC87_191109_LF_LIB_consensus_vsearch	2868	C	Y	206	13	5.8%	2	1	93	93	1.016217291023551E-4	1	1	75	131	0	13	T
H3_BC87_191109_LF_LIB_consensus_vsearch	2869	C	*/-T	206	17	7.42%	2	2	93	93	5.5582526785826E-6	1	1	78	128	2	15	-T
H3_BC87_191109_LF_LIB_consensus_vsearch	2870	T	Y	195	13	6.13%	2	1	93	93	1.0061064586351875E-4	1	1	78	117	0	13	C
H3_BC87_191109_LF_LIB_consensus_vsearch	2871	G	G	218	5	2.18%	2	1	93	93	0.030550130621104243	1	1	73	145	5	0	A
H3_BC87_191109_LF_LIB_consensus_vsearch	2872	C	C	217	3	1.34%	2	1	93	93	0.12414578587710072	1	1	77	140	0	3	-G
H3_BC87_191109_LF_LIB_consensus_vsearch	2873	G	G	216	6	2.69%	2	2	93	93	0.015099533131216845	1	1	73	143	5	1	A
H3_BC87_191109_LF_LIB_consensus_vsearch	2874	G	G	217	3	1.32%	2	2	93	93	0.12414578587710072	1	1	73	144	1	2	-T
H3_BC87_191109_LF_LIB_consensus_vsearch	2875	T	Y	186	37	16.52%	2	1	93	93	1.4276707624694763E-12	1	1	79	107	0	37	C
H3_BC87_191109_LF_LIB_consensus_vsearch	2876	T	Y	216	10	4.39%	2	1	93	93	8.821271222096345E-4	1	1	79	137	0	10	C
H3_BC87_191109_LF_LIB_consensus_vsearch	2877	G	G	222	3	1.32%	2	2	93	93	0.12416481069040536	1	1	79	143	1	2	+C
H3_BC87_191109_LF_LIB_consensus_vsearch	2878	C	C	221	3	1.33%	2	1	93	93	0.12416107382546236	1	1	78	143	0	3	T
H3_BC87_191109_LF_LIB_consensus_vsearch	2879	T	*/+G	210	8	3.57%	2	1	93	93	0.0036591481612605	1	1	76	134	0	8	+G
H3_BC87_191109_LF_LIB_consensus_vsearch	2880	G	G	226	1	0.44%	2	1	93	93	0.4999999999999138	1	1	79	147	1	0	-A
H3_BC87_191109_LF_LIB_consensus_vsearch	2881	A	A	226	1	0.44%	2	1	93	93	0.4999999999999138	1	1	77	149	1	0	+T
H3_BC87_191109_LF_LIB_consensus_vsearch	2882	T	*/-C	218	7	3.06%	2	2	93	93	0.007451182688346346	1	1	74	144	5	2	-C
H3_BC87_191109_LF_LIB_consensus_vsearch	2883	C	C	220	1	0.45%	2	1	93	93	0.4999999999999138	1	1	73	147	1	0	+A
H3_BC87_191109_LF_LIB_consensus_vsearch	2884	C	C	226	2	0.87%	2	1	93	93	0.24945054945064127	1	1	80	146	0	2	-TC
H3_BC87_191109_LF_LIB_consensus_vsearch	2885	T	T	219	4	1.76%	2	2	93	93	0.06165825449566743	1	1	77	142	2	2	+C
H3_BC87_191109_LF_LIB_consensus_vsearch	2886	C	C	223	1	0.45%	2	1	93	93	0.5000000000003686	1	1	79	144	1	0	+A
H3_BC87_191109_LF_LIB_consensus_vsearch	2887	C	C	219	6	2.65%	2	2	93	93	0.015106507368173285	1	1	77	142	2	4	-T
H3_BC87_191109_LF_LIB_consensus_vsearch	2888	T	Y	203	15	6.82%	2	1	93	93	2.37871086741396E-5	1	1	77	126	0	15	C
H3_BC87_191109_LF_LIB_consensus_vsearch	2889	G	G	224	2	0.87%	2	1	93	93	0.24944567627499675	1	1	77	147	2	0	A
H3_BC87_191109_LF_LIB_consensus_vsearch	2890	C	C	219	3	1.32%	2	2	93	93	0.12415349887135622	1	1	76	143	2	1	T
H3_BC87_191109_LF_LIB_consensus_vsearch	2891	G	G	223	1	0.44%	2	1	93	93	0.5000000000003686	1	1	80	143	0	1	+C
H3_BC87_191109_LF_LIB_consensus_vsearch	2892	A	A	223	3	1.32%	2	1	93	93	0.12416851441234596	1	1	79	144	0	3	-C
H3_BC87_191109_LF_LIB_consensus_vsearch	2893	C	C	223	2	0.89%	2	1	93	93	0.24944320712692292	1	1	80	143	0	2	+T
H3_BC87_191109_LF_LIB_consensus_vsearch	2894	C	*/-T	113	56	24.56%	2	2	93	93	5.746167605891165E-20	1	1	55	58	4	52	-T
H3_BC87_191109_LF_LIB_consensus_vsearch	2895	T	T	156	1	0.64%	2	1	93	93	0.4999999999999138	1	1	75	81	1	0	C
H3_BC87_191109_LF_LIB_consensus_vsearch	2896	T	T	211	1	0.47%	2	1	93	93	0.5000000000001412	1	1	79	132	0	1	+CT
H3_BC87_191109_LF_LIB_consensus_vsearch	2897	T	T	223	1	0.44%	2	1	93	93	0.5000000000003686	1	1	78	145	1	0	+A
H3_BC87_191109_LF_LIB_consensus_vsearch	2898	T	T	219	4	1.75%	2	2	93	93	0.06165825449566743	1	1	74	145	3	1	-G
H3_BC87_191109_LF_LIB_consensus_vsearch	2899	G	G	219	2	0.89%	2	2	93	93	0.24943310657599216	1	1	74	145	1	1	+A
H3_BC87_191109_LF_LIB_consensus_vsearch	2900	T	*/-A	207	12	5.29%	2	2	93	93	2.091345729349345E-4	1	1	70	137	5	7	-A
H3_BC87_191109_LF_LIB_consensus_vsearch	2901	A	A	214	1	0.47%	2	1	93	93	0.5000000000001412	1	1	73	141	1	0	+CAACA
H3_BC87_191109_LF_LIB_consensus_vsearch	2902	A	A	222	1	0.44%	2	1	93	93	0.4999999999999138	1	1	76	146	1	0	+T
H3_BC87_191109_LF_LIB_consensus_vsearch	2903	T	Y	213	10	4.42%	2	1	93	93	8.808946039600796E-4	1	1	75	138	0	10	C
H3_BC87_191109_LF_LIB_consensus_vsearch	2904	T	T	221	4	1.76%	2	2	93	93	0.06166574490670126	1	1	74	147	2	2	-G
H3_BC87_191109_LF_LIB_consensus_vsearch	2905	G	G	215	2	0.89%	2	1	93	93	0.2494226327944578	1	1	72	143	0	2	-C
H3_BC87_191109_LF_LIB_consensus_vsearch	2906	C	*/-G	205	13	5.78%	2	2	93	93	1.0153375468649412E-4	1	1	72	133	3	10	-G
H3_BC87_191109_LF_LIB_consensus_vsearch	2907	G	R	185	24	11.21%	2	2	93	93	2.9597819574977793E-8	1	1	49	136	23	1	A
H3_BC87_191109_LF_LIB_consensus_vsearch	2908	G	G	227	1	0.44%	2	1	93	93	0.4999999999999138	1	1	79	148	1	0	+A
H3_BC87_191109_LF_LIB_consensus_vsearch	2909	G	G	225	2	0.87%	2	2	93	93	0.24944812362040697	1	1	79	146	1	1	A
H3_BC87_191109_LF_LIB_consensus_vsearch	2910	T	T	224	3	1.32%	2	1	93	93	0.12417218543044797	1	1	79	145	0	3	C
H3_BC87_191109_LF_LIB_consensus_vsearch	2911	C	C	227	1	0.44%	2	1	93	93	0.4999999999999138	1	1	80	147	0	1	+T
H3_BC87_191109_LF_LIB_consensus_vsearch	2912	T	T	227	1	0.44%	2	1	93	93	0.4999999999999138	1	1	79	148	1	0	G
H3_BC87_191109_LF_LIB_consensus_vsearch	2913	T	*/+G	216	9	3.93%	2	1	93	93	0.0018001779733764346	1	1	77	139	0	9	+G
H3_BC87_191109_LF_LIB_consensus_vsearch	2914	G	R	216	11	4.8%	2	2	93	93	4.313270586514381E-4	1	1	76	140	2	9	A
H3_BC87_191109_LF_LIB_consensus_vsearch	2915	C	Y	208	17	7.42%	2	1	93	93	5.574528228215115E-6	1	1	80	128	0	17	T
H3_BC87_191109_LF_LIB_consensus_vsearch	2916	G	G	226	1	0.44%	2	1	93	93	0.4999999999999138	1	1	80	146	0	1	+A
H3_BC87_191109_LF_LIB_consensus_vsearch	2917	A	A	222	3	1.31%	2	1	93	93	0.12416481069040536	1	1	79	143	0	3	-C
H3_BC87_191109_LF_LIB_consensus_vsearch	2918	C	C	220	4	1.77%	2	1	93	93	0.061662016439223415	1	1	80	140	0	4	T
H3_BC87_191109_LF_LIB_consensus_vsearch	2919	C	Y	209	17	7.42%	2	1	93	93	5.582571341748222E-6	1	1	80	129	0	17	T
H3_BC87_191109_LF_LIB_consensus_vsearch	2920	G	G	223	2	0.88%	2	1	93	93	0.24944320712692292	1	1	77	146	0	2	+CG
H3_BC87_191109_LF_LIB_consensus_vsearch	2921	T	T	223	4	1.75%	2	1	93	93	0.061673103185009646	1	1	79	144	0	4	C
H3_BC87_191109_LF_LIB_consensus_vsearch	2922	T	T	219	4	1.75%	2	1	93	93	0.06165825449566743	1	1	78	141	0	4	C
H3_BC87_191109_LF_LIB_consensus_vsearch	2923	A	A	216	3	1.33%	2	1	93	93	0.12414187643025615	1	1	78	138	0	3	+G
H3_BC87_191109_LF_LIB_consensus_vsearch	2924	G	G	221	3	1.32%	2	2	93	93	0.12416107382546236	1	1	76	145	2	1	+C
H3_BC87_191109_LF_LIB_consensus_vsearch	2925	C	C	223	1	0.44%	2	1	93	93	0.5000000000003686	1	1	77	146	1	0	+T
H3_BC87_191109_LF_LIB_consensus_vsearch	2926	C	C	223	2	0.87%	2	1	93	93	0.24944320712692292	1	1	79	144	0	2	-GCC
H3_BC87_191109_LF_LIB_consensus_vsearch	2927	G	*/-C	213	8	3.52%	2	2	93	93	0.0036624519192641563	1	1	68	145	7	1	-C
H3_BC87_191109_LF_LIB_consensus_vsearch	2928	C	C	217	1	0.46%	2	1	93	93	0.4999999999999138	1	1	72	145	1	0	T
H3_BC87_191109_LF_LIB_consensus_vsearch	2929	C	C	225	1	0.44%	2	1	93	93	0.5000000000003686	1	1	79	146	1	0	A
H3_BC87_191109_LF_LIB_consensus_vsearch	2930	C	C	221	5	2.19%	2	1	93	93	0.03055941016990272	1	1	79	142	0	5	T
H3_BC87_191109_LF_LIB_consensus_vsearch	2931	G	G	218	4	1.77%	2	1	93	93	0.061654458623218986	1	1	75	143	4	0	A
H3_BC87_191109_LF_LIB_consensus_vsearch	2932	T	T	220	3	1.33%	2	2	93	93	0.12415730337075404	1	1	78	142	1	2	C
H3_BC87_191109_LF_LIB_consensus_vsearch	2933	C	C	221	5	2.2%	2	1	93	93	0.03055941016990272	1	1	80	141	0	5	-T
H3_BC87_191109_LF_LIB_consensus_vsearch	2934	T	T	215	3	1.35%	2	2	93	93	0.12413793103441495	1	1	76	139	1	2	C
H3_BC87_191109_LF_LIB_consensus_vsearch	2935	T	T	216	5	2.19%	2	1	93	93	0.030543804461782422	1	1	76	140	0	5	+G
H3_BC87_191109_LF_LIB_consensus_vsearch	2936	G	G	219	5	2.19%	2	1	93	93	0.030553251388732716	1	1	79	140	0	5	-A
H3_BC87_191109_LF_LIB_consensus_vsearch	2937	A	A	220	4	1.79%	2	1	93	93	0.061662016439223415	1	1	80	140	0	4	G
H3_BC87_191109_LF_LIB_consensus_vsearch	2938	A	A	227	1	0.44%	2	1	93	93	0.4999999999999138	1	1	79	148	0	1	+C
H3_BC87_191109_LF_LIB_consensus_vsearch	2939	A	A	222	3	1.31%	2	2	93	93	0.12416481069040536	1	1	78	144	2	1	G
H3_BC87_191109_LF_LIB_consensus_vsearch	2940	C	C	222	2	0.88%	2	1	93	93	0.24944071588395061	1	1	80	142	0	2	G
H3_BC87_191109_LF_LIB_consensus_vsearch	2941	A	A	224	2	0.88%	2	1	93	93	0.24944567627499675	1	1	77	147	2	0	G
H3_BC87_191109_LF_LIB_consensus_vsearch	2942	C	C	218	3	1.32%	2	1	93	93	0.12414965986396012	1	1	76	142	0	3	-G
H3_BC87_191109_LF_LIB_consensus_vsearch	2943	G	G	221	2	0.89%	2	2	93	93	0.24943820224728358	1	1	77	144	1	1	A
H3_BC87_191109_LF_LIB_consensus_vsearch	2944	G	G	224	1	0.44%	2	1	93	93	0.4999999999999138	1	1	78	146	0	1	+A
H3_BC87_191109_LF_LIB_consensus_vsearch	2945	A	A	217	6	2.63%	2	2	93	93	0.015101878629034914	1	1	73	144	5	1	-C
H3_BC87_191109_LF_LIB_consensus_vsearch	2946	C	C	220	2	0.9%	2	2	93	93	0.2494356659142869	1	1	73	147	1	1	T
H3_BC87_191109_LF_LIB_consensus_vsearch	2947	C	*/-A	214	9	3.95%	2	2	93	93	0.0017988361772468277	1	1	68	146	8	1	-A
H3_BC87_191109_LF_LIB_consensus_vsearch	2948	A	A	213	5	2.28%	2	2	93	93	0.030534097847134272	1	1	69	144	1	4	G
H3_BC87_191109_LF_LIB_consensus_vsearch	2949	A	A	220	6	2.62%	2	2	93	93	0.015108791157819889	1	1	76	144	3	3	-G
H3_BC87_191109_LF_LIB_consensus_vsearch	2950	G	G	217	3	1.35%	2	1	93	93	0.12414578587710072	1	1	74	143	3	0	+A
H3_BC87_191109_LF_LIB_consensus_vsearch	2951	G	*/-A	209	8	3.49%	2	1	93	93	0.003658026926953576	1	1	60	149	8	0	-A
H3_BC87_191109_LF_LIB_consensus_vsearch	2952	A	A	213	1	0.46%	2	1	93	93	0.4999999999999138	1	1	65	148	0	1	+G
H3_BC87_191109_LF_LIB_consensus_vsearch	2953	G	*/-T	203	10	4.48%	2	1	93	93	8.765435124402236E-4	1	1	66	137	0	10	-T
H3_BC87_191109_LF_LIB_consensus_vsearch	2954	T	Y	207	7	3.24%	2	2	93	93	0.007432788253078562	1	1	72	135	5	2	C
H3_BC87_191109_LF_LIB_consensus_vsearch	2955	G	G	222	1	0.45%	2	1	93	93	0.4999999999999138	1	1	77	145	0	1	-C
H3_BC87_191109_LF_LIB_consensus_vsearch	2956	C	C	220	3	1.33%	2	2	93	93	0.12415730337075404	1	1	76	144	1	2	T
H3_BC87_191109_LF_LIB_consensus_vsearch	2957	A	A	219	6	2.65%	2	1	93	93	0.015106507368173285	1	1	78	141	0	6	-C
H3_BC87_191109_LF_LIB_consensus_vsearch	2958	C	C	214	2	0.91%	2	1	93	93	0.24941995359642635	1	1	77	137	0	2	+T
H3_BC87_191109_LF_LIB_consensus_vsearch	2959	C	*/-T	197	20	8.77%	2	1	93	93	6.029113548186886E-7	1	1	76	121	0	20	-T
H3_BC87_191109_LF_LIB_consensus_vsearch	2960	T	T	200	4	1.94%	2	2	93	93	0.061579761579775204	1	1	76	124	2	2	C
H3_BC87_191109_LF_LIB_consensus_vsearch	2961	T	T	221	5	2.2%	2	1	93	93	0.03055941016990272	1	1	78	143	0	5	C
H3_BC87_191109_LF_LIB_consensus_vsearch	2962	G	G	224	1	0.44%	2	1	93	93	0.4999999999999138	1	1	78	146	1	0	+C
H3_BC87_191109_LF_LIB_consensus_vsearch	2963	C	Y	216	8	3.51%	2	2	93	93	0.003665668526289429	1	1	78	138	1	7	T
H3_BC87_191109_LF_LIB_consensus_vsearch	2964	A	A	219	2	0.88%	2	2	93	93	0.24943310657599216	1	1	79	140	1	1	-TG
H3_BC87_191109_LF_LIB_consensus_vsearch	2965	T	T	223	1	0.44%	2	1	93	93	0.5000000000003686	1	1	79	144	0	1	+G
H3_BC87_191109_LF_LIB_consensus_vsearch	2966	G	G	219	5	2.2%	2	1	93	93	0.030553251388732716	1	1	77	142	0	5	-CG
H3_BC87_191109_LF_LIB_consensus_vsearch	2967	C	*/-G	210	7	3.14%	2	2	93	93	0.007437988084800957	1	1	70	140	6	1	-G
H3_BC87_191109_LF_LIB_consensus_vsearch	2968	G	G	211	4	1.84%	2	1	93	93	0.06162689769249	1	1	68	143	4	0	+A
H3_BC87_191109_LF_LIB_consensus_vsearch	2969	A	A	225	1	0.44%	2	1	93	93	0.5000000000003686	1	1	77	148	1	0	+G
H3_BC87_191109_LF_LIB_consensus_vsearch	2970	G	G	226	2	0.88%	2	1	93	93	0.24945054945064127	1	1	80	146	0	2	+AG
H3_BC87_191109_LF_LIB_consensus_vsearch	2971	T	T	221	5	2.19%	2	1	93	93	0.03055941016990272	1	1	78	143	0	5	C
H3_BC87_191109_LF_LIB_consensus_vsearch	2972	C	C	220	4	1.76%	2	2	93	93	0.061662016439223415	1	1	73	147	3	1	+A
H3_BC87_191109_LF_LIB_consensus_vsearch	2973	G	G	215	5	2.21%	2	2	93	93	0.03054059830172664	1	1	71	144	4	1	-A
H3_BC87_191109_LF_LIB_consensus_vsearch	2974	A	A	218	1	0.45%	2	1	93	93	0.5000000000003686	1	1	72	146	1	0	+G
H3_BC87_191109_LF_LIB_consensus_vsearch	2975	A	*/-G	171	50	22.12%	2	2	93	93	3.885486177041765E-17	1	1	64	107	13	37	-G
H3_BC87_191109_LF_LIB_consensus_vsearch	2976	G	G	171	4	2.25%	2	1	93	93	0.061427049701525516	1	1	62	109	4	0	+A
H3_BC87_191109_LF_LIB_consensus_vsearch	2977	G	G	226	1	0.44%	2	1	93	93	0.4999999999999138	1	1	80	146	0	1	+T
H3_BC87_191109_LF_LIB_consensus_vsearch	2978	G	G	226	2	0.87%	2	2	93	93	0.24945054945064127	1	1	79	147	1	1	-A
H3_BC87_191109_LF_LIB_consensus_vsearch	2979	A	A	223	2	0.88%	2	2	93	93	0.24944320712692292	1	1	77	146	1	1	G
H3_BC87_191109_LF_LIB_consensus_vsearch	2980	T	*/-C	204	22	9.65%	2	1	93	93	1.3938223685465813E-7	1	1	57	147	22	0	-C
H3_BC87_191109_LF_LIB_consensus_vsearch	2981	C	C	207	0	0%	2	0	93	0	1.0	1	0	58	149	0	0	
H3_BC87_191109_LF_LIB_consensus_vsearch	2982	C	*/+G	211	10	4.37%	2	2	93	93	8.800549103686053E-4	1	1	75	136	1	9	+G
H3_BC87_191109_LF_LIB_consensus_vsearch	2983	G	*/-A	207	12	5.24%	2	2	93	93	2.091345729349345E-4	1	1	75	132	5	7	-A
H3_BC87_191109_LF_LIB_consensus_vsearch	2984	A	A	214	2	0.92%	2	1	93	93	0.24941995359642635	1	1	74	140	0	2	G
H3_BC87_191109_LF_LIB_consensus_vsearch	2985	A	A	227	1	0.44%	2	1	93	93	0.4999999999999138	1	1	78	149	1	0	+G
H3_BC87_191109_LF_LIB_consensus_vsearch	2986	A	A	219	6	2.62%	2	2	93	93	0.015106507368173285	1	1	77	142	1	5	-C
H3_BC87_191109_LF_LIB_consensus_vsearch	2987	C	*/+T	206	12	5.38%	2	1	93	93	2.089820970245861E-4	1	1	78	128	0	12	+T
H3_BC87_191109_LF_LIB_consensus_vsearch	2988	C	C	224	5	2.18%	2	2	93	93	0.03056844687042959	1	1	78	146	2	3	-T
H3_BC87_191109_LF_LIB_consensus_vsearch	2989	T	*/-G	160	34	15.18%	2	1	93	93	1.1931074742962612E-11	1	1	76	84	0	34	-G
H3_BC87_191109_LF_LIB_consensus_vsearch	2990	G	G	191	3	1.54%	2	1	93	93	0.1240310077519331	1	1	80	111	0	3	C
H3_BC87_191109_LF_LIB_consensus_vsearch	2991	G	G	223	2	0.87%	2	1	93	93	0.24944320712692292	1	1	76	147	0	2	-A
H3_BC87_191109_LF_LIB_consensus_vsearch	2992	A	A	220	3	1.33%	2	1	93	93	0.12415730337075404	1	1	73	147	3	0	+G
H3_BC87_191109_LF_LIB_consensus_vsearch	2993	G	G	218	2	0.88%	2	1	93	93	0.24943052391823226	1	1	72	146	0	2	+C
H3_BC87_191109_LF_LIB_consensus_vsearch	2994	G	G	225	1	0.44%	2	1	93	93	0.5000000000003686	1	1	77	148	0	1	-C
H3_BC87_191109_LF_LIB_consensus_vsearch	2995	C	C	222	1	0.44%	2	1	93	93	0.4999999999999138	1	1	75	147	1	0	+AC
H3_BC87_191109_LF_LIB_consensus_vsearch	2996	G	G	226	1	0.44%	2	1	93	93	0.4999999999999138	1	1	78	148	0	1	+CG
H3_BC87_191109_LF_LIB_consensus_vsearch	2997	T	W	215	7	3.07%	2	1	93	93	0.007446345105805389	1	1	78	137	0	7	A
H3_BC87_191109_LF_LIB_consensus_vsearch	2998	A	A	224	3	1.32%	2	2	93	93	0.12417218543044797	1	1	78	146	1	2	G
H3_BC87_191109_LF_LIB_consensus_vsearch	2999	G	G	223	2	0.87%	2	1	93	93	0.24944320712692292	1	1	76	147	2	0	+CC
H3_BC87_191109_LF_LIB_consensus_vsearch	3000	C	C	213	4	1.76%	2	1	93	93	0.06163495389099757	1	1	69	144	4	0	+G
H3_BC87_191109_LF_LIB_consensus_vsearch	3001	G	G	214	4	1.78%	2	2	93	93	0.061638926495252586	1	1	71	143	3	1	-A
H3_BC87_191109_LF_LIB_consensus_vsearch	3002	A	A	215	3	1.36%	2	1	93	93	0.12413793103441495	1	1	67	148	3	0	G
H3_BC87_191109_LF_LIB_consensus_vsearch	3003	A	A	219	6	2.64%	2	2	93	93	0.015106507368173285	1	1	71	148	5	1	-C
H3_BC87_191109_LF_LIB_consensus_vsearch	3004	C	C	219	3	1.35%	2	1	93	93	0.12415349887135622	1	1	71	148	3	0	G
H3_BC87_191109_LF_LIB_consensus_vsearch	3005	G	G	223	4	1.75%	2	2	93	93	0.061673103185009646	1	1	76	147	3	1	-CG
H3_BC87_191109_LF_LIB_consensus_vsearch	3006	C	C	223	1	0.44%	2	1	93	93	0.5000000000003686	1	1	77	146	0	1	+G
H3_BC87_191109_LF_LIB_consensus_vsearch	3007	G	G	224	1	0.44%	2	1	93	93	0.4999999999999138	1	1	77	147	0	1	+CG
H3_BC87_191109_LF_LIB_consensus_vsearch	3008	A	A	226	2	0.87%	2	2	93	93	0.24945054945064127	1	1	79	147	1	1	G
H3_BC87_191109_LF_LIB_consensus_vsearch	3009	C	C	225	2	0.87%	2	1	93	93	0.24944812362040697	1	1	79	146	0	2	T
H3_BC87_191109_LF_LIB_consensus_vsearch	3010	G	G	224	2	0.88%	2	1	93	93	0.24944567627499675	1	1	76	148	2	0	-A
H3_BC87_191109_LF_LIB_consensus_vsearch	3011	A	A	222	1	0.44%	2	1	93	93	0.4999999999999138	1	1	76	146	0	1	-TG
H3_BC87_191109_LF_LIB_consensus_vsearch	3012	T	*/-G	183	31	13.66%	2	2	93	93	1.4438723128112539E-10	1	1	59	124	17	14	-G
H3_BC87_191109_LF_LIB_consensus_vsearch	3013	G	G	186	3	1.55%	2	1	93	93	0.1240053050397967	1	1	55	131	3	0	+A
H3_BC87_191109_LF_LIB_consensus_vsearch	3014	G	G	223	2	0.88%	2	1	93	93	0.24944320712692292	1	1	76	147	2	0	A
H3_BC87_191109_LF_LIB_consensus_vsearch	3015	G	G	223	3	1.33%	2	2	93	93	0.12416851441234596	1	1	76	147	2	1	A
H3_BC87_191109_LF_LIB_consensus_vsearch	3016	G	G	219	3	1.31%	2	1	93	93	0.12415349887135622	1	1	74	145	0	3	+A
H3_BC87_191109_LF_LIB_consensus_vsearch	3017	A	A	223	2	0.89%	2	1	93	93	0.24944320712692292	1	1	74	149	2	0	+G
H3_BC87_191109_LF_LIB_consensus_vsearch	3018	A	A	223	3	1.32%	2	2	93	93	0.12416851441234596	1	1	75	148	2	1	G
H3_BC87_191109_LF_LIB_consensus_vsearch	3019	T	T	220	5	2.19%	2	2	93	93	0.03055634444922604	1	1	76	144	2	3	C
H3_BC87_191109_LF_LIB_consensus_vsearch	3020	G	G	224	4	1.75%	2	1	93	93	0.06167673386217682	1	1	76	148	4	0	A
H3_BC87_191109_LF_LIB_consensus_vsearch	3021	T	T	225	2	0.88%	2	2	93	93	0.24944812362040697	1	1	78	147	1	1	-C
H3_BC87_191109_LF_LIB_consensus_vsearch	3022	C	C	222	2	0.88%	2	1	93	93	0.24944071588395061	1	1	76	146	0	2	+T
H3_BC87_191109_LF_LIB_consensus_vsearch	3023	C	*/-T	180	32	13.97%	2	1	93	93	6.571054618738405E-11	1	1	79	101	0	32	-T
H3_BC87_191109_LF_LIB_consensus_vsearch	3024	T	T	182	5	2.66%	2	1	93	93	0.030415585729470396	1	1	80	102	0	5	C
H3_BC87_191109_LF_LIB_consensus_vsearch	3025	T	W	204	7	3.18%	2	1	93	93	0.007427442022474603	1	1	77	127	0	7	A
H3_BC87_191109_LF_LIB_consensus_vsearch	3026	G	G	201	6	2.71%	2	2	93	93	0.01506164496890816	1	1	73	128	3	3	-TG
H3_BC87_191109_LF_LIB_consensus_vsearch	3027	T	T	197	6	2.79%	2	2	93	93	0.015050600683290578	1	1	72	125	3	3	-G
H3_BC87_191109_LF_LIB_consensus_vsearch	3028	G	R	204	7	3.3%	2	2	93	93	0.007427442022474603	1	1	68	136	5	2	A
H3_BC87_191109_LF_LIB_consensus_vsearch	3029	G	G	217	4	1.79%	2	2	93	93	0.0616506283607095	1	1	74	143	3	1	-C
H3_BC87_191109_LF_LIB_consensus_vsearch	3030	C	C	208	5	2.25%	2	1	93	93	0.03051731330830772	1	1	68	140	5	0	+G
H3_BC87_191109_LF_LIB_consensus_vsearch	3031	A	*/-G	210	9	4%	2	2	93	93	0.0017960807336148846	1	1	68	142	8	1	-G
H3_BC87_191109_LF_LIB_consensus_vsearch	3032	G	G	215	1	0.46%	2	1	93	93	0.4999999999999138	1	1	70	145	1	0	+A
H3_BC87_191109_LF_LIB_consensus_vsearch	3033	A	A	219	3	1.33%	2	2	93	93	0.12415349887135622	1	1	76	143	1	2	G
H3_BC87_191109_LF_LIB_consensus_vsearch	3034	C	C	219	4	1.77%	2	1	93	93	0.06165825449566743	1	1	77	142	0	4	+A
H3_BC87_191109_LF_LIB_consensus_vsearch	3035	A	*/-C	207	16	7.05%	2	2	93	93	1.1546128752618848E-5	1	1	65	142	11	5	-C
H3_BC87_191109_LF_LIB_consensus_vsearch	3036	C	C	204	5	2.37%	2	1	93	93	0.030503308196835104	1	1	67	137	0	5	T
H3_BC87_191109_LF_LIB_consensus_vsearch	3037	C	C	226	2	0.88%	2	1	93	93	0.24945054945064127	1	1	79	147	0	2	T
H3_BC87_191109_LF_LIB_consensus_vsearch	3038	C	Y	217	11	4.82%	2	1	93	93	4.3156732794080477E-4	1	1	79	138	0	11	T
H3_BC87_191109_LF_LIB_consensus_vsearch	3039	G	G	227	2	0.87%	2	1	93	93	0.24945295404843976	1	1	78	149	2	0	A
H3_BC87_191109_LF_LIB_consensus_vsearch	3040	C	C	224	3	1.31%	2	1	93	93	0.12417218543044797	1	1	78	146	0	3	+A
H3_BC87_191109_LF_LIB_consensus_vsearch	3041	A	*/-C	216	7	3.08%	2	2	93	93	0.007447971960236055	1	1	72	144	5	2	-C
H3_BC87_191109_LF_LIB_consensus_vsearch	3042	C	C	214	3	1.37%	2	1	93	93	0.12413394919162732	1	1	72	142	0	3	T
H3_BC87_191109_LF_LIB_consensus_vsearch	3043	C	C	223	2	0.88%	2	2	93	93	0.24944320712692292	1	1	78	145	1	1	T
H3_BC87_191109_LF_LIB_consensus_vsearch	3044	C	Y	215	10	4.42%	2	1	93	93	8.817198236951184E-4	1	1	78	137	0	10	T
H3_BC87_191109_LF_LIB_consensus_vsearch	3045	G	G	222	2	0.88%	2	1	93	93	0.24944071588395061	1	1	77	145	0	2	-C
H3_BC87_191109_LF_LIB_consensus_vsearch	3046	C	C	221	2	0.88%	2	1	93	93	0.24943820224728358	1	1	77	144	2	0	+A
H3_BC87_191109_LF_LIB_consensus_vsearch	3047	C	*/-T	215	8	3.49%	2	2	93	93	0.0036646057936482192	1	1	78	137	1	7	-T
H3_BC87_191109_LF_LIB_consensus_vsearch	3048	T	T	216	2	0.91%	2	2	93	93	0.249425287356441	1	1	76	140	1	1	C
H3_BC87_191109_LF_LIB_consensus_vsearch	3049	T	T	218	6	2.63%	2	2	93	93	0.015104203282490625	1	1	75	143	1	5	C
H3_BC87_191109_LF_LIB_consensus_vsearch	3050	G	G	219	3	1.31%	2	1	93	93	0.12415349887135622	1	1	76	143	0	3	+C
H3_BC87_191109_LF_LIB_consensus_vsearch	3051	T	T	218	5	2.19%	2	1	93	93	0.030550130621104243	1	1	78	140	0	5	A
H3_BC87_191109_LF_LIB_consensus_vsearch	3052	G	R	219	7	3.08%	2	2	93	93	0.007452766938834958	1	1	76	143	3	4	A
H3_BC87_191109_LF_LIB_consensus_vsearch	3053	C	Y	209	7	3.07%	2	2	93	93	0.007436270701269745	1	1	72	137	1	6	T
H3_BC87_191109_LF_LIB_consensus_vsearch	3054	G	G	210	5	2.24%	2	2	93	93	0.0305241206880699	1	1	69	141	4	1	-AG
H3_BC87_191109_LF_LIB_consensus_vsearch	3055	A	*/-G	204	12	5.5%	2	1	93	93	2.0867313373012331E-4	1	1	59	145	12	0	-G
H3_BC87_191109_LF_LIB_consensus_vsearch	3056	G	G	200	5	2.39%	2	1	93	93	0.03048875726138147	1	1	54	146	5	0	+A
H3_BC87_191109_LF_LIB_consensus_vsearch	3057	G	G	221	3	1.33%	2	2	93	93	0.12416107382546236	1	1	74	147	2	1	-T
H3_BC87_191109_LF_LIB_consensus_vsearch	3058	T	T	213	5	2.24%	2	1	93	93	0.030534097847134272	1	1	69	144	5	0	+A
H3_BC87_191109_LF_LIB_consensus_vsearch	3059	A	A	222	1	0.44%	2	1	93	93	0.4999999999999138	1	1	76	146	0	1	+G
H3_BC87_191109_LF_LIB_consensus_vsearch	3060	G	G	223	2	0.88%	2	1	93	93	0.24944320712692292	1	1	77	146	0	2	+A
H3_BC87_191109_LF_LIB_consensus_vsearch	3061	A	A	223	3	1.32%	2	2	93	93	0.12416851441234596	1	1	78	145	1	2	-G
H3_BC87_191109_LF_LIB_consensus_vsearch	3062	G	G	220	2	0.88%	2	1	93	93	0.2494356659142869	1	1	77	143	2	0	A
H3_BC87_191109_LF_LIB_consensus_vsearch	3063	C	C	221	5	2.19%	2	2	93	93	0.03055941016990272	1	1	78	143	1	4	T
H3_BC87_191109_LF_LIB_consensus_vsearch	3064	A	A	223	2	0.88%	2	2	93	93	0.24944320712692292	1	1	79	144	1	1	G
H3_BC87_191109_LF_LIB_consensus_vsearch	3065	T	T	220	5	2.19%	2	1	93	93	0.03055634444922604	1	1	79	141	0	5	C
H3_BC87_191109_LF_LIB_consensus_vsearch	3066	G	G	223	1	0.44%	2	1	93	93	0.5000000000003686	1	1	78	145	0	1	+A
H3_BC87_191109_LF_LIB_consensus_vsearch	3067	T	T	211	6	2.65%	2	2	93	93	0.015087482939793164	1	1	75	136	2	4	C
H3_BC87_191109_LF_LIB_consensus_vsearch	3068	A	A	220	5	2.2%	2	2	93	93	0.03055634444922604	1	1	73	147	3	2	G
H3_BC87_191109_LF_LIB_consensus_vsearch	3069	C	Y	213	11	4.85%	2	1	93	93	4.305938947768699E-4	1	1	78	135	0	11	T
H3_BC87_191109_LF_LIB_consensus_vsearch	3070	G	G	215	6	2.67%	2	2	93	93	0.01509716650743782	1	1	72	143	5	1	A
H3_BC87_191109_LF_LIB_consensus_vsearch	3071	G	G	222	2	0.88%	2	1	93	93	0.24944071588395061	1	1	77	145	0	2	A
H3_BC87_191109_LF_LIB_consensus_vsearch	3072	T	T	221	3	1.32%	2	1	93	93	0.12416107382546236	1	1	79	142	0	3	A
H3_BC87_191109_LF_LIB_consensus_vsearch	3073	G	G	222	4	1.75%	2	1	93	93	0.061669440342892484	1	1	76	146	4	0	A
H3_BC87_191109_LF_LIB_consensus_vsearch	3074	C	C	220	5	2.2%	2	1	93	93	0.03055634444922604	1	1	80	140	0	5	T
H3_BC87_191109_LF_LIB_consensus_vsearch	3075	G	G	225	1	0.44%	2	1	93	93	0.5000000000003686	1	1	80	145	0	1	+A
H3_BC87_191109_LF_LIB_consensus_vsearch	3076	A	A	222	3	1.31%	2	1	93	93	0.12416481069040536	1	1	73	149	3	0	-CC
H3_BC87_191109_LF_LIB_consensus_vsearch	3077	C	C	220	2	0.9%	2	1	93	93	0.2494356659142869	1	1	74	146	0	2	T
H3_BC87_191109_LF_LIB_consensus_vsearch	3078	C	C	224	1	0.44%	2	1	93	93	0.4999999999999138	1	1	76	148	0	1	T
H3_BC87_191109_LF_LIB_consensus_vsearch	3079	C	Y	201	18	7.89%	2	1	93	93	2.6509133703959145E-6	1	1	79	122	0	18	T
H3_BC87_191109_LF_LIB_consensus_vsearch	3080	G	*/-A	203	20	8.85%	2	2	93	93	6.107459539817822E-7	1	1	60	143	19	1	-A
H3_BC87_191109_LF_LIB_consensus_vsearch	3081	A	A	206	1	0.48%	2	1	93	93	0.5000000000001412	1	1	60	146	0	1	C
H3_BC87_191109_LF_LIB_consensus_vsearch	3082	A	A	224	2	0.88%	2	1	93	93	0.24944567627499675	1	1	78	146	0	2	G
H3_BC87_191109_LF_LIB_consensus_vsearch	3083	A	A	228	1	0.44%	2	1	93	93	0.4999999999999138	1	1	79	149	1	0	G
H3_BC87_191109_LF_LIB_consensus_vsearch	3084	G	G	227	1	0.44%	2	1	93	93	0.4999999999999138	1	1	80	147	0	1	+C
H3_BC87_191109_LF_LIB_consensus_vsearch	3085	A	A	226	3	1.31%	2	2	93	93	0.12417943107231426	1	1	79	147	1	2	G
H3_BC87_191109_LF_LIB_consensus_vsearch	3086	T	T	223	3	1.31%	2	1	93	93	0.12416851441234596	1	1	80	143	0	3	C
H3_BC87_191109_LF_LIB_consensus_vsearch	3087	G	G	221	2	0.88%	2	1	93	93	0.24943820224728358	1	1	76	145	2	0	+A
H3_BC87_191109_LF_LIB_consensus_vsearch	3088	G	G	225	1	0.44%	2	1	93	93	0.5000000000003686	1	1	79	146	0	1	+C
H3_BC87_191109_LF_LIB_consensus_vsearch	3089	T	T	216	4	1.75%	2	2	93	93	0.061646763238677425	1	1	77	139	2	2	+A
H3_BC87_191109_LF_LIB_consensus_vsearch	3090	G	G	222	3	1.32%	2	1	93	93	0.12416481069040536	1	1	75	147	3	0	-A
H3_BC87_191109_LF_LIB_consensus_vsearch	3091	A	A	222	1	0.44%	2	1	93	93	0.4999999999999138	1	1	75	147	1	0	+G
H3_BC87_191109_LF_LIB_consensus_vsearch	3092	A	A	219	4	1.75%	2	2	93	93	0.06165825449566743	1	1	74	145	3	1	G
H3_BC87_191109_LF_LIB_consensus_vsearch	3093	C	C	222	2	0.88%	2	1	93	93	0.24944071588395061	1	1	76	146	0	2	-T
H3_BC87_191109_LF_LIB_consensus_vsearch	3094	T	T	220	3	1.32%	2	1	93	93	0.12415730337075404	1	1	78	142	0	3	C
H3_BC87_191109_LF_LIB_consensus_vsearch	3095	A	A	224	1	0.44%	2	1	93	93	0.4999999999999138	1	1	78	146	0	1	-T
H3_BC87_191109_LF_LIB_consensus_vsearch	3096	T	T	220	3	1.32%	2	2	93	93	0.12415730337075404	1	1	76	144	1	2	C
H3_BC87_191109_LF_LIB_consensus_vsearch	3097	G	*/-C	206	13	5.75%	2	2	93	93	1.016217291023551E-4	1	1	66	140	6	7	-C
H3_BC87_191109_LF_LIB_consensus_vsearch	3098	C	C	206	2	0.95%	2	1	93	93	0.2493975903616476	1	1	68	138	0	2	T
H3_BC87_191109_LF_LIB_consensus_vsearch	3099	C	C	219	3	1.35%	2	2	93	93	0.12415349887135622	1	1	72	147	2	1	T
H3_BC87_191109_LF_LIB_consensus_vsearch	3100	C	*/-G	177	25	10.92%	2	1	93	93	1.3511268759586835E-8	1	1	77	100	0	25	-G
H3_BC87_191109_LF_LIB_consensus_vsearch	3101	G	R	174	8	4.23%	2	1	93	93	0.003611166483247444	1	1	71	103	8	0	A
H3_BC87_191109_LF_LIB_consensus_vsearch	3102	G	G	206	4	1.87%	2	2	93	93	0.06160608506034647	1	1	77	129	3	1	+A
H3_BC87_191109_LF_LIB_consensus_vsearch	3103	G	G	227	1	0.44%	2	1	93	93	0.4999999999999138	1	1	79	148	1	0	-T
H3_BC87_191109_LF_LIB_consensus_vsearch	3104	T	*/-A	178	17	7.49%	2	2	93	93	5.300321947348008E-6	1	1	53	125	12	5	-A
H3_BC87_191109_LF_LIB_consensus_vsearch	3105	A	A	206	1	0.48%	2	1	93	93	0.5000000000001412	1	1	66	140	0	1	+GTA
H3_BC87_191109_LF_LIB_consensus_vsearch	3106	A	A	216	4	1.77%	2	2	93	93	0.061646763238677425	1	1	78	138	2	2	-G
H3_BC87_191109_LF_LIB_consensus_vsearch	3107	G	*/+A	209	14	6.25%	2	1	93	93	4.9452447660699634E-5	1	1	63	146	14	0	+A
H3_BC87_191109_LF_LIB_consensus_vsearch	3108	G	G	225	2	0.87%	2	1	93	93	0.24944812362040697	1	1	79	146	0	2	-TG
H3_BC87_191109_LF_LIB_consensus_vsearch	3109	T	T	214	4	1.76%	2	2	93	93	0.061638926495252586	1	1	76	138	2	2	+A
H3_BC87_191109_LF_LIB_consensus_vsearch	3110	G	G	216	3	1.33%	2	2	93	93	0.12414187643025615	1	1	78	138	1	2	-A
H3_BC87_191109_LF_LIB_consensus_vsearch	3111	A	A	215	3	1.36%	2	2	93	93	0.12413793103441495	1	1	77	138	1	2	G
H3_BC87_191109_LF_LIB_consensus_vsearch	3112	A	A	219	4	1.77%	2	1	93	93	0.06165825449566743	1	1	80	139	0	4	G
H3_BC87_191109_LF_LIB_consensus_vsearch	3113	G	G	223	3	1.32%	2	2	93	93	0.12416851441234596	1	1	77	146	2	1	-C
H3_BC87_191109_LF_LIB_consensus_vsearch	3114	C	C	220	3	1.33%	2	1	93	93	0.12415730337075404	1	1	77	143	0	3	T
H3_BC87_191109_LF_LIB_consensus_vsearch	3115	C	C	225	2	0.87%	2	1	93	93	0.24944812362040697	1	1	80	145	0	2	G
H3_BC87_191109_LF_LIB_consensus_vsearch	3116	A	R	218	9	3.93%	2	2	93	93	0.001801496644156972	1	1	75	143	5	4	G
H3_BC87_191109_LF_LIB_consensus_vsearch	3117	G	G	226	2	0.87%	2	1	93	93	0.24945054945064127	1	1	80	146	0	2	-T
H3_BC87_191109_LF_LIB_consensus_vsearch	3118	T	T	217	4	1.77%	2	2	93	93	0.0616506283607095	1	1	77	140	1	3	-G
H3_BC87_191109_LF_LIB_consensus_vsearch	3119	G	G	222	1	0.45%	2	1	93	93	0.4999999999999138	1	1	78	144	0	1	+C
H3_BC87_191109_LF_LIB_consensus_vsearch	3120	G	G	222	3	1.32%	2	2	93	93	0.12416481069040536	1	1	78	144	1	2	-A
H3_BC87_191109_LF_LIB_consensus_vsearch	3121	A	A	221	3	1.33%	2	2	93	93	0.12416107382546236	1	1	76	145	2	1	G
H3_BC87_191109_LF_LIB_consensus_vsearch	3122	A	A	226	1	0.44%	2	1	93	93	0.4999999999999138	1	1	79	147	1	0	C
H3_BC87_191109_LF_LIB_consensus_vsearch	3123	A	A	225	2	0.87%	2	2	93	93	0.24944812362040697	1	1	78	147	1	1	G
H3_BC87_191109_LF_LIB_consensus_vsearch	3124	C	C	223	2	0.88%	2	2	93	93	0.24944320712692292	1	1	76	147	1	1	-G
H3_BC87_191109_LF_LIB_consensus_vsearch	3125	G	G	222	2	0.89%	2	2	93	93	0.24944071588395061	1	1	76	146	1	1	A
H3_BC87_191109_LF_LIB_consensus_vsearch	3126	C	C	219	3	1.32%	2	2	93	93	0.12415349887135622	1	1	73	146	1	2	-T
H3_BC87_191109_LF_LIB_consensus_vsearch	3127	T	T	219	3	1.33%	2	1	93	93	0.12415349887135622	1	1	78	141	0	3	-G
H3_BC87_191109_LF_LIB_consensus_vsearch	3128	G	G	217	4	1.77%	2	2	93	93	0.0616506283607095	1	1	76	141	2	2	A
H3_BC87_191109_LF_LIB_consensus_vsearch	3129	G	G	220	3	1.31%	2	1	93	93	0.12415730337075404	1	1	79	141	0	3	-TGG
H3_BC87_191109_LF_LIB_consensus_vsearch	3130	T	T	214	3	1.34%	2	1	93	93	0.12413394919162732	1	1	78	136	0	3	+G
H3_BC87_191109_LF_LIB_consensus_vsearch	3131	G	G	219	1	0.45%	2	1	93	93	0.4999999999999138	1	1	78	141	0	1	+TG
H3_BC87_191109_LF_LIB_consensus_vsearch	3132	G	G	217	4	1.78%	2	2	93	93	0.0616506283607095	1	1	73	144	3	1	-A
H3_BC87_191109_LF_LIB_consensus_vsearch	3133	A	A	218	2	0.9%	2	2	93	93	0.24943052391823226	1	1	72	146	1	1	-G
H3_BC87_191109_LF_LIB_consensus_vsearch	3134	G	G	220	1	0.44%	2	1	93	93	0.4999999999999138	1	1	74	146	1	0	+A
H3_BC87_191109_LF_LIB_consensus_vsearch	3135	G	*/-C	219	8	3.49%	2	2	93	93	0.0036688013849068284	1	1	74	145	5	3	-C
H3_BC87_191109_LF_LIB_consensus_vsearch	3136	C	C	212	6	2.71%	2	1	93	93	0.015089936987088519	1	1	75	137	0	6	+T
H3_BC87_191109_LF_LIB_consensus_vsearch	3137	C	C	220	6	2.62%	2	1	93	93	0.015108791157819889	1	1	79	141	0	6	-TG
H3_BC87_191109_LF_LIB_consensus_vsearch	3138	T	Y	201	8	3.62%	2	1	93	93	0.003648677074969142	1	1	77	124	0	8	C
H3_BC87_191109_LF_LIB_consensus_vsearch	3139	G	G	207	3	1.4%	2	1	93	93	0.12410501193315207	1	1	72	135	3	0	+C
H3_BC87_191109_LF_LIB_consensus_vsearch	3140	T	Y	198	17	7.59%	2	2	93	93	5.490515091509853E-6	1	1	71	127	1	16	C
H3_BC87_191109_LF_LIB_consensus_vsearch	3141	A	A	214	6	2.67%	2	1	93	93	0.015094778470947015	1	1	70	144	6	0	G
H3_BC87_191109_LF_LIB_consensus_vsearch	3142	G	G	222	2	0.89%	2	2	93	93	0.24944071588395061	1	1	77	145	1	1	-CG
H3_BC87_191109_LF_LIB_consensus_vsearch	3143	C	C	215	3	1.33%	2	1	93	93	0.12413793103441495	1	1	71	144	3	0	-G
H3_BC87_191109_LF_LIB_consensus_vsearch	3144	G	G	216	4	1.79%	2	1	93	93	0.061646763238677425	1	1	71	145	4	0	-A
H3_BC87_191109_LF_LIB_consensus_vsearch	3145	A	A	218	1	0.44%	2	1	93	93	0.5000000000003686	1	1	74	144	0	1	+CA
H3_BC87_191109_LF_LIB_consensus_vsearch	3146	T	T	220	3	1.33%	2	1	93	93	0.12415730337075404	1	1	78	142	0	3	C
H3_BC87_191109_LF_LIB_consensus_vsearch	3147	T	T	216	6	2.64%	2	2	93	93	0.015099533131216845	1	1	74	142	5	1	+C
H3_BC87_191109_LF_LIB_consensus_vsearch	3148	C	C	218	2	0.89%	2	1	93	93	0.24943052391823226	1	1	76	142	2	0	+A
H3_BC87_191109_LF_LIB_consensus_vsearch	3149	T	T	216	6	2.64%	2	1	93	93	0.015099533131216845	1	1	77	139	0	6	+G
H3_BC87_191109_LF_LIB_consensus_vsearch	3150	G	G	228	1	0.44%	2	1	93	93	0.4999999999999138	1	1	80	148	0	1	+A
H3_BC87_191109_LF_LIB_consensus_vsearch	3151	A	A	226	3	1.31%	2	2	93	93	0.12417943107231426	1	1	78	148	2	1	G
H3_BC87_191109_LF_LIB_consensus_vsearch	3152	C	C	226	1	0.44%	2	1	93	93	0.4999999999999138	1	1	78	148	1	0	+AC
H3_BC87_191109_LF_LIB_consensus_vsearch	3153	G	*/-TG	194	33	14.41%	2	1	93	93	3.322335140775101E-11	1	1	78	116	0	33	-TG
H3_BC87_191109_LF_LIB_consensus_vsearch	3154	T	T	189	4	2.04%	2	2	93	93	0.061527245600347336	1	1	77	112	1	3	C
H3_BC87_191109_LF_LIB_consensus_vsearch	3155	G	G	187	2	1.03%	2	1	93	93	0.24933687002661706	1	1	74	113	2	0	+C
H3_BC87_191109_LF_LIB_consensus_vsearch	3156	C	*/-A	191	24	10.67%	2	2	93	93	3.0216532806748016E-8	1	1	72	119	1	23	-A
H3_BC87_191109_LF_LIB_consensus_vsearch	3157	A	A	201	2	0.99%	2	2	93	93	0.2493827160493913	1	1	77	124	1	1	G
H3_BC87_191109_LF_LIB_consensus_vsearch	3158	A	A	226	3	1.31%	2	1	93	93	0.12417943107231426	1	1	77	149	3	0	G
H3_BC87_191109_LF_LIB_consensus_vsearch	3159	A	A	226	1	0.44%	2	1	93	93	0.4999999999999138	1	1	80	146	0	1	+T
H3_BC87_191109_LF_LIB_consensus_vsearch	3160	T	Y	215	11	4.82%	2	1	93	93	4.3108474750487954E-4	1	1	79	136	0	11	C
H3_BC87_191109_LF_LIB_consensus_vsearch	3161	C	C	223	2	0.88%	2	1	93	93	0.24944320712692292	1	1	77	146	0	2	+G
H3_BC87_191109_LF_LIB_consensus_vsearch	3162	G	G	227	1	0.44%	2	1	93	93	0.4999999999999138	1	1	78	149	1	0	-A
H3_BC87_191109_LF_LIB_consensus_vsearch	3163	A	A	227	1	0.44%	2	1	93	93	0.4999999999999138	1	1	79	148	0	1	-T
H3_BC87_191109_LF_LIB_consensus_vsearch	3164	T	T	226	1	0.44%	2	1	93	93	0.4999999999999138	1	1	78	148	1	0	+C
H3_BC87_191109_LF_LIB_consensus_vsearch	3165	C	C	226	1	0.44%	2	1	93	93	0.4999999999999138	1	1	79	147	0	1	+AT
H3_BC87_191109_LF_LIB_consensus_vsearch	3166	G	*/-CG	221	7	3.06%	2	2	93	93	0.007455894130096957	1	1	77	144	3	4	-CG
H3_BC87_191109_LF_LIB_consensus_vsearch	3167	C	C	219	2	0.9%	2	1	93	93	0.24943310657599216	1	1	77	142	0	2	T
H3_BC87_191109_LF_LIB_consensus_vsearch	3168	G	G	219	1	0.45%	2	1	93	93	0.4999999999999138	1	1	75	144	1	0	+CG
H3_BC87_191109_LF_LIB_consensus_vsearch	3169	T	T	224	2	0.88%	2	1	93	93	0.24944567627499675	1	1	79	145	0	2	+A
H3_BC87_191109_LF_LIB_consensus_vsearch	3170	A	A	227	1	0.44%	2	1	93	93	0.4999999999999138	1	1	78	149	1	0	+GTA
H3_BC87_191109_LF_LIB_consensus_vsearch	3171	A	A	222	2	0.88%	2	2	93	93	0.24944071588395061	1	1	78	144	1	1	+C
H3_BC87_191109_LF_LIB_consensus_vsearch	3172	C	C	226	1	0.44%	2	1	93	93	0.4999999999999138	1	1	80	146	0	1	T
H3_BC87_191109_LF_LIB_consensus_vsearch	3173	C	C	225	1	0.44%	2	1	93	93	0.5000000000003686	1	1	78	147	0	1	+T
H3_BC87_191109_LF_LIB_consensus_vsearch	3174	T	*/-G	208	7	3.08%	2	2	93	93	0.007434537497224064	1	1	77	131	1	6	-G
H3_BC87_191109_LF_LIB_consensus_vsearch	3175	G	G	208	2	0.93%	2	2	93	93	0.24940334128888852	1	1	78	130	1	1	+CA
H3_BC87_191109_LF_LIB_consensus_vsearch	3176	G	G	214	3	1.35%	2	1	93	93	0.12413394919162732	1	1	76	138	3	0	+A
H3_BC87_191109_LF_LIB_consensus_vsearch	3177	G	G	225	2	0.87%	2	1	93	93	0.24944812362040697	1	1	80	145	0	2	A
H3_BC87_191109_LF_LIB_consensus_vsearch	3178	T	Y	199	21	9.21%	2	2	93	93	2.8898665118248697E-7	1	1	79	120	1	20	C
H3_BC87_191109_LF_LIB_consensus_vsearch	3179	A	A	213	3	1.33%	2	1	93	93	0.12412993039444345	1	1	77	136	0	3	-T
H3_BC87_191109_LF_LIB_consensus_vsearch	3180	T	T	214	3	1.36%	2	1	93	93	0.12413394919162732	1	1	75	139	3	0	+G
H3_BC87_191109_LF_LIB_consensus_vsearch	3181	A	*/-G	147	57	25.56%	2	2	93	93	7.257428954966233E-20	1	1	66	81	10	47	-G
H3_BC87_191109_LF_LIB_consensus_vsearch	3182	G	G	158	4	2.47%	2	2	93	93	0.06134081768466403	1	1	69	89	1	3	A
H3_BC87_191109_LF_LIB_consensus_vsearch	3183	G	G	217	1	0.46%	2	1	93	93	0.4999999999999138	1	1	80	137	0	1	+A
H3_BC87_191109_LF_LIB_consensus_vsearch	3184	G	G	217	2	0.9%	2	1	93	93	0.24942791762028085	1	1	77	140	2	0	+C
H3_BC87_191109_LF_LIB_consensus_vsearch	3185	G	G	221	2	0.87%	2	2	93	93	0.24943820224728358	1	1	78	143	1	1	-C
H3_BC87_191109_LF_LIB_consensus_vsearch	3186	C	C	215	3	1.34%	2	1	93	93	0.12413793103441495	1	1	76	139	0	3	T
H3_BC87_191109_LF_LIB_consensus_vsearch	3187	G	*/-A	190	17	7.59%	2	2	93	93	5.4182475667478395E-6	1	1	53	137	16	1	-A
H3_BC87_191109_LF_LIB_consensus_vsearch	3188	A	A	204	0	0%	2	0	93	0	1.0	1	0	61	143	0	0	
H3_BC87_191109_LF_LIB_consensus_vsearch	3189	A	*/+G	207	9	4.07%	2	1	93	93	0.001793948723227531	1	1	64	143	9	0	+G
H3_BC87_191109_LF_LIB_consensus_vsearch	3190	A	*/-G	205	11	4.82%	2	2	93	93	4.285433624407098E-4	1	1	59	146	10	1	-G
H3_BC87_191109_LF_LIB_consensus_vsearch	3191	G	G	203	4	1.9%	2	1	93	93	0.06159311429633927	1	1	58	145	4	0	+A
H3_BC87_191109_LF_LIB_consensus_vsearch	3192	A	*/+C	203	8	3.62%	2	1	93	93	0.0036510799339400076	1	1	59	144	8	0	+C
H3_BC87_191109_LF_LIB_consensus_vsearch	3193	C	C	214	4	1.79%	2	1	93	93	0.061638926495252586	1	1	75	139	0	4	+T
H3_BC87_191109_LF_LIB_consensus_vsearch	3194	C	C	218	6	2.62%	2	1	93	93	0.015104203282490625	1	1	79	139	0	6	-T
H3_BC87_191109_LF_LIB_consensus_vsearch	3195	T	Y	209	9	4.05%	2	2	93	93	0.0017953764342624938	1	1	79	130	1	8	C
H3_BC87_191109_LF_LIB_consensus_vsearch	3196	A	A	220	2	0.88%	2	1	93	93	0.2494356659142869	1	1	80	140	0	2	+T
H3_BC87_191109_LF_LIB_consensus_vsearch	3197	T	T	222	2	0.88%	2	2	93	93	0.24944071588395061	1	1	78	144	1	1	-C
H3_BC87_191109_LF_LIB_consensus_vsearch	3198	C	C	218	4	1.77%	2	1	93	93	0.061654458623218986	1	1	74	144	4	0	+A
H3_BC87_191109_LF_LIB_consensus_vsearch	3199	G	G	221	4	1.75%	2	2	93	93	0.06166574490670126	1	1	76	145	3	1	-A
H3_BC87_191109_LF_LIB_consensus_vsearch	3200	A	A	222	1	0.44%	2	1	93	93	0.4999999999999138	1	1	75	147	1	0	+G
H3_BC87_191109_LF_LIB_consensus_vsearch	3201	A	A	227	1	0.44%	2	1	93	93	0.4999999999999138	1	1	79	148	0	1	-C
H3_BC87_191109_LF_LIB_consensus_vsearch	3202	C	C	225	1	0.44%	2	1	93	93	0.5000000000003686	1	1	78	147	0	1	+T
H3_BC87_191109_LF_LIB_consensus_vsearch	3203	C	Y	215	11	4.8%	2	1	93	93	4.3108474750487954E-4	1	1	79	136	0	11	T
H3_BC87_191109_LF_LIB_consensus_vsearch	3204	G	*/+T	217	8	3.51%	2	1	93	93	0.0036667219549938834	1	1	79	138	0	8	+T
H3_BC87_191109_LF_LIB_consensus_vsearch	3205	T	T	218	6	2.62%	2	2	93	93	0.015104203282490625	1	1	76	142	1	5	C
H3_BC87_191109_LF_LIB_consensus_vsearch	3206	C	*/-T	217	11	4.82%	2	2	93	93	4.3156732794080477E-4	1	1	77	140	3	8	-T
H3_BC87_191109_LF_LIB_consensus_vsearch	3207	T	T	202	5	2.29%	2	2	93	93	0.030496102932097202	1	1	71	131	3	2	-A
H3_BC87_191109_LF_LIB_consensus_vsearch	3208	A	A	216	3	1.35%	2	2	93	93	0.12414187643025615	1	1	74	142	1	2	C
H3_BC87_191109_LF_LIB_consensus_vsearch	3209	A	R	215	8	3.52%	2	2	93	93	0.0036646057936482192	1	1	73	142	4	4	G
H3_BC87_191109_LF_LIB_consensus_vsearch	3210	T	T	219	2	0.88%	2	2	93	93	0.24943310657599216	1	1	74	145	1	1	+C
H3_BC87_191109_LF_LIB_consensus_vsearch	3211	G	G	225	0	0%	2	0	93	0	1.0	1	0	76	149	0	0	
H3_BC87_191109_LF_LIB_consensus_vsearch	3212	G	G	223	2	0.88%	2	1	93	93	0.24944320712692292	1	1	76	147	2	0	-C
H3_BC87_191109_LF_LIB_consensus_vsearch	3213	C	C	222	3	1.33%	2	2	93	93	0.12416481069040536	1	1	76	146	1	2	T
H3_BC87_191109_LF_LIB_consensus_vsearch	3214	T	T	227	1	0.44%	2	1	93	93	0.4999999999999138	1	1	79	148	0	1	-G
H3_BC87_191109_LF_LIB_consensus_vsearch	3215	G	G	224	1	0.44%	2	1	93	93	0.4999999999999138	1	1	77	147	1	0	+TG
H3_BC87_191109_LF_LIB_consensus_vsearch	3216	G	G	220	4	1.75%	2	2	93	93	0.061662016439223415	1	1	75	145	1	3	-T
H3_BC87_191109_LF_LIB_consensus_vsearch	3217	T	T	220	2	0.89%	2	1	93	93	0.2494356659142869	1	1	77	143	0	2	+C
H3_BC87_191109_LF_LIB_consensus_vsearch	3218	T	*/-C	214	9	3.93%	2	2	93	93	0.0017988361772468277	1	1	71	143	8	1	-C
H3_BC87_191109_LF_LIB_consensus_vsearch	3219	C	C	217	3	1.36%	2	1	93	93	0.12414578587710072	1	1	72	145	0	3	+T
H3_BC87_191109_LF_LIB_consensus_vsearch	3220	C	*/+T	151	69	30.13%	2	2	93	93	2.955542186613449E-24	1	1	63	88	14	55	+T
H3_BC87_191109_LF_LIB_consensus_vsearch	3221	C	*/-T	158	70	30.57%	2	2	93	93	1.5828906175371356E-24	1	1	65	93	15	55	-T
H3_BC87_191109_LF_LIB_consensus_vsearch	3222	T	*/+C	38	110	69.62%	2	2	93	93	9.7214825136366E-49	1	1	32	6	29	81	+C
H3_BC87_191109_LF_LIB_consensus_vsearch	3223	C	*/-G	193	10	4.42%	2	2	93	93	8.717782032788638E-4	1	1	64	129	9	1	-G
H3_BC87_191109_LF_LIB_consensus_vsearch	3224	G	G	206	6	2.79%	2	2	93	93	0.015074867144143777	1	1	61	145	3	3	-AA
H3_BC87_191109_LF_LIB_consensus_vsearch	3225	A	M	206	10	4.59%	2	2	93	93	8.778898007284436E-4	1	1	62	144	9	1	C
H3_BC87_191109_LF_LIB_consensus_vsearch	3226	A	A	221	1	0.45%	2	1	93	93	0.4999999999999138	1	1	75	146	1	0	+G
H3_BC87_191109_LF_LIB_consensus_vsearch	3227	G	G	220	3	1.31%	2	2	93	93	0.12415730337075404	1	1	75	145	1	2	+C
H3_BC87_191109_LF_LIB_consensus_vsearch	3228	T	T	222	5	2.2%	2	1	93	93	0.030562448911634975	1	1	79	143	0	5	C
H3_BC87_191109_LF_LIB_consensus_vsearch	3229	T	T	227	2	0.87%	2	1	93	93	0.24945295404843976	1	1	80	147	0	2	C
H3_BC87_191109_LF_LIB_consensus_vsearch	3230	T	*/-C	118	70	30.57%	2	2	93	93	2.992527446359349E-25	1	1	59	59	18	52	-C
H3_BC87_191109_LF_LIB_consensus_vsearch	3231	C	C	138	1	0.72%	2	1	93	93	0.5000000000001412	1	1	62	76	0	1	T
H3_BC87_191109_LF_LIB_consensus_vsearch	3232	C	C	202	3	1.44%	2	1	93	93	0.12408312958435573	1	1	78	124	0	3	+T
H3_BC87_191109_LF_LIB_consensus_vsearch	3233	C	*/-T	203	7	3.27%	2	2	93	93	0.007425626339083171	1	1	79	124	1	6	-T
H3_BC87_191109_LF_LIB_consensus_vsearch	3234	T	T	200	3	1.45%	2	1	93	93	0.12407407407409911	1	1	76	124	3	0	+C
H3_BC87_191109_LF_LIB_consensus_vsearch	3235	C	C	224	2	0.88%	2	2	93	93	0.24944567627499675	1	1	79	145	1	1	-A
H3_BC87_191109_LF_LIB_consensus_vsearch	3236	A	*/-G	197	24	10.57%	2	1	93	93	3.081154251806747E-8	1	1	76	121	0	24	-G
H3_BC87_191109_LF_LIB_consensus_vsearch	3237	G	G	203	2	0.98%	2	1	93	93	0.2493887530563227	1	1	80	123	0	2	+T
H3_BC87_191109_LF_LIB_consensus_vsearch	3238	G	G	228	1	0.44%	2	1	93	93	0.4999999999999138	1	1	80	148	0	1	-A
H3_BC87_191109_LF_LIB_consensus_vsearch	3239	A	A	224	1	0.44%	2	1	93	93	0.4999999999999138	1	1	78	146	1	0	-TAG
H3_BC87_191109_LF_LIB_consensus_vsearch	3240	T	T	224	2	0.88%	2	1	93	93	0.24944567627499675	1	1	79	145	0	2	C
H3_BC87_191109_LF_LIB_consensus_vsearch	3241	A	A	221	3	1.32%	2	2	93	93	0.12416107382546236	1	1	78	143	1	2	-G
H3_BC87_191109_LF_LIB_consensus_vsearch	3242	G	G	219	1	0.45%	2	1	93	93	0.4999999999999138	1	1	77	142	0	1	+T
H3_BC87_191109_LF_LIB_consensus_vsearch	3243	C	C	220	3	1.33%	2	2	93	93	0.12415730337075404	1	1	78	142	1	2	T
H3_BC87_191109_LF_LIB_consensus_vsearch	3244	T	T	214	5	2.2%	2	1	93	93	0.030537362897492103	1	1	78	136	0	5	+GG
H3_BC87_191109_LF_LIB_consensus_vsearch	3245	G	G	214	5	2.19%	2	1	93	93	0.030537362897492103	1	1	80	134	0	5	-CG
H3_BC87_191109_LF_LIB_consensus_vsearch	3246	C	S	188	20	9.09%	2	1	93	93	5.904806231127145E-7	1	1	80	108	0	20	G
H3_BC87_191109_LF_LIB_consensus_vsearch	3247	G	G	212	5	2.27%	2	1	93	93	0.030530802741347875	1	1	78	134	0	5	-T
H3_BC87_191109_LF_LIB_consensus_vsearch	3248	T	*/+GT	200	14	6.36%	2	1	93	93	4.9002433333818565E-5	1	1	80	120	0	14	+GT
H3_BC87_191109_LF_LIB_consensus_vsearch	3249	T	*/-C	203	21	9.17%	2	2	93	93	2.917097565439073E-7	1	1	69	134	10	11	-C
H3_BC87_191109_LF_LIB_consensus_vsearch	3250	C	C	199	4	1.94%	2	2	93	93	0.061575222865550984	1	1	67	132	2	2	T
H3_BC87_191109_LF_LIB_consensus_vsearch	3251	C	Y	205	12	5.29%	2	1	93	93	2.0882828978061456E-4	1	1	77	128	0	12	T
H3_BC87_191109_LF_LIB_consensus_vsearch	3252	T	T	213	3	1.35%	2	1	93	93	0.12412993039444345	1	1	74	139	0	3	G
H3_BC87_191109_LF_LIB_consensus_vsearch	3253	A	A	217	5	2.23%	2	2	93	93	0.03054698177238809	1	1	75	142	2	3	G
H3_BC87_191109_LF_LIB_consensus_vsearch	3254	T	T	217	4	1.78%	2	2	93	93	0.0616506283607095	1	1	73	144	2	2	C
H3_BC87_191109_LF_LIB_consensus_vsearch	3255	T	T	213	5	2.22%	2	2	93	93	0.030534097847134272	1	1	75	138	1	4	+G
H3_BC87_191109_LF_LIB_consensus_vsearch	3256	G	G	225	2	0.88%	2	2	93	93	0.24944812362040697	1	1	77	148	1	1	-A
H3_BC87_191109_LF_LIB_consensus_vsearch	3257	A	*/-G	209	13	5.73%	2	1	93	93	1.0188120004185222E-4	1	1	62	147	13	0	-G
H3_BC87_191109_LF_LIB_consensus_vsearch	3258	G	G	204	6	2.78%	2	2	93	93	0.015069653452839263	1	1	59	145	5	1	+A
H3_BC87_191109_LF_LIB_consensus_vsearch	3259	A	A	224	0	0%	2	0	93	0	1.0	1	0	77	147	0	0	
H3_BC87_191109_LF_LIB_consensus_vsearch	3260	G	G	222	2	0.89%	2	1	93	93	0.24944071588395061	1	1	77	145	0	2	+AG
H3_BC87_191109_LF_LIB_consensus_vsearch	3261	T	T	229	0	0%	2	0	93	0	1.0	1	0	80	149	0	0	
H3_BC87_191109_LF_LIB_consensus_vsearch	3262	C	C	227	1	0.44%	2	1	93	93	0.4999999999999138	1	1	79	148	0	1	+A
H3_BC87_191109_LF_LIB_consensus_vsearch	3263	A	A	217	4	1.75%	2	2	93	93	0.0616506283607095	1	1	76	141	3	1	G
H3_BC87_191109_LF_LIB_consensus_vsearch	3264	G	G	225	1	0.44%	2	1	93	93	0.5000000000003686	1	1	80	145	0	1	+CT
H3_BC87_191109_LF_LIB_consensus_vsearch	3265	T	T	224	3	1.31%	2	1	93	93	0.12417218543044797	1	1	79	145	0	3	C
H3_BC87_191109_LF_LIB_consensus_vsearch	3266	T	T	222	3	1.31%	2	1	93	93	0.12416481069040536	1	1	80	142	0	3	A
H3_BC87_191109_LF_LIB_consensus_vsearch	3267	G	G	226	2	0.87%	2	1	93	93	0.24945054945064127	1	1	80	146	0	2	A
H3_BC87_191109_LF_LIB_consensus_vsearch	3268	C	C	224	3	1.31%	2	1	93	93	0.12417218543044797	1	1	79	145	0	3	T
H3_BC87_191109_LF_LIB_consensus_vsearch	3269	A	A	223	3	1.32%	2	2	93	93	0.12416851441234596	1	1	79	144	1	2	G
H3_BC87_191109_LF_LIB_consensus_vsearch	3270	T	T	224	4	1.75%	2	2	93	93	0.06167673386217682	1	1	79	145	1	3	C
H3_BC87_191109_LF_LIB_consensus_vsearch	3271	T	T	224	4	1.75%	2	1	93	93	0.06167673386217682	1	1	80	144	0	4	+G
H3_BC87_191109_LF_LIB_consensus_vsearch	3272	G	G	227	1	0.44%	2	1	93	93	0.4999999999999138	1	1	78	149	1	0	+C
H3_BC87_191109_LF_LIB_consensus_vsearch	3273	C	C	218	5	2.19%	2	1	93	93	0.030550130621104243	1	1	77	141	0	5	T
H3_BC87_191109_LF_LIB_consensus_vsearch	3274	G	G	221	4	1.78%	2	1	93	93	0.06166574490670126	1	1	74	147	4	0	A
H3_BC87_191109_LF_LIB_consensus_vsearch	3275	G	G	226	2	0.88%	2	2	93	93	0.24945054945064127	1	1	79	147	1	1	+T
H3_BC87_191109_LF_LIB_consensus_vsearch	3276	T	T	215	5	2.19%	2	2	93	93	0.03054059830172664	1	1	75	140	1	4	C
H3_BC87_191109_LF_LIB_consensus_vsearch	3277	A	A	223	2	0.88%	2	1	93	93	0.24944320712692292	1	1	79	144	0	2	-G
H3_BC87_191109_LF_LIB_consensus_vsearch	3278	G	G	222	4	1.77%	2	1	93	93	0.061669440342892484	1	1	76	146	4	0	-A
H3_BC87_191109_LF_LIB_consensus_vsearch	3279	A	A	219	3	1.34%	2	1	93	93	0.12415349887135622	1	1	72	147	3	0	+G
H3_BC87_191109_LF_LIB_consensus_vsearch	3280	G	G	226	1	0.44%	2	1	93	93	0.4999999999999138	1	1	80	146	0	1	+C
H3_BC87_191109_LF_LIB_consensus_vsearch	3281	C	C	224	3	1.31%	2	1	93	93	0.12417218543044797	1	1	77	147	3	0	+A
H3_BC87_191109_LF_LIB_consensus_vsearch	3282	G	G	219	5	2.18%	2	2	93	93	0.030553251388732716	1	1	75	144	3	2	-A
H3_BC87_191109_LF_LIB_consensus_vsearch	3283	A	A	218	4	1.79%	2	2	93	93	0.061654458623218986	1	1	74	144	2	2	G
H3_BC87_191109_LF_LIB_consensus_vsearch	3284	A	A	223	3	1.32%	2	1	93	93	0.12416851441234596	1	1	78	145	0	3	-T
H3_BC87_191109_LF_LIB_consensus_vsearch	3285	T	T	221	3	1.33%	2	2	93	93	0.12416107382546236	1	1	78	143	2	1	C
H3_BC87_191109_LF_LIB_consensus_vsearch	3286	G	G	228	1	0.44%	2	1	93	93	0.4999999999999138	1	1	79	149	1	0	-A
H3_BC87_191109_LF_LIB_consensus_vsearch	3287	A	A	223	2	0.88%	2	1	93	93	0.24944320712692292	1	1	79	144	0	2	G
H3_BC87_191109_LF_LIB_consensus_vsearch	3288	T	T	226	1	0.44%	2	1	93	93	0.4999999999999138	1	1	79	147	1	0	C
H3_BC87_191109_LF_LIB_consensus_vsearch	3289	T	T	224	3	1.32%	2	1	93	93	0.12417218543044797	1	1	76	148	3	0	+A
H3_BC87_191109_LF_LIB_consensus_vsearch	3290	A	*/-G	190	25	10.96%	2	1	93	93	1.4215166911555927E-8	1	1	79	111	0	25	-G
H3_BC87_191109_LF_LIB_consensus_vsearch	3291	G	G	197	2	0.99%	2	2	93	93	0.2493702770781863	1	1	77	120	1	1	A
H3_BC87_191109_LF_LIB_consensus_vsearch	3292	G	G	222	2	0.88%	2	1	93	93	0.24944071588395061	1	1	77	145	0	2	-T
H3_BC87_191109_LF_LIB_consensus_vsearch	3293	T	T	222	1	0.44%	2	1	93	93	0.4999999999999138	1	1	78	144	1	0	+AT
H3_BC87_191109_LF_LIB_consensus_vsearch	3294	G	G	225	2	0.88%	2	1	93	93	0.24944812362040697	1	1	80	145	0	2	+C
H3_BC87_191109_LF_LIB_consensus_vsearch	3295	T	T	220	5	2.18%	2	2	93	93	0.03055634444922604	1	1	78	142	1	4	C
H3_BC87_191109_LF_LIB_consensus_vsearch	3296	C	*/-T	215	7	3.08%	2	1	93	93	0.007446345105805389	1	1	79	136	0	7	-T
H3_BC87_191109_LF_LIB_consensus_vsearch	3297	T	*/+C	204	9	4.07%	2	1	93	93	0.0017917580621936403	1	1	68	136	9	0	+C
H3_BC87_191109_LF_LIB_consensus_vsearch	3298	C	*/-G	195	17	7.56%	2	2	93	93	5.4639692209021505E-6	1	1	71	124	4	13	-G
H3_BC87_191109_LF_LIB_consensus_vsearch	3299	G	R	193	10	4.9%	2	1	93	93	8.717782032788638E-4	1	1	65	128	10	0	A
H3_BC87_191109_LF_LIB_consensus_vsearch	3300	G	G	218	3	1.36%	2	2	93	93	0.12414965986396012	1	1	79	139	1	2	A
H3_BC87_191109_LF_LIB_consensus_vsearch	3301	G	R	219	8	3.51%	2	2	93	93	0.0036688013849068284	1	1	76	143	3	5	A
H3_BC87_191109_LF_LIB_consensus_vsearch	3302	G	G	223	2	0.87%	2	1	93	93	0.24944320712692292	1	1	77	146	0	2	A
H3_BC87_191109_LF_LIB_consensus_vsearch	3303	C	C	223	2	0.88%	2	1	93	93	0.24944320712692292	1	1	79	144	0	2	T
H3_BC87_191109_LF_LIB_consensus_vsearch	3304	C	C	222	4	1.76%	2	1	93	93	0.061669440342892484	1	1	79	143	0	4	T
H3_BC87_191109_LF_LIB_consensus_vsearch	3305	A	A	222	3	1.32%	2	1	93	93	0.12416481069040536	1	1	79	143	0	3	+C
H3_BC87_191109_LF_LIB_consensus_vsearch	3306	T	T	219	4	1.76%	2	2	93	93	0.06165825449566743	1	1	77	142	2	2	-C
H3_BC87_191109_LF_LIB_consensus_vsearch	3307	C	C	217	2	0.89%	2	1	93	93	0.24942791762028085	1	1	73	144	0	2	-A
H3_BC87_191109_LF_LIB_consensus_vsearch	3308	A	A	215	4	1.79%	2	2	93	93	0.06164286277914926	1	1	71	144	3	1	G
H3_BC87_191109_LF_LIB_consensus_vsearch	3309	T	T	214	4	1.79%	2	1	93	93	0.061638926495252586	1	1	74	140	0	4	-G
H3_BC87_191109_LF_LIB_consensus_vsearch	3310	G	G	219	1	0.45%	2	1	93	93	0.4999999999999138	1	1	77	142	0	1	+C
H3_BC87_191109_LF_LIB_consensus_vsearch	3311	G	G	214	4	1.75%	2	1	93	93	0.061638926495252586	1	1	75	139	0	4	A
H3_BC87_191109_LF_LIB_consensus_vsearch	3312	C	C	220	2	0.88%	2	2	93	93	0.2494356659142869	1	1	77	143	1	1	+T
H3_BC87_191109_LF_LIB_consensus_vsearch	3313	C	C	217	6	2.63%	2	1	93	93	0.015101878629034914	1	1	77	140	0	6	-T
H3_BC87_191109_LF_LIB_consensus_vsearch	3314	T	T	213	3	1.35%	2	1	93	93	0.12412993039444345	1	1	76	137	0	3	-C
H3_BC87_191109_LF_LIB_consensus_vsearch	3315	C	C	218	5	2.21%	2	1	93	93	0.030550130621104243	1	1	78	140	0	5	-G
H3_BC87_191109_LF_LIB_consensus_vsearch	3316	G	G	221	2	0.89%	2	1	93	93	0.24943820224728358	1	1	77	144	2	0	A
H3_BC87_191109_LF_LIB_consensus_vsearch	3317	G	G	222	3	1.31%	2	1	93	93	0.12416481069040536	1	1	79	143	0	3	+C
H3_BC87_191109_LF_LIB_consensus_vsearch	3318	C	C	223	3	1.31%	2	2	93	93	0.12416851441234596	1	1	77	146	2	1	-T
H3_BC87_191109_LF_LIB_consensus_vsearch	3319	T	T	217	3	1.33%	2	1	93	93	0.12414578587710072	1	1	75	142	0	3	-C
H3_BC87_191109_LF_LIB_consensus_vsearch	3320	C	C	223	1	0.44%	2	1	93	93	0.5000000000003686	1	1	78	145	1	0	+A
H3_BC87_191109_LF_LIB_consensus_vsearch	3321	A	A	217	2	0.88%	2	1	93	93	0.24942791762028085	1	1	76	141	0	2	+CT
H3_BC87_191109_LF_LIB_consensus_vsearch	3322	T	T	223	2	0.88%	2	2	93	93	0.24944320712692292	1	1	79	144	1	1	C
H3_BC87_191109_LF_LIB_consensus_vsearch	3323	T	T	224	3	1.32%	2	1	93	93	0.12417218543044797	1	1	80	144	0	3	C
H3_BC87_191109_LF_LIB_consensus_vsearch	3324	C	C	226	2	0.87%	2	1	93	93	0.24945054945064127	1	1	79	147	0	2	-TC
H3_BC87_191109_LF_LIB_consensus_vsearch	3325	T	T	221	2	0.88%	2	2	93	93	0.24943820224728358	1	1	77	144	1	1	A
H3_BC87_191109_LF_LIB_consensus_vsearch	3326	C	*/-A	213	7	3.1%	2	1	93	93	0.007443047448823043	1	1	80	133	0	7	-A
H3_BC87_191109_LF_LIB_consensus_vsearch	3327	A	A	218	2	0.9%	2	1	93	93	0.24943052391823226	1	1	80	138	0	2	G
H3_BC87_191109_LF_LIB_consensus_vsearch	3328	A	A	228	0	0%	2	0	93	0	1.0	1	0	80	148	0	0	
H3_BC87_191109_LF_LIB_consensus_vsearch	3329	A	A	222	5	2.19%	2	1	93	93	0.030562448911634975	1	1	80	142	0	5	C
H3_BC87_191109_LF_LIB_consensus_vsearch	3330	C	*/-T	211	17	7.46%	2	1	93	93	5.598471848662059E-6	1	1	80	131	0	17	-T
H3_BC87_191109_LF_LIB_consensus_vsearch	3331	T	*/-C	196	9	4.27%	2	2	93	93	0.001785610469261078	1	1	73	123	6	3	-C
H3_BC87_191109_LF_LIB_consensus_vsearch	3332	C	C	215	0	0%	2	0	93	0	1.0	1	0	74	141	0	0	
H3_BC87_191109_LF_LIB_consensus_vsearch	3333	C	Y	207	8	3.57%	2	1	93	93	0.003655753662936563	1	1	74	133	0	8	T
H3_BC87_191109_LF_LIB_consensus_vsearch	3334	G	G	222	3	1.33%	2	2	93	93	0.12416481069040536	1	1	74	148	2	1	-A
H3_BC87_191109_LF_LIB_consensus_vsearch	3335	A	A	221	2	0.9%	2	1	93	93	0.24943820224728358	1	1	73	148	2	0	G
H3_BC87_191109_LF_LIB_consensus_vsearch	3336	A	A	224	1	0.44%	2	1	93	93	0.4999999999999138	1	1	77	147	1	0	+GAA
H3_BC87_191109_LF_LIB_consensus_vsearch	3337	T	T	217	6	2.64%	2	1	93	93	0.015101878629034914	1	1	74	143	6	0	G
H3_BC87_191109_LF_LIB_consensus_vsearch	3338	T	T	225	1	0.44%	2	1	93	93	0.5000000000003686	1	1	80	145	0	1	+A
H3_BC87_191109_LF_LIB_consensus_vsearch	3339	G	G	225	3	1.32%	2	2	93	93	0.12417582417582212	1	1	79	146	1	2	A
H3_BC87_191109_LF_LIB_consensus_vsearch	3340	C	C	226	2	0.87%	2	1	93	93	0.24945054945064127	1	1	80	146	0	2	-A
H3_BC87_191109_LF_LIB_consensus_vsearch	3341	A	R	217	7	3.08%	2	2	93	93	0.007449584424390529	1	1	76	141	3	4	G
H3_BC87_191109_LF_LIB_consensus_vsearch	3342	T	T	218	5	2.2%	2	1	93	93	0.030550130621104243	1	1	78	140	0	5	C
H3_BC87_191109_LF_LIB_consensus_vsearch	3343	G	G	216	3	1.32%	2	1	93	93	0.12414187643025615	1	1	74	142	0	3	-CG
H3_BC87_191109_LF_LIB_consensus_vsearch	3344	C	C	216	6	2.68%	2	1	93	93	0.015099533131216845	1	1	77	139	0	6	T
H3_BC87_191109_LF_LIB_consensus_vsearch	3345	G	G	217	4	1.78%	2	1	93	93	0.0616506283607095	1	1	75	142	4	0	-A
H3_BC87_191109_LF_LIB_consensus_vsearch	3346	A	A	220	2	0.89%	2	1	93	93	0.2494356659142869	1	1	75	145	0	2	G
H3_BC87_191109_LF_LIB_consensus_vsearch	3347	T	*/-C	192	34	14.91%	2	2	93	93	1.5211963238738746E-11	1	1	47	145	31	3	-C
H3_BC87_191109_LF_LIB_consensus_vsearch	3348	C	C	193	0	0%	2	0	93	0	1.0	1	0	47	146	0	0	
H3_BC87_191109_LF_LIB_consensus_vsearch	3349	C	C	226	1	0.44%	2	1	93	93	0.4999999999999138	1	1	78	148	0	1	G
H3_BC87_191109_LF_LIB_consensus_vsearch	3350	C	C	220	6	2.62%	2	1	93	93	0.015108791157819889	1	1	78	142	0	6	T
H3_BC87_191109_LF_LIB_consensus_vsearch	3351	G	G	225	2	0.88%	2	1	93	93	0.24944812362040697	1	1	78	147	0	2	+C
H3_BC87_191109_LF_LIB_consensus_vsearch	3352	C	C	226	1	0.44%	2	1	93	93	0.4999999999999138	1	1	77	149	1	0	+T
H3_BC87_191109_LF_LIB_consensus_vsearch	3353	T	T	223	3	1.31%	2	1	93	93	0.12416851441234596	1	1	79	144	0	3	C
H3_BC87_191109_LF_LIB_consensus_vsearch	3354	G	*/-CTG	216	7	3.07%	2	2	93	93	0.007447971960236055	1	1	75	141	1	6	-CTG
H3_BC87_191109_LF_LIB_consensus_vsearch	3355	C	Y	204	9	4.11%	2	1	93	93	0.0017917580621936403	1	1	76	128	0	9	T
H3_BC87_191109_LF_LIB_consensus_vsearch	3356	T	T	206	2	0.93%	2	1	93	93	0.2493975903616476	1	1	75	131	2	0	+G
H3_BC87_191109_LF_LIB_consensus_vsearch	3357	G	G	209	4	1.83%	2	1	93	93	0.061618690029214815	1	1	76	133	0	4	C
H3_BC87_191109_LF_LIB_consensus_vsearch	3358	T	T	214	6	2.65%	2	1	93	93	0.015094778470947015	1	1	77	137	0	6	A
H3_BC87_191109_LF_LIB_consensus_vsearch	3359	G	G	223	1	0.44%	2	1	93	93	0.5000000000003686	1	1	76	147	1	0	+A
H3_BC87_191109_LF_LIB_consensus_vsearch	3360	A	*/-C	215	7	3.06%	2	2	93	93	0.007446345105805389	1	1	71	144	4	3	-C
H3_BC87_191109_LF_LIB_consensus_vsearch	3361	C	C	221	1	0.45%	2	1	93	93	0.4999999999999138	1	1	75	146	1	0	G
H3_BC87_191109_LF_LIB_consensus_vsearch	3362	C	*/+T	205	11	4.8%	2	2	93	93	4.285433624407098E-4	1	1	75	130	1	10	+T
H3_BC87_191109_LF_LIB_consensus_vsearch	3363	T	T	216	1	0.46%	2	1	93	93	0.4999999999999138	1	1	76	140	1	0	+GC
H3_BC87_191109_LF_LIB_consensus_vsearch	3364	T	T	220	3	1.32%	2	1	93	93	0.12415730337075404	1	1	76	144	0	3	C
H3_BC87_191109_LF_LIB_consensus_vsearch	3365	G	G	216	6	2.64%	2	2	93	93	0.015099533131216845	1	1	72	144	5	1	-TG
H3_BC87_191109_LF_LIB_consensus_vsearch	3366	T	T	210	4	1.8%	2	2	93	93	0.06162281305968737	1	1	70	140	1	3	A
H3_BC87_191109_LF_LIB_consensus_vsearch	3367	G	G	219	2	0.9%	2	1	93	93	0.24943310657599216	1	1	73	146	2	0	A
H3_BC87_191109_LF_LIB_consensus_vsearch	3368	G	G	225	3	1.31%	2	1	93	93	0.12417582417582212	1	1	79	146	0	3	A
H3_BC87_191109_LF_LIB_consensus_vsearch	3369	C	C	224	3	1.31%	2	1	93	93	0.12417218543044797	1	1	77	147	3	0	-AC
H3_BC87_191109_LF_LIB_consensus_vsearch	3370	A	A	222	3	1.33%	2	1	93	93	0.12416481069040536	1	1	73	149	3	0	G
H3_BC87_191109_LF_LIB_consensus_vsearch	3371	C	C	223	2	0.88%	2	2	93	93	0.24944320712692292	1	1	75	148	1	1	T
H3_BC87_191109_LF_LIB_consensus_vsearch	3372	G	G	223	3	1.31%	2	2	93	93	0.12416851441234596	1	1	77	146	1	2	-C
H3_BC87_191109_LF_LIB_consensus_vsearch	3373	C	C	225	0	0%	2	0	93	0	1.0	1	0	78	147	0	0	
H3_BC87_191109_LF_LIB_consensus_vsearch	3374	C	C	216	5	2.19%	2	2	93	93	0.030543804461782422	1	1	76	140	1	4	-G
H3_BC87_191109_LF_LIB_consensus_vsearch	3375	G	G	213	2	0.9%	2	1	93	93	0.249417249417318	1	1	73	140	2	0	+AA
H3_BC87_191109_LF_LIB_consensus_vsearch	3376	G	G	222	2	0.88%	2	2	93	93	0.24944071588395061	1	1	76	146	1	1	A
H3_BC87_191109_LF_LIB_consensus_vsearch	3377	G	G	221	3	1.31%	2	1	93	93	0.12416107382546236	1	1	74	147	3	0	+C
H3_BC87_191109_LF_LIB_consensus_vsearch	3378	C	*/+A	172	42	18.42%	2	1	93	93	2.440076430473919E-14	1	1	75	97	0	42	+A
H3_BC87_191109_LF_LIB_consensus_vsearch	3379	A	A	219	1	0.45%	2	1	93	93	0.4999999999999138	1	1	76	143	1	0	+G
H3_BC87_191109_LF_LIB_consensus_vsearch	3380	A	A	226	2	0.87%	2	1	93	93	0.24945054945064127	1	1	78	148	2	0	G
H3_BC87_191109_LF_LIB_consensus_vsearch	3381	A	A	222	4	1.75%	2	2	93	93	0.061669440342892484	1	1	77	145	1	3	-T
H3_BC87_191109_LF_LIB_consensus_vsearch	3382	T	T	217	3	1.33%	2	2	93	93	0.12414578587710072	1	1	77	140	1	2	C
H3_BC87_191109_LF_LIB_consensus_vsearch	3383	G	G	223	2	0.88%	2	1	93	93	0.24944320712692292	1	1	77	146	0	2	C
H3_BC87_191109_LF_LIB_consensus_vsearch	3384	A	A	221	2	0.88%	2	2	93	93	0.24943820224728358	1	1	75	146	1	1	G
H3_BC87_191109_LF_LIB_consensus_vsearch	3385	C	C	224	2	0.88%	2	1	93	93	0.24944567627499675	1	1	77	147	2	0	+A
H3_BC87_191109_LF_LIB_consensus_vsearch	3386	A	*/-G	206	13	5.73%	2	1	93	93	1.016217291023551E-4	1	1	77	129	0	13	-G
H3_BC87_191109_LF_LIB_consensus_vsearch	3387	G	G	209	2	0.93%	2	1	93	93	0.24940617577189375	1	1	79	130	0	2	+T
H3_BC87_191109_LF_LIB_consensus_vsearch	3388	G	G	226	3	1.31%	2	2	93	93	0.12417943107231426	1	1	79	147	1	2	-A
H3_BC87_191109_LF_LIB_consensus_vsearch	3389	A	A	226	0	0%	2	0	93	0	1.0	1	0	79	147	0	0	
H3_BC87_191109_LF_LIB_consensus_vsearch	3390	C	C	221	3	1.31%	2	1	93	93	0.12416107382546236	1	1	76	145	3	0	+A
H3_BC87_191109_LF_LIB_consensus_vsearch	3391	G	G	223	3	1.31%	2	1	93	93	0.12416851441234596	1	1	75	148	3	0	C
H3_BC87_191109_LF_LIB_consensus_vsearch	3392	C	*/-AA	203	8	3.51%	2	1	93	93	0.0036510799339400076	1	1	71	132	0	8	-AA
H3_BC87_191109_LF_LIB_consensus_vsearch	3393	A	A	211	1	0.47%	2	1	93	93	0.5000000000001412	1	1	75	136	1	0	G
H3_BC87_191109_LF_LIB_consensus_vsearch	3394	A	A	215	1	0.46%	2	1	93	93	0.4999999999999138	1	1	79	136	0	1	+G
H3_BC87_191109_LF_LIB_consensus_vsearch	3395	G	*/-TG	204	15	6.67%	2	1	93	93	2.3815125527116474E-5	1	1	79	125	0	15	-TG
H3_BC87_191109_LF_LIB_consensus_vsearch	3396	T	*/-G	176	14	6.76%	2	2	93	93	4.7612708551473615E-5	1	1	78	98	1	13	-G
H3_BC87_191109_LF_LIB_consensus_vsearch	3397	G	G	197	1	0.5%	2	1	93	93	0.5000000000001412	1	1	78	119	1	0	+CA
H3_BC87_191109_LF_LIB_consensus_vsearch	3398	G	G	223	3	1.31%	2	1	93	93	0.12416851441234596	1	1	74	149	3	0	+A
H3_BC87_191109_LF_LIB_consensus_vsearch	3399	G	G	228	1	0.44%	2	1	93	93	0.4999999999999138	1	1	80	148	0	1	A
H3_BC87_191109_LF_LIB_consensus_vsearch	3400	C	C	218	6	2.62%	2	1	93	93	0.015104203282490625	1	1	77	141	0	6	T
H3_BC87_191109_LF_LIB_consensus_vsearch	3401	T	T	222	2	0.88%	2	2	93	93	0.24944071588395061	1	1	77	145	1	1	C
H3_BC87_191109_LF_LIB_consensus_vsearch	3402	G	G	225	1	0.44%	2	1	93	93	0.5000000000003686	1	1	78	147	0	1	+A
H3_BC87_191109_LF_LIB_consensus_vsearch	3403	G	*/+T	84	129	56.33%	2	2	93	93	5.1176582680912674E-52	1	1	25	59	47	82	+T
H3_BC87_191109_LF_LIB_consensus_vsearch	3404	T	T	226	0	0%	2	0	93	0	1.0	1	0	79	147	0	0	
H3_BC87_191109_LF_LIB_consensus_vsearch	3405	T	T	226	1	0.44%	2	1	93	93	0.4999999999999138	1	1	78	148	1	0	+G
H3_BC87_191109_LF_LIB_consensus_vsearch	3406	T	T	215	6	2.62%	2	1	93	93	0.01509716650743782	1	1	77	138	0	6	-G
H3_BC87_191109_LF_LIB_consensus_vsearch	3407	G	K	174	38	17.19%	2	1	93	93	5.884165440442083E-13	1	1	76	98	0	38	T
H3_BC87_191109_LF_LIB_consensus_vsearch	3408	G	G	219	6	2.64%	2	1	93	93	0.015106507368173285	1	1	80	139	0	6	-T
H3_BC87_191109_LF_LIB_consensus_vsearch	3409	T	Y	175	31	13.9%	2	1	93	93	1.3745359226014947E-10	1	1	78	97	0	31	C
H3_BC87_191109_LF_LIB_consensus_vsearch	3410	A	A	211	4	1.83%	2	1	93	93	0.06162689769249	1	1	78	133	0	4	C
H3_BC87_191109_LF_LIB_consensus_vsearch	3411	A	A	211	4	1.76%	2	1	93	93	0.06162689769249	1	1	79	132	0	4	+G
H3_BC87_191109_LF_LIB_consensus_vsearch	3412	G	G	211	5	2.22%	2	1	93	93	0.030527477163211258	1	1	73	138	5	0	A
H3_BC87_191109_LF_LIB_consensus_vsearch	3413	C	C	208	6	2.7%	2	1	93	93	0.015079983859610983	1	1	75	133	0	6	G
H3_BC87_191109_LF_LIB_consensus_vsearch	3414	A	A	213	5	2.23%	2	1	93	93	0.030534097847134272	1	1	77	136	0	5	T
H3_BC87_191109_LF_LIB_consensus_vsearch	3415	G	G	223	2	0.87%	2	1	93	93	0.24944320712692292	1	1	78	145	0	2	+T
H3_BC87_191109_LF_LIB_consensus_vsearch	3416	A	A	220	3	1.32%	2	2	93	93	0.12415730337075404	1	1	76	144	1	2	G
H3_BC87_191109_LF_LIB_consensus_vsearch	3417	A	A	220	4	1.75%	2	1	93	93	0.061662016439223415	1	1	75	145	4	0	G
H3_BC87_191109_LF_LIB_consensus_vsearch	3418	C	C	225	1	0.44%	2	1	93	93	0.5000000000003686	1	1	78	147	1	0	+TT
H3_BC87_191109_LF_LIB_consensus_vsearch	3419	T	Y	219	7	3.07%	2	1	93	93	0.007452766938834958	1	1	78	141	0	7	C
H3_BC87_191109_LF_LIB_consensus_vsearch	3420	G	G	227	1	0.44%	2	1	93	93	0.4999999999999138	1	1	79	148	1	0	A
H3_BC87_191109_LF_LIB_consensus_vsearch	3421	G	G	226	2	0.87%	2	1	93	93	0.24945054945064127	1	1	80	146	0	2	A
H3_BC87_191109_LF_LIB_consensus_vsearch	3422	C	C	225	2	0.88%	2	2	93	93	0.24944812362040697	1	1	79	146	1	1	-GC
H3_BC87_191109_LF_LIB_consensus_vsearch	3423	G	G	223	2	0.88%	2	2	93	93	0.24944320712692292	1	1	78	145	1	1	-C
H3_BC87_191109_LF_LIB_consensus_vsearch	3424	C	C	217	2	0.89%	2	1	93	93	0.24942791762028085	1	1	77	140	0	2	T
H3_BC87_191109_LF_LIB_consensus_vsearch	3425	T	T	223	2	0.88%	2	1	93	93	0.24944320712692292	1	1	80	143	0	2	C
H3_BC87_191109_LF_LIB_consensus_vsearch	3426	G	*/-C	209	13	5.7%	2	2	93	93	1.0188120004185222E-4	1	1	78	131	1	12	-C
H3_BC87_191109_LF_LIB_consensus_vsearch	3427	C	*/-G	148	36	17.06%	2	2	93	93	2.1801083576644604E-12	1	1	68	80	1	35	-G
H3_BC87_191109_LF_LIB_consensus_vsearch	3428	G	R	148	14	7.57%	2	1	93	93	4.5525965244911325E-5	1	1	63	85	14	0	A
H3_BC87_191109_LF_LIB_consensus_vsearch	3429	G	G	218	3	1.34%	2	2	93	93	0.12414965986396012	1	1	78	140	1	2	A
H3_BC87_191109_LF_LIB_consensus_vsearch	3430	G	G	224	3	1.31%	2	1	93	93	0.12417218543044797	1	1	76	148	3	0	A
H3_BC87_191109_LF_LIB_consensus_vsearch	3431	A	A	225	1	0.44%	2	1	93	93	0.5000000000003686	1	1	79	146	0	1	+T
H3_BC87_191109_LF_LIB_consensus_vsearch	3432	T	T	224	2	0.88%	2	1	93	93	0.24944567627499675	1	1	79	145	0	2	C
H3_BC87_191109_LF_LIB_consensus_vsearch	3433	C	*/+A	215	8	3.49%	2	1	93	93	0.0036646057936482192	1	1	77	138	0	8	+A
H3_BC87_191109_LF_LIB_consensus_vsearch	3434	A	A	219	2	0.89%	2	1	93	93	0.24943310657599216	1	1	75	144	0	2	G
H3_BC87_191109_LF_LIB_consensus_vsearch	3435	A	R	211	10	4.39%	2	1	93	93	8.800549103686053E-4	1	1	66	145	10	0	G
H3_BC87_191109_LF_LIB_consensus_vsearch	3436	C	C	221	4	1.77%	2	1	93	93	0.06166574490670126	1	1	74	147	4	0	G
H3_BC87_191109_LF_LIB_consensus_vsearch	3437	C	C	212	6	2.63%	2	1	93	93	0.015089936987088519	1	1	72	140	6	0	+A
H3_BC87_191109_LF_LIB_consensus_vsearch	3438	G	G	219	6	2.64%	2	1	93	93	0.015106507368173285	1	1	73	146	6	0	-A
H3_BC87_191109_LF_LIB_consensus_vsearch	3439	A	A	220	2	0.9%	2	2	93	93	0.2494356659142869	1	1	72	148	1	1	G
H3_BC87_191109_LF_LIB_consensus_vsearch	3440	A	A	223	2	0.87%	2	2	93	93	0.24944320712692292	1	1	77	146	1	1	G
H3_BC87_191109_LF_LIB_consensus_vsearch	3441	C	C	218	5	2.19%	2	1	93	93	0.030550130621104243	1	1	77	141	0	5	T
H3_BC87_191109_LF_LIB_consensus_vsearch	3442	G	G	222	2	0.88%	2	1	93	93	0.24944071588395061	1	1	76	146	2	0	A
H3_BC87_191109_LF_LIB_consensus_vsearch	3443	C	C	215	3	1.33%	2	2	93	93	0.12413793103441495	1	1	74	141	2	1	+GC
H3_BC87_191109_LF_LIB_consensus_vsearch	3444	C	C	216	4	1.77%	2	2	93	93	0.061646763238677425	1	1	77	139	1	3	T
H3_BC87_191109_LF_LIB_consensus_vsearch	3445	A	A	218	5	2.2%	2	2	93	93	0.030550130621104243	1	1	78	140	2	3	G
H3_BC87_191109_LF_LIB_consensus_vsearch	3446	T	T	214	5	2.21%	2	1	93	93	0.030537362897492103	1	1	79	135	0	5	C
H3_BC87_191109_LF_LIB_consensus_vsearch	3447	G	G	222	1	0.45%	2	1	93	93	0.4999999999999138	1	1	77	145	1	0	+TA
H3_BC87_191109_LF_LIB_consensus_vsearch	3448	C	C	219	3	1.33%	2	1	93	93	0.12415349887135622	1	1	79	140	0	3	T
H3_BC87_191109_LF_LIB_consensus_vsearch	3449	T	*/-A	203	8	3.56%	2	2	93	93	0.0036510799339400076	1	1	66	137	6	2	-A
H3_BC87_191109_LF_LIB_consensus_vsearch	3450	A	A	211	4	1.85%	2	2	93	93	0.06162689769249	1	1	72	139	1	3	G
H3_BC87_191109_LF_LIB_consensus_vsearch	3451	A	A	216	4	1.78%	2	1	93	93	0.061646763238677425	1	1	74	142	4	0	-G
H3_BC87_191109_LF_LIB_consensus_vsearch	3452	G	G	214	5	2.24%	2	1	93	93	0.030537362897492103	1	1	68	146	5	0	+A
H3_BC87_191109_LF_LIB_consensus_vsearch	3453	G	K	218	7	3.07%	2	1	93	93	0.007451182688346346	1	1	71	147	7	0	T
H3_BC87_191109_LF_LIB_consensus_vsearch	3454	T	T	223	2	0.88%	2	1	93	93	0.24944320712692292	1	1	77	146	0	2	C
H3_BC87_191109_LF_LIB_consensus_vsearch	3455	G	*/-C	204	15	6.67%	2	1	93	93	2.3815125527116474E-5	1	1	57	147	15	0	-C
H3_BC87_191109_LF_LIB_consensus_vsearch	3456	C	C	206	3	1.42%	2	2	93	93	0.1241007194244273	1	1	60	146	2	1	T
H3_BC87_191109_LF_LIB_consensus_vsearch	3457	C	C	220	5	2.19%	2	2	93	93	0.03055634444922604	1	1	76	144	1	4	-T
H3_BC87_191109_LF_LIB_consensus_vsearch	3458	T	Y	203	8	3.59%	2	2	93	93	0.0036510799339400076	1	1	73	130	1	7	C
H3_BC87_191109_LF_LIB_consensus_vsearch	3459	A	A	213	4	1.82%	2	2	93	93	0.06163495389099757	1	1	75	138	1	3	G
H3_BC87_191109_LF_LIB_consensus_vsearch	3460	A	A	215	6	2.68%	2	2	93	93	0.01509716650743782	1	1	77	138	2	4	G
H3_BC87_191109_LF_LIB_consensus_vsearch	3461	G	*/+T	210	13	5.75%	2	1	93	93	1.0196623731956113E-4	1	1	79	131	0	13	+T
H3_BC87_191109_LF_LIB_consensus_vsearch	3462	T	T	224	3	1.31%	2	2	93	93	0.12417218543044797	1	1	78	146	1	2	C
H3_BC87_191109_LF_LIB_consensus_vsearch	3463	C	*/-T	212	16	7.02%	2	1	93	93	1.1619469874592578E-5	1	1	80	132	0	16	-T
H3_BC87_191109_LF_LIB_consensus_vsearch	3464	T	T	206	3	1.41%	2	1	93	93	0.1241007194244273	1	1	78	128	0	3	C
H3_BC87_191109_LF_LIB_consensus_vsearch	3465	A	*/-G	196	21	9.25%	2	2	93	93	2.868926012059276E-7	1	1	73	123	1	20	-G
H3_BC87_191109_LF_LIB_consensus_vsearch	3466	G	G	202	3	1.44%	2	2	93	93	0.12408312958435573	1	1	76	126	2	1	+A
H3_BC87_191109_LF_LIB_consensus_vsearch	3467	G	G	224	4	1.75%	2	1	93	93	0.06167673386217682	1	1	75	149	4	0	-C
H3_BC87_191109_LF_LIB_consensus_vsearch	3468	C	C	224	1	0.44%	2	1	93	93	0.4999999999999138	1	1	75	149	1	0	G
H3_BC87_191109_LF_LIB_consensus_vsearch	3469	C	C	226	2	0.87%	2	1	93	93	0.24945054945064127	1	1	78	148	2	0	T
H3_BC87_191109_LF_LIB_consensus_vsearch	3470	A	A	227	1	0.44%	2	1	93	93	0.4999999999999138	1	1	80	147	0	1	+CA
H3_BC87_191109_LF_LIB_consensus_vsearch	3471	A	A	224	2	0.87%	2	1	93	93	0.24944567627499675	1	1	80	144	0	2	C
H3_BC87_191109_LF_LIB_consensus_vsearch	3472	T	T	221	6	2.63%	2	1	93	93	0.015111054918444918	1	1	79	142	0	6	-G
H3_BC87_191109_LF_LIB_consensus_vsearch	3473	G	G	222	0	0%	2	0	93	0	1.0	1	0	80	142	0	0	
H3_BC87_191109_LF_LIB_consensus_vsearch	3474	G	G	229	0	0%	2	0	93	0	1.0	1	0	80	149	0	0	
H3_BC87_191109_LF_LIB_consensus_vsearch	3475	A	A	229	0	0%	2	0	93	0	1.0	1	0	80	149	0	0	
H3_BC87_191109_LF_LIB_consensus_vsearch	3476	T	T	227	1	0.44%	2	1	93	93	0.4999999999999138	1	1	78	149	1	0	+AT
H3_BC87_191109_LF_LIB_consensus_vsearch	3477	G	G	225	1	0.44%	2	1	93	93	0.5000000000003686	1	1	79	146	0	1	-TAA
H3_BC87_191109_LF_LIB_consensus_vsearch	3478	T	*/-A	148	46	20.35%	2	2	93	93	6.860286130088943E-16	1	1	45	103	24	22	-A
H3_BC87_191109_LF_LIB_consensus_vsearch	3479	A	A	168	1	0.59%	2	1	93	93	0.4999999999999138	1	1	50	118	0	1	G
H3_BC87_191109_LF_LIB_consensus_vsearch	3480	A	A	214	1	0.47%	2	1	93	93	0.5000000000001412	1	1	74	140	0	1	G
H3_BC87_191109_LF_LIB_consensus_vsearch	3481	A	A	222	1	0.45%	2	1	93	93	0.4999999999999138	1	1	79	143	1	0	+G
H3_BC87_191109_LF_LIB_consensus_vsearch	3482	A	A	222	2	0.89%	2	1	93	93	0.24944071588395061	1	1	79	143	0	2	C
H3_BC87_191109_LF_LIB_consensus_vsearch	3483	A	A	220	5	2.21%	2	2	93	93	0.03055634444922604	1	1	76	144	4	1	-G
H3_BC87_191109_LF_LIB_consensus_vsearch	3484	G	G	220	3	1.34%	2	1	93	93	0.12415730337075404	1	1	76	144	0	3	+T
H3_BC87_191109_LF_LIB_consensus_vsearch	3485	G	G	227	1	0.44%	2	1	93	93	0.4999999999999138	1	1	79	148	1	0	+CC
H3_BC87_191109_LF_LIB_consensus_vsearch	3486	C	C	226	1	0.44%	2	1	93	93	0.4999999999999138	1	1	80	146	0	1	+A
H3_BC87_191109_LF_LIB_consensus_vsearch	3487	G	G	224	2	0.87%	2	1	93	93	0.24944567627499675	1	1	80	144	0	2	+T
H3_BC87_191109_LF_LIB_consensus_vsearch	3488	T	T	222	2	0.88%	2	1	93	93	0.24944071588395061	1	1	78	144	0	2	-C
H3_BC87_191109_LF_LIB_consensus_vsearch	3489	C	C	219	5	2.2%	2	1	93	93	0.030553251388732716	1	1	80	139	0	5	+G
H3_BC87_191109_LF_LIB_consensus_vsearch	3490	G	R	220	7	3.07%	2	2	93	93	0.007454337359329176	1	1	74	146	6	1	A
H3_BC87_191109_LF_LIB_consensus_vsearch	3491	G	G	227	1	0.44%	2	1	93	93	0.4999999999999138	1	1	79	148	1	0	+A
H3_BC87_191109_LF_LIB_consensus_vsearch	3492	G	G	227	1	0.44%	2	1	93	93	0.4999999999999138	1	1	80	147	0	1	-C
H3_BC87_191109_LF_LIB_consensus_vsearch	3493	C	C	222	4	1.76%	2	1	93	93	0.061669440342892484	1	1	79	143	0	4	-G
H3_BC87_191109_LF_LIB_consensus_vsearch	3494	G	R	207	11	4.93%	2	2	93	93	4.2906952287648286E-4	1	1	66	141	10	1	A
H3_BC87_191109_LF_LIB_consensus_vsearch	3495	G	G	224	1	0.44%	2	1	93	93	0.4999999999999138	1	1	77	147	1	0	+T
H3_BC87_191109_LF_LIB_consensus_vsearch	3496	T	T	219	4	1.77%	2	2	93	93	0.06165825449566743	1	1	75	144	2	2	+A
H3_BC87_191109_LF_LIB_consensus_vsearch	3497	G	G	223	2	0.88%	2	2	93	93	0.24944320712692292	1	1	78	145	1	1	-A
H3_BC87_191109_LF_LIB_consensus_vsearch	3498	A	A	218	5	2.2%	2	1	93	93	0.030550130621104243	1	1	73	145	5	0	-TGA
H3_BC87_191109_LF_LIB_consensus_vsearch	3499	T	T	220	1	0.45%	2	1	93	93	0.4999999999999138	1	1	74	146	0	1	+A
H3_BC87_191109_LF_LIB_consensus_vsearch	3500	G	G	220	2	0.9%	2	1	93	93	0.2494356659142869	1	1	75	145	0	2	+C
H3_BC87_191109_LF_LIB_consensus_vsearch	3501	A	A	218	2	0.89%	2	1	93	93	0.24943052391823226	1	1	74	144	0	2	+T
H3_BC87_191109_LF_LIB_consensus_vsearch	3502	C	C	222	3	1.31%	2	1	93	93	0.12416481069040536	1	1	78	144	0	3	T
H3_BC87_191109_LF_LIB_consensus_vsearch	3503	A	A	222	3	1.32%	2	2	93	93	0.12416481069040536	1	1	77	145	1	2	G
H3_BC87_191109_LF_LIB_consensus_vsearch	3504	G	G	221	4	1.75%	2	2	93	93	0.06166574490670126	1	1	75	146	2	2	A
H3_BC87_191109_LF_LIB_consensus_vsearch	3505	C	C	222	2	0.88%	2	2	93	93	0.24944071588395061	1	1	77	145	1	1	-A
H3_BC87_191109_LF_LIB_consensus_vsearch	3506	A	*/-G	201	16	7.08%	2	1	93	93	1.1454151088665753E-5	1	1	72	129	0	16	-G
H3_BC87_191109_LF_LIB_consensus_vsearch	3507	G	G	209	4	1.88%	2	1	93	93	0.061618690029214815	1	1	80	129	0	4	+T
H3_BC87_191109_LF_LIB_consensus_vsearch	3508	G	G	227	1	0.44%	2	1	93	93	0.4999999999999138	1	1	80	147	0	1	-ACGG
H3_BC87_191109_LF_LIB_consensus_vsearch	3509	A	A	224	2	0.88%	2	2	93	93	0.24944567627499675	1	1	79	145	1	1	G
H3_BC87_191109_LF_LIB_consensus_vsearch	3510	C	Y	209	13	5.73%	2	1	93	93	1.0188120004185222E-4	1	1	79	130	0	13	T
H3_BC87_191109_LF_LIB_consensus_vsearch	3511	G	G	220	3	1.34%	2	1	93	93	0.12415730337075404	1	1	76	144	3	0	A
H3_BC87_191109_LF_LIB_consensus_vsearch	3512	G	G	223	1	0.44%	2	1	93	93	0.5000000000003686	1	1	78	145	0	1	+C
H3_BC87_191109_LF_LIB_consensus_vsearch	3513	T	T	216	5	2.19%	2	1	93	93	0.030543804461782422	1	1	79	137	0	5	-G
H3_BC87_191109_LF_LIB_consensus_vsearch	3514	G	G	217	2	0.91%	2	1	93	93	0.24942791762028085	1	1	77	140	2	0	A
H3_BC87_191109_LF_LIB_consensus_vsearch	3515	G	G	215	5	2.21%	2	2	93	93	0.03054059830172664	1	1	78	137	1	4	-C
H3_BC87_191109_LF_LIB_consensus_vsearch	3516	C	C	215	3	1.35%	2	1	93	93	0.12413793103441495	1	1	77	138	0	3	T
H3_BC87_191109_LF_LIB_consensus_vsearch	3517	C	Y	207	14	6.17%	2	2	93	93	4.93553660030744E-5	1	1	76	131	2	12	T
H3_BC87_191109_LF_LIB_consensus_vsearch	3518	A	A	218	2	0.89%	2	1	93	93	0.24943052391823226	1	1	77	141	0	2	-T
H3_BC87_191109_LF_LIB_consensus_vsearch	3519	T	*/-G	201	17	7.62%	2	2	93	93	5.516424489829313E-6	1	1	69	132	9	8	-G
H3_BC87_191109_LF_LIB_consensus_vsearch	3520	G	G	205	1	0.48%	2	1	93	93	0.5000000000001412	1	1	69	136	0	1	+T
H3_BC87_191109_LF_LIB_consensus_vsearch	3521	G	G	207	4	1.78%	2	2	93	93	0.06161032658914256	1	1	74	133	2	2	-A
H3_BC87_191109_LF_LIB_consensus_vsearch	3522	A	A	206	4	1.85%	2	1	93	93	0.06160608506034647	1	1	74	132	0	4	C
H3_BC87_191109_LF_LIB_consensus_vsearch	3523	A	A	213	4	1.81%	2	2	93	93	0.06163495389099757	1	1	75	138	3	1	-G
H3_BC87_191109_LF_LIB_consensus_vsearch	3524	G	G	217	2	0.9%	2	1	93	93	0.24942791762028085	1	1	75	142	0	2	+C
H3_BC87_191109_LF_LIB_consensus_vsearch	3525	T	T	222	3	1.31%	2	2	93	93	0.12416481069040536	1	1	76	146	1	2	C
H3_BC87_191109_LF_LIB_consensus_vsearch	3526	C	C	226	1	0.44%	2	1	93	93	0.4999999999999138	1	1	79	147	0	1	T
H3_BC87_191109_LF_LIB_consensus_vsearch	3527	G	G	222	6	2.62%	2	2	93	93	0.015113298912360445	1	1	76	146	4	2	A
H3_BC87_191109_LF_LIB_consensus_vsearch	3528	G	G	227	1	0.44%	2	1	93	93	0.4999999999999138	1	1	80	147	0	1	+T
H3_BC87_191109_LF_LIB_consensus_vsearch	3529	C	C	225	2	0.88%	2	2	93	93	0.24944812362040697	1	1	79	146	1	1	T
H3_BC87_191109_LF_LIB_consensus_vsearch	3530	A	A	227	2	0.87%	2	1	93	93	0.24945295404843976	1	1	80	147	0	2	-T
H3_BC87_191109_LF_LIB_consensus_vsearch	3531	T	T	222	2	0.88%	2	1	93	93	0.24944071588395061	1	1	76	146	2	0	+C
H3_BC87_191109_LF_LIB_consensus_vsearch	3532	C	C	228	0	0%	2	0	93	0	1.0	1	0	79	149	0	0	
H3_BC87_191109_LF_LIB_consensus_vsearch	3533	C	C	221	2	0.88%	2	1	93	93	0.24943820224728358	1	1	77	144	0	2	+GG
H3_BC87_191109_LF_LIB_consensus_vsearch	3534	G	G	223	2	0.88%	2	2	93	93	0.24944320712692292	1	1	78	145	1	1	A
H3_BC87_191109_LF_LIB_consensus_vsearch	3535	C	C	223	1	0.44%	2	1	93	93	0.5000000000003686	1	1	79	144	0	1	-T
H3_BC87_191109_LF_LIB_consensus_vsearch	3536	T	Y	212	7	3.11%	2	1	93	93	0.00744137624879223	1	1	75	137	0	7	C
H3_BC87_191109_LF_LIB_consensus_vsearch	3537	A	A	221	2	0.89%	2	1	93	93	0.24943820224728358	1	1	73	148	2	0	+G
H3_BC87_191109_LF_LIB_consensus_vsearch	3538	A	*/-GA	213	8	3.51%	2	1	93	93	0.0036624519192641563	1	1	65	148	8	0	-GA
H3_BC87_191109_LF_LIB_consensus_vsearch	3539	G	*/-A	196	7	3.26%	2	2	93	93	0.007412420836520295	1	1	50	146	6	1	-A
H3_BC87_191109_LF_LIB_consensus_vsearch	3540	A	A	203	1	0.49%	2	1	93	93	0.4999999999999138	1	1	58	145	1	0	+TTT
H3_BC87_191109_LF_LIB_consensus_vsearch	3541	A	R	213	7	3.17%	2	2	93	93	0.007443047448823043	1	1	68	145	5	2	G
H3_BC87_191109_LF_LIB_consensus_vsearch	3542	G	G	217	4	1.8%	2	1	93	93	0.0616506283607095	1	1	70	147	4	0	T
H3_BC87_191109_LF_LIB_consensus_vsearch	3543	T	Y	212	11	4.85%	2	2	93	93	4.303452996410444E-4	1	1	77	135	1	10	C
H3_BC87_191109_LF_LIB_consensus_vsearch	3544	G	G	221	2	0.88%	2	1	93	93	0.24943820224728358	1	1	76	145	2	0	A
H3_BC87_191109_LF_LIB_consensus_vsearch	3545	T	*/-GT	168	47	20.89%	2	2	93	93	4.211114663089133E-16	1	1	79	89	1	46	-GT
H3_BC87_191109_LF_LIB_consensus_vsearch	3546	G	G	173	1	0.57%	2	1	93	93	0.4999999999999138	1	1	79	94	0	1	A
H3_BC87_191109_LF_LIB_consensus_vsearch	3547	T	T	164	6	3.37%	2	2	93	93	0.014939776838607147	1	1	76	88	1	5	+GT
H3_BC87_191109_LF_LIB_consensus_vsearch	3548	A	A	222	2	0.88%	2	2	93	93	0.24944071588395061	1	1	77	145	1	1	G
H3_BC87_191109_LF_LIB_consensus_vsearch	3549	A	A	220	2	0.88%	2	1	93	93	0.2494356659142869	1	1	77	143	0	2	+T
H3_BC87_191109_LF_LIB_consensus_vsearch	3550	C	C	211	6	2.68%	2	1	93	93	0.015087482939793164	1	1	78	133	0	6	T
H3_BC87_191109_LF_LIB_consensus_vsearch	3551	A	A	221	1	0.45%	2	1	93	93	0.4999999999999138	1	1	78	143	0	1	+GC
H3_BC87_191109_LF_LIB_consensus_vsearch	3552	A	A	212	4	1.79%	2	1	93	93	0.061630944461591126	1	1	75	137	0	4	+T
H3_BC87_191109_LF_LIB_consensus_vsearch	3553	C	*/-TT	193	21	9.42%	2	1	93	93	2.8475265963193784E-7	1	1	55	138	21	0	-TT
H3_BC87_191109_LF_LIB_consensus_vsearch	3554	T	T	198	1	0.5%	2	1	93	93	0.5000000000001412	1	1	56	142	0	1	+C
H3_BC87_191109_LF_LIB_consensus_vsearch	3555	T	Y	195	7	3.38%	2	1	93	93	0.007410460397262536	1	1	56	139	0	7	C
H3_BC87_191109_LF_LIB_consensus_vsearch	3556	A	A	213	5	2.23%	2	1	93	93	0.030534097847134272	1	1	67	146	5	0	G
H3_BC87_191109_LF_LIB_consensus_vsearch	3557	C	C	218	2	0.9%	2	1	93	93	0.24943052391823226	1	1	75	143	0	2	T
H3_BC87_191109_LF_LIB_consensus_vsearch	3558	C	C	217	6	2.63%	2	2	93	93	0.015101878629034914	1	1	73	144	3	3	-T
H3_BC87_191109_LF_LIB_consensus_vsearch	3559	T	Y	183	33	15.07%	2	2	93	93	3.100203503251058E-11	1	1	73	110	1	32	C
H3_BC87_191109_LF_LIB_consensus_vsearch	3560	G	G	217	4	1.78%	2	2	93	93	0.0616506283607095	1	1	71	146	3	1	-C
H3_BC87_191109_LF_LIB_consensus_vsearch	3561	C	C	220	1	0.45%	2	1	93	93	0.4999999999999138	1	1	75	145	0	1	A
H3_BC87_191109_LF_LIB_consensus_vsearch	3562	C	C	212	6	2.64%	2	1	93	93	0.015089936987088519	1	1	70	142	6	0	+A
H3_BC87_191109_LF_LIB_consensus_vsearch	3563	G	G	218	5	2.21%	2	1	93	93	0.030550130621104243	1	1	72	146	5	0	-A
H3_BC87_191109_LF_LIB_consensus_vsearch	3564	A	A	220	3	1.34%	2	1	93	93	0.12415730337075404	1	1	71	149	3	0	G
H3_BC87_191109_LF_LIB_consensus_vsearch	3565	A	A	227	1	0.44%	2	1	93	93	0.4999999999999138	1	1	80	147	0	1	-TCG
H3_BC87_191109_LF_LIB_consensus_vsearch	3566	T	T	223	2	0.88%	2	2	93	93	0.24944320712692292	1	1	78	145	1	1	-C
H3_BC87_191109_LF_LIB_consensus_vsearch	3567	C	C	219	3	1.33%	2	2	93	93	0.12415349887135622	1	1	76	143	2	1	-G
H3_BC87_191109_LF_LIB_consensus_vsearch	3568	G	G	214	5	2.22%	2	1	93	93	0.030537362897492103	1	1	74	140	0	5	+C
H3_BC87_191109_LF_LIB_consensus_vsearch	3569	C	C	221	3	1.32%	2	2	93	93	0.12416107382546236	1	1	75	146	2	1	A
H3_BC87_191109_LF_LIB_consensus_vsearch	3570	T	T	218	5	2.19%	2	2	93	93	0.030550130621104243	1	1	77	141	1	4	-C
H3_BC87_191109_LF_LIB_consensus_vsearch	3571	C	C	219	2	0.89%	2	1	93	93	0.24943310657599216	1	1	79	140	0	2	T
H3_BC87_191109_LF_LIB_consensus_vsearch	3572	G	G	224	2	0.88%	2	1	93	93	0.24944567627499675	1	1	78	146	0	2	C
H3_BC87_191109_LF_LIB_consensus_vsearch	3573	G	G	210	5	2.18%	2	1	93	93	0.0305241206880699	1	1	69	141	5	0	-C
H3_BC87_191109_LF_LIB_consensus_vsearch	3574	C	C	216	5	2.26%	2	1	93	93	0.030543804461782422	1	1	72	144	0	5	+T
H3_BC87_191109_LF_LIB_consensus_vsearch	3575	C	C	219	6	2.65%	2	2	93	93	0.015106507368173285	1	1	76	143	1	5	T
H3_BC87_191109_LF_LIB_consensus_vsearch	3576	C	C	226	2	0.87%	2	1	93	93	0.24945054945064127	1	1	79	147	0	2	-T
H3_BC87_191109_LF_LIB_consensus_vsearch	3577	T	Y	218	7	3.08%	2	1	93	93	0.007451182688346346	1	1	79	139	0	7	C
H3_BC87_191109_LF_LIB_consensus_vsearch	3578	G	*/-A	196	16	6.99%	2	2	93	93	1.137397674554477E-5	1	1	74	122	2	14	-A
H3_BC87_191109_LF_LIB_consensus_vsearch	3579	A	A	202	4	1.9%	2	1	93	93	0.06158870665501416	1	1	72	130	0	4	G
H3_BC87_191109_LF_LIB_consensus_vsearch	3580	A	A	225	1	0.44%	2	1	93	93	0.5000000000003686	1	1	78	147	0	1	+CGCA
H3_BC87_191109_LF_LIB_consensus_vsearch	3581	A	A	228	0	0%	2	0	93	0	1.0	1	0	79	149	0	0	
H3_BC87_191109_LF_LIB_consensus_vsearch	3582	A	A	224	2	0.88%	2	2	93	93	0.24944567627499675	1	1	77	147	1	1	G
H3_BC87_191109_LF_LIB_consensus_vsearch	3583	T	*/-G	217	7	3.07%	2	1	93	93	0.007449584424390529	1	1	78	139	0	7	-G
H3_BC87_191109_LF_LIB_consensus_vsearch	3584	G	G	216	1	0.45%	2	1	93	93	0.4999999999999138	1	1	77	139	0	1	+AC
H3_BC87_191109_LF_LIB_consensus_vsearch	3585	G	G	224	1	0.44%	2	1	93	93	0.4999999999999138	1	1	78	146	0	1	+TGAA
H3_BC87_191109_LF_LIB_consensus_vsearch	3586	A	A	223	1	0.44%	2	1	93	93	0.5000000000003686	1	1	77	146	0	1	-T
H3_BC87_191109_LF_LIB_consensus_vsearch	3587	T	T	222	3	1.33%	2	1	93	93	0.12416481069040536	1	1	78	144	0	3	C
H3_BC87_191109_LF_LIB_consensus_vsearch	3588	G	G	220	5	2.21%	2	2	93	93	0.03055634444922604	1	1	73	147	4	1	A
H3_BC87_191109_LF_LIB_consensus_vsearch	3589	G	G	225	1	0.44%	2	1	93	93	0.5000000000003686	1	1	78	147	0	1	+TGG
H3_BC87_191109_LF_LIB_consensus_vsearch	3590	C	C	226	1	0.44%	2	1	93	93	0.4999999999999138	1	1	79	147	1	0	-G
H3_BC87_191109_LF_LIB_consensus_vsearch	3591	G	G	224	1	0.44%	2	1	93	93	0.4999999999999138	1	1	76	148	1	0	+C
H3_BC87_191109_LF_LIB_consensus_vsearch	3592	C	*/-T	197	23	10.13%	2	2	93	93	6.501382894958495E-8	1	1	74	123	3	20	-T
H3_BC87_191109_LF_LIB_consensus_vsearch	3593	T	T	199	2	0.99%	2	2	93	93	0.24937655860363442	1	1	74	125	1	1	C
H3_BC87_191109_LF_LIB_consensus_vsearch	3594	T	Y	201	7	3.11%	2	2	93	93	0.007421943123229272	1	1	72	129	5	2	C
H3_BC87_191109_LF_LIB_consensus_vsearch	3595	A	A	207	3	1.4%	2	1	93	93	0.12410501193315207	1	1	78	129	0	3	C
H3_BC87_191109_LF_LIB_consensus_vsearch	3596	A	A	208	6	2.71%	2	1	93	93	0.015079983859610983	1	1	77	131	0	6	G
H3_BC87_191109_LF_LIB_consensus_vsearch	3597	G	*/-C	209	11	4.87%	2	2	93	93	4.2958650804029443E-4	1	1	67	142	9	2	-C
H3_BC87_191109_LF_LIB_consensus_vsearch	3598	C	C	207	6	2.76%	2	1	93	93	0.015077437453979417	1	1	69	138	0	6	+T
H3_BC87_191109_LF_LIB_consensus_vsearch	3599	C	*/-T	209	13	5.68%	2	2	93	93	1.0188120004185222E-4	1	1	77	132	1	12	-T
H3_BC87_191109_LF_LIB_consensus_vsearch	3600	T	Y	192	14	6.51%	2	2	93	93	4.85721545340522E-5	1	1	76	116	1	13	C
H3_BC87_191109_LF_LIB_consensus_vsearch	3601	A	A	219	5	2.21%	2	1	93	93	0.030553251388732716	1	1	73	146	5	0	G
H3_BC87_191109_LF_LIB_consensus_vsearch	3602	G	G	224	2	0.88%	2	1	93	93	0.24944567627499675	1	1	78	146	2	0	A
H3_BC87_191109_LF_LIB_consensus_vsearch	3603	C	C	225	2	0.87%	2	1	93	93	0.24944812362040697	1	1	78	147	0	2	+A
H3_BC87_191109_LF_LIB_consensus_vsearch	3604	A	A	221	4	1.75%	2	2	93	93	0.06166574490670126	1	1	74	147	3	1	-C
H3_BC87_191109_LF_LIB_consensus_vsearch	3605	C	C	221	2	0.9%	2	1	93	93	0.24943820224728358	1	1	76	145	0	2	T
H3_BC87_191109_LF_LIB_consensus_vsearch	3606	C	C	219	4	1.76%	2	1	93	93	0.06165825449566743	1	1	77	142	0	4	T
H3_BC87_191109_LF_LIB_consensus_vsearch	3607	G	G	220	5	2.21%	2	2	93	93	0.03055634444922604	1	1	74	146	4	1	-A
H3_BC87_191109_LF_LIB_consensus_vsearch	3608	A	A	221	1	0.45%	2	1	93	93	0.4999999999999138	1	1	75	146	0	1	+G
H3_BC87_191109_LF_LIB_consensus_vsearch	3609	T	T	216	5	2.2%	2	1	93	93	0.030543804461782422	1	1	76	140	0	5	+G
H3_BC87_191109_LF_LIB_consensus_vsearch	3610	G	G	209	4	1.79%	2	1	93	93	0.061618690029214815	1	1	71	138	4	0	A
H3_BC87_191109_LF_LIB_consensus_vsearch	3611	C	C	212	5	2.25%	2	1	93	93	0.030530802741347875	1	1	78	134	0	5	T
H3_BC87_191109_LF_LIB_consensus_vsearch	3612	A	A	215	3	1.35%	2	1	93	93	0.12413793103441495	1	1	78	137	0	3	+T
H3_BC87_191109_LF_LIB_consensus_vsearch	3613	T	T	211	5	2.25%	2	1	93	93	0.030527477163211258	1	1	78	133	0	5	-G
H3_BC87_191109_LF_LIB_consensus_vsearch	3614	G	G	219	1	0.45%	2	1	93	93	0.4999999999999138	1	1	79	140	0	1	+C
H3_BC87_191109_LF_LIB_consensus_vsearch	3615	G	G	219	4	1.75%	2	2	93	93	0.06165825449566743	1	1	76	143	2	2	-C
H3_BC87_191109_LF_LIB_consensus_vsearch	3616	C	C	216	6	2.67%	2	1	93	93	0.015099533131216845	1	1	77	139	0	6	+T
H3_BC87_191109_LF_LIB_consensus_vsearch	3617	C	C	227	1	0.44%	2	1	93	93	0.4999999999999138	1	1	80	147	0	1	+T
H3_BC87_191109_LF_LIB_consensus_vsearch	3618	C	C	222	3	1.31%	2	1	93	93	0.12416481069040536	1	1	80	142	0	3	T
H3_BC87_191109_LF_LIB_consensus_vsearch	3619	A	R	218	7	3.08%	2	2	93	93	0.007451182688346346	1	1	79	139	1	6	G
H3_BC87_191109_LF_LIB_consensus_vsearch	3620	T	Y	217	9	3.93%	2	1	93	93	0.0018008401619304512	1	1	79	138	0	9	C
H3_BC87_191109_LF_LIB_consensus_vsearch	3621	G	G	224	3	1.32%	2	2	93	93	0.12417218543044797	1	1	78	146	1	2	A
H3_BC87_191109_LF_LIB_consensus_vsearch	3622	T	*/-C	213	10	4.39%	2	1	93	93	8.808946039600796E-4	1	1	68	145	10	0	-C
H3_BC87_191109_LF_LIB_consensus_vsearch	3623	C	C	218	0	0%	2	0	93	0	1.0	1	0	69	149	0	0	
H3_BC87_191109_LF_LIB_consensus_vsearch	3624	C	C	224	2	0.87%	2	2	93	93	0.24944567627499675	1	1	78	146	1	1	-G
H3_BC87_191109_LF_LIB_consensus_vsearch	3625	G	R	218	8	3.52%	2	2	93	93	0.003667766201363899	1	1	74	144	5	3	A
H3_BC87_191109_LF_LIB_consensus_vsearch	3626	G	G	227	1	0.44%	2	1	93	93	0.4999999999999138	1	1	80	147	0	1	+TC
H3_BC87_191109_LF_LIB_consensus_vsearch	3627	C	Y	209	11	4.8%	2	1	93	93	4.2958650804029443E-4	1	1	77	132	0	11	T
H3_BC87_191109_LF_LIB_consensus_vsearch	3628	T	T	224	1	0.44%	2	1	93	93	0.4999999999999138	1	1	78	146	0	1	C
H3_BC87_191109_LF_LIB_consensus_vsearch	3629	T	T	221	2	0.88%	2	1	93	93	0.24943820224728358	1	1	78	143	0	2	+G
H3_BC87_191109_LF_LIB_consensus_vsearch	3630	G	G	221	2	0.88%	2	1	93	93	0.24943820224728358	1	1	75	146	2	0	+C
H3_BC87_191109_LF_LIB_consensus_vsearch	3631	C	C	220	3	1.33%	2	1	93	93	0.12415730337075404	1	1	77	143	0	3	T
H3_BC87_191109_LF_LIB_consensus_vsearch	3632	C	C	208	5	2.2%	2	1	93	93	0.03051731330830772	1	1	78	130	0	5	+G
H3_BC87_191109_LF_LIB_consensus_vsearch	3633	G	G	220	2	0.9%	2	2	93	93	0.2494356659142869	1	1	77	143	1	1	A
H3_BC87_191109_LF_LIB_consensus_vsearch	3634	G	G	217	3	1.32%	2	1	93	93	0.12414578587710072	1	1	75	142	3	0	A
H3_BC87_191109_LF_LIB_consensus_vsearch	3635	C	C	214	3	1.34%	2	1	93	93	0.12413394919162732	1	1	71	143	3	0	+GC
H3_BC87_191109_LF_LIB_consensus_vsearch	3636	A	A	219	2	0.89%	2	1	93	93	0.24943310657599216	1	1	74	145	2	0	G
H3_BC87_191109_LF_LIB_consensus_vsearch	3637	T	*/+G	207	10	4.41%	2	2	93	93	8.783305527122537E-4	1	1	74	133	1	9	+G
H3_BC87_191109_LF_LIB_consensus_vsearch	3638	G	G	220	2	0.9%	2	2	93	93	0.2494356659142869	1	1	77	143	1	1	A
H3_BC87_191109_LF_LIB_consensus_vsearch	3639	G	*/-A	211	12	5.31%	2	1	93	93	2.0973150235371546E-4	1	1	66	145	12	0	-A
H3_BC87_191109_LF_LIB_consensus_vsearch	3640	A	A	210	4	1.86%	2	1	93	93	0.06162281305968737	1	1	62	148	4	0	-G
H3_BC87_191109_LF_LIB_consensus_vsearch	3641	G	G	214	4	1.79%	2	1	93	93	0.061638926495252586	1	1	75	139	0	4	+AG
H3_BC87_191109_LF_LIB_consensus_vsearch	3642	T	T	203	6	2.65%	2	2	93	93	0.01506700937567325	1	1	68	135	1	5	C
H3_BC87_191109_LF_LIB_consensus_vsearch	3643	A	*/-G	193	14	6.28%	2	2	93	93	4.862760706844154E-5	1	1	63	130	5	9	-G
H3_BC87_191109_LF_LIB_consensus_vsearch	3644	G	G	209	1	0.47%	2	1	93	93	0.4999999999999138	1	1	70	139	0	1	+TA
H3_BC87_191109_LF_LIB_consensus_vsearch	3645	G	G	219	5	2.2%	2	2	93	93	0.030553251388732716	1	1	73	146	2	3	-A
H3_BC87_191109_LF_LIB_consensus_vsearch	3646	A	*/-G	201	9	4.05%	2	2	93	93	0.0017895062981052791	1	1	60	141	6	3	-G
H3_BC87_191109_LF_LIB_consensus_vsearch	3647	G	G	205	2	0.95%	2	1	93	93	0.24939467312372118	1	1	61	144	2	0	+A
H3_BC87_191109_LF_LIB_consensus_vsearch	3648	G	*/+A	200	7	3.18%	2	1	93	93	0.007420075094973923	1	1	53	147	7	0	+A
H3_BC87_191109_LF_LIB_consensus_vsearch	3649	G	R	209	12	5.31%	2	2	93	93	2.0943559915765036E-4	1	1	64	145	11	1	A
H3_BC87_191109_LF_LIB_consensus_vsearch	3650	C	C	219	2	0.89%	2	1	93	93	0.24943310657599216	1	1	76	143	0	2	A
H3_BC87_191109_LF_LIB_consensus_vsearch	3651	G	*/-TG	200	18	8%	2	1	93	93	2.6463038722080364E-6	1	1	76	124	0	18	-TG
H3_BC87_191109_LF_LIB_consensus_vsearch	3652	T	T	196	3	1.46%	2	1	93	93	0.12405541561711925	1	1	78	118	0	3	+G
H3_BC87_191109_LF_LIB_consensus_vsearch	3653	G	G	207	0	0%	2	0	93	0	1.0	1	0	78	129	0	0	
H3_BC87_191109_LF_LIB_consensus_vsearch	3654	G	G	226	1	0.44%	2	1	93	93	0.4999999999999138	1	1	78	148	1	0	-AG
H3_BC87_191109_LF_LIB_consensus_vsearch	3655	A	*/-G	212	13	5.73%	2	1	93	93	1.0213418662308634E-4	1	1	64	148	13	0	-G
H3_BC87_191109_LF_LIB_consensus_vsearch	3656	G	G	209	1	0.47%	2	1	93	93	0.4999999999999138	1	1	64	145	1	0	+AG
H3_BC87_191109_LF_LIB_consensus_vsearch	3657	G	G	223	1	0.44%	2	1	93	93	0.5000000000003686	1	1	78	145	0	1	+CAAG
H3_BC87_191109_LF_LIB_consensus_vsearch	3658	T	T	220	5	2.22%	2	1	93	93	0.03055634444922604	1	1	78	142	0	5	C
H3_BC87_191109_LF_LIB_consensus_vsearch	3659	T	T	222	2	0.88%	2	1	93	93	0.24944071588395061	1	1	78	144	0	2	-A
H3_BC87_191109_LF_LIB_consensus_vsearch	3660	A	A	222	2	0.89%	2	2	93	93	0.24944071588395061	1	1	78	144	1	1	G
H3_BC87_191109_LF_LIB_consensus_vsearch	3661	A	A	221	3	1.32%	2	1	93	93	0.12416107382546236	1	1	77	144	0	3	+T
H3_BC87_191109_LF_LIB_consensus_vsearch	3662	T	T	224	1	0.44%	2	1	93	93	0.4999999999999138	1	1	78	146	0	1	+C
H3_BC87_191109_LF_LIB_consensus_vsearch	3663	T	T	224	3	1.32%	2	2	93	93	0.12417218543044797	1	1	78	146	1	2	C
H3_BC87_191109_LF_LIB_consensus_vsearch	3664	T	T	221	2	0.88%	2	1	93	93	0.24943820224728358	1	1	77	144	0	2	+G
H3_BC87_191109_LF_LIB_consensus_vsearch	3665	G	G	223	2	0.88%	2	2	93	93	0.24944320712692292	1	1	78	145	1	1	-C
H3_BC87_191109_LF_LIB_consensus_vsearch	3666	C	Y	201	19	8.37%	2	1	93	93	1.2711099418435063E-6	1	1	76	125	0	19	T
H3_BC87_191109_LF_LIB_consensus_vsearch	3667	T	*/+G	202	17	7.56%	2	1	93	93	5.524923410580334E-6	1	1	76	126	0	17	+G
H3_BC87_191109_LF_LIB_consensus_vsearch	3668	G	G	223	3	1.32%	2	2	93	93	0.12416851441234596	1	1	76	147	2	1	-A
H3_BC87_191109_LF_LIB_consensus_vsearch	3669	A	*/-GA	203	16	7.08%	2	1	93	93	1.1485308764863282E-5	1	1	57	146	16	0	-GA
H3_BC87_191109_LF_LIB_consensus_vsearch	3670	G	*/+A	201	7	3.29%	2	1	93	93	0.007421943123229272	1	1	56	145	7	0	+A
H3_BC87_191109_LF_LIB_consensus_vsearch	3671	A	A	209	0	0%	2	0	93	0	1.0	1	0	63	146	0	0	
H3_BC87_191109_LF_LIB_consensus_vsearch	3672	A	A	220	6	2.63%	2	2	93	93	0.015108791157819889	1	1	75	145	4	2	-G
H3_BC87_191109_LF_LIB_consensus_vsearch	3673	G	G	218	3	1.36%	2	1	93	93	0.12414965986396012	1	1	72	146	3	0	A
H3_BC87_191109_LF_LIB_consensus_vsearch	3674	G	G	221	6	2.63%	2	2	93	93	0.015111054918444918	1	1	74	147	5	1	A
H3_BC87_191109_LF_LIB_consensus_vsearch	3675	C	Y	212	7	3.06%	2	1	93	93	0.00744137624879223	1	1	74	138	0	7	T
H3_BC87_191109_LF_LIB_consensus_vsearch	3676	T	T	219	3	1.35%	2	2	93	93	0.12415349887135622	1	1	73	146	1	2	C
H3_BC87_191109_LF_LIB_consensus_vsearch	3677	T	*/+G	212	8	3.54%	2	1	93	93	0.003661360523321731	1	1	75	137	0	8	+G
H3_BC87_191109_LF_LIB_consensus_vsearch	3678	G	G	228	1	0.44%	2	1	93	93	0.4999999999999138	1	1	79	149	1	0	T
H3_BC87_191109_LF_LIB_consensus_vsearch	3679	A	A	227	1	0.44%	2	1	93	93	0.4999999999999138	1	1	80	147	0	1	+T
H3_BC87_191109_LF_LIB_consensus_vsearch	3680	C	*/-AC	202	15	6.58%	2	2	93	93	2.375885795125084E-5	1	1	67	135	11	4	-AC
H3_BC87_191109_LF_LIB_consensus_vsearch	3681	A	A	207	3	1.41%	2	1	93	93	0.12410501193315207	1	1	67	140	0	3	+T
H3_BC87_191109_LF_LIB_consensus_vsearch	3682	C	C	210	1	0.47%	2	1	93	93	0.4999999999999138	1	1	69	141	0	1	+G
H3_BC87_191109_LF_LIB_consensus_vsearch	3683	G	G	223	1	0.44%	2	1	93	93	0.5000000000003686	1	1	80	143	0	1	+C
H3_BC87_191109_LF_LIB_consensus_vsearch	3684	C	C	220	2	0.88%	2	2	93	93	0.2494356659142869	1	1	78	142	1	1	-G
H3_BC87_191109_LF_LIB_consensus_vsearch	3685	G	G	219	4	1.78%	2	2	93	93	0.06165825449566743	1	1	74	145	3	1	-A
H3_BC87_191109_LF_LIB_consensus_vsearch	3686	A	A	218	3	1.34%	2	2	93	93	0.12414965986396012	1	1	75	143	1	2	+G
H3_BC87_191109_LF_LIB_consensus_vsearch	3687	G	G	223	3	1.33%	2	2	93	93	0.12416851441234596	1	1	79	144	1	2	-T
H3_BC87_191109_LF_LIB_consensus_vsearch	3688	T	T	217	3	1.33%	2	2	93	93	0.12414578587710072	1	1	73	144	1	2	+G
H3_BC87_191109_LF_LIB_consensus_vsearch	3689	G	*/-TG	204	16	6.99%	2	2	93	93	1.1500698432241858E-5	1	1	76	128	2	14	-TG
H3_BC87_191109_LF_LIB_consensus_vsearch	3690	T	T	202	3	1.42%	2	2	93	93	0.12408312958435573	1	1	75	127	1	2	-G
H3_BC87_191109_LF_LIB_consensus_vsearch	3691	G	G	202	4	1.91%	2	2	93	93	0.06158870665501416	1	1	74	128	3	1	A
H3_BC87_191109_LF_LIB_consensus_vsearch	3692	G	G	225	2	0.88%	2	1	93	93	0.24944812362040697	1	1	80	145	0	2	-C
H3_BC87_191109_LF_LIB_consensus_vsearch	3693	C	C	222	2	0.88%	2	1	93	93	0.24944071588395061	1	1	80	142	0	2	-T
H3_BC87_191109_LF_LIB_consensus_vsearch	3694	T	*/-G	205	19	8.37%	2	1	93	93	1.2807606843266436E-6	1	1	78	127	0	19	-G
H3_BC87_191109_LF_LIB_consensus_vsearch	3695	G	G	205	2	0.95%	2	1	93	93	0.24939467312372118	1	1	79	126	0	2	C
H3_BC87_191109_LF_LIB_consensus_vsearch	3696	G	G	225	2	0.87%	2	1	93	93	0.24944812362040697	1	1	80	145	0	2	-AG
H3_BC87_191109_LF_LIB_consensus_vsearch	3697	A	A	221	2	0.88%	2	1	93	93	0.24943820224728358	1	1	77	144	2	0	+G
H3_BC87_191109_LF_LIB_consensus_vsearch	3698	G	G	222	4	1.77%	2	1	93	93	0.061669440342892484	1	1	76	146	4	0	A
H3_BC87_191109_LF_LIB_consensus_vsearch	3699	C	C	225	2	0.87%	2	1	93	93	0.24944812362040697	1	1	80	145	0	2	-A
H3_BC87_191109_LF_LIB_consensus_vsearch	3700	A	A	219	3	1.32%	2	2	93	93	0.12415349887135622	1	1	78	141	1	2	G
H3_BC87_191109_LF_LIB_consensus_vsearch	3701	G	R	203	11	4.85%	2	1	93	93	4.280077806644155E-4	1	1	67	136	11	0	A
H3_BC87_191109_LF_LIB_consensus_vsearch	3702	C	C	215	3	1.36%	2	1	93	93	0.12413793103441495	1	1	78	137	0	3	+T
H3_BC87_191109_LF_LIB_consensus_vsearch	3703	C	*/-T	213	9	3.93%	2	1	93	93	0.0017981564163397133	1	1	79	134	0	9	-T
H3_BC87_191109_LF_LIB_consensus_vsearch	3704	T	T	210	4	1.82%	2	2	93	93	0.06162281305968737	1	1	76	134	2	2	-CT
H3_BC87_191109_LF_LIB_consensus_vsearch	3705	C	*/-T	214	8	3.56%	2	1	93	93	0.003663533633296164	1	1	78	136	0	8	-T
H3_BC87_191109_LF_LIB_consensus_vsearch	3706	T	*/+G	200	7	3.24%	2	1	93	93	0.007420075094973923	1	1	69	131	7	0	+G
H3_BC87_191109_LF_LIB_consensus_vsearch	3707	A	R	207	11	4.87%	2	2	93	93	4.2906952287648286E-4	1	1	70	137	10	1	G
H3_BC87_191109_LF_LIB_consensus_vsearch	3708	G	G	220	1	0.45%	2	1	93	93	0.4999999999999138	1	1	80	140	0	1	-TG
H3_BC87_191109_LF_LIB_consensus_vsearch	3709	T	T	223	3	1.32%	2	1	93	93	0.12416851441234596	1	1	80	143	0	3	C
H3_BC87_191109_LF_LIB_consensus_vsearch	3710	G	G	221	5	2.2%	2	2	93	93	0.03055941016990272	1	1	76	145	3	2	A
H3_BC87_191109_LF_LIB_consensus_vsearch	3711	C	C	223	2	0.88%	2	1	93	93	0.24944320712692292	1	1	75	148	2	0	+GC
H3_BC87_191109_LF_LIB_consensus_vsearch	3712	C	C	221	5	2.18%	2	2	93	93	0.03055941016990272	1	1	77	144	1	4	T
H3_BC87_191109_LF_LIB_consensus_vsearch	3713	G	G	225	1	0.44%	2	1	93	93	0.5000000000003686	1	1	77	148	0	1	+CCG
H3_BC87_191109_LF_LIB_consensus_vsearch	3714	A	A	223	2	0.88%	2	1	93	93	0.24944320712692292	1	1	76	147	2	0	+CG
H3_BC87_191109_LF_LIB_consensus_vsearch	3715	T	T	226	2	0.87%	2	2	93	93	0.24945054945064127	1	1	79	147	1	1	C
H3_BC87_191109_LF_LIB_consensus_vsearch	3716	C	*/-T	218	9	3.95%	2	1	93	93	0.001801496644156972	1	1	80	138	0	9	-T
H3_BC87_191109_LF_LIB_consensus_vsearch	3717	T	T	219	1	0.45%	2	1	93	93	0.4999999999999138	1	1	80	139	0	1	C
H3_BC87_191109_LF_LIB_consensus_vsearch	3718	T	*/-G	212	13	5.68%	2	1	93	93	1.0213418662308634E-4	1	1	80	132	0	13	-G
H3_BC87_191109_LF_LIB_consensus_vsearch	3719	G	G	209	3	1.4%	2	1	93	93	0.12411347517731831	1	1	77	132	3	0	+A
H3_BC87_191109_LF_LIB_consensus_vsearch	3720	G	G	222	4	1.76%	2	2	93	93	0.061669440342892484	1	1	78	144	1	3	A
H3_BC87_191109_LF_LIB_consensus_vsearch	3721	T	Y	214	8	3.52%	2	1	93	93	0.003663533633296164	1	1	80	134	0	8	C
H3_BC87_191109_LF_LIB_consensus_vsearch	3722	G	R	218	7	3.11%	2	2	93	93	0.007451182688346346	1	1	77	141	3	4	A
H3_BC87_191109_LF_LIB_consensus_vsearch	3723	G	G	224	1	0.44%	2	1	93	93	0.4999999999999138	1	1	79	145	0	1	-C
H3_BC87_191109_LF_LIB_consensus_vsearch	3724	C	C	222	1	0.44%	2	1	93	93	0.4999999999999138	1	1	78	144	1	0	+G
H3_BC87_191109_LF_LIB_consensus_vsearch	3725	A	R	211	14	6.19%	2	2	93	93	4.9547934929218304E-5	1	1	66	145	13	1	G
H3_BC87_191109_LF_LIB_consensus_vsearch	3726	G	G	218	3	1.32%	2	1	93	93	0.12414965986396012	1	1	78	140	0	3	-TA
H3_BC87_191109_LF_LIB_consensus_vsearch	3727	T	T	216	2	0.9%	2	1	93	93	0.249425287356441	1	1	78	138	0	2	+A
H3_BC87_191109_LF_LIB_consensus_vsearch	3728	A	A	212	4	1.8%	2	1	93	93	0.061630944461591126	1	1	72	140	4	0	G
H3_BC87_191109_LF_LIB_consensus_vsearch	3729	G	G	220	1	0.45%	2	1	93	93	0.4999999999999138	1	1	77	143	1	0	+C
H3_BC87_191109_LF_LIB_consensus_vsearch	3730	C	*/-A	197	13	5.8%	2	2	93	93	1.0080182645455998E-4	1	1	70	127	2	11	-A
H3_BC87_191109_LF_LIB_consensus_vsearch	3731	A	A	209	3	1.42%	2	1	93	93	0.12411347517731831	1	1	77	132	0	3	T
H3_BC87_191109_LF_LIB_consensus_vsearch	3732	A	A	224	1	0.44%	2	1	93	93	0.4999999999999138	1	1	78	146	0	1	+T
H3_BC87_191109_LF_LIB_consensus_vsearch	3733	A	A	221	4	1.76%	2	2	93	93	0.06166574490670126	1	1	78	143	2	2	G
H3_BC87_191109_LF_LIB_consensus_vsearch	3734	T	T	220	3	1.32%	2	1	93	93	0.12415730337075404	1	1	79	141	0	3	C
H3_BC87_191109_LF_LIB_consensus_vsearch	3735	A	A	218	3	1.33%	2	1	93	93	0.12414965986396012	1	1	78	140	0	3	-T
H3_BC87_191109_LF_LIB_consensus_vsearch	3736	T	T	221	1	0.45%	2	1	93	93	0.4999999999999138	1	1	79	142	0	1	+C
H3_BC87_191109_LF_LIB_consensus_vsearch	3737	T	T	219	3	1.32%	2	1	93	93	0.12415349887135622	1	1	78	141	0	3	G
H3_BC87_191109_LF_LIB_consensus_vsearch	3738	C	C	221	3	1.32%	2	1	93	93	0.12416107382546236	1	1	79	142	0	3	-T
H3_BC87_191109_LF_LIB_consensus_vsearch	3739	T	T	216	4	1.78%	2	2	93	93	0.061646763238677425	1	1	77	139	2	2	C
H3_BC87_191109_LF_LIB_consensus_vsearch	3740	C	*/+AA	206	7	3.1%	2	1	93	93	0.007431022745174962	1	1	77	129	0	7	+AA
H3_BC87_191109_LF_LIB_consensus_vsearch	3741	G	R	207	12	5.33%	2	1	93	93	2.091345729349345E-4	1	1	77	130	0	12	A
H3_BC87_191109_LF_LIB_consensus_vsearch	3742	T	W	203	17	7.52%	2	2	93	93	5.533354906074952E-6	1	1	76	127	1	16	A
H3_BC87_191109_LF_LIB_consensus_vsearch	3743	G	R	213	10	4.39%	2	2	93	93	8.808946039600796E-4	1	1	76	137	2	8	A
H3_BC87_191109_LF_LIB_consensus_vsearch	3744	C	Y	199	11	4.89%	2	1	93	93	4.2690732409863933E-4	1	1	74	125	0	11	T
H3_BC87_191109_LF_LIB_consensus_vsearch	3745	G	G	216	2	0.9%	2	1	93	93	0.249425287356441	1	1	72	144	2	0	+A
H3_BC87_191109_LF_LIB_consensus_vsearch	3746	A	A	221	3	1.32%	2	1	93	93	0.12416107382546236	1	1	75	146	0	3	G
H3_BC87_191109_LF_LIB_consensus_vsearch	3747	G	*/-C	221	7	3.07%	2	2	93	93	0.007455894130096957	1	1	75	146	4	3	-C
H3_BC87_191109_LF_LIB_consensus_vsearch	3748	C	C	218	1	0.45%	2	1	93	93	0.5000000000003686	1	1	74	144	0	1	+TT
H3_BC87_191109_LF_LIB_consensus_vsearch	3749	C	*/-G	192	25	10.92%	2	2	93	93	1.4318453833139122E-8	1	1	70	122	8	17	-G
H3_BC87_191109_LF_LIB_consensus_vsearch	3750	G	R	188	8	3.98%	2	1	93	93	0.0036318839680821967	1	1	62	126	8	0	A
H3_BC87_191109_LF_LIB_consensus_vsearch	3751	G	G	223	1	0.44%	2	1	93	93	0.5000000000003686	1	1	79	144	1	0	A
H3_BC87_191109_LF_LIB_consensus_vsearch	3752	G	G	222	2	0.87%	2	1	93	93	0.24944071588395061	1	1	77	145	2	0	-A
H3_BC87_191109_LF_LIB_consensus_vsearch	3753	A	A	219	4	1.79%	2	2	93	93	0.06165825449566743	1	1	77	142	1	3	G
H3_BC87_191109_LF_LIB_consensus_vsearch	3754	A	A	220	3	1.33%	2	2	93	93	0.12415730337075404	1	1	78	142	1	2	-G
H3_BC87_191109_LF_LIB_consensus_vsearch	3755	G	G	223	0	0%	2	0	93	0	1.0	1	0	79	144	0	0	
H3_BC87_191109_LF_LIB_consensus_vsearch	3756	G	G	220	3	1.33%	2	1	93	93	0.12415730337075404	1	1	79	141	0	3	+C
H3_BC87_191109_LF_LIB_consensus_vsearch	3757	C	Y	214	9	3.96%	2	1	93	93	0.0017988361772468277	1	1	78	136	0	9	T
H3_BC87_191109_LF_LIB_consensus_vsearch	3758	T	*/+G	208	8	3.56%	2	1	93	93	0.0036568954742723925	1	1	78	130	0	8	+G
H3_BC87_191109_LF_LIB_consensus_vsearch	3759	G	G	226	1	0.44%	2	1	93	93	0.4999999999999138	1	1	79	147	1	0	-A
H3_BC87_191109_LF_LIB_consensus_vsearch	3760	A	A	224	3	1.32%	2	1	93	93	0.12417218543044797	1	1	76	148	3	0	G
H3_BC87_191109_LF_LIB_consensus_vsearch	3761	T	T	227	1	0.44%	2	1	93	93	0.4999999999999138	1	1	79	148	1	0	A
H3_BC87_191109_LF_LIB_consensus_vsearch	3762	G	G	218	6	2.62%	2	1	93	93	0.015104203282490625	1	1	79	139	0	6	-TG
H3_BC87_191109_LF_LIB_consensus_vsearch	3763	T	*/-G	203	7	3.21%	2	2	93	93	0.007425626339083171	1	1	73	130	2	5	-G
H3_BC87_191109_LF_LIB_consensus_vsearch	3764	G	G	208	2	0.94%	2	2	93	93	0.24940334128888852	1	1	73	135	1	1	+A
H3_BC87_191109_LF_LIB_consensus_vsearch	3765	G	G	224	1	0.44%	2	1	93	93	0.4999999999999138	1	1	75	149	1	0	+TGAG
H3_BC87_191109_LF_LIB_consensus_vsearch	3766	A	A	220	3	1.32%	2	2	93	93	0.12415730337075404	1	1	73	147	2	1	G
H3_BC87_191109_LF_LIB_consensus_vsearch	3767	G	*/-A	211	9	3.98%	2	2	93	93	0.0017967787753331713	1	1	64	147	8	1	-A
H3_BC87_191109_LF_LIB_consensus_vsearch	3768	A	A	217	0	0%	2	0	93	0	1.0	1	0	70	147	0	0	
H3_BC87_191109_LF_LIB_consensus_vsearch	3769	A	A	226	1	0.44%	2	1	93	93	0.4999999999999138	1	1	78	148	0	1	G
H3_BC87_191109_LF_LIB_consensus_vsearch	3770	A	A	226	1	0.44%	2	1	93	93	0.4999999999999138	1	1	78	148	0	1	+G
H3_BC87_191109_LF_LIB_consensus_vsearch	3771	G	G	225	1	0.44%	2	1	93	93	0.5000000000003686	1	1	77	148	0	1	+CG
H3_BC87_191109_LF_LIB_consensus_vsearch	3772	G	G	223	3	1.32%	2	2	93	93	0.12416851441234596	1	1	76	147	1	2	-T
H3_BC87_191109_LF_LIB_consensus_vsearch	3773	T	T	223	1	0.44%	2	1	93	93	0.5000000000003686	1	1	78	145	0	1	+C
H3_BC87_191109_LF_LIB_consensus_vsearch	3774	T	*/-C	193	35	15.28%	2	2	93	93	7.082780409997741E-12	1	1	54	139	25	10	-C
H3_BC87_191109_LF_LIB_consensus_vsearch	3775	C	C	190	3	1.55%	2	1	93	93	0.12402597402595401	1	1	52	138	3	0	+A
H3_BC87_191109_LF_LIB_consensus_vsearch	3776	C	*/-T	218	10	4.37%	2	2	93	93	8.829313223014774E-4	1	1	77	141	3	7	-T
H3_BC87_191109_LF_LIB_consensus_vsearch	3777	T	T	207	6	2.75%	2	1	93	93	0.015077437453979417	1	1	76	131	0	6	C
H3_BC87_191109_LF_LIB_consensus_vsearch	3778	G	G	221	2	0.89%	2	1	93	93	0.24943820224728358	1	1	76	145	2	0	A
H3_BC87_191109_LF_LIB_consensus_vsearch	3779	G	G	219	4	1.75%	2	1	93	93	0.06165825449566743	1	1	77	142	0	4	-C
H3_BC87_191109_LF_LIB_consensus_vsearch	3780	C	Y	197	11	4.91%	2	1	93	93	4.263419112240475E-4	1	1	78	119	0	11	T
H3_BC87_191109_LF_LIB_consensus_vsearch	3781	T	T	218	1	0.45%	2	1	93	93	0.5000000000003686	1	1	77	141	0	1	+C
H3_BC87_191109_LF_LIB_consensus_vsearch	3782	T	T	212	6	2.65%	2	2	93	93	0.015089936987088519	1	1	76	136	1	5	C
H3_BC87_191109_LF_LIB_consensus_vsearch	3783	A	R	212	9	3.96%	2	2	93	93	0.00179747064240055	1	1	70	142	5	4	G
H3_BC87_191109_LF_LIB_consensus_vsearch	3784	C	C	212	5	2.21%	2	1	93	93	0.030530802741347875	1	1	75	137	0	5	T
H3_BC87_191109_LF_LIB_consensus_vsearch	3785	C	C	219	5	2.2%	2	1	93	93	0.030553251388732716	1	1	75	144	0	5	T
H3_BC87_191109_LF_LIB_consensus_vsearch	3786	G	G	223	2	0.88%	2	2	93	93	0.24944320712692292	1	1	76	147	1	1	+C
H3_BC87_191109_LF_LIB_consensus_vsearch	3787	T	*/-A	209	10	4.39%	2	2	93	93	8.792003591123169E-4	1	1	75	134	1	9	-A
H3_BC87_191109_LF_LIB_consensus_vsearch	3788	A	A	217	1	0.46%	2	1	93	93	0.4999999999999138	1	1	78	139	1	0	+C
H3_BC87_191109_LF_LIB_consensus_vsearch	3789	A	A	227	1	0.44%	2	1	93	93	0.4999999999999138	1	1	79	148	1	0	-TG
H3_BC87_191109_LF_LIB_consensus_vsearch	3790	T	Y	213	10	4.39%	2	1	93	93	8.808946039600796E-4	1	1	75	138	0	10	C
H3_BC87_191109_LF_LIB_consensus_vsearch	3791	G	G	220	3	1.32%	2	2	93	93	0.12415730337075404	1	1	75	145	2	1	+A
H3_BC87_191109_LF_LIB_consensus_vsearch	3792	G	G	226	1	0.44%	2	1	93	93	0.4999999999999138	1	1	79	147	0	1	+C
H3_BC87_191109_LF_LIB_consensus_vsearch	3793	T	T	224	2	0.88%	2	1	93	93	0.24944567627499675	1	1	79	145	0	2	A
H3_BC87_191109_LF_LIB_consensus_vsearch	3794	G	G	224	2	0.87%	2	1	93	93	0.24944567627499675	1	1	76	148	2	0	+C
H3_BC87_191109_LF_LIB_consensus_vsearch	3795	C	C	223	2	0.88%	2	1	93	93	0.24944320712692292	1	1	79	144	0	2	T
H3_BC87_191109_LF_LIB_consensus_vsearch	3796	C	*/-G	191	13	5.68%	2	2	93	93	1.0021782040526559E-4	1	1	68	123	5	8	-G
H3_BC87_191109_LF_LIB_consensus_vsearch	3797	G	R	195	7	3.43%	2	2	93	93	0.007410460397262536	1	1	65	130	5	2	A
H3_BC87_191109_LF_LIB_consensus_vsearch	3798	G	G	209	6	2.76%	2	2	93	93	0.015082506692930204	1	1	70	139	5	1	A
H3_BC87_191109_LF_LIB_consensus_vsearch	3799	G	G	216	6	2.67%	2	2	93	93	0.015099533131216845	1	1	76	140	3	3	A
H3_BC87_191109_LF_LIB_consensus_vsearch	3800	G	G	221	2	0.88%	2	1	93	93	0.24943820224728358	1	1	78	143	0	2	-T
H3_BC87_191109_LF_LIB_consensus_vsearch	3801	T	T	209	5	2.22%	2	1	93	93	0.030520732883336912	1	1	74	135	0	5	C
H3_BC87_191109_LF_LIB_consensus_vsearch	3802	G	G	220	3	1.33%	2	2	93	93	0.12415730337075404	1	1	76	144	2	1	-A
H3_BC87_191109_LF_LIB_consensus_vsearch	3803	A	A	215	3	1.33%	2	2	93	93	0.12413793103441495	1	1	73	142	1	2	C
H3_BC87_191109_LF_LIB_consensus_vsearch	3804	G	G	220	3	1.33%	2	1	93	93	0.12415730337075404	1	1	78	142	0	3	A
H3_BC87_191109_LF_LIB_consensus_vsearch	3805	T	T	222	4	1.76%	2	2	93	93	0.061669440342892484	1	1	77	145	2	2	-C
H3_BC87_191109_LF_LIB_consensus_vsearch	3806	C	C	220	1	0.44%	2	1	93	93	0.4999999999999138	1	1	76	144	1	0	+A
H3_BC87_191109_LF_LIB_consensus_vsearch	3807	G	G	224	1	0.44%	2	1	93	93	0.4999999999999138	1	1	78	146	0	1	+TG
H3_BC87_191109_LF_LIB_consensus_vsearch	3808	A	A	222	4	1.77%	2	1	93	93	0.061669440342892484	1	1	78	144	0	4	-T
H3_BC87_191109_LF_LIB_consensus_vsearch	3809	T	*/-C	187	34	15.18%	2	2	93	93	1.4719290601018672E-11	1	1	54	133	24	10	-C
H3_BC87_191109_LF_LIB_consensus_vsearch	3810	C	Y	176	8	4.19%	2	1	93	93	0.0036143155518784634	1	1	53	123	0	8	T
H3_BC87_191109_LF_LIB_consensus_vsearch	3811	C	*/-T	203	11	4.89%	2	2	93	93	4.280077806644155E-4	1	1	77	126	1	10	-T
H3_BC87_191109_LF_LIB_consensus_vsearch	3812	T	*/-A	197	10	4.63%	2	2	93	93	8.737377439902802E-4	1	1	76	121	1	9	-A
H3_BC87_191109_LF_LIB_consensus_vsearch	3813	A	A	199	6	2.84%	2	1	93	93	0.015056176425366772	1	1	77	122	0	6	G
H3_BC87_191109_LF_LIB_consensus_vsearch	3814	A	R	200	12	5.43%	2	2	93	93	2.0803866112796158E-4	1	1	77	123	1	11	G
H3_BC87_191109_LF_LIB_consensus_vsearch	3815	G	G	218	2	0.89%	2	1	93	93	0.24943052391823226	1	1	76	142	0	2	-CG
H3_BC87_191109_LF_LIB_consensus_vsearch	3816	C	C	210	4	1.77%	2	2	93	93	0.06162281305968737	1	1	78	132	1	3	T
H3_BC87_191109_LF_LIB_consensus_vsearch	3817	G	G	217	3	1.36%	2	2	93	93	0.12414578587710072	1	1	78	139	2	1	A
H3_BC87_191109_LF_LIB_consensus_vsearch	3818	G	G	224	1	0.44%	2	1	93	93	0.4999999999999138	1	1	78	146	1	0	-TAG
H3_BC87_191109_LF_LIB_consensus_vsearch	3819	T	T	221	2	0.88%	2	1	93	93	0.24943820224728358	1	1	77	144	0	2	C
H3_BC87_191109_LF_LIB_consensus_vsearch	3820	A	A	221	3	1.32%	2	1	93	93	0.12416107382546236	1	1	78	143	0	3	G
H3_BC87_191109_LF_LIB_consensus_vsearch	3821	G	*/-C	213	7	3.1%	2	1	93	93	0.007443047448823043	1	1	65	148	7	0	-C
H3_BC87_191109_LF_LIB_consensus_vsearch	3822	C	C	217	2	0.9%	2	2	93	93	0.24942791762028085	1	1	72	145	1	1	A
H3_BC87_191109_LF_LIB_consensus_vsearch	3823	C	C	222	3	1.31%	2	1	93	93	0.12416481069040536	1	1	80	142	0	3	-T
H3_BC87_191109_LF_LIB_consensus_vsearch	3824	T	T	212	4	1.78%	2	1	93	93	0.061630944461591126	1	1	79	133	0	4	C
H3_BC87_191109_LF_LIB_consensus_vsearch	3825	A	A	222	2	0.88%	2	1	93	93	0.24944071588395061	1	1	78	144	0	2	G
H3_BC87_191109_LF_LIB_consensus_vsearch	3826	A	A	218	3	1.32%	2	1	93	93	0.12414965986396012	1	1	74	144	3	0	G
H3_BC87_191109_LF_LIB_consensus_vsearch	3827	C	C	215	4	1.76%	2	1	93	93	0.06164286277914926	1	1	76	139	0	4	T
H3_BC87_191109_LF_LIB_consensus_vsearch	3828	G	G	217	3	1.35%	2	1	93	93	0.12414578587710072	1	1	77	140	0	3	T
H3_BC87_191109_LF_LIB_consensus_vsearch	3829	G	*/+T	206	7	3.11%	2	1	93	93	0.007431022745174962	1	1	76	130	0	7	+T
H3_BC87_191109_LF_LIB_consensus_vsearch	3830	C	Y	183	13	5.94%	2	1	93	93	9.938754956784761E-5	1	1	74	109	0	13	T
H3_BC87_191109_LF_LIB_consensus_vsearch	3831	T	T	210	1	0.47%	2	1	93	93	0.4999999999999138	1	1	75	135	0	1	+ACT
H3_BC87_191109_LF_LIB_consensus_vsearch	3832	T	T	211	3	1.37%	2	2	93	93	0.12412177985949331	1	1	70	141	2	1	+C
H3_BC87_191109_LF_LIB_consensus_vsearch	3833	T	T	212	4	1.79%	2	2	93	93	0.061630944461591126	1	1	75	137	1	3	-A
H3_BC87_191109_LF_LIB_consensus_vsearch	3834	A	A	217	2	0.9%	2	1	93	93	0.24942791762028085	1	1	78	139	0	2	+C
H3_BC87_191109_LF_LIB_consensus_vsearch	3835	A	A	210	5	2.21%	2	2	93	93	0.0305241206880699	1	1	75	135	1	4	-T
H3_BC87_191109_LF_LIB_consensus_vsearch	3836	T	T	210	6	2.75%	2	1	93	93	0.01508500627971554	1	1	78	132	0	6	C
H3_BC87_191109_LF_LIB_consensus_vsearch	3837	T	T	212	6	2.67%	2	1	93	93	0.015089936987088519	1	1	80	132	0	6	C
H3_BC87_191109_LF_LIB_consensus_vsearch	3838	T	T	202	6	2.63%	2	2	93	93	0.015064340002589747	1	1	76	126	4	2	+C
H3_BC87_191109_LF_LIB_consensus_vsearch	3839	C	*/-A	194	13	5.86%	2	2	93	93	1.0051376512604206E-4	1	1	74	120	5	8	-A
H3_BC87_191109_LF_LIB_consensus_vsearch	3840	A	A	186	6	2.94%	2	1	93	93	0.015017869058322414	1	1	73	113	0	6	T
H3_BC87_191109_LF_LIB_consensus_vsearch	3841	A	A	201	6	2.74%	2	1	93	93	0.01506164496890816	1	1	77	124	0	6	T
H3_BC87_191109_LF_LIB_consensus_vsearch	3842	G	K	192	16	7.34%	2	2	93	93	1.1307383330374262E-5	1	1	73	119	1	15	T
H3_BC87_191109_LF_LIB_consensus_vsearch	3843	G	*/-CG	208	12	5.33%	2	1	93	93	2.0928573468617033E-4	1	1	78	130	0	12	-CG
H3_BC87_191109_LF_LIB_consensus_vsearch	3844	C	C	205	3	1.4%	2	1	93	93	0.12409638554214404	1	1	78	127	0	3	T
H3_BC87_191109_LF_LIB_consensus_vsearch	3845	G	G	204	4	1.86%	2	2	93	93	0.06159747950639958	1	1	77	127	3	1	A
H3_BC87_191109_LF_LIB_consensus_vsearch	3846	T	T	219	5	2.19%	2	1	93	93	0.030553251388732716	1	1	79	140	0	5	-C
H3_BC87_191109_LF_LIB_consensus_vsearch	3847	C	*/-T	209	9	4.02%	2	1	93	93	0.0017953764342624938	1	1	79	130	0	9	-T
H3_BC87_191109_LF_LIB_consensus_vsearch	3848	T	T	208	6	2.74%	2	1	93	93	0.015079983859610983	1	1	76	132	0	6	C
H3_BC87_191109_LF_LIB_consensus_vsearch	3849	C	C	210	5	2.23%	2	1	93	93	0.0305241206880699	1	1	74	136	0	5	-G
H3_BC87_191109_LF_LIB_consensus_vsearch	3850	G	G	217	2	0.9%	2	1	93	93	0.24942791762028085	1	1	76	141	2	0	T
H3_BC87_191109_LF_LIB_consensus_vsearch	3851	C	C	224	1	0.44%	2	1	93	93	0.4999999999999138	1	1	77	147	0	1	+T
H3_BC87_191109_LF_LIB_consensus_vsearch	3852	G	G	227	0	0%	2	0	93	0	1.0	1	0	78	149	0	0	
H3_BC87_191109_LF_LIB_consensus_vsearch	3853	C	*/-GC	203	23	10.13%	2	2	93	93	6.612552632176875E-8	1	1	64	139	13	10	-GC
H3_BC87_191109_LF_LIB_consensus_vsearch	3854	G	G	202	1	0.49%	2	1	93	93	0.4999999999999138	1	1	64	138	0	1	-C
H3_BC87_191109_LF_LIB_consensus_vsearch	3855	C	C	197	2	0.99%	2	2	93	93	0.2493702770781863	1	1	60	137	1	1	+GC
H3_BC87_191109_LF_LIB_consensus_vsearch	3856	C	C	216	6	2.63%	2	1	93	93	0.015099533131216845	1	1	76	140	0	6	-T
H3_BC87_191109_LF_LIB_consensus_vsearch	3857	T	T	218	1	0.45%	2	1	93	93	0.5000000000003686	1	1	76	142	1	0	+C
H3_BC87_191109_LF_LIB_consensus_vsearch	3858	T	T	218	4	1.76%	2	2	93	93	0.061654458623218986	1	1	75	143	2	2	C
H3_BC87_191109_LF_LIB_consensus_vsearch	3859	G	G	220	5	2.21%	2	1	93	93	0.03055634444922604	1	1	74	146	5	0	A
H3_BC87_191109_LF_LIB_consensus_vsearch	3860	G	G	219	4	1.75%	2	1	93	93	0.06165825449566743	1	1	74	145	4	0	-C
H3_BC87_191109_LF_LIB_consensus_vsearch	3861	C	C	216	5	2.24%	2	2	93	93	0.030543804461782422	1	1	74	142	1	4	T
H3_BC87_191109_LF_LIB_consensus_vsearch	3862	C	Y	194	28	12.33%	2	1	93	93	1.5021880097714738E-9	1	1	79	115	0	28	T
H3_BC87_191109_LF_LIB_consensus_vsearch	3863	G	G	224	1	0.44%	2	1	93	93	0.4999999999999138	1	1	79	145	0	1	+C
H3_BC87_191109_LF_LIB_consensus_vsearch	3864	C	Y	208	16	7.02%	2	1	93	93	1.1561030828960615E-5	1	1	77	131	0	16	T
H3_BC87_191109_LF_LIB_consensus_vsearch	3865	T	T	217	5	2.23%	2	1	93	93	0.03054698177238809	1	1	76	141	0	5	C
H3_BC87_191109_LF_LIB_consensus_vsearch	3866	G	*/-A	42	157	69.78%	2	2	93	93	6.857801126808559E-72	1	1	23	19	36	121	-A
H3_BC87_191109_LF_LIB_consensus_vsearch	3867	A	R	31	9	20.45%	2	1	93	93	0.0011791225940696183	1	1	23	8	0	9	G
H3_BC87_191109_LF_LIB_consensus_vsearch	3868	A	A	199	2	0.99%	2	1	93	93	0.24937655860363442	1	1	60	139	0	2	G
H3_BC87_191109_LF_LIB_consensus_vsearch	3869	A	A	207	2	0.94%	2	2	93	93	0.24940047961641743	1	1	68	139	1	1	+G
H3_BC87_191109_LF_LIB_consensus_vsearch	3870	A	*/-G	123	88	39.46%	2	2	93	93	3.0271959310087856E-32	1	1	26	97	44	44	-G
H3_BC87_191109_LF_LIB_consensus_vsearch	3871	G	G	123	6	4.48%	2	1	93	93	0.014723749883521119	1	1	27	96	0	6	+C
H3_BC87_191109_LF_LIB_consensus_vsearch	3872	G	G	216	3	1.35%	2	2	93	93	0.12414187643025615	1	1	73	143	1	2	T
H3_BC87_191109_LF_LIB_consensus_vsearch	3873	G	*/-A	199	9	4.02%	2	2	93	93	0.0017879699024036485	1	1	68	131	6	3	-A
H3_BC87_191109_LF_LIB_consensus_vsearch	3874	A	A	210	1	0.47%	2	1	93	93	0.4999999999999138	1	1	69	141	0	1	T
H3_BC87_191109_LF_LIB_consensus_vsearch	3875	A	A	222	1	0.45%	2	1	93	93	0.4999999999999138	1	1	78	144	0	1	G
H3_BC87_191109_LF_LIB_consensus_vsearch	3876	A	A	222	3	1.32%	2	1	93	93	0.12416481069040536	1	1	77	145	0	3	T
H3_BC87_191109_LF_LIB_consensus_vsearch	3877	G	G	224	1	0.44%	2	1	93	93	0.4999999999999138	1	1	76	148	1	0	+C
H3_BC87_191109_LF_LIB_consensus_vsearch	3878	C	C	223	4	1.76%	2	1	93	93	0.061673103185009646	1	1	78	145	0	4	T
H3_BC87_191109_LF_LIB_consensus_vsearch	3879	C	C	219	3	1.32%	2	1	93	93	0.12415349887135622	1	1	76	143	0	3	-GCT
H3_BC87_191109_LF_LIB_consensus_vsearch	3880	G	G	221	2	0.9%	2	2	93	93	0.24943820224728358	1	1	76	145	1	1	A
H3_BC87_191109_LF_LIB_consensus_vsearch	3881	C	C	218	2	0.88%	2	1	93	93	0.24943052391823226	1	1	78	140	0	2	-T
H3_BC87_191109_LF_LIB_consensus_vsearch	3882	T	Y	181	22	9.91%	2	2	93	93	1.3070401671130853E-7	1	1	62	119	1	21	C
H3_BC87_191109_LF_LIB_consensus_vsearch	3883	A	A	208	1	0.48%	2	1	93	93	0.5000000000001412	1	1	64	144	0	1	+CA
H3_BC87_191109_LF_LIB_consensus_vsearch	3884	A	A	227	1	0.44%	2	1	93	93	0.4999999999999138	1	1	79	148	0	1	C
H3_BC87_191109_LF_LIB_consensus_vsearch	3885	G	G	226	2	0.87%	2	1	93	93	0.24945054945064127	1	1	80	146	0	2	C
H3_BC87_191109_LF_LIB_consensus_vsearch	3886	A	A	228	1	0.44%	2	1	93	93	0.4999999999999138	1	1	80	148	0	1	-T
H3_BC87_191109_LF_LIB_consensus_vsearch	3887	T	*/+C	216	8	3.51%	2	1	93	93	0.003665668526289429	1	1	80	136	0	8	+C
H3_BC87_191109_LF_LIB_consensus_vsearch	3888	T	*/-C	220	7	3.06%	2	1	93	93	0.007454337359329176	1	1	80	140	0	7	-C
H3_BC87_191109_LF_LIB_consensus_vsearch	3889	C	*/-G	206	9	4.05%	2	2	93	93	0.001793225137980622	1	1	78	128	2	7	-G
H3_BC87_191109_LF_LIB_consensus_vsearch	3890	G	G	212	4	1.84%	2	1	93	93	0.061630944461591126	1	1	74	138	4	0	A
H3_BC87_191109_LF_LIB_consensus_vsearch	3891	G	G	222	3	1.33%	2	1	93	93	0.12416481069040536	1	1	79	143	0	3	A
H3_BC87_191109_LF_LIB_consensus_vsearch	3892	C	C	216	3	1.33%	2	2	93	93	0.12414187643025615	1	1	76	140	1	2	-T
H3_BC87_191109_LF_LIB_consensus_vsearch	3893	T	Y	208	9	4.04%	2	2	93	93	0.0017946657928001688	1	1	71	137	4	5	C
H3_BC87_191109_LF_LIB_consensus_vsearch	3894	A	R	210	8	3.56%	2	2	93	93	0.0036591481612605	1	1	71	139	2	6	G
H3_BC87_191109_LF_LIB_consensus_vsearch	3895	C	C	217	2	0.9%	2	1	93	93	0.24942791762028085	1	1	75	142	0	2	+A
H3_BC87_191109_LF_LIB_consensus_vsearch	3896	A	A	220	3	1.35%	2	2	93	93	0.12415730337075404	1	1	75	145	2	1	G
H3_BC87_191109_LF_LIB_consensus_vsearch	3897	A	A	218	6	2.64%	2	1	93	93	0.015104203282490625	1	1	72	146	6	0	G
H3_BC87_191109_LF_LIB_consensus_vsearch	3898	C	C	221	3	1.32%	2	1	93	93	0.12416107382546236	1	1	78	143	0	3	+G
H3_BC87_191109_LF_LIB_consensus_vsearch	3899	G	G	222	4	1.77%	2	2	93	93	0.061669440342892484	1	1	76	146	3	1	A
H3_BC87_191109_LF_LIB_consensus_vsearch	3900	G	G	227	1	0.44%	2	1	93	93	0.4999999999999138	1	1	79	148	0	1	-CA
H3_BC87_191109_LF_LIB_consensus_vsearch	3901	C	C	226	1	0.44%	2	1	93	93	0.4999999999999138	1	1	78	148	1	0	+G
H3_BC87_191109_LF_LIB_consensus_vsearch	3902	A	*/+G	201	14	6.14%	2	2	93	93	4.905414704302361E-5	1	1	72	129	3	11	+G
H3_BC87_191109_LF_LIB_consensus_vsearch	3903	G	G	215	3	1.35%	2	2	93	93	0.12413793103441495	1	1	75	140	1	2	A
H3_BC87_191109_LF_LIB_consensus_vsearch	3904	G	*/+A	210	13	5.68%	2	1	93	93	1.0196623731956113E-4	1	1	64	146	13	0	+A
H3_BC87_191109_LF_LIB_consensus_vsearch	3905	G	G	224	4	1.75%	2	2	93	93	0.06167673386217682	1	1	78	146	1	3	A
H3_BC87_191109_LF_LIB_consensus_vsearch	3906	T	T	218	4	1.75%	2	2	93	93	0.061654458623218986	1	1	76	142	2	2	C
H3_BC87_191109_LF_LIB_consensus_vsearch	3907	G	G	225	1	0.44%	2	1	93	93	0.5000000000003686	1	1	79	146	0	1	+CG
H3_BC87_191109_LF_LIB_consensus_vsearch	3908	A	A	213	6	2.64%	2	1	93	93	0.0150923687299321	1	1	73	140	0	6	+T
H3_BC87_191109_LF_LIB_consensus_vsearch	3909	C	*/-T	215	9	3.98%	2	2	93	93	0.0017995100038167202	1	1	76	139	1	8	-T
H3_BC87_191109_LF_LIB_consensus_vsearch	3910	T	T	211	3	1.36%	2	1	93	93	0.12412177985949331	1	1	74	137	0	3	C
H3_BC87_191109_LF_LIB_consensus_vsearch	3911	A	A	224	1	0.44%	2	1	93	93	0.4999999999999138	1	1	76	148	1	0	-T
H3_BC87_191109_LF_LIB_consensus_vsearch	3912	T	T	223	2	0.88%	2	1	93	93	0.24944320712692292	1	1	76	147	0	2	C
H3_BC87_191109_LF_LIB_consensus_vsearch	3913	T	T	221	2	0.88%	2	1	93	93	0.24943820224728358	1	1	78	143	0	2	-G
H3_BC87_191109_LF_LIB_consensus_vsearch	3914	G	G	225	2	0.88%	2	1	93	93	0.24944812362040697	1	1	78	147	2	0	A
H3_BC87_191109_LF_LIB_consensus_vsearch	3915	G	G	225	2	0.87%	2	1	93	93	0.24944812362040697	1	1	79	146	0	2	A
H3_BC87_191109_LF_LIB_consensus_vsearch	3916	C	C	221	3	1.32%	2	1	93	93	0.12416107382546236	1	1	79	142	0	3	-G
H3_BC87_191109_LF_LIB_consensus_vsearch	3917	G	R	216	7	3.11%	2	1	93	93	0.007447971960236055	1	1	72	144	7	0	A
H3_BC87_191109_LF_LIB_consensus_vsearch	3918	G	G	227	1	0.44%	2	1	93	93	0.4999999999999138	1	1	79	148	0	1	T
H3_BC87_191109_LF_LIB_consensus_vsearch	3919	C	C	221	2	0.88%	2	1	93	93	0.24943820224728358	1	1	77	144	0	2	T
H3_BC87_191109_LF_LIB_consensus_vsearch	3920	A	A	224	2	0.88%	2	2	93	93	0.24944567627499675	1	1	77	147	1	1	G
H3_BC87_191109_LF_LIB_consensus_vsearch	3921	A	A	220	4	1.76%	2	2	93	93	0.061662016439223415	1	1	75	145	3	1	G
H3_BC87_191109_LF_LIB_consensus_vsearch	3922	C	C	219	4	1.77%	2	1	93	93	0.06165825449566743	1	1	74	145	4	0	-GC
H3_BC87_191109_LF_LIB_consensus_vsearch	3923	G	G	217	2	0.9%	2	1	93	93	0.24942791762028085	1	1	70	147	2	0	-CT
H3_BC87_191109_LF_LIB_consensus_vsearch	3924	C	C	211	4	1.81%	2	2	93	93	0.06162689769249	1	1	69	142	1	3	T
H3_BC87_191109_LF_LIB_consensus_vsearch	3925	T	Y	209	9	4.02%	2	2	93	93	0.0017953764342624938	1	1	73	136	2	7	C
H3_BC87_191109_LF_LIB_consensus_vsearch	3926	G	G	223	1	0.44%	2	1	93	93	0.5000000000003686	1	1	77	146	0	1	+A
H3_BC87_191109_LF_LIB_consensus_vsearch	3927	A	A	221	2	0.88%	2	1	93	93	0.24943820224728358	1	1	74	147	0	2	+C
H3_BC87_191109_LF_LIB_consensus_vsearch	3928	C	C	219	6	2.64%	2	2	93	93	0.015106507368173285	1	1	76	143	1	5	T
H3_BC87_191109_LF_LIB_consensus_vsearch	3929	T	T	218	5	2.19%	2	2	93	93	0.030550130621104243	1	1	77	141	2	3	C
H3_BC87_191109_LF_LIB_consensus_vsearch	3930	G	G	226	1	0.44%	2	1	93	93	0.4999999999999138	1	1	78	148	1	0	-AC
H3_BC87_191109_LF_LIB_consensus_vsearch	3931	A	*/-C	203	11	4.82%	2	2	93	93	4.280077806644155E-4	1	1	65	138	3	8	-C
H3_BC87_191109_LF_LIB_consensus_vsearch	3932	C	C	207	0	0%	2	0	93	0	1.0	1	0	66	141	0	0	
H3_BC87_191109_LF_LIB_consensus_vsearch	3933	C	C	215	1	0.46%	2	1	93	93	0.4999999999999138	1	1	69	146	0	1	+T
H3_BC87_191109_LF_LIB_consensus_vsearch	3934	C	Y	196	15	6.55%	2	2	93	93	2.358427531063154E-5	1	1	70	126	2	13	T
H3_BC87_191109_LF_LIB_consensus_vsearch	3935	A	R	200	7	3.26%	2	2	93	93	0.007420075094973923	1	1	67	133	3	4	G
H3_BC87_191109_LF_LIB_consensus_vsearch	3936	A	*/-G	158	53	23.45%	2	2	93	93	2.631949547090463E-18	1	1	66	92	11	42	-G
H3_BC87_191109_LF_LIB_consensus_vsearch	3937	G	G	161	5	2.86%	2	1	93	93	0.030310195685913578	1	1	64	97	0	5	+C
H3_BC87_191109_LF_LIB_consensus_vsearch	3938	G	G	216	6	2.63%	2	1	93	93	0.015099533131216845	1	1	79	137	0	6	+C
H3_BC87_191109_LF_LIB_consensus_vsearch	3939	G	G	227	1	0.44%	2	1	93	93	0.4999999999999138	1	1	79	148	0	1	A
H3_BC87_191109_LF_LIB_consensus_vsearch	3940	A	A	225	1	0.44%	2	1	93	93	0.5000000000003686	1	1	79	146	0	1	-C
H3_BC87_191109_LF_LIB_consensus_vsearch	3941	C	C	222	2	0.88%	2	1	93	93	0.24944071588395061	1	1	78	144	0	2	T
H3_BC87_191109_LF_LIB_consensus_vsearch	3942	G	R	219	8	3.51%	2	2	93	93	0.0036688013849068284	1	1	72	147	7	1	A
H3_BC87_191109_LF_LIB_consensus_vsearch	3943	G	G	222	5	2.18%	2	2	93	93	0.030562448911634975	1	1	79	143	1	4	-TG
H3_BC87_191109_LF_LIB_consensus_vsearch	3944	T	T	216	4	1.79%	2	2	93	93	0.061646763238677425	1	1	76	140	1	3	C
H3_BC87_191109_LF_LIB_consensus_vsearch	3945	G	G	220	1	0.45%	2	1	93	93	0.4999999999999138	1	1	77	143	0	1	+TG
H3_BC87_191109_LF_LIB_consensus_vsearch	3946	C	C	220	2	0.88%	2	1	93	93	0.2494356659142869	1	1	78	142	0	2	+A
H3_BC87_191109_LF_LIB_consensus_vsearch	3947	A	A	217	5	2.19%	2	2	93	93	0.03054698177238809	1	1	74	143	3	2	+C
H3_BC87_191109_LF_LIB_consensus_vsearch	3948	C	C	222	1	0.45%	2	1	93	93	0.4999999999999138	1	1	77	145	0	1	+TG
H3_BC87_191109_LF_LIB_consensus_vsearch	3949	C	C	221	4	1.78%	2	2	93	93	0.06166574490670126	1	1	75	146	3	1	-A
H3_BC87_191109_LF_LIB_consensus_vsearch	3950	A	*/-G	165	50	22.62%	2	1	93	93	3.518388521828365E-17	1	1	70	95	0	50	-G
H3_BC87_191109_LF_LIB_consensus_vsearch	3951	G	G	177	2	1.12%	2	1	93	93	0.24929971988807545	1	1	80	97	0	2	+T
H3_BC87_191109_LF_LIB_consensus_vsearch	3952	G	G	228	1	0.44%	2	1	93	93	0.4999999999999138	1	1	80	148	0	1	A
H3_BC87_191109_LF_LIB_consensus_vsearch	3953	A	A	227	2	0.87%	2	1	93	93	0.24945295404843976	1	1	78	149	2	0	G
H3_BC87_191109_LF_LIB_consensus_vsearch	3954	C	C	228	1	0.44%	2	1	93	93	0.4999999999999138	1	1	80	148	0	1	T
H3_BC87_191109_LF_LIB_consensus_vsearch	3955	C	C	221	4	1.75%	2	1	93	93	0.06166574490670126	1	1	80	141	0	4	+G
H3_BC87_191109_LF_LIB_consensus_vsearch	3956	G	G	223	4	1.75%	2	1	93	93	0.061673103185009646	1	1	76	147	4	0	-AG
H3_BC87_191109_LF_LIB_consensus_vsearch	3957	A	A	216	3	1.34%	2	1	93	93	0.12414187643025615	1	1	71	145	3	0	G
H3_BC87_191109_LF_LIB_consensus_vsearch	3958	G	G	217	1	0.45%	2	1	93	93	0.4999999999999138	1	1	73	144	1	0	+A
H3_BC87_191109_LF_LIB_consensus_vsearch	3959	G	G	226	0	0%	2	0	93	0	1.0	1	0	79	147	0	0	
H3_BC87_191109_LF_LIB_consensus_vsearch	3960	A	A	223	1	0.44%	2	1	93	93	0.5000000000003686	1	1	77	146	1	0	+C
H3_BC87_191109_LF_LIB_consensus_vsearch	3961	C	C	222	3	1.32%	2	1	93	93	0.12416481069040536	1	1	79	143	0	3	T
H3_BC87_191109_LF_LIB_consensus_vsearch	3962	A	A	222	3	1.33%	2	1	93	93	0.12416481069040536	1	1	78	144	0	3	G
H3_BC87_191109_LF_LIB_consensus_vsearch	3963	A	A	221	6	2.64%	2	2	93	93	0.015111054918444918	1	1	76	145	4	2	G
H3_BC87_191109_LF_LIB_consensus_vsearch	3964	G	G	224	2	0.87%	2	1	93	93	0.24944567627499675	1	1	79	145	0	2	-T
H3_BC87_191109_LF_LIB_consensus_vsearch	3965	T	T	222	3	1.33%	2	1	93	93	0.12416481069040536	1	1	80	142	0	3	C
H3_BC87_191109_LF_LIB_consensus_vsearch	3966	T	T	221	2	0.88%	2	1	93	93	0.24943820224728358	1	1	78	143	2	0	+A
H3_BC87_191109_LF_LIB_consensus_vsearch	3967	C	C	220	4	1.75%	2	1	93	93	0.061662016439223415	1	1	79	141	0	4	-T
H3_BC87_191109_LF_LIB_consensus_vsearch	3968	T	*/-C	205	7	3.12%	2	1	93	93	0.0074292407456773525	1	1	79	126	0	7	-C
H3_BC87_191109_LF_LIB_consensus_vsearch	3969	C	*/-T	189	17	7.94%	2	2	93	93	5.408873197496746E-6	1	1	77	112	1	16	-T
H3_BC87_191109_LF_LIB_consensus_vsearch	3970	T	T	201	1	0.49%	2	1	93	93	0.4999999999999138	1	1	79	122	0	1	+CT
H3_BC87_191109_LF_LIB_consensus_vsearch	3971	T	T	222	1	0.44%	2	1	93	93	0.4999999999999138	1	1	80	142	0	1	+C
H3_BC87_191109_LF_LIB_consensus_vsearch	3972	G	G	226	1	0.44%	2	1	93	93	0.4999999999999138	1	1	80	146	0	1	+AAG
H3_BC87_191109_LF_LIB_consensus_vsearch	3973	T	T	224	3	1.32%	2	1	93	93	0.12417218543044797	1	1	80	144	0	3	C
H3_BC87_191109_LF_LIB_consensus_vsearch	3974	T	T	223	1	0.44%	2	1	93	93	0.5000000000003686	1	1	80	143	0	1	+AT
H3_BC87_191109_LF_LIB_consensus_vsearch	3975	G	G	224	1	0.44%	2	1	93	93	0.4999999999999138	1	1	79	145	0	1	+C
H3_BC87_191109_LF_LIB_consensus_vsearch	3976	T	T	221	5	2.2%	2	2	93	93	0.03055941016990272	1	1	78	143	2	3	C
H3_BC87_191109_LF_LIB_consensus_vsearch	3977	C	C	222	2	0.88%	2	2	93	93	0.24944071588395061	1	1	76	146	1	1	-GT
H3_BC87_191109_LF_LIB_consensus_vsearch	3978	G	G	219	5	2.21%	2	2	93	93	0.030553251388732716	1	1	73	146	4	1	A
H3_BC87_191109_LF_LIB_consensus_vsearch	3979	T	Y	212	9	3.98%	2	2	93	93	0.00179747064240055	1	1	74	138	1	8	C
H3_BC87_191109_LF_LIB_consensus_vsearch	3980	A	A	225	0	0%	2	0	93	0	1.0	1	0	77	148	0	0	
H3_BC87_191109_LF_LIB_consensus_vsearch	3981	A	A	226	3	1.31%	2	1	93	93	0.12417943107231426	1	1	77	149	3	0	G
H3_BC87_191109_LF_LIB_consensus_vsearch	3982	T	T	227	1	0.44%	2	1	93	93	0.4999999999999138	1	1	79	148	0	1	+C
H3_BC87_191109_LF_LIB_consensus_vsearch	3983	C	C	228	1	0.44%	2	1	93	93	0.4999999999999138	1	1	80	148	0	1	A
H3_BC87_191109_LF_LIB_consensus_vsearch	3984	G	G	226	2	0.87%	2	1	93	93	0.24945054945064127	1	1	80	146	0	2	A
H3_BC87_191109_LF_LIB_consensus_vsearch	3985	T	T	222	5	2.18%	2	2	93	93	0.030562448911634975	1	1	78	144	1	4	C
H3_BC87_191109_LF_LIB_consensus_vsearch	3986	C	C	220	3	1.32%	2	2	93	93	0.12415730337075404	1	1	76	144	1	2	+A
H3_BC87_191109_LF_LIB_consensus_vsearch	3987	G	G	223	1	0.44%	2	1	93	93	0.5000000000003686	1	1	78	145	0	1	+CT
H3_BC87_191109_LF_LIB_consensus_vsearch	3988	T	T	220	2	0.89%	2	1	93	93	0.2494356659142869	1	1	76	144	0	2	C
H3_BC87_191109_LF_LIB_consensus_vsearch	3989	C	C	218	6	2.65%	2	2	93	93	0.015104203282490625	1	1	76	142	3	3	+G
H3_BC87_191109_LF_LIB_consensus_vsearch	3990	A	*/-G	207	12	5.29%	2	2	93	93	2.091345729349345E-4	1	1	76	131	3	9	-G
H3_BC87_191109_LF_LIB_consensus_vsearch	3991	G	G	213	1	0.47%	2	1	93	93	0.4999999999999138	1	1	77	136	0	1	A
H3_BC87_191109_LF_LIB_consensus_vsearch	3992	G	G	214	5	2.2%	2	1	93	93	0.030537362897492103	1	1	77	137	0	5	-C
H3_BC87_191109_LF_LIB_consensus_vsearch	3993	C	C	219	1	0.45%	2	1	93	93	0.4999999999999138	1	1	79	140	1	0	+G
H3_BC87_191109_LF_LIB_consensus_vsearch	3994	C	*/-T	215	7	3.08%	2	2	93	93	0.007446345105805389	1	1	79	136	1	6	-T
H3_BC87_191109_LF_LIB_consensus_vsearch	3995	T	T	202	5	2.29%	2	1	93	93	0.030496102932097202	1	1	69	133	5	0	+C
H3_BC87_191109_LF_LIB_consensus_vsearch	3996	C	*/-G	175	35	15.91%	2	2	93	93	6.205002718756778E-12	1	1	64	111	11	24	-G
H3_BC87_191109_LF_LIB_consensus_vsearch	3997	G	G	180	2	1.07%	2	2	93	93	0.24931129476584768	1	1	62	118	1	1	T
H3_BC87_191109_LF_LIB_consensus_vsearch	3998	G	G	206	6	2.68%	2	2	93	93	0.015074867144143777	1	1	73	133	1	5	+A
H3_BC87_191109_LF_LIB_consensus_vsearch	3999	A	A	217	1	0.46%	2	1	93	93	0.4999999999999138	1	1	76	141	1	0	+G
H3_BC87_191109_LF_LIB_consensus_vsearch	4000	A	A	224	1	0.44%	2	1	93	93	0.4999999999999138	1	1	78	146	1	0	+G
H3_BC87_191109_LF_LIB_consensus_vsearch	4001	A	A	221	2	0.88%	2	1	93	93	0.24943820224728358	1	1	78	143	0	2	-TG
H3_BC87_191109_LF_LIB_consensus_vsearch	4002	T	T	223	2	0.88%	2	2	93	93	0.24944320712692292	1	1	79	144	1	1	C
H3_BC87_191109_LF_LIB_consensus_vsearch	4003	G	G	222	2	0.88%	2	1	93	93	0.24944071588395061	1	1	78	144	2	0	A
H3_BC87_191109_LF_LIB_consensus_vsearch	4004	C	C	221	3	1.32%	2	2	93	93	0.12416107382546236	1	1	79	142	1	2	-A
H3_BC87_191109_LF_LIB_consensus_vsearch	4005	A	A	214	5	2.22%	2	2	93	93	0.030537362897492103	1	1	74	140	2	3	-T
H3_BC87_191109_LF_LIB_consensus_vsearch	4006	T	T	219	1	0.45%	2	1	93	93	0.4999999999999138	1	1	75	144	1	0	+C
H3_BC87_191109_LF_LIB_consensus_vsearch	4007	T	*/+G	216	7	3.06%	2	1	93	93	0.007447971960236055	1	1	80	136	0	7	+G
H3_BC87_191109_LF_LIB_consensus_vsearch	4008	G	G	217	4	1.77%	2	1	93	93	0.0616506283607095	1	1	80	137	0	4	-C
H3_BC87_191109_LF_LIB_consensus_vsearch	4009	C	Y	204	10	4.46%	2	1	93	93	8.769963348909129E-4	1	1	79	125	0	10	T
H3_BC87_191109_LF_LIB_consensus_vsearch	4010	G	G	216	3	1.35%	2	2	93	93	0.12414187643025615	1	1	77	139	2	1	A
H3_BC87_191109_LF_LIB_consensus_vsearch	4011	C	C	211	3	1.36%	2	2	93	93	0.12412177985949331	1	1	75	136	2	1	-A
H3_BC87_191109_LF_LIB_consensus_vsearch	4012	A	A	221	2	0.9%	2	1	93	93	0.24943820224728358	1	1	76	145	2	0	-G
H3_BC87_191109_LF_LIB_consensus_vsearch	4013	G	G	218	3	1.34%	2	1	93	93	0.12414965986396012	1	1	77	141	0	3	-A
H3_BC87_191109_LF_LIB_consensus_vsearch	4014	A	A	221	1	0.45%	2	1	93	93	0.4999999999999138	1	1	79	142	0	1	G
H3_BC87_191109_LF_LIB_consensus_vsearch	4015	G	*/-A	187	14	6.17%	2	2	93	93	4.828732418008738E-5	1	1	55	132	6	8	-A
H3_BC87_191109_LF_LIB_consensus_vsearch	4016	A	*/+G	57	87	46.03%	2	2	93	93	3.016612668102525E-35	1	1	11	46	10	77	+G
H3_BC87_191109_LF_LIB_consensus_vsearch	4017	G	G	157	1	0.62%	2	1	93	93	0.5000000000001412	1	1	26	131	1	0	+A
H3_BC87_191109_LF_LIB_consensus_vsearch	4018	G	G	209	1	0.47%	2	1	93	93	0.4999999999999138	1	1	67	142	0	1	+TCTT
H3_BC87_191109_LF_LIB_consensus_vsearch	4019	G	G	228	0	0%	2	0	93	0	1.0	1	0	80	148	0	0	
H3_BC87_191109_LF_LIB_consensus_vsearch	4020	G	G	218	3	1.32%	2	1	93	93	0.12414965986396012	1	1	77	141	0	3	+C
H3_BC87_191109_LF_LIB_consensus_vsearch	4021	C	C	216	5	2.21%	2	1	93	93	0.030543804461782422	1	1	78	138	0	5	G
H3_BC87_191109_LF_LIB_consensus_vsearch	4022	C	C	221	5	2.19%	2	1	93	93	0.03055941016990272	1	1	80	141	0	5	-T
H3_BC87_191109_LF_LIB_consensus_vsearch	4023	T	*/+C	205	7	3.12%	2	1	93	93	0.0074292407456773525	1	1	78	127	0	7	+C
H3_BC87_191109_LF_LIB_consensus_vsearch	4024	G	G	225	2	0.87%	2	1	93	93	0.24944812362040697	1	1	80	145	0	2	C
H3_BC87_191109_LF_LIB_consensus_vsearch	4025	A	A	223	2	0.88%	2	1	93	93	0.24944320712692292	1	1	80	143	0	2	-T
H3_BC87_191109_LF_LIB_consensus_vsearch	4026	T	T	222	2	0.89%	2	1	93	93	0.24944071588395061	1	1	80	142	0	2	C
H3_BC87_191109_LF_LIB_consensus_vsearch	4027	C	C	223	1	0.44%	2	1	93	93	0.5000000000003686	1	1	78	145	0	1	+A
H3_BC87_191109_LF_LIB_consensus_vsearch	4028	G	G	219	4	1.77%	2	2	93	93	0.06165825449566743	1	1	74	145	3	1	-C
H3_BC87_191109_LF_LIB_consensus_vsearch	4029	C	C	218	2	0.9%	2	1	93	93	0.24943052391823226	1	1	75	143	0	2	+T
H3_BC87_191109_LF_LIB_consensus_vsearch	4030	C	C	216	3	1.32%	2	1	93	93	0.12414187643025615	1	1	78	138	0	3	+G
H3_BC87_191109_LF_LIB_consensus_vsearch	4031	G	G	213	3	1.33%	2	2	93	93	0.12412993039444345	1	1	72	141	2	1	+A
H3_BC87_191109_LF_LIB_consensus_vsearch	4032	A	*/-G	190	16	7.08%	2	2	93	93	1.1273230453731282E-5	1	1	48	142	13	3	-G
H3_BC87_191109_LF_LIB_consensus_vsearch	4033	G	G	184	6	3.05%	2	2	93	93	0.015011512916161563	1	1	43	141	5	1	A
H3_BC87_191109_LF_LIB_consensus_vsearch	4034	G	G	202	4	1.88%	2	1	93	93	0.06158870665501416	1	1	53	149	4	0	-A
H3_BC87_191109_LF_LIB_consensus_vsearch	4035	A	A	202	1	0.48%	2	1	93	93	0.4999999999999138	1	1	55	147	1	0	+G
H3_BC87_191109_LF_LIB_consensus_vsearch	4036	G	G	212	5	2.25%	2	1	93	93	0.030530802741347875	1	1	68	144	5	0	A
H3_BC87_191109_LF_LIB_consensus_vsearch	4037	C	*/-GC	211	7	3.12%	2	2	93	93	0.007439689863414905	1	1	74	137	1	6	-GC
H3_BC87_191109_LF_LIB_consensus_vsearch	4038	G	*/-C	180	28	12.84%	2	1	93	93	1.4068589834878034E-9	1	1	46	134	28	0	-C
H3_BC87_191109_LF_LIB_consensus_vsearch	4039	C	C	188	1	0.53%	2	1	93	93	0.5000000000001412	1	1	47	141	0	1	+T
H3_BC87_191109_LF_LIB_consensus_vsearch	4040	C	C	219	3	1.33%	2	1	93	93	0.12415349887135622	1	1	75	144	0	3	+T
H3_BC87_191109_LF_LIB_consensus_vsearch	4041	C	*/-T	217	9	3.93%	2	1	93	93	0.0018008401619304512	1	1	79	138	0	9	-T
H3_BC87_191109_LF_LIB_consensus_vsearch	4042	T	T	206	5	2.28%	2	1	93	93	0.030510377042941562	1	1	76	130	0	5	C
H3_BC87_191109_LF_LIB_consensus_vsearch	4043	A	A	219	4	1.77%	2	2	93	93	0.06165825449566743	1	1	79	140	1	3	-G
H3_BC87_191109_LF_LIB_consensus_vsearch	4044	G	G	217	4	1.78%	2	1	93	93	0.0616506283607095	1	1	78	139	0	4	-TG
H3_BC87_191109_LF_LIB_consensus_vsearch	4045	T	T	215	4	1.79%	2	1	93	93	0.06164286277914926	1	1	78	137	0	4	C
H3_BC87_191109_LF_LIB_consensus_vsearch	4046	G	*/-CG	211	9	4.04%	2	1	93	93	0.0017967787753331713	1	1	77	134	0	9	-CG
H3_BC87_191109_LF_LIB_consensus_vsearch	4047	C	C	214	2	0.91%	2	1	93	93	0.24941995359642635	1	1	80	134	0	2	+G
H3_BC87_191109_LF_LIB_consensus_vsearch	4048	G	G	207	3	1.38%	2	1	93	93	0.12410501193315207	1	1	79	128	0	3	+T
H3_BC87_191109_LF_LIB_consensus_vsearch	4049	T	Y	216	8	3.51%	2	2	93	93	0.003665668526289429	1	1	79	137	1	7	C
H3_BC87_191109_LF_LIB_consensus_vsearch	4050	C	C	219	5	2.19%	2	1	93	93	0.030553251388732716	1	1	78	141	0	5	-T
H3_BC87_191109_LF_LIB_consensus_vsearch	4051	T	Y	205	9	4.05%	2	2	93	93	0.0017924949478988227	1	1	75	130	2	7	C
H3_BC87_191109_LF_LIB_consensus_vsearch	4052	C	C	208	4	1.82%	2	2	93	93	0.06161452805712106	1	1	73	135	3	1	+A
H3_BC87_191109_LF_LIB_consensus_vsearch	4053	G	G	215	3	1.32%	2	2	93	93	0.12413793103441495	1	1	74	141	1	2	A
H3_BC87_191109_LF_LIB_consensus_vsearch	4054	T	T	215	5	2.19%	2	1	93	93	0.03054059830172664	1	1	76	139	0	5	A
H3_BC87_191109_LF_LIB_consensus_vsearch	4055	G	G	219	3	1.33%	2	2	93	93	0.12415349887135622	1	1	77	142	1	2	A
H3_BC87_191109_LF_LIB_consensus_vsearch	4056	C	*/-T	203	18	7.96%	2	1	93	93	2.660025487728775E-6	1	1	78	125	0	18	-T
H3_BC87_191109_LF_LIB_consensus_vsearch	4057	T	T	201	6	2.88%	2	2	93	93	0.01506164496890816	1	1	77	124	1	5	C
H3_BC87_191109_LF_LIB_consensus_vsearch	4058	T	T	212	5	2.2%	2	2	93	93	0.030530802741347875	1	1	73	139	2	3	+C
H3_BC87_191109_LF_LIB_consensus_vsearch	4059	C	C	214	4	1.79%	2	2	93	93	0.061638926495252586	1	1	76	138	1	3	-T
H3_BC87_191109_LF_LIB_consensus_vsearch	4060	T	T	216	5	2.26%	2	2	93	93	0.030543804461782422	1	1	77	139	2	3	A
H3_BC87_191109_LF_LIB_consensus_vsearch	4061	G	G	219	6	2.63%	2	1	93	93	0.015106507368173285	1	1	73	146	6	0	A
H3_BC87_191109_LF_LIB_consensus_vsearch	4062	G	G	223	2	0.88%	2	1	93	93	0.24944320712692292	1	1	78	145	2	0	T
H3_BC87_191109_LF_LIB_consensus_vsearch	4063	T	T	223	1	0.44%	2	1	93	93	0.5000000000003686	1	1	78	145	1	0	+ACT
H3_BC87_191109_LF_LIB_consensus_vsearch	4064	G	G	226	1	0.44%	2	1	93	93	0.4999999999999138	1	1	78	148	1	0	-C
H3_BC87_191109_LF_LIB_consensus_vsearch	4065	C	C	221	4	1.76%	2	2	93	93	0.06166574490670126	1	1	76	145	2	2	-GC
H3_BC87_191109_LF_LIB_consensus_vsearch	4066	G	*/-C	170	36	16%	2	2	93	93	2.72353599514503E-12	1	1	68	102	6	30	-C
H3_BC87_191109_LF_LIB_consensus_vsearch	4067	C	*/+T	174	7	3.8%	2	1	93	93	0.007364345131566664	1	1	70	104	0	7	+T
H3_BC87_191109_LF_LIB_consensus_vsearch	4068	C	C	219	3	1.34%	2	1	93	93	0.12415349887135622	1	1	77	142	0	3	T
H3_BC87_191109_LF_LIB_consensus_vsearch	4069	C	C	222	4	1.75%	2	1	93	93	0.061669440342892484	1	1	78	144	0	4	+T
H3_BC87_191109_LF_LIB_consensus_vsearch	4070	C	*/-T	198	19	8.3%	2	2	93	93	1.2636778396454046E-6	1	1	75	123	2	17	-T
H3_BC87_191109_LF_LIB_consensus_vsearch	4071	T	T	205	3	1.44%	2	2	93	93	0.12409638554214404	1	1	75	130	1	2	C
H3_BC87_191109_LF_LIB_consensus_vsearch	4072	T	Y	217	8	3.52%	2	2	93	93	0.0036667219549938834	1	1	74	143	2	6	C
H3_BC87_191109_LF_LIB_consensus_vsearch	4073	G	*/-A	199	25	10.96%	2	2	93	93	1.4670068930690744E-8	1	1	73	126	6	19	-A
H3_BC87_191109_LF_LIB_consensus_vsearch	4074	A	A	200	1	0.5%	2	1	93	93	0.4999999999999138	1	1	73	127	0	1	G
H3_BC87_191109_LF_LIB_consensus_vsearch	4075	A	A	226	1	0.44%	2	1	93	93	0.4999999999999138	1	1	79	147	1	0	G
H3_BC87_191109_LF_LIB_consensus_vsearch	4076	A	A	225	3	1.31%	2	2	93	93	0.12417582417582212	1	1	79	146	1	2	G
H3_BC87_191109_LF_LIB_consensus_vsearch	4077	A	A	217	5	2.18%	2	2	93	93	0.03054698177238809	1	1	75	142	3	2	G
H3_BC87_191109_LF_LIB_consensus_vsearch	4078	C	C	226	2	0.88%	2	1	93	93	0.24945054945064127	1	1	79	147	0	2	+T
H3_BC87_191109_LF_LIB_consensus_vsearch	4079	C	*/-T	214	10	4.37%	2	1	93	93	8.813089995913842E-4	1	1	80	134	0	10	-T
H3_BC87_191109_LF_LIB_consensus_vsearch	4080	T	T	213	2	0.92%	2	2	93	93	0.249417249417318	1	1	78	135	1	1	C
H3_BC87_191109_LF_LIB_consensus_vsearch	4081	C	*/-G	214	7	3.08%	2	1	93	93	0.007444703667648697	1	1	80	134	0	7	-G
H3_BC87_191109_LF_LIB_consensus_vsearch	4082	G	G	217	4	1.8%	2	2	93	93	0.0616506283607095	1	1	77	140	3	1	A
H3_BC87_191109_LF_LIB_consensus_vsearch	4083	G	G	224	2	0.87%	2	1	93	93	0.24944567627499675	1	1	79	145	0	2	-T
H3_BC87_191109_LF_LIB_consensus_vsearch	4084	T	W	215	7	3.08%	2	1	93	93	0.007446345105805389	1	1	77	138	0	7	A
H3_BC87_191109_LF_LIB_consensus_vsearch	4085	G	G	225	2	0.87%	2	1	93	93	0.24944812362040697	1	1	80	145	0	2	A
H3_BC87_191109_LF_LIB_consensus_vsearch	4086	A	A	225	2	0.88%	2	2	93	93	0.24944812362040697	1	1	78	147	1	1	G
H3_BC87_191109_LF_LIB_consensus_vsearch	4087	T	T	221	2	0.88%	2	1	93	93	0.24943820224728358	1	1	76	145	2	0	+C
H3_BC87_191109_LF_LIB_consensus_vsearch	4088	C	C	214	6	2.65%	2	1	93	93	0.015094778470947015	1	1	76	138	0	6	+G
H3_BC87_191109_LF_LIB_consensus_vsearch	4089	A	R	205	11	4.87%	2	2	93	93	4.285433624407098E-4	1	1	74	131	4	7	G
H3_BC87_191109_LF_LIB_consensus_vsearch	4090	C	*/-A	200	11	4.89%	2	1	93	93	4.27186182801716E-4	1	1	80	120	0	11	-A
H3_BC87_191109_LF_LIB_consensus_vsearch	4091	A	A	213	1	0.47%	2	1	93	93	0.4999999999999138	1	1	79	134	0	1	+GCA
H3_BC87_191109_LF_LIB_consensus_vsearch	4092	A	A	219	4	1.75%	2	1	93	93	0.06165825449566743	1	1	74	145	4	0	G
H3_BC87_191109_LF_LIB_consensus_vsearch	4093	C	C	221	3	1.33%	2	1	93	93	0.12416107382546236	1	1	80	141	0	3	T
H3_BC87_191109_LF_LIB_consensus_vsearch	4094	T	Y	210	16	7.02%	2	2	93	93	1.1590481452408359E-5	1	1	78	132	2	14	C
H3_BC87_191109_LF_LIB_consensus_vsearch	4095	A	A	221	3	1.31%	2	2	93	93	0.12416107382546236	1	1	77	144	2	1	G
H3_BC87_191109_LF_LIB_consensus_vsearch	4096	C	C	217	6	2.64%	2	1	93	93	0.015101878629034914	1	1	78	139	0	6	T
H3_BC87_191109_LF_LIB_consensus_vsearch	4097	G	*/-C	218	8	3.54%	2	2	93	93	0.003667766201363899	1	1	74	144	5	3	-C
H3_BC87_191109_LF_LIB_consensus_vsearch	4098	C	C	218	0	0%	2	0	93	0	1.0	1	0	74	144	0	0	
H3_BC87_191109_LF_LIB_consensus_vsearch	4099	C	C	224	1	0.44%	2	1	93	93	0.4999999999999138	1	1	80	144	0	1	+G
H3_BC87_191109_LF_LIB_consensus_vsearch	4100	C	C	223	2	0.87%	2	1	93	93	0.24944320712692292	1	1	77	146	0	2	-G
H3_BC87_191109_LF_LIB_consensus_vsearch	4101	G	G	223	1	0.44%	2	1	93	93	0.5000000000003686	1	1	78	145	1	0	+AG
H3_BC87_191109_LF_LIB_consensus_vsearch	4102	T	T	217	3	1.31%	2	2	93	93	0.12414578587710072	1	1	73	144	1	2	C
H3_BC87_191109_LF_LIB_consensus_vsearch	4103	G	G	220	2	0.88%	2	2	93	93	0.2494356659142869	1	1	75	145	1	1	+TG
H3_BC87_191109_LF_LIB_consensus_vsearch	4104	C	C	223	2	0.88%	2	2	93	93	0.24944320712692292	1	1	79	144	1	1	-T
H3_BC87_191109_LF_LIB_consensus_vsearch	4105	T	T	221	4	1.78%	2	2	93	93	0.06166574490670126	1	1	78	143	1	3	C
H3_BC87_191109_LF_LIB_consensus_vsearch	4106	T	T	221	3	1.32%	2	2	93	93	0.12416107382546236	1	1	76	145	1	2	-C
H3_BC87_191109_LF_LIB_consensus_vsearch	4107	C	C	216	2	0.89%	2	2	93	93	0.249425287356441	1	1	78	138	1	1	+AC
H3_BC87_191109_LF_LIB_consensus_vsearch	4108	G	G	215	5	2.2%	2	1	93	93	0.03054059830172664	1	1	77	138	0	5	-TTG
H3_BC87_191109_LF_LIB_consensus_vsearch	4109	T	Y	210	11	4.95%	2	1	93	93	4.298416344617859E-4	1	1	79	131	0	11	C
H3_BC87_191109_LF_LIB_consensus_vsearch	4110	T	T	217	2	0.9%	2	1	93	93	0.24942791762028085	1	1	80	137	0	2	+G
H3_BC87_191109_LF_LIB_consensus_vsearch	4111	G	G	222	1	0.45%	2	1	93	93	0.4999999999999138	1	1	80	142	0	1	+C
H3_BC87_191109_LF_LIB_consensus_vsearch	4112	T	T	220	6	2.63%	2	2	93	93	0.015108791157819889	1	1	77	143	2	4	C
H3_BC87_191109_LF_LIB_consensus_vsearch	4113	C	C	220	3	1.32%	2	2	93	93	0.12415730337075404	1	1	76	144	2	1	+A
H3_BC87_191109_LF_LIB_consensus_vsearch	4114	G	G	219	2	0.88%	2	1	93	93	0.24943310657599216	1	1	76	143	2	0	T
H3_BC87_191109_LF_LIB_consensus_vsearch	4115	T	T	219	6	2.64%	2	1	93	93	0.015106507368173285	1	1	80	139	0	6	C
H3_BC87_191109_LF_LIB_consensus_vsearch	4116	A	A	221	5	2.18%	2	1	93	93	0.03055941016990272	1	1	79	142	0	5	+C
H3_BC87_191109_LF_LIB_consensus_vsearch	4117	C	C	222	3	1.31%	2	2	93	93	0.12416481069040536	1	1	79	143	1	2	-T
H3_BC87_191109_LF_LIB_consensus_vsearch	4118	T	*/-C	168	44	19.47%	2	1	93	93	4.705156124110114E-15	1	1	72	96	0	44	-C
H3_BC87_191109_LF_LIB_consensus_vsearch	4119	C	C	169	5	2.72%	2	2	93	93	0.0303533391805526	1	1	73	96	2	3	+G
H3_BC87_191109_LF_LIB_consensus_vsearch	4120	G	G	219	4	1.77%	2	2	93	93	0.06165825449566743	1	1	77	142	2	2	-A
H3_BC87_191109_LF_LIB_consensus_vsearch	4121	A	A	221	2	0.89%	2	1	93	93	0.24943820224728358	1	1	77	144	0	2	G
H3_BC87_191109_LF_LIB_consensus_vsearch	4122	A	A	226	2	0.88%	2	1	93	93	0.24945054945064127	1	1	78	148	2	0	G
H3_BC87_191109_LF_LIB_consensus_vsearch	4123	A	A	216	4	1.75%	2	2	93	93	0.061646763238677425	1	1	70	146	3	1	-C
H3_BC87_191109_LF_LIB_consensus_vsearch	4124	C	C	222	1	0.45%	2	1	93	93	0.4999999999999138	1	1	76	146	1	0	+G
H3_BC87_191109_LF_LIB_consensus_vsearch	4125	C	C	220	2	0.88%	2	1	93	93	0.2494356659142869	1	1	75	145	2	0	+A
H3_BC87_191109_LF_LIB_consensus_vsearch	4126	G	G	219	4	1.78%	2	1	93	93	0.06165825449566743	1	1	73	146	4	0	A
H3_BC87_191109_LF_LIB_consensus_vsearch	4127	C	C	221	2	0.88%	2	2	93	93	0.24943820224728358	1	1	78	143	1	1	+A
H3_BC87_191109_LF_LIB_consensus_vsearch	4128	A	A	222	3	1.33%	2	2	93	93	0.12416481069040536	1	1	78	144	1	2	G
H3_BC87_191109_LF_LIB_consensus_vsearch	4129	G	G	221	4	1.76%	2	2	93	93	0.06166574490670126	1	1	77	144	1	3	-CAG
H3_BC87_191109_LF_LIB_consensus_vsearch	4130	C	C	219	1	0.45%	2	1	93	93	0.4999999999999138	1	1	76	143	1	0	+A
H3_BC87_191109_LF_LIB_consensus_vsearch	4131	A	A	215	3	1.35%	2	2	93	93	0.12413793103441495	1	1	77	138	1	2	G
H3_BC87_191109_LF_LIB_consensus_vsearch	4132	G	G	222	0	0%	2	0	93	0	1.0	1	0	79	143	0	0	
H3_BC87_191109_LF_LIB_consensus_vsearch	4133	G	G	224	2	0.88%	2	1	93	93	0.24944567627499675	1	1	79	145	0	2	-T
H3_BC87_191109_LF_LIB_consensus_vsearch	4134	T	T	218	4	1.77%	2	1	93	93	0.061654458623218986	1	1	80	138	0	4	+C
H3_BC87_191109_LF_LIB_consensus_vsearch	4135	C	C	225	1	0.44%	2	1	93	93	0.5000000000003686	1	1	80	145	0	1	-T
H3_BC87_191109_LF_LIB_consensus_vsearch	4136	T	*/-C	193	29	12.78%	2	2	93	93	7.00539600710601E-10	1	1	57	136	21	8	-C
H3_BC87_191109_LF_LIB_consensus_vsearch	4137	C	C	195	1	0.5%	2	1	93	93	0.5000000000001412	1	1	58	137	0	1	+T
H3_BC87_191109_LF_LIB_consensus_vsearch	4138	C	C	217	3	1.32%	2	1	93	93	0.12414578587710072	1	1	78	139	0	3	+T
H3_BC87_191109_LF_LIB_consensus_vsearch	4139	T	T	213	4	1.77%	2	2	93	93	0.06163495389099757	1	1	70	143	3	1	+G
H3_BC87_191109_LF_LIB_consensus_vsearch	4140	A	*/+G	206	9	4%	2	1	93	93	0.001793225137980622	1	1	70	136	0	9	+G
H3_BC87_191109_LF_LIB_consensus_vsearch	4141	G	G	220	2	0.88%	2	2	93	93	0.2494356659142869	1	1	74	146	1	1	A
H3_BC87_191109_LF_LIB_consensus_vsearch	4142	G	G	220	2	0.87%	2	1	93	93	0.2494356659142869	1	1	74	146	2	0	+C
H3_BC87_191109_LF_LIB_consensus_vsearch	4143	C	C	218	3	1.32%	2	1	93	93	0.12414965986396012	1	1	72	146	3	0	+A
H3_BC87_191109_LF_LIB_consensus_vsearch	4144	G	G	219	4	1.76%	2	1	93	93	0.06165825449566743	1	1	71	148	4	0	-A
H3_BC87_191109_LF_LIB_consensus_vsearch	4145	A	A	219	2	0.89%	2	2	93	93	0.24943310657599216	1	1	74	145	1	1	-G
H3_BC87_191109_LF_LIB_consensus_vsearch	4146	G	G	223	2	0.88%	2	1	93	93	0.24944320712692292	1	1	77	146	2	0	A
H3_BC87_191109_LF_LIB_consensus_vsearch	4147	C	*/+A	218	7	3.06%	2	1	93	93	0.007451182688346346	1	1	79	139	0	7	+A
H3_BC87_191109_LF_LIB_consensus_vsearch	4148	A	A	229	0	0%	2	0	93	0	1.0	1	0	80	149	0	0	
H3_BC87_191109_LF_LIB_consensus_vsearch	4149	A	A	215	6	2.62%	2	2	93	93	0.01509716650743782	1	1	71	144	3	3	-C
H3_BC87_191109_LF_LIB_consensus_vsearch	4150	C	C	215	5	2.25%	2	1	93	93	0.03054059830172664	1	1	76	139	0	5	A
H3_BC87_191109_LF_LIB_consensus_vsearch	4151	C	*/-T	206	17	7.46%	2	1	93	93	5.5582526785826E-6	1	1	78	128	0	17	-T
H3_BC87_191109_LF_LIB_consensus_vsearch	4152	T	T	205	4	1.9%	2	2	93	93	0.06160180289502593	1	1	75	130	3	1	+C
H3_BC87_191109_LF_LIB_consensus_vsearch	4153	C	*/-T	209	13	5.75%	2	2	93	93	1.0188120004185222E-4	1	1	77	132	1	12	-T
H3_BC87_191109_LF_LIB_consensus_vsearch	4154	T	T	202	4	1.88%	2	1	93	93	0.06158870665501416	1	1	73	129	0	4	+CT
H3_BC87_191109_LF_LIB_consensus_vsearch	4155	A	R	211	10	4.41%	2	2	93	93	8.800549103686053E-4	1	1	68	143	8	2	G
H3_BC87_191109_LF_LIB_consensus_vsearch	4156	G	G	222	1	0.44%	2	1	93	93	0.4999999999999138	1	1	76	146	1	0	+A
H3_BC87_191109_LF_LIB_consensus_vsearch	4157	T	T	220	4	1.75%	2	1	93	93	0.061662016439223415	1	1	79	141	0	4	+C
H3_BC87_191109_LF_LIB_consensus_vsearch	4158	C	C	222	2	0.88%	2	1	93	93	0.24944071588395061	1	1	80	142	0	2	+T
H3_BC87_191109_LF_LIB_consensus_vsearch	4159	T	T	216	5	2.21%	2	1	93	93	0.030543804461782422	1	1	76	140	0	5	C
H3_BC87_191109_LF_LIB_consensus_vsearch	4160	C	C	218	4	1.79%	2	2	93	93	0.061654458623218986	1	1	73	145	2	2	+T
H3_BC87_191109_LF_LIB_consensus_vsearch	4161	A	A	217	5	2.21%	2	2	93	93	0.03054698177238809	1	1	73	144	4	1	G
H3_BC87_191109_LF_LIB_consensus_vsearch	4162	C	C	223	3	1.32%	2	2	93	93	0.12416851441234596	1	1	77	146	1	2	T
H3_BC87_191109_LF_LIB_consensus_vsearch	4163	G	G	223	2	0.88%	2	1	93	93	0.24944320712692292	1	1	77	146	2	0	A
H3_BC87_191109_LF_LIB_consensus_vsearch	4164	G	G	226	1	0.44%	2	1	93	93	0.4999999999999138	1	1	78	148	1	0	-A
H3_BC87_191109_LF_LIB_consensus_vsearch	4165	A	A	223	2	0.88%	2	1	93	93	0.24944320712692292	1	1	76	147	0	2	+T
H3_BC87_191109_LF_LIB_consensus_vsearch	4166	C	C	223	2	0.88%	2	1	93	93	0.24944320712692292	1	1	76	147	0	2	-T
H3_BC87_191109_LF_LIB_consensus_vsearch	4167	T	T	223	2	0.88%	2	2	93	93	0.24944320712692292	1	1	79	144	1	1	-A
H3_BC87_191109_LF_LIB_consensus_vsearch	4168	A	A	226	1	0.44%	2	1	93	93	0.4999999999999138	1	1	78	148	1	0	G
H3_BC87_191109_LF_LIB_consensus_vsearch	4169	A	A	223	3	1.31%	2	1	93	93	0.12416851441234596	1	1	79	144	0	3	C
H3_BC87_191109_LF_LIB_consensus_vsearch	4170	T	T	222	4	1.75%	2	1	93	93	0.061669440342892484	1	1	78	144	0	4	C
H3_BC87_191109_LF_LIB_consensus_vsearch	4171	G	*/-TG	212	9	3.95%	2	2	93	93	0.00179747064240055	1	1	76	136	2	7	-TG
H3_BC87_191109_LF_LIB_consensus_vsearch	4172	T	*/-G	182	18	8.41%	2	2	93	93	2.556712983549592E-6	1	1	73	109	2	16	-G
H3_BC87_191109_LF_LIB_consensus_vsearch	4173	G	R	185	7	3.61%	2	2	93	93	0.007389745092191117	1	1	70	115	6	1	A
H3_BC87_191109_LF_LIB_consensus_vsearch	4174	G	G	215	5	2.26%	2	1	93	93	0.03054059830172664	1	1	75	140	5	0	+A
H3_BC87_191109_LF_LIB_consensus_vsearch	4175	G	G	221	2	0.88%	2	2	93	93	0.24943820224728358	1	1	78	143	1	1	-T
H3_BC87_191109_LF_LIB_consensus_vsearch	4176	T	*/-A	201	7	3.1%	2	2	93	93	0.007421943123229272	1	1	66	135	6	1	-A
H3_BC87_191109_LF_LIB_consensus_vsearch	4177	A	A	206	3	1.38%	2	2	93	93	0.1241007194244273	1	1	68	138	1	2	G
H3_BC87_191109_LF_LIB_consensus_vsearch	4178	A	*/+G	51	140	62.5%	2	2	93	93	2.0584975981147166E-61	1	1	27	24	30	110	+G
H3_BC87_191109_LF_LIB_consensus_vsearch	4179	G	G	209	2	0.92%	2	1	93	93	0.24940617577189375	1	1	69	140	0	2	+TGG
H3_BC87_191109_LF_LIB_consensus_vsearch	4180	G	G	219	4	1.77%	2	1	93	93	0.06165825449566743	1	1	79	140	0	4	-AA
H3_BC87_191109_LF_LIB_consensus_vsearch	4181	A	A	215	4	1.81%	2	2	93	93	0.06164286277914926	1	1	76	139	3	1	G
H3_BC87_191109_LF_LIB_consensus_vsearch	4182	A	A	212	6	2.69%	2	2	93	93	0.015089936987088519	1	1	77	135	2	4	G
H3_BC87_191109_LF_LIB_consensus_vsearch	4183	G	G	216	3	1.35%	2	1	93	93	0.12414187643025615	1	1	79	137	0	3	+C
H3_BC87_191109_LF_LIB_consensus_vsearch	4184	T	*/-C	216	9	3.95%	2	1	93	93	0.0018001779733764346	1	1	79	137	0	9	-C
H3_BC87_191109_LF_LIB_consensus_vsearch	4185	C	C	210	3	1.37%	2	1	93	93	0.1241176470588473	1	1	77	133	0	3	-G
H3_BC87_191109_LF_LIB_consensus_vsearch	4186	G	R	209	12	5.38%	2	1	93	93	2.0943559915765036E-4	1	1	65	144	12	0	A
H3_BC87_191109_LF_LIB_consensus_vsearch	4187	G	G	220	2	0.88%	2	1	93	93	0.2494356659142869	1	1	77	143	0	2	-CA
H3_BC87_191109_LF_LIB_consensus_vsearch	4188	C	*/-A	205	8	3.59%	2	2	93	93	0.0036534383902297935	1	1	73	132	3	5	-A
H3_BC87_191109_LF_LIB_consensus_vsearch	4189	A	A	205	5	2.35%	2	2	93	93	0.03050685942891605	1	1	72	133	2	3	G
H3_BC87_191109_LF_LIB_consensus_vsearch	4190	A	W	212	7	3.14%	2	1	93	93	0.00744137624879223	1	1	76	136	0	7	T
H3_BC87_191109_LF_LIB_consensus_vsearch	4191	G	G	221	3	1.32%	2	2	93	93	0.12416107382546236	1	1	76	145	1	2	T
H3_BC87_191109_LF_LIB_consensus_vsearch	4192	T	Y	218	7	3.08%	2	2	93	93	0.007451182688346346	1	1	74	144	2	5	C
H3_BC87_191109_LF_LIB_consensus_vsearch	4193	C	C	220	3	1.32%	2	2	93	93	0.12415730337075404	1	1	77	143	1	2	-A
H3_BC87_191109_LF_LIB_consensus_vsearch	4194	A	R	214	7	3.11%	2	2	93	93	0.007444703667648697	1	1	74	140	3	4	G
H3_BC87_191109_LF_LIB_consensus_vsearch	4195	G	G	219	3	1.33%	2	1	93	93	0.12415349887135622	1	1	79	140	0	3	-C
H3_BC87_191109_LF_LIB_consensus_vsearch	4196	C	*/-T	200	21	9.33%	2	2	93	93	2.896747146375421E-7	1	1	77	123	1	20	-T
H3_BC87_191109_LF_LIB_consensus_vsearch	4197	T	T	203	2	0.96%	2	2	93	93	0.2493887530563227	1	1	77	126	1	1	+C
H3_BC87_191109_LF_LIB_consensus_vsearch	4198	C	C	223	2	0.88%	2	1	93	93	0.24944320712692292	1	1	79	144	0	2	T
H3_BC87_191109_LF_LIB_consensus_vsearch	4199	C	Y	206	9	3.95%	2	2	93	93	0.001793225137980622	1	1	76	130	1	8	T
H3_BC87_191109_LF_LIB_consensus_vsearch	4200	G	G	226	1	0.44%	2	1	93	93	0.4999999999999138	1	1	77	149	1	0	A
H3_BC87_191109_LF_LIB_consensus_vsearch	4201	T	Y	216	10	4.41%	2	2	93	93	8.821271222096345E-4	1	1	77	139	1	9	C
H3_BC87_191109_LF_LIB_consensus_vsearch	4202	A	A	229	0	0%	2	0	93	0	1.0	1	0	80	149	0	0	
H3_BC87_191109_LF_LIB_consensus_vsearch	4203	A	A	226	3	1.31%	2	2	93	93	0.12417943107231426	1	1	79	147	1	2	-C
H3_BC87_191109_LF_LIB_consensus_vsearch	4204	C	*/+T	215	10	4.42%	2	1	93	93	8.817198236951184E-4	1	1	79	136	0	10	+T
H3_BC87_191109_LF_LIB_consensus_vsearch	4205	C	*/-T	213	10	4.37%	2	1	93	93	8.808946039600796E-4	1	1	79	134	0	10	-T
H3_BC87_191109_LF_LIB_consensus_vsearch	4206	T	Y	203	7	3.21%	2	2	93	93	0.007425626339083171	1	1	74	129	1	6	C
H3_BC87_191109_LF_LIB_consensus_vsearch	4207	A	*/-G	167	45	20%	2	2	93	93	2.0801742864478777E-15	1	1	70	97	2	43	-G
H3_BC87_191109_LF_LIB_consensus_vsearch	4208	G	G	178	1	0.56%	2	1	93	93	0.4999999999999138	1	1	78	100	0	1	+T
H3_BC87_191109_LF_LIB_consensus_vsearch	4209	G	G	221	3	1.33%	2	2	93	93	0.12416107382546236	1	1	78	143	2	1	+A
H3_BC87_191109_LF_LIB_consensus_vsearch	4210	G	G	226	1	0.44%	2	1	93	93	0.4999999999999138	1	1	79	147	1	0	-A
H3_BC87_191109_LF_LIB_consensus_vsearch	4211	A	A	224	1	0.44%	2	1	93	93	0.4999999999999138	1	1	78	146	1	0	+T
H3_BC87_191109_LF_LIB_consensus_vsearch	4212	T	T	218	4	1.75%	2	2	93	93	0.061654458623218986	1	1	75	143	3	1	+G
H3_BC87_191109_LF_LIB_consensus_vsearch	4213	A	R	216	7	3.12%	2	2	93	93	0.007447971960236055	1	1	74	142	4	3	G
H3_BC87_191109_LF_LIB_consensus_vsearch	4214	A	*/-G	166	20	8.81%	2	2	93	93	5.561517304816399E-7	1	1	53	113	11	9	-G
H3_BC87_191109_LF_LIB_consensus_vsearch	4215	G	G	185	2	1.04%	2	1	93	93	0.24932975871318122	1	1	65	120	0	2	+C
H3_BC87_191109_LF_LIB_consensus_vsearch	4216	G	G	210	1	0.47%	2	1	93	93	0.4999999999999138	1	1	79	131	0	1	+C
H3_BC87_191109_LF_LIB_consensus_vsearch	4217	G	G	226	1	0.44%	2	1	93	93	0.4999999999999138	1	1	78	148	1	0	+AG
H3_BC87_191109_LF_LIB_consensus_vsearch	4218	G	G	225	2	0.87%	2	1	93	93	0.24944812362040697	1	1	78	147	0	2	-TGG
H3_BC87_191109_LF_LIB_consensus_vsearch	4219	T	*/-G	214	10	4.42%	2	1	93	93	8.813089995913842E-4	1	1	78	136	0	10	-G
H3_BC87_191109_LF_LIB_consensus_vsearch	4220	G	G	214	1	0.46%	2	1	93	93	0.5000000000001412	1	1	78	136	1	0	+TG
H3_BC87_191109_LF_LIB_consensus_vsearch	4221	G	G	218	4	1.76%	2	1	93	93	0.061654458623218986	1	1	80	138	0	4	A
H3_BC87_191109_LF_LIB_consensus_vsearch	4222	C	C	217	4	1.77%	2	1	93	93	0.0616506283607095	1	1	80	137	0	4	T
H3_BC87_191109_LF_LIB_consensus_vsearch	4223	T	T	218	4	1.77%	2	2	93	93	0.061654458623218986	1	1	78	140	2	2	+C
H3_BC87_191109_LF_LIB_consensus_vsearch	4224	C	C	218	3	1.33%	2	1	93	93	0.12414965986396012	1	1	80	138	0	3	+T
H3_BC87_191109_LF_LIB_consensus_vsearch	4225	T	T	219	4	1.76%	2	1	93	93	0.06165825449566743	1	1	79	140	0	4	+G
H3_BC87_191109_LF_LIB_consensus_vsearch	4226	G	G	220	4	1.75%	2	2	93	93	0.061662016439223415	1	1	79	141	1	3	-A
H3_BC87_191109_LF_LIB_consensus_vsearch	4227	A	*/-G	196	20	8.97%	2	2	93	93	6.015714107611032E-7	1	1	67	129	10	10	-G
H3_BC87_191109_LF_LIB_consensus_vsearch	4228	G	G	205	2	0.96%	2	1	93	93	0.24939467312372118	1	1	70	135	0	2	C
H3_BC87_191109_LF_LIB_consensus_vsearch	4229	G	G	224	2	0.88%	2	1	93	93	0.24944567627499675	1	1	78	146	2	0	+A
H3_BC87_191109_LF_LIB_consensus_vsearch	4230	G	G	226	1	0.44%	2	1	93	93	0.4999999999999138	1	1	79	147	1	0	+C
H3_BC87_191109_LF_LIB_consensus_vsearch	4231	C	C	225	2	0.87%	2	2	93	93	0.24944812362040697	1	1	79	146	1	1	-T
H3_BC87_191109_LF_LIB_consensus_vsearch	4232	T	T	217	5	2.2%	2	1	93	93	0.03054698177238809	1	1	77	140	0	5	+G
H3_BC87_191109_LF_LIB_consensus_vsearch	4233	G	G	226	1	0.44%	2	1	93	93	0.4999999999999138	1	1	79	147	0	1	+A
H3_BC87_191109_LF_LIB_consensus_vsearch	4234	A	A	224	3	1.32%	2	2	93	93	0.12417218543044797	1	1	76	148	2	1	G
H3_BC87_191109_LF_LIB_consensus_vsearch	4235	A	A	225	2	0.88%	2	1	93	93	0.24944812362040697	1	1	76	149	2	0	G
H3_BC87_191109_LF_LIB_consensus_vsearch	4236	T	T	226	2	0.87%	2	1	93	93	0.24945054945064127	1	1	80	146	0	2	C
H3_BC87_191109_LF_LIB_consensus_vsearch	4237	G	G	223	2	0.87%	2	1	93	93	0.24944320712692292	1	1	79	144	0	2	-C
H3_BC87_191109_LF_LIB_consensus_vsearch	4238	C	C	225	1	0.44%	2	1	93	93	0.5000000000003686	1	1	80	145	0	1	+T
H3_BC87_191109_LF_LIB_consensus_vsearch	4239	C	C	223	3	1.31%	2	1	93	93	0.12416851441234596	1	1	79	144	0	3	-T
H3_BC87_191109_LF_LIB_consensus_vsearch	4240	T	Y	201	20	8.89%	2	1	93	93	6.081727839654859E-7	1	1	79	122	0	20	C
H3_BC87_191109_LF_LIB_consensus_vsearch	4241	G	G	225	1	0.44%	2	1	93	93	0.5000000000003686	1	1	78	147	0	1	+T
H3_BC87_191109_LF_LIB_consensus_vsearch	4242	C	C	226	1	0.44%	2	1	93	93	0.4999999999999138	1	1	79	147	0	1	T
H3_BC87_191109_LF_LIB_consensus_vsearch	4243	C	Y	216	7	3.08%	2	1	93	93	0.007447971960236055	1	1	79	137	0	7	T
H3_BC87_191109_LF_LIB_consensus_vsearch	4244	G	G	229	0	0%	2	0	93	0	1.0	1	0	80	149	0	0	
H3_BC87_191109_LF_LIB_consensus_vsearch	4245	A	A	228	1	0.44%	2	1	93	93	0.4999999999999138	1	1	80	148	0	1	-T
H3_BC87_191109_LF_LIB_consensus_vsearch	4246	T	T	226	1	0.44%	2	1	93	93	0.4999999999999138	1	1	78	148	1	0	+C
H3_BC87_191109_LF_LIB_consensus_vsearch	4247	C	*/+G	92	104	45.41%	2	2	93	93	2.803625569661076E-40	1	1	41	51	32	72	+G
H3_BC87_191109_LF_LIB_consensus_vsearch	4248	G	*/+A	204	11	4.93%	2	1	93	93	4.2827676494109035E-4	1	1	63	141	11	0	+A
H3_BC87_191109_LF_LIB_consensus_vsearch	4249	G	R	220	7	3.08%	2	2	93	93	0.007454337359329176	1	1	77	143	3	4	A
H3_BC87_191109_LF_LIB_consensus_vsearch	4250	G	G	222	2	0.87%	2	1	93	93	0.24944071588395061	1	1	79	143	0	2	+A
H3_BC87_191109_LF_LIB_consensus_vsearch	4251	A	A	217	4	1.77%	2	1	93	93	0.0616506283607095	1	1	76	141	0	4	+GA
H3_BC87_191109_LF_LIB_consensus_vsearch	4252	A	A	219	5	2.2%	2	2	93	93	0.030553251388732716	1	1	77	142	3	2	G
H3_BC87_191109_LF_LIB_consensus_vsearch	4253	C	C	216	4	1.77%	2	2	93	93	0.061646763238677425	1	1	76	140	3	1	T
H3_BC87_191109_LF_LIB_consensus_vsearch	4254	G	G	224	2	0.88%	2	2	93	93	0.24944567627499675	1	1	77	147	1	1	A
H3_BC87_191109_LF_LIB_consensus_vsearch	4255	A	A	219	6	2.63%	2	2	93	93	0.015106507368173285	1	1	75	144	3	3	G
H3_BC87_191109_LF_LIB_consensus_vsearch	4256	C	C	217	4	1.75%	2	1	93	93	0.0616506283607095	1	1	76	141	0	4	-G
H3_BC87_191109_LF_LIB_consensus_vsearch	4257	G	G	220	1	0.45%	2	1	93	93	0.4999999999999138	1	1	77	143	0	1	+ATT
H3_BC87_191109_LF_LIB_consensus_vsearch	4258	G	*/-C	213	11	4.8%	2	2	93	93	4.305938947768699E-4	1	1	70	143	5	6	-C
H3_BC87_191109_LF_LIB_consensus_vsearch	4259	C	C	214	3	1.38%	2	2	93	93	0.12413394919162732	1	1	74	140	1	2	T
H3_BC87_191109_LF_LIB_consensus_vsearch	4260	C	C	228	1	0.44%	2	1	93	93	0.4999999999999138	1	1	80	148	0	1	+T
H3_BC87_191109_LF_LIB_consensus_vsearch	4261	C	*/-T	204	13	5.68%	2	1	93	93	1.0144502228683225E-4	1	1	78	126	0	13	-T
H3_BC87_191109_LF_LIB_consensus_vsearch	4262	T	T	210	3	1.4%	2	1	93	93	0.1241176470588473	1	1	79	131	0	3	C
H3_BC87_191109_LF_LIB_consensus_vsearch	4263	T	T	222	2	0.88%	2	2	93	93	0.24944071588395061	1	1	78	144	1	1	C
H3_BC87_191109_LF_LIB_consensus_vsearch	4264	G	G	224	3	1.32%	2	2	93	93	0.12417218543044797	1	1	79	145	1	2	A
H3_BC87_191109_LF_LIB_consensus_vsearch	4265	T	T	227	2	0.87%	2	1	93	93	0.24945295404843976	1	1	78	149	2	0	C
H3_BC87_191109_LF_LIB_consensus_vsearch	4266	C	C	224	2	0.87%	2	2	93	93	0.24944567627499675	1	1	78	146	1	1	+T
H3_BC87_191109_LF_LIB_consensus_vsearch	4267	G	G	217	4	1.76%	2	1	93	93	0.0616506283607095	1	1	72	145	4	0	A
H3_BC87_191109_LF_LIB_consensus_vsearch	4268	C	C	214	5	2.22%	2	1	93	93	0.030537362897492103	1	1	74	140	0	5	-G
H3_BC87_191109_LF_LIB_consensus_vsearch	4269	G	R	206	12	5.41%	2	2	93	93	2.089820970245861E-4	1	1	67	139	11	1	A
H3_BC87_191109_LF_LIB_consensus_vsearch	4270	G	R	209	9	3.93%	2	1	93	93	0.0017953764342624938	1	1	66	143	9	0	A
H3_BC87_191109_LF_LIB_consensus_vsearch	4271	C	C	217	2	0.9%	2	1	93	93	0.24942791762028085	1	1	74	143	2	0	T
H3_BC87_191109_LF_LIB_consensus_vsearch	4272	C	C	225	3	1.31%	2	1	93	93	0.12417582417582212	1	1	77	148	3	0	T
H3_BC87_191109_LF_LIB_consensus_vsearch	4273	T	T	224	2	0.87%	2	2	93	93	0.24944567627499675	1	1	79	145	1	1	-G
H3_BC87_191109_LF_LIB_consensus_vsearch	4274	G	G	217	3	1.32%	2	1	93	93	0.12414578587710072	1	1	76	141	0	3	+C
H3_BC87_191109_LF_LIB_consensus_vsearch	4275	C	*/-T	194	29	12.89%	2	2	93	93	7.038341573869359E-10	1	1	78	116	1	28	-T
H3_BC87_191109_LF_LIB_consensus_vsearch	4276	T	*/-C	182	11	5.53%	2	2	93	93	4.217452292539659E-4	1	1	72	110	7	4	-C
H3_BC87_191109_LF_LIB_consensus_vsearch	4277	C	C	214	1	0.46%	2	1	93	93	0.5000000000001412	1	1	72	142	0	1	+T
H3_BC87_191109_LF_LIB_consensus_vsearch	4278	C	Y	199	19	8.33%	2	1	93	93	1.266174101535565E-6	1	1	80	119	0	19	T
H3_BC87_191109_LF_LIB_consensus_vsearch	4279	G	G	219	4	1.78%	2	2	93	93	0.06165825449566743	1	1	77	142	2	2	A
H3_BC87_191109_LF_LIB_consensus_vsearch	4280	G	G	224	2	0.87%	2	2	93	93	0.24944567627499675	1	1	77	147	1	1	+C
H3_BC87_191109_LF_LIB_consensus_vsearch	4281	C	*/-G	205	12	5.26%	2	2	93	93	2.0882828978061456E-4	1	1	71	134	4	8	-G
H3_BC87_191109_LF_LIB_consensus_vsearch	4282	G	R	186	19	8.8%	2	1	93	93	1.2321623742189908E-6	1	1	50	136	19	0	A
H3_BC87_191109_LF_LIB_consensus_vsearch	4283	G	R	213	9	3.95%	2	2	93	93	0.0017981564163397133	1	1	69	144	6	3	A
H3_BC87_191109_LF_LIB_consensus_vsearch	4284	G	K	206	10	4.39%	2	1	93	93	8.778898007284436E-4	1	1	67	139	10	0	T
H3_BC87_191109_LF_LIB_consensus_vsearch	4285	T	T	210	6	2.67%	2	2	93	93	0.01508500627971554	1	1	78	132	1	5	C
H3_BC87_191109_LF_LIB_consensus_vsearch	4286	G	G	219	2	0.9%	2	2	93	93	0.24943310657599216	1	1	78	141	1	1	A
H3_BC87_191109_LF_LIB_consensus_vsearch	4287	C	C	222	4	1.76%	2	2	93	93	0.061669440342892484	1	1	78	144	1	3	-T
H3_BC87_191109_LF_LIB_consensus_vsearch	4288	T	T	220	2	0.89%	2	1	93	93	0.2494356659142869	1	1	75	145	2	0	+A
H3_BC87_191109_LF_LIB_consensus_vsearch	4289	G	G	219	2	0.87%	2	1	93	93	0.24943310657599216	1	1	74	145	2	0	-T
H3_BC87_191109_LF_LIB_consensus_vsearch	4290	T	T	217	3	1.33%	2	1	93	93	0.12414578587710072	1	1	74	143	3	0	+A
H3_BC87_191109_LF_LIB_consensus_vsearch	4291	G	G	222	2	0.88%	2	1	93	93	0.24944071588395061	1	1	77	145	2	0	-CT
H3_BC87_191109_LF_LIB_consensus_vsearch	4292	C	*/-T	209	8	3.54%	2	2	93	93	0.003658026926953576	1	1	70	139	4	4	-T
H3_BC87_191109_LF_LIB_consensus_vsearch	4293	T	T	211	4	1.85%	2	1	93	93	0.06162689769249	1	1	67	144	4	0	C
H3_BC87_191109_LF_LIB_consensus_vsearch	4294	T	*/-G	199	13	5.75%	2	2	93	93	1.0098964132434686E-4	1	1	65	134	1	12	-G
H3_BC87_191109_LF_LIB_consensus_vsearch	4295	G	R	185	24	11.21%	2	1	93	93	2.9597819574977793E-8	1	1	49	136	24	0	A
H3_BC87_191109_LF_LIB_consensus_vsearch	4296	G	G	219	5	2.19%	2	1	93	93	0.030553251388732716	1	1	73	146	5	0	T
H3_BC87_191109_LF_LIB_consensus_vsearch	4297	T	Y	215	7	3.06%	2	1	93	93	0.007446345105805389	1	1	78	137	0	7	C
H3_BC87_191109_LF_LIB_consensus_vsearch	4298	G	*/-C	211	10	4.44%	2	1	93	93	8.800549103686053E-4	1	1	77	134	0	10	-C
H3_BC87_191109_LF_LIB_consensus_vsearch	4299	C	C	210	3	1.39%	2	1	93	93	0.1241176470588473	1	1	78	132	0	3	+T
H3_BC87_191109_LF_LIB_consensus_vsearch	4300	C	*/-T	202	19	8.41%	2	1	93	93	1.273549938699874E-6	1	1	79	123	0	19	-T
H3_BC87_191109_LF_LIB_consensus_vsearch	4301	T	T	196	6	2.87%	2	1	93	93	0.015047771623015741	1	1	75	121	0	6	-C
H3_BC87_191109_LF_LIB_consensus_vsearch	4302	C	C	206	5	2.26%	2	2	93	93	0.030510377042941562	1	1	75	131	2	3	-T
H3_BC87_191109_LF_LIB_consensus_vsearch	4303	T	K	209	7	3.18%	2	1	93	93	0.007436270701269745	1	1	76	133	0	7	G
H3_BC87_191109_LF_LIB_consensus_vsearch	4304	A	*/-T	204	15	6.64%	2	2	93	93	2.3815125527116474E-5	1	1	76	128	2	13	-T
H3_BC87_191109_LF_LIB_consensus_vsearch	4305	T	T	202	4	1.9%	2	2	93	93	0.06158870665501416	1	1	76	126	1	3	A
H3_BC87_191109_LF_LIB_consensus_vsearch	4306	T	T	212	5	2.21%	2	1	93	93	0.030530802741347875	1	1	78	134	0	5	C
H3_BC87_191109_LF_LIB_consensus_vsearch	4307	A	*/-C	204	11	4.95%	2	2	93	93	4.2827676494109035E-4	1	1	73	131	2	9	-C
H3_BC87_191109_LF_LIB_consensus_vsearch	4308	C	C	203	5	2.35%	2	1	93	93	0.030499722862415764	1	1	77	126	0	5	+T
H3_BC87_191109_LF_LIB_consensus_vsearch	4309	C	Y	215	7	3.07%	2	2	93	93	0.007446345105805389	1	1	77	138	2	5	T
H3_BC87_191109_LF_LIB_consensus_vsearch	4310	C	C	215	6	2.63%	2	2	93	93	0.01509716650743782	1	1	78	137	2	4	T
H3_BC87_191109_LF_LIB_consensus_vsearch	4311	A	A	219	3	1.33%	2	2	93	93	0.12415349887135622	1	1	79	140	1	2	G
H3_BC87_191109_LF_LIB_consensus_vsearch	4312	G	G	220	5	2.18%	2	1	93	93	0.03055634444922604	1	1	79	141	0	5	-CG
H3_BC87_191109_LF_LIB_consensus_vsearch	4313	C	C	213	3	1.34%	2	1	93	93	0.12412993039444345	1	1	78	135	0	3	T
H3_BC87_191109_LF_LIB_consensus_vsearch	4314	G	G	214	3	1.35%	2	2	93	93	0.12413394919162732	1	1	78	136	1	2	+CG
H3_BC87_191109_LF_LIB_consensus_vsearch	4315	T	Y	216	8	3.57%	2	2	93	93	0.003665668526289429	1	1	79	137	1	7	C
H3_BC87_191109_LF_LIB_consensus_vsearch	4316	T	*/-G	213	9	3.95%	2	1	93	93	0.0017981564163397133	1	1	78	135	0	9	-G
H3_BC87_191109_LF_LIB_consensus_vsearch	4317	G	G	215	1	0.46%	2	1	93	93	0.4999999999999138	1	1	79	136	0	1	+C
H3_BC87_191109_LF_LIB_consensus_vsearch	4318	G	G	221	3	1.33%	2	1	93	93	0.12416107382546236	1	1	78	143	0	3	A
H3_BC87_191109_LF_LIB_consensus_vsearch	4319	C	C	216	5	2.2%	2	2	93	93	0.030543804461782422	1	1	76	140	1	4	-A
H3_BC87_191109_LF_LIB_consensus_vsearch	4320	A	R	205	8	3.59%	2	2	93	93	0.0036534383902297935	1	1	72	133	3	5	G
H3_BC87_191109_LF_LIB_consensus_vsearch	4321	G	G	219	2	0.9%	2	1	93	93	0.24943310657599216	1	1	73	146	2	0	A
H3_BC87_191109_LF_LIB_consensus_vsearch	4322	C	C	217	3	1.35%	2	1	93	93	0.12414578587710072	1	1	73	144	3	0	-A
H3_BC87_191109_LF_LIB_consensus_vsearch	4323	A	A	215	1	0.45%	2	1	93	93	0.4999999999999138	1	1	70	145	0	1	+C
H3_BC87_191109_LF_LIB_consensus_vsearch	4324	T	T	223	3	1.32%	2	1	93	93	0.12416851441234596	1	1	75	148	3	0	G
H3_BC87_191109_LF_LIB_consensus_vsearch	4325	T	T	224	3	1.32%	2	2	93	93	0.12417218543044797	1	1	78	146	1	2	+G
H3_BC87_191109_LF_LIB_consensus_vsearch	4326	G	*/+T	217	7	3.07%	2	1	93	93	0.007449584424390529	1	1	78	139	0	7	+T
H3_BC87_191109_LF_LIB_consensus_vsearch	4327	T	T	224	1	0.44%	2	1	93	93	0.4999999999999138	1	1	78	146	1	0	+C
H3_BC87_191109_LF_LIB_consensus_vsearch	4328	C	*/-T	219	7	3.07%	2	2	93	93	0.007452766938834958	1	1	77	142	1	6	-T
H3_BC87_191109_LF_LIB_consensus_vsearch	4329	T	T	218	1	0.45%	2	1	93	93	0.5000000000003686	1	1	77	141	0	1	+CC
H3_BC87_191109_LF_LIB_consensus_vsearch	4330	G	G	223	2	0.88%	2	1	93	93	0.24944320712692292	1	1	75	148	2	0	A
H3_BC87_191109_LF_LIB_consensus_vsearch	4331	C	C	225	1	0.44%	2	1	93	93	0.5000000000003686	1	1	78	147	0	1	+A
H3_BC87_191109_LF_LIB_consensus_vsearch	4332	A	A	223	2	0.88%	2	2	93	93	0.24944320712692292	1	1	77	146	1	1	-G
H3_BC87_191109_LF_LIB_consensus_vsearch	4333	G	G	218	3	1.32%	2	1	93	93	0.12414965986396012	1	1	70	148	3	0	-C
H3_BC87_191109_LF_LIB_consensus_vsearch	4334	C	C	223	1	0.44%	2	1	93	93	0.5000000000003686	1	1	75	148	0	1	A
H3_BC87_191109_LF_LIB_consensus_vsearch	4335	C	C	224	2	0.87%	2	1	93	93	0.24944567627499675	1	1	79	145	0	2	-A
H3_BC87_191109_LF_LIB_consensus_vsearch	4336	A	A	225	2	0.88%	2	1	93	93	0.24944812362040697	1	1	80	145	0	2	G
H3_BC87_191109_LF_LIB_consensus_vsearch	4337	A	A	217	3	1.31%	2	1	93	93	0.12414578587710072	1	1	77	140	0	3	+C
H3_BC87_191109_LF_LIB_consensus_vsearch	4338	C	C	219	4	1.75%	2	1	93	93	0.06165825449566743	1	1	80	139	0	4	+T
H3_BC87_191109_LF_LIB_consensus_vsearch	4339	T	*/+C	198	15	6.67%	2	2	93	93	2.3643457204170923E-5	1	1	74	124	6	9	+C
H3_BC87_191109_LF_LIB_consensus_vsearch	4340	C	C	221	3	1.33%	2	1	93	93	0.12416107382546236	1	1	76	145	3	0	+A
H3_BC87_191109_LF_LIB_consensus_vsearch	4341	A	A	222	2	0.87%	2	1	93	93	0.24944071588395061	1	1	76	146	2	0	+G
H3_BC87_191109_LF_LIB_consensus_vsearch	4342	G	G	226	1	0.44%	2	1	93	93	0.4999999999999138	1	1	78	148	0	1	-A
H3_BC87_191109_LF_LIB_consensus_vsearch	4343	A	A	223	2	0.88%	2	1	93	93	0.24944320712692292	1	1	76	147	2	0	G
H3_BC87_191109_LF_LIB_consensus_vsearch	4344	A	A	222	3	1.32%	2	2	93	93	0.12416481069040536	1	1	75	147	2	1	G
H3_BC87_191109_LF_LIB_consensus_vsearch	4345	C	C	223	2	0.88%	2	1	93	93	0.24944320712692292	1	1	74	149	2	0	-T
H3_BC87_191109_LF_LIB_consensus_vsearch	4346	T	T	221	2	0.89%	2	1	93	93	0.24943820224728358	1	1	75	146	0	2	C
H3_BC87_191109_LF_LIB_consensus_vsearch	4347	G	G	222	2	0.88%	2	1	93	93	0.24944071588395061	1	1	74	148	2	0	+TA
H3_BC87_191109_LF_LIB_consensus_vsearch	4348	G	G	226	1	0.44%	2	1	93	93	0.4999999999999138	1	1	78	148	0	1	+TAG
H3_BC87_191109_LF_LIB_consensus_vsearch	4349	C	Y	209	11	4.85%	2	1	93	93	4.2958650804029443E-4	1	1	77	132	0	11	T
H3_BC87_191109_LF_LIB_consensus_vsearch	4350	A	A	222	3	1.32%	2	1	93	93	0.12416481069040536	1	1	74	148	3	0	+C
H3_BC87_191109_LF_LIB_consensus_vsearch	4351	C	*/-G	202	8	3.52%	2	1	93	93	0.0036498841327700354	1	1	73	129	0	8	-G
H3_BC87_191109_LF_LIB_consensus_vsearch	4352	G	G	212	5	2.28%	2	2	93	93	0.030530802741347875	1	1	74	138	4	1	A
H3_BC87_191109_LF_LIB_consensus_vsearch	4353	G	G	226	1	0.44%	2	1	93	93	0.4999999999999138	1	1	78	148	0	1	T
H3_BC87_191109_LF_LIB_consensus_vsearch	4354	A	A	226	1	0.44%	2	1	93	93	0.4999999999999138	1	1	78	148	0	1	G
H3_BC87_191109_LF_LIB_consensus_vsearch	4355	C	C	210	4	1.76%	2	1	93	93	0.06162281305968737	1	1	67	143	4	0	-TT
H3_BC87_191109_LF_LIB_consensus_vsearch	4356	T	T	212	1	0.47%	2	1	93	93	0.5000000000001412	1	1	66	146	0	1	+C
H3_BC87_191109_LF_LIB_consensus_vsearch	4357	T	*/-G	164	41	19.07%	2	2	93	93	4.9208511446108474E-14	1	1	42	122	21	20	-G
H3_BC87_191109_LF_LIB_consensus_vsearch	4358	G	R	160	11	6.25%	2	2	93	93	4.136216803787874E-4	1	1	36	124	10	1	A
H3_BC87_191109_LF_LIB_consensus_vsearch	4359	G	G	216	4	1.82%	2	1	93	93	0.061646763238677425	1	1	68	148	4	0	A
H3_BC87_191109_LF_LIB_consensus_vsearch	4360	G	G	220	4	1.78%	2	1	93	93	0.061662016439223415	1	1	73	147	4	0	A
H3_BC87_191109_LF_LIB_consensus_vsearch	4361	G	G	221	2	0.89%	2	1	93	93	0.24943820224728358	1	1	77	144	0	2	-A
H3_BC87_191109_LF_LIB_consensus_vsearch	4362	A	A	222	0	0%	2	0	93	0	1.0	1	0	77	145	0	0	
H3_BC87_191109_LF_LIB_consensus_vsearch	4363	A	A	218	3	1.34%	2	2	93	93	0.12414965986396012	1	1	76	142	1	2	G
H3_BC87_191109_LF_LIB_consensus_vsearch	4364	T	T	215	4	1.79%	2	1	93	93	0.06164286277914926	1	1	74	141	0	4	C
H3_BC87_191109_LF_LIB_consensus_vsearch	4365	C	C	218	3	1.34%	2	2	93	93	0.12414965986396012	1	1	76	142	1	2	T
H3_BC87_191109_LF_LIB_consensus_vsearch	4366	T	Y	206	7	3.14%	2	2	93	93	0.007431022745174962	1	1	75	131	2	5	C
H3_BC87_191109_LF_LIB_consensus_vsearch	4367	G	G	224	0	0%	2	0	93	0	1.0	1	0	77	147	0	0	
H3_BC87_191109_LF_LIB_consensus_vsearch	4368	A	A	221	2	0.89%	2	2	93	93	0.24943820224728358	1	1	76	145	1	1	-C
H3_BC87_191109_LF_LIB_consensus_vsearch	4369	C	C	219	1	0.45%	2	1	93	93	0.4999999999999138	1	1	76	143	0	1	+G
H3_BC87_191109_LF_LIB_consensus_vsearch	4370	T	T	216	2	0.91%	2	1	93	93	0.249425287356441	1	1	74	142	0	2	C
H3_BC87_191109_LF_LIB_consensus_vsearch	4371	G	G	213	5	2.27%	2	1	93	93	0.030534097847134272	1	1	74	139	0	5	+T
H3_BC87_191109_LF_LIB_consensus_vsearch	4372	T	T	216	3	1.37%	2	1	93	93	0.12414187643025615	1	1	70	146	3	0	+C
H3_BC87_191109_LF_LIB_consensus_vsearch	4373	C	C	208	6	2.76%	2	1	93	93	0.015079983859610983	1	1	71	137	0	6	-T
H3_BC87_191109_LF_LIB_consensus_vsearch	4374	T	T	203	2	0.97%	2	1	93	93	0.2493887530563227	1	1	67	136	0	2	C
H3_BC87_191109_LF_LIB_consensus_vsearch	4375	A	A	205	2	0.97%	2	1	93	93	0.24939467312372118	1	1	62	143	2	0	G
H3_BC87_191109_LF_LIB_consensus_vsearch	4376	A	A	201	3	1.47%	2	1	93	93	0.12407862407864012	1	1	60	141	0	3	-T
H3_BC87_191109_LF_LIB_consensus_vsearch	4377	T	T	194	2	1.02%	2	1	93	93	0.24936061381078306	1	1	53	141	2	0	G
H3_BC87_191109_LF_LIB_consensus_vsearch	4378	T	*/-A	161	24	12.18%	2	1	93	93	2.685862201776044E-8	1	1	52	109	0	24	-A
H3_BC87_191109_LF_LIB_consensus_vsearch	4379	A	A	166	2	1.19%	2	1	93	93	0.24925373134341675	1	1	49	117	0	2	G
H3_BC87_191109_LF_LIB_consensus_vsearch	4380	A	A	190	0	0%	2	0	93	0	1.0	1	0	47	143	0	0	
H3_BC87_191109_LF_LIB_consensus_vsearch	4381	A	A	186	0	0%	2	0	93	0	1.0	1	0	43	143	0	0	
H3_BC87_191109_LF_LIB_consensus_vsearch	4382	A	A	184	0	0%	2	0	93	0	1.0	1	0	42	142	0	0	
H3_BC87_191109_LF_LIB_consensus_vsearch	4383	C	C	169	0	0%	2	0	93	0	1.0	1	0	32	137	0	0	
H3_BC87_191109_LF_LIB_consensus_vsearch	4384	A	A	164	0	0%	2	0	93	0	1.0	1	0	28	136	0	0	
H3_BC87_191109_LF_LIB_consensus_vsearch	4385	T	T	161	0	0%	2	0	93	0	1.0	1	0	27	134	0	0	
