Chrom	Position	Ref	Cons	Reads1	Reads2	VarFreq	Strands1	Strands2	Qual1	Qual2	Pvalue	MapQual1	MapQual2	Reads1Plus	Reads1Minus	Reads2Plus	Reads2Minus	VarAllele
barcode79_consensus_vsearch	21	C	*/+A	365	7	1.72%	2	1	93	93	0.007593177034187656	1	1	151	214	7	0	+A
barcode79_consensus_vsearch	21	C	*/-A	365	19	4.67%	2	2	93	93	1.518220570262078E-6	1	1	151	214	18	1	-A
barcode79_consensus_vsearch	42	G	*/-A	384	11	2.75%	2	1	93	93	4.5501547153779163E-4	1	1	166	218	11	0	-A
barcode79_consensus_vsearch	108	T	*/+A	384	9	2.23%	2	2	93	93	0.0018647509458963453	1	1	174	210	3	6	+A
barcode79_consensus_vsearch	127	G	*/-TG	394	7	1.72%	2	1	93	93	0.007608958034696689	1	1	180	214	0	7	-TG
barcode79_consensus_vsearch	138	A	*/+G	371	12	2.98%	2	2	93	93	2.236910591562848E-4	1	1	168	203	8	4	+G
barcode79_consensus_vsearch	138	A	*/-G	371	13	3.23%	2	1	93	93	1.10095664708683E-4	1	1	168	203	0	13	-G
barcode79_consensus_vsearch	153	C	*/-AC	397	7	1.73%	2	1	93	93	0.00761046189928152	1	1	175	222	7	0	-AC
barcode79_consensus_vsearch	170	C	*/-G	377	20	4.94%	2	1	93	93	7.461874627489505E-7	1	1	156	221	20	0	-G
barcode79_consensus_vsearch	179	G	*/-TG	390	11	2.7%	2	2	93	93	4.555025215794059E-4	1	1	178	212	1	10	-TG
barcode79_consensus_vsearch	181	G	*/+C	381	10	2.53%	2	1	93	93	9.212992345460898E-4	1	1	179	202	0	10	+C
barcode79_consensus_vsearch	183	T	*/-C	396	8	1.97%	2	1	93	93	0.0037719767465882576	1	1	182	214	0	8	-C
barcode79_consensus_vsearch	191	T	*/-C	387	15	3.69%	2	2	93	93	2.6716994663227938E-5	1	1	167	220	14	1	-C
barcode79_consensus_vsearch	196	A	*/-C	381	24	5.88%	2	2	93	93	4.196179786620246E-8	1	1	183	198	1	23	-C
barcode79_consensus_vsearch	198	C	*/-T	392	8	1.96%	2	1	93	93	0.0037706450711110975	1	1	184	208	0	8	-T
barcode79_consensus_vsearch	201	G	*/+C	392	7	1.72%	2	2	93	93	0.007607942959128091	1	1	177	215	3	4	+C
barcode79_consensus_vsearch	220	T	*/+G	392	9	2.21%	2	2	93	93	0.0018664928473143382	1	1	171	221	8	1	+G
barcode79_consensus_vsearch	221	G	*/+A	383	16	3.92%	2	2	93	93	1.3089247338748483E-5	1	1	162	221	15	1	+A
barcode79_consensus_vsearch	222	A	*/-G	391	9	2.22%	2	1	93	93	0.0018662788735768444	1	1	168	223	9	0	-G
barcode79_consensus_vsearch	238	C	*/-G	393	7	1.72%	2	1	93	93	0.007608451759263046	1	1	182	211	0	7	-G
barcode79_consensus_vsearch	245	C	*/-A	390	8	1.97%	2	2	93	93	0.0037699692796093966	1	1	177	213	1	7	-A
barcode79_consensus_vsearch	253	A	*/+G	375	8	1.98%	2	2	93	93	0.003764677830168862	1	1	178	197	2	6	+G
barcode79_consensus_vsearch	253	A	*/-G	375	17	4.2%	2	1	93	93	6.390395927916272E-6	1	1	178	197	0	17	-G
barcode79_consensus_vsearch	265	C	*/-T	392	10	2.47%	2	1	93	93	9.227866256324819E-4	1	1	184	208	0	10	-T
barcode79_consensus_vsearch	282	C	*/+T	385	7	1.74%	2	1	93	93	0.007604309052101333	1	1	177	208	0	7	+T
barcode79_consensus_vsearch	302	T	*/-GT	398	7	1.73%	2	1	93	93	0.007610958261497833	1	1	184	214	0	7	-GT
barcode79_consensus_vsearch	307	T	*/-G	389	14	3.44%	2	2	93	93	5.441381266881181E-5	1	1	180	209	1	13	-G
barcode79_consensus_vsearch	326	C	*/-G	379	20	4.91%	2	1	93	93	7.47128900641539E-7	1	1	181	198	0	20	-G
barcode79_consensus_vsearch	333	C	*/+G	354	17	4.17%	2	2	93	93	6.325161087718083E-6	1	1	151	203	12	5	+G
barcode79_consensus_vsearch	333	C	*/-G	354	23	5.64%	2	2	93	93	8.434889033931025E-8	1	1	151	203	12	11	-G
barcode79_consensus_vsearch	339	A	*/-T	397	7	1.72%	2	2	93	93	0.00761046189928152	1	1	175	222	6	1	-T
barcode79_consensus_vsearch	341	T	*/-A	390	8	1.96%	2	2	93	93	0.0037699692796093966	1	1	169	221	7	1	-A
barcode79_consensus_vsearch	343	G	*/-A	392	12	2.96%	2	1	93	93	2.2472535825225005E-4	1	1	170	222	12	0	-A
barcode79_consensus_vsearch	352	T	*/-C	372	33	8.09%	2	2	93	93	5.901944137644817E-11	1	1	154	218	28	5	-C
barcode79_consensus_vsearch	354	C	*/-G	381	20	4.9%	2	1	93	93	7.480618802321155E-7	1	1	183	198	0	20	-G
barcode79_consensus_vsearch	358	G	*/-A	383	15	3.69%	2	1	93	93	2.6680639716138052E-5	1	1	166	217	15	0	-A
barcode79_consensus_vsearch	385	T	*/-C	392	11	2.71%	2	2	93	93	4.5566171886911473E-4	1	1	171	221	10	1	-C
barcode79_consensus_vsearch	387	C	*/+A	390	8	1.96%	2	1	93	93	0.0037699692796093966	1	1	168	222	8	0	+A
barcode79_consensus_vsearch	391	G	*/+A	390	7	1.72%	2	2	93	93	0.007606917708857565	1	1	178	212	3	4	+A
barcode79_consensus_vsearch	393	A	*/+GG	391	9	2.23%	2	1	93	93	0.0018662788735768444	1	1	183	208	0	9	+GG
barcode79_consensus_vsearch	405	C	*/-GC	392	12	2.94%	2	2	93	93	2.2472535825225005E-4	1	1	176	216	6	6	-GC
barcode79_consensus_vsearch	407	C	*/-A	366	12	3.05%	2	2	93	93	2.234283568245827E-4	1	1	167	199	1	11	-A
barcode79_consensus_vsearch	410	A	*/-T	392	8	1.97%	2	2	93	93	0.0037706450711110975	1	1	173	219	5	3	-T
barcode79_consensus_vsearch	475	A	*/+C	395	8	1.97%	2	1	93	93	0.00377164628554966	1	1	174	221	8	0	+C
barcode79_consensus_vsearch	478	T	*/-A	393	7	1.73%	2	1	93	93	0.007608451759263046	1	1	176	217	7	0	-A
barcode79_consensus_vsearch	489	A	*/+G	385	10	2.46%	2	1	93	93	9.218495267512253E-4	1	1	165	220	10	0	+G
barcode79_consensus_vsearch	490	G	*/-A	251	99	24.75%	2	2	93	93	4.782931972536617E-34	1	1	150	101	21	78	-A
barcode79_consensus_vsearch	490	G	*/-AA	251	39	9.75%	2	1	93	93	4.62414385730143E-13	1	1	150	101	0	39	-A
barcode79_consensus_vsearch	506	T	*/+G	400	7	1.72%	2	1	93	93	0.007611943705349879	1	1	184	216	0	7	+G
barcode79_consensus_vsearch	521	T	*/-G	358	43	10.54%	2	1	93	93	3.4601148625390965E-14	1	1	180	178	0	43	-G
barcode79_consensus_vsearch	524	A	*/-G	377	13	3.23%	2	2	93	93	1.1027355068065241E-4	1	1	171	206	5	8	-G
barcode79_consensus_vsearch	534	T	*/-G	383	10	2.46%	2	2	93	93	9.215757570452482E-4	1	1	179	204	2	8	-G
barcode79_consensus_vsearch	556	T	*/-C	394	8	1.97%	2	2	93	93	0.0037713141940397903	1	1	175	219	6	2	-C
barcode79_consensus_vsearch	562	T	*/-C	361	41	10.17%	2	1	93	93	1.5528109399087245E-13	1	1	143	218	41	0	-C
barcode79_consensus_vsearch	564	C	*/-A	365	33	8.09%	2	1	93	93	5.828841998801362E-11	1	1	146	219	33	0	-A
barcode79_consensus_vsearch	578	A	*/+G	391	9	2.22%	2	2	93	93	0.0018662788735768444	1	1	169	222	7	2	+G
barcode79_consensus_vsearch	580	A	*/-G	389	12	2.96%	2	2	93	93	2.245840498305788E-4	1	1	168	221	11	1	-G
barcode79_consensus_vsearch	583	T	*/+A	396	8	1.96%	2	1	93	93	0.0037719767465882576	1	1	175	221	8	0	+A
barcode79_consensus_vsearch	592	T	*/-A	391	14	3.43%	2	2	93	93	5.4445204224320063E-5	1	1	182	209	1	13	-A
barcode79_consensus_vsearch	598	G	*/-TG	397	9	2.21%	2	1	93	93	0.0018675470949966115	1	1	182	215	0	9	-TG
barcode79_consensus_vsearch	613	T	*/+G	383	16	3.95%	2	1	93	93	1.3089247338748483E-5	1	1	184	199	0	16	+G
barcode79_consensus_vsearch	615	A	*/+G	263	18	4.47%	2	2	93	93	2.880089741499654E-6	1	1	70	193	16	2	+G
barcode79_consensus_vsearch	615	A	*/-G	263	106	26.3%	2	2	93	93	1.7856653484444738E-36	1	1	70	193	88	18	-G
barcode79_consensus_vsearch	615	A	*/-GG	263	8	1.99%	2	2	93	93	0.003706880776381375	1	1	70	193	3	5	-G
barcode79_consensus_vsearch	628	C	*/-T	370	26	6.4%	2	2	93	93	9.750863912474895E-9	1	1	178	192	1	25	-T
barcode79_consensus_vsearch	630	T	*/-A	382	7	1.75%	2	2	93	93	0.0076027118384171	1	1	164	218	4	3	-A
barcode79_consensus_vsearch	631	A	*/+G	378	15	3.76%	2	2	93	93	2.663420769821532E-5	1	1	171	207	3	12	+G
barcode79_consensus_vsearch	634	A	*/-C	391	7	1.72%	2	2	93	93	0.007607431615374521	1	1	171	220	6	1	-C
barcode79_consensus_vsearch	639	T	*/-C	382	18	4.44%	2	2	93	93	3.137160031756088E-6	1	1	174	208	9	9	-C
barcode79_consensus_vsearch	642	C	*/-T	387	14	3.43%	2	2	93	93	5.438212094947901E-5	1	1	181	206	1	13	-T
barcode79_consensus_vsearch	646	C	*/+G	384	8	1.96%	2	2	93	93	0.0037679008816766993	1	1	182	202	1	7	+G
barcode79_consensus_vsearch	646	C	*/-G	384	9	2.21%	2	1	93	93	0.0018647509458963453	1	1	182	202	0	9	-G
barcode79_consensus_vsearch	650	C	*/-G	390	7	1.72%	2	1	93	93	0.007606917708857565	1	1	182	208	0	7	-G
barcode79_consensus_vsearch	657	C	*/-A	382	10	2.48%	2	2	93	93	9.214378424824657E-4	1	1	166	216	8	2	-A
barcode79_consensus_vsearch	657	C	*/-ACT	382	7	1.74%	2	1	93	93	0.0076027118384171	1	1	166	216	7	0	-A
barcode79_consensus_vsearch	659	C	*/-T	384	8	2%	2	2	93	93	0.0037679008816766993	1	1	166	218	7	1	-T
barcode79_consensus_vsearch	668	T	*/+C	326	14	3.47%	2	2	93	93	5.324514617660385E-5	1	1	138	188	2	12	+C
barcode79_consensus_vsearch	668	T	*/-C	326	39	9.68%	2	2	93	93	6.225968428556271E-13	1	1	138	188	25	14	-C
barcode79_consensus_vsearch	668	T	*/-CC	326	18	4.47%	2	2	93	93	3.0363241491957594E-6	1	1	138	188	16	2	-C
barcode79_consensus_vsearch	672	C	*/+T	366	16	3.92%	2	1	93	93	1.2998365918939041E-5	1	1	178	188	0	16	+T
barcode79_consensus_vsearch	672	C	*/-T	366	17	4.17%	2	2	93	93	6.36325233547173E-6	1	1	178	188	6	11	-T
barcode79_consensus_vsearch	694	G	*/-TGG	397	8	1.96%	2	1	93	93	0.003772305589141729	1	1	184	213	0	8	-TGG
barcode79_consensus_vsearch	699	C	*/-T	393	9	2.21%	2	2	93	93	0.0018667057694086889	1	1	183	210	1	8	-T
barcode79_consensus_vsearch	700	T	*/-C	387	7	1.75%	2	2	93	93	0.007605360418658285	1	1	177	210	1	6	-C
barcode79_consensus_vsearch	707	C	*/-T	360	20	5.03%	2	2	93	93	7.378269482246793E-7	1	1	178	182	1	19	-T
barcode79_consensus_vsearch	707	C	*/-TT	360	8	2.01%	2	2	93	93	0.0037589589194791835	1	1	178	182	1	7	-T
barcode79_consensus_vsearch	710	T	*/+C	233	57	14.29%	2	2	93	93	3.2709278129627623E-19	1	1	169	64	2	55	+C
barcode79_consensus_vsearch	710	T	*/-C	233	67	16.79%	2	2	93	93	1.0627779531580453E-22	1	1	169	64	10	57	-C
barcode79_consensus_vsearch	710	T	*/-CC	233	13	3.26%	2	1	93	93	1.0374225858311641E-4	1	1	169	64	0	13	-C
barcode79_consensus_vsearch	713	C	*/-T	377	11	2.76%	2	1	93	93	4.544286380884945E-4	1	1	183	194	0	11	-T
barcode79_consensus_vsearch	715	C	*/-A	389	7	1.76%	2	2	93	93	0.0076064012202881484	1	1	176	213	6	1	-A
barcode79_consensus_vsearch	718	A	*/+G	375	10	2.47%	2	1	93	93	9.204527288502928E-4	1	1	171	204	0	10	+G
barcode79_consensus_vsearch	718	A	*/-G	375	10	2.47%	2	2	93	93	9.204527288502928E-4	1	1	171	204	3	7	+G
barcode79_consensus_vsearch	722	T	*/-G	398	8	1.96%	2	2	93	93	0.003772632825065396	1	1	183	215	1	7	-G
barcode79_consensus_vsearch	729	C	*/-G	381	9	2.24%	2	1	93	93	0.0018640795393290628	1	1	180	201	0	9	-G
barcode79_consensus_vsearch	735	A	*/+T	385	7	1.72%	2	2	93	93	0.007604309052101333	1	1	168	217	5	2	+T
barcode79_consensus_vsearch	735	A	*/-T	385	13	3.19%	2	2	93	93	1.1050267709682812E-4	1	1	168	217	9	4	-T
barcode79_consensus_vsearch	743	C	*/+G	387	7	1.75%	2	2	93	93	0.007605360418658285	1	1	174	213	1	6	+G
barcode79_consensus_vsearch	757	C	*/-GC	385	15	3.69%	2	2	93	93	2.669890358265385E-5	1	1	174	211	7	8	-GC
barcode79_consensus_vsearch	767	A	*/-G	387	12	2.96%	2	2	93	93	2.2448869655710964E-4	1	1	175	212	5	7	-G
barcode79_consensus_vsearch	769	G	*/-C	384	21	5.15%	2	2	93	93	3.6545901487679177E-7	1	1	161	223	20	1	-C
barcode79_consensus_vsearch	832	G	*/+T	391	11	2.7%	2	2	93	93	4.5558231391399246E-4	1	1	169	222	10	1	+T
barcode79_consensus_vsearch	859	A	*/+G	353	7	1.72%	2	1	93	93	0.0075859074962920095	1	1	167	186	0	7	+G
barcode79_consensus_vsearch	859	A	*/-G	353	28	6.9%	2	2	93	93	2.226406722969495E-9	1	1	167	186	13	15	-G
barcode79_consensus_vsearch	859	A	*/-GGG	353	13	3.2%	2	1	93	93	1.0952832598351308E-4	1	1	167	186	0	13	-G
barcode79_consensus_vsearch	866	C	*/+T	388	7	1.72%	2	1	93	93	0.007605882130108492	1	1	182	206	0	7	+T
barcode79_consensus_vsearch	866	C	*/-T	388	7	1.72%	2	2	93	93	0.007605882130108492	1	1	182	206	1	6	+T
barcode79_consensus_vsearch	867	T	*/-C	353	29	7.23%	2	1	93	93	1.0723518619811153E-9	1	1	178	175	0	29	-C
barcode79_consensus_vsearch	867	T	*/-CG	353	9	2.24%	2	1	93	93	0.0018572836808082116	1	1	178	175	0	9	-C
barcode79_consensus_vsearch	868	C	*/-G	342	9	2.46%	2	2	93	93	0.0018543213632639765	1	1	181	161	1	8	-G
barcode79_consensus_vsearch	883	T	*/-C	390	7	1.73%	2	1	93	93	0.007606917708857565	1	1	182	208	0	7	-C
barcode79_consensus_vsearch	885	T	*/+G	377	7	1.74%	2	1	93	93	0.007599994652592844	1	1	178	199	0	7	+G
barcode79_consensus_vsearch	885	T	*/-G	377	13	3.23%	2	2	93	93	1.1027355068065241E-4	1	1	178	199	3	10	-G
barcode79_consensus_vsearch	898	G	*/-A	392	7	1.73%	2	2	93	93	0.007607942959128091	1	1	178	214	3	4	-A
barcode79_consensus_vsearch	903	T	*/+C	377	10	2.46%	2	1	93	93	9.207377634483318E-4	1	1	184	193	0	10	+C
barcode79_consensus_vsearch	903	T	*/-C	377	16	3.93%	2	1	93	93	1.3058016225586293E-5	1	1	184	193	0	16	-C
barcode79_consensus_vsearch	909	A	*/+C	330	11	2.7%	2	2	93	93	4.498805515561457E-4	1	1	158	172	3	8	+C
barcode79_consensus_vsearch	909	A	*/-C	330	57	13.97%	2	2	93	93	7.485994818320485E-19	1	1	158	172	18	39	-C
barcode79_consensus_vsearch	944	C	*/-A	380	12	2.96%	2	2	93	93	2.2414751491838127E-4	1	1	158	222	11	1	-A
barcode79_consensus_vsearch	946	A	*/-G	380	17	4.18%	2	2	93	93	6.404980089016243E-6	1	1	162	218	15	2	-G
barcode79_consensus_vsearch	959	T	*/+G	397	7	1.72%	2	1	93	93	0.00761046189928152	1	1	183	214	0	7	+G
barcode79_consensus_vsearch	963	C	*/-A	394	11	2.7%	2	1	93	93	4.5581937785957034E-4	1	1	184	210	0	11	-A
barcode79_consensus_vsearch	965	A	*/-G	395	9	2.21%	2	1	93	93	0.0018671284895574335	1	1	184	211	0	9	-G
barcode79_consensus_vsearch	972	A	*/-G	386	10	2.46%	2	2	93	93	9.219853921161506E-4	1	1	172	214	6	4	-G
barcode79_consensus_vsearch	973	G	*/+A	388	7	1.76%	2	1	93	93	0.007605882130108492	1	1	169	219	7	0	+A
barcode79_consensus_vsearch	976	T	*/+G	221	11	2.72%	2	2	93	93	4.3250849347899065E-4	1	1	116	105	4	7	+G
barcode79_consensus_vsearch	976	T	*/-G	221	139	34.32%	2	2	93	93	8.403670337037607E-50	1	1	116	105	38	101	-G
barcode79_consensus_vsearch	976	T	*/-GG	221	27	6.67%	2	2	93	93	3.5264498592700116E-9	1	1	116	105	21	6	-G
barcode79_consensus_vsearch	984	C	*/+A	374	11	2.71%	2	2	93	93	4.541707543665027E-4	1	1	182	192	1	10	+A
barcode79_consensus_vsearch	984	C	*/-AA	374	12	2.96%	2	1	93	93	2.2384550798854884E-4	1	1	182	192	0	12	-AA
barcode79_consensus_vsearch	995	A	*/+G	396	9	2.21%	2	1	93	93	0.0018673383028544072	1	1	181	215	0	9	+G
barcode79_consensus_vsearch	1009	T	*/-C	393	8	1.97%	2	1	93	93	0.003770980459969231	1	1	172	221	8	0	-C
barcode79_consensus_vsearch	1013	A	*/+C	396	7	1.72%	2	2	93	93	0.007609963086240239	1	1	175	221	6	1	+C
barcode79_consensus_vsearch	1037	C	*/-T	392	8	1.96%	2	1	93	93	0.0037706450711110975	1	1	183	209	0	8	-T
barcode79_consensus_vsearch	1062	C	*/+A	319	12	3%	2	2	93	93	2.2058404097008725E-4	1	1	157	162	11	1	+A
barcode79_consensus_vsearch	1062	C	*/+G	319	17	4.25%	2	2	93	93	6.199765720397519E-6	1	1	157	162	2	15	+G
barcode79_consensus_vsearch	1062	C	*/-G	319	49	12.25%	2	2	93	93	3.206511590952523E-16	1	1	157	162	12	37	-G
barcode79_consensus_vsearch	1080	A	*/-G	387	8	1.96%	2	1	93	93	0.0037689428690762675	1	1	172	215	8	0	-G
barcode79_consensus_vsearch	1085	C	*/-T	390	11	2.7%	2	1	93	93	4.555025215794059E-4	1	1	184	206	0	11	-T
barcode79_consensus_vsearch	1095	T	*/+G	194	151	37.1%	2	2	93	93	2.0222534462556992E-55	1	1	102	92	52	99	+G
barcode79_consensus_vsearch	1095	T	*/+GG	194	12	2.95%	2	1	93	93	2.070433166935576E-4	1	1	102	92	0	12	+G
barcode79_consensus_vsearch	1095	T	*/-G	194	39	9.58%	2	2	93	93	3.206515867492819E-13	1	1	102	92	24	15	-G
barcode79_consensus_vsearch	1095	T	*/-GG	194	7	1.72%	2	2	93	93	0.007408480654387502	1	1	102	92	4	3	-G
barcode79_consensus_vsearch	1111	C	*/+A	387	7	1.73%	2	1	93	93	0.007605360418658285	1	1	172	215	7	0	+A
barcode79_consensus_vsearch	1124	T	*/-A	388	11	2.7%	2	2	93	93	4.5534176337797E-4	1	1	167	221	10	1	-A
barcode79_consensus_vsearch	1140	A	*/-G	388	13	3.2%	2	2	93	93	1.1058632327078025E-4	1	1	176	212	4	9	-G
barcode79_consensus_vsearch	1141	G	*/+AG	380	7	1.79%	2	1	93	93	0.007601633344865528	1	1	170	210	7	0	+AG
barcode79_consensus_vsearch	1144	C	*/+A	376	20	4.95%	2	1	93	93	7.457135361429162E-7	1	1	181	195	0	20	+A
barcode79_consensus_vsearch	1151	A	*/+G	389	7	1.72%	2	1	93	93	0.0076064012202881484	1	1	181	208	0	7	+G
barcode79_consensus_vsearch	1155	G	*/-TG	374	20	4.99%	2	2	93	93	7.447591948950539E-7	1	1	181	193	1	19	-TG
barcode79_consensus_vsearch	1168	C	*/-TT	370	31	7.6%	2	1	93	93	2.548256913762768E-10	1	1	149	221	31	0	-TT
barcode79_consensus_vsearch	1170	T	*/-A	351	7	1.86%	2	2	93	93	0.0075846487975676224	1	1	130	221	4	3	-A
barcode79_consensus_vsearch	1172	A	*/-T	368	26	6.47%	2	2	93	93	9.729187254824139E-9	1	1	149	219	24	2	-T
barcode79_consensus_vsearch	1174	T	*/+C	387	7	1.72%	2	1	93	93	0.007605360418658285	1	1	174	213	0	7	+C
barcode79_consensus_vsearch	1185	C	*/+G	312	10	2.46%	2	2	93	93	9.096993569105878E-4	1	1	110	202	9	1	+G
barcode79_consensus_vsearch	1185	C	*/-G	312	75	18.43%	2	2	93	93	4.9725737862262075E-25	1	1	110	202	57	18	-G
barcode79_consensus_vsearch	1204	A	*/-G	379	13	3.19%	2	1	93	93	1.1033167832753745E-4	1	1	179	200	0	13	-G
barcode79_consensus_vsearch	1215	A	*/-G	389	9	2.21%	2	1	93	93	0.0018658477399051397	1	1	181	208	0	9	-G
barcode79_consensus_vsearch	1236	C	*/-T	389	13	3.19%	2	2	93	93	1.1061393736967548E-4	1	1	182	207	2	11	-T
barcode79_consensus_vsearch	1246	C	*/-TC	386	16	3.94%	2	1	93	93	1.310453350400098E-5	1	1	166	220	16	0	-TC
barcode79_consensus_vsearch	1259	G	*/-TG	396	8	1.97%	2	1	93	93	0.0037719767465882576	1	1	184	212	0	8	-TG
barcode79_consensus_vsearch	1278	T	*/-C	396	9	2.21%	2	2	93	93	0.0018673383028544072	1	1	181	215	1	8	-C
barcode79_consensus_vsearch	1290	C	*/-T	398	7	1.72%	2	2	93	93	0.007610958261497833	1	1	182	216	1	6	-T
barcode79_consensus_vsearch	1303	T	*/-C	395	11	2.71%	2	2	93	93	4.558976374421885E-4	1	1	178	217	6	5	-C
barcode79_consensus_vsearch	1321	C	*/+G	381	11	2.7%	2	2	93	93	4.547664803982017E-4	1	1	179	202	1	10	+G
barcode79_consensus_vsearch	1325	T	*/-C	372	32	7.86%	2	1	93	93	1.229002009614241E-10	1	1	150	222	32	0	-C
barcode79_consensus_vsearch	1327	C	*/-G	358	42	10.29%	2	2	93	93	7.303167338328031E-14	1	1	180	178	2	40	-G
barcode79_consensus_vsearch	1343	T	*/+C	339	13	3.19%	2	2	93	93	1.0904851456684069E-4	1	1	155	184	5	8	+C
barcode79_consensus_vsearch	1343	T	*/-C	339	49	12.01%	2	2	93	93	3.52350471824878E-16	1	1	155	184	19	30	-C
barcode79_consensus_vsearch	1347	C	*/-TC	374	28	6.86%	2	1	93	93	2.2892939757561792E-9	1	1	181	193	0	28	-TC
barcode79_consensus_vsearch	1348	T	*/-C	360	9	2.4%	2	2	93	93	0.0018590780544759323	1	1	179	181	1	8	-C
barcode79_consensus_vsearch	1349	C	*/+T	361	7	1.89%	2	1	93	93	0.007590806239049772	1	1	181	180	0	7	+T
barcode79_consensus_vsearch	1350	A	*/-T	238	40	9.85%	2	2	93	93	2.0058753734568649E-13	1	1	49	189	14	26	-T
barcode79_consensus_vsearch	1350	A	*/-TT	238	88	21.67%	2	2	93	93	3.567859638590463E-30	1	1	49	189	83	5	-TT
barcode79_consensus_vsearch	1350	A	*/-TTT	238	30	7.39%	2	1	93	93	3.943683279375187E-10	1	1	49	189	30	0	-TT
barcode79_consensus_vsearch	1367	T	*/+G	394	8	1.96%	2	2	93	93	0.0037713141940397903	1	1	181	213	1	7	+G
barcode79_consensus_vsearch	1368	G	*/-A	390	16	3.93%	2	1	93	93	1.3124583755675277E-5	1	1	167	223	16	0	-A
barcode79_consensus_vsearch	1369	A	*/-G	362	15	3.84%	2	2	93	93	2.647778278892089E-5	1	1	148	214	8	7	-G
barcode79_consensus_vsearch	1373	A	*/+C	390	7	1.74%	2	1	93	93	0.007606917708857565	1	1	178	212	0	7	+C
barcode79_consensus_vsearch	1375	T	*/-C	393	7	1.72%	2	1	93	93	0.007608451759263046	1	1	180	213	0	7	-C
barcode79_consensus_vsearch	1378	C	*/-GC	395	7	1.72%	2	2	93	93	0.007609461804174083	1	1	177	218	5	2	-GC
barcode79_consensus_vsearch	1380	C	*/-T	368	13	3.26%	2	2	93	93	1.1000469648005649E-4	1	1	174	194	1	12	-T
barcode79_consensus_vsearch	1380	C	*/-TC	368	14	3.51%	2	1	93	93	5.40652177981554E-5	1	1	174	194	0	14	-TC
barcode79_consensus_vsearch	1381	T	*/-C	364	7	1.84%	2	2	93	93	0.007592589101619866	1	1	181	183	1	6	-C
barcode79_consensus_vsearch	1386	A	*/+G	350	24	6.03%	2	2	93	93	4.071980184919863E-8	1	1	171	179	1	23	+G
barcode79_consensus_vsearch	1386	A	*/-G	350	8	2.01%	2	2	93	93	0.00375488254999716	1	1	171	179	1	7	+G
barcode79_consensus_vsearch	1405	A	*/-G	373	16	3.95%	2	1	93	93	1.3036692196399446E-5	1	1	173	200	0	16	-G
barcode79_consensus_vsearch	1410	G	*/-TG	392	8	1.97%	2	2	93	93	0.0037706450711110975	1	1	181	211	2	6	-TG
barcode79_consensus_vsearch	1420	T	*/-C	382	14	3.46%	2	1	93	93	5.430154987343997E-5	1	1	182	200	0	14	-C
barcode79_consensus_vsearch	1424	C	*/-A	397	7	1.72%	2	2	93	93	0.00761046189928152	1	1	181	216	1	6	-A
barcode79_consensus_vsearch	1448	A	*/+G	390	11	2.72%	2	1	93	93	4.555025215794059E-4	1	1	179	211	0	11	+G
barcode79_consensus_vsearch	1453	T	*/-C	398	7	1.72%	2	2	93	93	0.007610958261497833	1	1	177	221	6	1	-C
barcode79_consensus_vsearch	1456	T	*/-G	391	7	1.72%	2	2	93	93	0.007607431615374521	1	1	179	212	2	5	-G
barcode79_consensus_vsearch	1467	C	*/-GCGC	399	7	1.72%	2	2	93	93	0.007611452190916357	1	1	178	221	6	1	-GCGC
barcode79_consensus_vsearch	1469	C	*/-GC	324	73	18.25%	2	2	93	93	2.7558718487467012E-24	1	1	136	188	40	33	-GC
barcode79_consensus_vsearch	1506	G	*/+A	382	17	4.23%	2	1	93	93	6.410718325764792E-6	1	1	158	224	17	0	+A
barcode79_consensus_vsearch	1508	G	*/-A	358	27	6.68%	2	1	93	93	4.646437263674475E-9	1	1	139	219	27	0	-A
barcode79_consensus_vsearch	1508	G	*/-AG	358	15	3.71%	2	2	93	93	2.6436691015052886E-5	1	1	139	219	11	4	-A
barcode79_consensus_vsearch	1511	C	*/-GC	391	9	2.22%	2	2	93	93	0.0018662788735768444	1	1	171	220	6	3	-GC
barcode79_consensus_vsearch	1542	T	*/-G	368	23	5.72%	2	2	93	93	8.54317848873366E-8	1	1	166	202	11	12	-G
barcode79_consensus_vsearch	1556	T	*/-G	381	20	4.91%	2	2	93	93	7.480618802321155E-7	1	1	175	206	6	14	-G
barcode79_consensus_vsearch	1558	G	*/-A	396	9	2.21%	2	2	93	93	0.0018673383028544072	1	1	177	219	5	4	-A
barcode79_consensus_vsearch	1564	G	*/-C	394	8	1.98%	2	1	93	93	0.0037713141940397903	1	1	181	213	0	8	-C
barcode79_consensus_vsearch	1583	C	*/+T	375	16	3.92%	2	2	93	93	1.3047405506016577E-5	1	1	182	193	1	15	+T
barcode79_consensus_vsearch	1583	C	*/-T	375	9	2.21%	2	1	93	93	0.001862705653908663	1	1	182	193	0	9	+T
barcode79_consensus_vsearch	1598	C	*/-A	396	7	1.72%	2	1	93	93	0.007609963086240239	1	1	174	222	7	0	-A
barcode79_consensus_vsearch	1606	C	*/-AC	394	9	2.21%	2	1	93	93	0.0018669176476072253	1	1	171	223	9	0	-AC
barcode79_consensus_vsearch	1619	T	*/+C	349	11	2.72%	2	2	93	93	4.5185864877991805E-4	1	1	130	219	9	2	+C
barcode79_consensus_vsearch	1619	T	*/-C	349	41	10.15%	2	2	93	93	1.4995425279949682E-13	1	1	130	219	40	1	-C
barcode79_consensus_vsearch	1627	C	*/-T	312	93	22.79%	2	2	93	93	2.556035211135322E-31	1	1	179	133	5	88	-T
barcode79_consensus_vsearch	1636	C	*/-AC	378	27	6.65%	2	2	93	93	4.759853698313382E-9	1	1	165	213	18	9	-AC
barcode79_consensus_vsearch	1651	C	*/-TAC	387	14	3.44%	2	2	93	93	5.438212094947901E-5	1	1	177	210	6	8	-TAC
barcode79_consensus_vsearch	1673	A	*/-GA	381	9	2.21%	2	1	93	93	0.0018640795393290628	1	1	161	220	9	0	-GA
barcode79_consensus_vsearch	1680	A	*/+G	381	7	1.72%	2	1	93	93	0.007602173974125566	1	1	169	212	0	7	+G
barcode79_consensus_vsearch	1682	G	*/-A	396	8	1.96%	2	2	93	93	0.0037719767465882576	1	1	175	221	7	1	-A
barcode79_consensus_vsearch	1688	C	*/-G	336	52	12.87%	2	2	93	93	3.5555936229491185E-17	1	1	173	163	7	45	-G
barcode79_consensus_vsearch	1693	A	*/+T	394	7	1.72%	2	1	93	93	0.007608958034696689	1	1	183	211	0	7	+T
barcode79_consensus_vsearch	1694	C	*/+T	362	14	3.43%	2	2	93	93	5.395878332906229E-5	1	1	170	192	2	12	+T
barcode79_consensus_vsearch	1694	C	*/-T	362	12	2.94%	2	2	93	93	2.232132880589182E-4	1	1	170	192	6	6	+T
barcode79_consensus_vsearch	1714	C	*/-T	389	14	3.44%	2	1	93	93	5.441381266881181E-5	1	1	182	207	0	14	-T
barcode79_consensus_vsearch	1716	T	*/-G	387	12	2.95%	2	1	93	93	2.2448869655710964E-4	1	1	180	207	0	12	-G
barcode79_consensus_vsearch	1718	G	*/-A	397	7	1.72%	2	1	93	93	0.00761046189928152	1	1	175	222	7	0	-A
barcode79_consensus_vsearch	1726	G	*/-C	395	8	1.97%	2	2	93	93	0.00377164628554966	1	1	181	214	1	7	-C
barcode79_consensus_vsearch	1728	C	*/-T	393	10	2.46%	2	1	93	93	9.229178835087009E-4	1	1	183	210	0	10	-T
barcode79_consensus_vsearch	1742	A	*/+T	391	7	1.72%	2	1	93	93	0.007607431615374521	1	1	170	221	7	0	+T
barcode79_consensus_vsearch	1745	T	*/+A	394	12	2.94%	2	1	93	93	2.2481843544276345E-4	1	1	170	224	12	0	+A
barcode79_consensus_vsearch	1746	A	*/+G	395	7	1.72%	2	1	93	93	0.007609461804174083	1	1	179	216	0	7	+G
barcode79_consensus_vsearch	1748	A	*/-G	389	8	1.99%	2	2	93	93	0.0037696288519149155	1	1	172	217	6	2	-G
barcode79_consensus_vsearch	1773	T	*/+C	389	9	2.21%	2	2	93	93	0.0018658477399051397	1	1	177	212	7	2	+C
barcode79_consensus_vsearch	1773	T	*/-C	389	9	2.21%	2	1	93	93	0.0018658477399051397	1	1	177	212	0	9	+C
barcode79_consensus_vsearch	1806	T	*/+G	382	8	1.97%	2	2	93	93	0.0037671973936205536	1	1	181	201	1	7	+G
barcode79_consensus_vsearch	1810	G	*/-AG	393	8	1.98%	2	2	93	93	0.003770980459969231	1	1	172	221	7	1	-AG
barcode79_consensus_vsearch	1816	A	*/+G	381	7	1.74%	2	1	93	93	0.007602173974125566	1	1	179	202	0	7	+G
barcode79_consensus_vsearch	1817	G	*/-C	378	14	3.47%	2	2	93	93	5.423567585746075E-5	1	1	174	204	7	7	-C
barcode79_consensus_vsearch	1820	C	*/-T	365	34	8.33%	2	2	93	93	2.7937486117153628E-11	1	1	183	182	1	33	-T
barcode79_consensus_vsearch	1827	G	*/+C	320	11	2.7%	2	2	93	93	4.4875065834828966E-4	1	1	141	179	2	9	+C
barcode79_consensus_vsearch	1827	G	*/-C	320	49	12.04%	2	2	93	93	3.2225006412897637E-16	1	1	141	179	17	32	-C
barcode79_consensus_vsearch	1827	G	*/-CC	320	18	4.42%	2	1	93	93	3.023720012675079E-6	1	1	141	179	18	0	-C
barcode79_consensus_vsearch	1831	C	*/-T	396	7	1.72%	2	2	93	93	0.007609963086240239	1	1	180	216	3	4	-T
barcode79_consensus_vsearch	1832	T	*/-C	381	15	3.76%	2	1	93	93	2.6662200580606564E-5	1	1	180	201	0	15	-C
barcode79_consensus_vsearch	1838	C	*/-A	393	10	2.46%	2	2	93	93	9.229178835087009E-4	1	1	173	220	9	1	-A
barcode79_consensus_vsearch	1841	T	*/-C	377	16	3.95%	2	1	93	93	1.3058016225586293E-5	1	1	179	198	0	16	-C
barcode79_consensus_vsearch	1843	T	*/-G	340	61	14.99%	2	1	93	93	3.665663078806936E-20	1	1	181	159	0	61	-G
barcode79_consensus_vsearch	1855	G	*/-C	295	99	24.5%	2	2	93	93	1.3553784507493376E-33	1	1	173	122	5	94	-C
barcode79_consensus_vsearch	1860	T	*/-C	386	13	3.22%	2	2	93	93	1.1053069410618301E-4	1	1	179	207	1	12	-C
barcode79_consensus_vsearch	1861	C	*/+A	370	11	2.8%	2	2	93	93	4.5382073751055476E-4	1	1	172	198	8	3	+A
barcode79_consensus_vsearch	1871	C	*/+T	391	7	1.73%	2	1	93	93	0.007607431615374521	1	1	179	212	0	7	+T
barcode79_consensus_vsearch	1877	T	*/+C	385	17	4.21%	2	1	93	93	6.419225802716349E-6	1	1	166	219	17	0	+C
barcode79_consensus_vsearch	1881	T	*/+C	380	11	2.72%	2	1	93	93	4.546826533185083E-4	1	1	168	212	0	11	+C
barcode79_consensus_vsearch	1881	T	*/-C	380	7	1.73%	2	1	93	93	0.007601633344865528	1	1	168	212	7	0	+C
barcode79_consensus_vsearch	1885	C	*/-TC	372	26	6.45%	2	2	93	93	9.772362925862572E-9	1	1	172	200	10	16	-TC
barcode79_consensus_vsearch	1887	C	*/-G	357	7	1.87%	2	1	93	93	0.0075883836321291274	1	1	172	185	0	7	-G
barcode79_consensus_vsearch	1892	C	*/-T	395	7	1.72%	2	1	93	93	0.007609461804174083	1	1	184	211	0	7	-T
barcode79_consensus_vsearch	1897	C	*/-A	386	10	2.45%	2	1	93	93	9.219853921161506E-4	1	1	181	205	0	10	-A
barcode79_consensus_vsearch	1902	C	*/+T	340	16	3.93%	2	2	93	93	1.2843675706834167E-5	1	1	146	194	4	12	+T
barcode79_consensus_vsearch	1902	C	*/-T	340	44	10.81%	2	2	93	93	1.5391069495098862E-14	1	1	146	194	30	14	-T
barcode79_consensus_vsearch	1911	T	*/-C	392	13	3.19%	2	1	93	93	1.1069598920089562E-4	1	1	169	223	13	0	-C
barcode79_consensus_vsearch	1936	C	*/+A	382	8	1.99%	2	1	93	93	0.0037671973936205536	1	1	164	218	8	0	+A
barcode79_consensus_vsearch	1936	C	*/-A	382	8	1.99%	2	1	93	93	0.0037671973936205536	1	1	164	218	8	0	+A
barcode79_consensus_vsearch	1962	T	*/-G	369	35	8.58%	2	1	93	93	1.3482386786535612E-11	1	1	182	187	0	35	-G
barcode79_consensus_vsearch	1966	T	*/+C	350	12	2.96%	2	2	93	93	2.2254044117729087E-4	1	1	160	190	4	8	+C
barcode79_consensus_vsearch	1966	T	*/-C	350	39	9.63%	2	2	93	93	6.675106453191227E-13	1	1	160	190	17	22	-C
barcode79_consensus_vsearch	1969	C	*/+T	377	13	3.19%	2	1	93	93	1.1027355068065241E-4	1	1	180	197	0	13	+T
barcode79_consensus_vsearch	1974	C	*/-AC	391	10	2.46%	2	2	93	93	9.226547240173711E-4	1	1	172	219	9	1	-AC
barcode79_consensus_vsearch	1998	C	*/-A	381	20	4.93%	2	2	93	93	7.480618802321155E-7	1	1	172	209	11	9	-A
barcode79_consensus_vsearch	2016	G	*/-T	381	16	3.95%	2	1	93	93	1.307893571981294E-5	1	1	183	198	0	16	-T
barcode79_consensus_vsearch	2017	T	*/+G	360	9	2.33%	2	1	93	93	0.0018590780544759323	1	1	180	180	0	9	+G
barcode79_consensus_vsearch	2028	T	*/-C	380	21	5.15%	2	1	93	93	3.644649314175973E-7	1	1	158	222	21	0	-C
barcode79_consensus_vsearch	2030	C	*/+A	382	10	2.46%	2	1	93	93	9.214378424824657E-4	1	1	181	201	0	10	+A
barcode79_consensus_vsearch	2030	C	*/-A	382	12	2.95%	2	1	93	93	2.2424619755304767E-4	1	1	181	201	0	12	-A
barcode79_consensus_vsearch	2035	C	*/-TT	391	14	3.43%	2	1	93	93	5.4445204224320063E-5	1	1	168	223	14	0	-TT
barcode79_consensus_vsearch	2051	C	*/-G	397	7	1.72%	2	1	93	93	0.00761046189928152	1	1	175	222	7	0	-G
barcode79_consensus_vsearch	2063	C	*/-GC	395	9	2.21%	2	1	93	93	0.0018671284895574335	1	1	172	223	9	0	-GC
barcode79_consensus_vsearch	2073	C	*/+A	392	11	2.7%	2	1	93	93	4.5566171886911473E-4	1	1	170	222	11	0	+A
barcode79_consensus_vsearch	2074	G	*/-A	392	11	2.7%	2	1	93	93	4.5566171886911473E-4	1	1	169	223	11	0	-A
barcode79_consensus_vsearch	2075	A	*/+G	385	7	1.77%	2	1	93	93	0.007604309052101333	1	1	163	222	7	0	+G
barcode79_consensus_vsearch	2076	G	*/+AG	385	10	2.46%	2	1	93	93	9.218495267512253E-4	1	1	169	216	10	0	+AG
barcode79_consensus_vsearch	2076	G	*/-C	385	8	1.97%	2	2	93	93	0.0037682499633968467	1	1	169	216	2	6	+AG
barcode79_consensus_vsearch	2078	C	*/-T	393	12	2.94%	2	1	93	93	2.247720086068572E-4	1	1	183	210	0	12	-T
barcode79_consensus_vsearch	2096	G	*/-C	396	7	1.72%	2	2	93	93	0.007609963086240239	1	1	177	219	3	4	-C
barcode79_consensus_vsearch	2115	T	*/+A	358	21	5.16%	2	1	93	93	3.5866641692660115E-7	1	1	181	177	0	21	+A
barcode79_consensus_vsearch	2115	T	*/-G	358	9	2.21%	2	1	93	93	0.0018585722679615095	1	1	181	177	0	9	+A
barcode79_consensus_vsearch	2115	T	*/-GT	358	8	1.97%	2	2	93	93	0.003758161303215178	1	1	181	177	1	7	+A
barcode79_consensus_vsearch	2116	G	*/-T	350	7	1.79%	2	1	93	93	0.007584014189966649	1	1	181	169	0	7	-T
barcode79_consensus_vsearch	2117	T	*/-CT	338	19	4.85%	2	1	93	93	1.4915546883493263E-6	1	1	180	158	0	19	-CT
barcode79_consensus_vsearch	2118	C	*/-T	364	11	2.86%	2	1	93	93	4.5328203918763523E-4	1	1	183	181	0	11	-T
barcode79_consensus_vsearch	2134	C	*/-T	393	8	1.97%	2	2	93	93	0.003770980459969231	1	1	176	217	3	5	-T
barcode79_consensus_vsearch	2138	C	*/-T	382	19	4.69%	2	2	93	93	1.5333310267608091E-6	1	1	180	202	1	18	-T
barcode79_consensus_vsearch	2149	T	*/-C	386	18	4.41%	2	2	93	93	3.143375425577397E-6	1	1	164	222	17	1	-C
barcode79_consensus_vsearch	2151	C	*/-GG	387	13	3.19%	2	1	93	93	1.1055857583867697E-4	1	1	183	204	0	13	-GG
barcode79_consensus_vsearch	2156	T	*/-C	392	9	2.21%	2	2	93	93	0.0018664928473143382	1	1	179	213	1	8	-C
barcode79_consensus_vsearch	2157	C	*/+A	344	9	2.26%	2	1	93	93	0.0018548735082316635	1	1	154	190	9	0	+A
barcode79_consensus_vsearch	2157	C	*/+G	344	11	2.76%	2	1	93	93	4.513581166031406E-4	1	1	154	190	0	11	+G
barcode79_consensus_vsearch	2157	C	*/-G	344	20	5.03%	2	2	93	93	7.293227176014746E-7	1	1	154	190	15	5	-G
barcode79_consensus_vsearch	2157	C	*/-GG	344	9	2.26%	2	1	93	93	0.0018548735082316635	1	1	154	190	0	9	-G
barcode79_consensus_vsearch	2160	G	*/-A	385	15	3.72%	2	1	93	93	2.669890358265385E-5	1	1	161	224	15	0	-A
barcode79_consensus_vsearch	2163	T	*/-C	392	7	1.72%	2	2	93	93	0.007607942959128091	1	1	171	221	6	1	-C
barcode79_consensus_vsearch	2200	T	*/-G	397	7	1.72%	2	2	93	93	0.00761046189928152	1	1	182	215	1	6	-G
barcode79_consensus_vsearch	2211	G	*/-A	394	10	2.46%	2	1	93	93	9.230485023476184E-4	1	1	172	222	10	0	-A
barcode79_consensus_vsearch	2214	C	*/+A	379	20	4.9%	2	1	93	93	7.47128900641539E-7	1	1	161	218	20	0	+A
barcode79_consensus_vsearch	2215	G	*/-A	378	22	5.39%	2	2	93	93	1.771976554085194E-7	1	1	161	217	20	2	-A
barcode79_consensus_vsearch	2225	C	*/+T	395	7	1.72%	2	1	93	93	0.007609461804174083	1	1	183	212	0	7	+T
barcode79_consensus_vsearch	2245	G	*/-TG	379	16	3.98%	2	2	93	93	1.306852581830906E-5	1	1	181	198	2	14	-TG
barcode79_consensus_vsearch	2246	T	*/-GC	364	16	4.12%	2	1	93	93	1.2987172071727063E-5	1	1	180	184	0	16	-GC
barcode79_consensus_vsearch	2252	C	*/+T	332	13	3.2%	2	2	93	93	1.0879458901301205E-4	1	1	154	178	5	8	+T
barcode79_consensus_vsearch	2252	C	*/-T	332	52	12.81%	2	2	93	93	3.483489355366461E-17	1	1	154	178	23	29	-T
barcode79_consensus_vsearch	2256	T	*/-G	389	11	2.7%	2	1	93	93	4.554223390235558E-4	1	1	181	208	0	11	-G
barcode79_consensus_vsearch	2259	T	*/-C	385	19	4.66%	2	1	93	93	1.5358771066795427E-6	1	1	162	223	19	0	-C
barcode79_consensus_vsearch	2261	C	*/+G	392	9	2.21%	2	2	93	93	0.0018664928473143382	1	1	177	215	2	7	+G
barcode79_consensus_vsearch	2267	C	*/-A	379	20	4.91%	2	2	93	93	7.47128900641539E-7	1	1	162	217	19	1	-A
barcode79_consensus_vsearch	2280	T	*/-CT	341	54	13.43%	2	2	93	93	7.93988734940526E-18	1	1	171	170	9	45	-CT
barcode79_consensus_vsearch	2288	G	*/-TG	389	11	2.7%	2	1	93	93	4.554223390235558E-4	1	1	182	207	0	11	-TG
barcode79_consensus_vsearch	2289	T	*/+G	355	14	3.59%	2	1	93	93	5.383043242702664E-5	1	1	179	176	0	14	+G
barcode79_consensus_vsearch	2289	T	*/-G	355	13	3.33%	2	2	93	93	1.0959400193010174E-4	1	1	179	176	2	11	+G
barcode79_consensus_vsearch	2293	A	*/+C	394	9	2.21%	2	1	93	93	0.0018669176476072253	1	1	182	212	0	9	+C
barcode79_consensus_vsearch	2303	G	*/-CG	396	12	2.94%	2	2	93	93	2.249106249509881E-4	1	1	180	216	4	8	-CG
barcode79_consensus_vsearch	2306	G	*/+C	385	13	3.19%	2	1	93	93	1.1050267709682812E-4	1	1	161	224	13	0	+C
barcode79_consensus_vsearch	2306	G	*/-C	385	9	2.21%	2	1	93	93	0.001864972504119446	1	1	161	224	9	0	+C
barcode79_consensus_vsearch	2311	G	*/-CG	387	9	2.22%	2	1	93	93	0.0018654123049784304	1	1	177	210	0	9	-CG
barcode79_consensus_vsearch	2325	T	*/-CT	373	20	4.96%	2	1	93	93	7.442787507713283E-7	1	1	175	198	0	20	-CT
barcode79_consensus_vsearch	2326	C	*/+T	358	8	2.11%	2	1	93	93	0.003758161303215178	1	1	173	185	0	8	+T
barcode79_consensus_vsearch	2330	A	*/-CA	372	29	7.14%	2	2	93	93	1.1018517250849488E-9	1	1	160	212	22	7	-CA
barcode79_consensus_vsearch	2335	A	*/+C	390	7	1.73%	2	1	93	93	0.007606917708857565	1	1	180	210	0	7	+C
barcode79_consensus_vsearch	2337	C	*/-TC	386	15	3.68%	2	1	93	93	2.6707970567795604E-5	1	1	184	202	0	15	-TC
barcode79_consensus_vsearch	2341	C	*/-G	235	113	27.97%	2	2	93	93	1.7543301807036225E-39	1	1	141	94	35	78	-G
barcode79_consensus_vsearch	2341	C	*/-GG	235	35	8.66%	2	2	93	93	8.961191867729496E-12	1	1	141	94	1	34	-G
barcode79_consensus_vsearch	2341	C	*/-GGG	235	7	1.73%	2	1	93	93	0.007476349629382664	1	1	141	94	0	7	-G
barcode79_consensus_vsearch	2347	T	*/-G	388	12	2.96%	2	1	93	93	2.2453648907484584E-4	1	1	179	209	0	12	-G
barcode79_consensus_vsearch	2361	A	*/+G	390	8	1.99%	2	1	93	93	0.0037699692796093966	1	1	183	207	0	8	+G
barcode79_consensus_vsearch	2387	G	*/+A	351	19	4.67%	2	2	93	93	1.5048331765837159E-6	1	1	138	213	16	3	+A
barcode79_consensus_vsearch	2387	G	*/+AA	351	9	2.21%	2	1	93	93	0.0018567583597153838	1	1	138	213	9	0	+A
barcode79_consensus_vsearch	2387	G	*/-A	351	24	5.9%	2	2	93	93	4.076255083390946E-8	1	1	138	213	18	6	-A
barcode79_consensus_vsearch	2400	C	*/-A	389	12	2.96%	2	2	93	93	2.245840498305788E-4	1	1	172	217	8	4	-A
barcode79_consensus_vsearch	2402	A	*/-G	394	8	1.97%	2	2	93	93	0.0037713141940397903	1	1	176	218	5	3	-G
barcode79_consensus_vsearch	2404	G	*/-A	397	9	2.21%	2	1	93	93	0.0018675470949966115	1	1	173	224	9	0	-A
barcode79_consensus_vsearch	2407	T	*/+C	267	11	2.7%	2	2	93	93	4.4144812348402026E-4	1	1	143	124	9	2	+C
barcode79_consensus_vsearch	2407	T	*/-C	267	127	31.13%	2	2	93	93	3.046528091166019E-44	1	1	143	124	32	95	-C
barcode79_consensus_vsearch	2421	C	*/-G	385	13	3.21%	2	1	93	93	1.1050267709682812E-4	1	1	169	216	13	0	-G
barcode79_consensus_vsearch	2430	A	*/+G	312	20	5.03%	2	2	93	93	7.101493258162727E-7	1	1	126	186	8	12	+G
barcode79_consensus_vsearch	2430	A	*/-G	312	53	13.32%	2	2	93	93	1.4494127656431908E-17	1	1	126	186	31	22	-G
barcode79_consensus_vsearch	2433	G	*/-A	395	13	3.19%	2	2	93	93	1.1077687497557693E-4	1	1	172	223	12	1	-A
barcode79_consensus_vsearch	2447	G	*/-TG	391	14	3.44%	2	2	93	93	5.4445204224320063E-5	1	1	174	217	8	6	-TG
barcode79_consensus_vsearch	2453	C	*/-G	388	9	2.21%	2	1	93	93	0.0018656305641170923	1	1	183	205	0	9	-G
barcode79_consensus_vsearch	2458	T	*/-G	379	12	2.95%	2	2	93	93	2.2409780578590554E-4	1	1	178	201	1	11	-G
barcode79_consensus_vsearch	2466	G	*/+C	318	7	1.73%	2	2	93	93	0.007561657789302346	1	1	135	183	5	2	+C
barcode79_consensus_vsearch	2466	G	*/-C	318	72	17.78%	2	2	93	93	5.70690587593368E-24	1	1	135	183	44	28	-C
barcode79_consensus_vsearch	2522	T	*/+G	386	7	1.74%	2	1	93	93	0.0076048360660226225	1	1	184	202	0	7	+G
barcode79_consensus_vsearch	2534	G	*/-A	397	7	1.72%	2	2	93	93	0.00761046189928152	1	1	178	219	3	4	-A
barcode79_consensus_vsearch	2538	C	*/-T	397	9	2.21%	2	1	93	93	0.0018675470949966115	1	1	183	214	0	9	-T
barcode79_consensus_vsearch	2539	T	*/+C	377	9	2.26%	2	1	93	93	0.0018631683014264863	1	1	174	203	9	0	+C
barcode79_consensus_vsearch	2551	A	*/-G	354	45	11.19%	2	2	93	93	7.63330195610014E-15	1	1	133	221	42	3	-G
barcode79_consensus_vsearch	2573	C	*/+T	395	8	1.97%	2	1	93	93	0.00377164628554966	1	1	183	212	0	8	+T
barcode79_consensus_vsearch	2582	C	*/-T	377	25	6.14%	2	2	93	93	2.028052419177446E-8	1	1	182	195	1	24	-T
barcode79_consensus_vsearch	2616	T	*/-A	394	8	1.98%	2	1	93	93	0.0037713141940397903	1	1	182	212	0	8	-A
barcode79_consensus_vsearch	2618	G	*/+T	375	12	2.95%	2	1	93	93	2.2389647410688774E-4	1	1	154	221	12	0	+T
barcode79_consensus_vsearch	2618	G	*/+TT	375	8	1.97%	2	1	93	93	0.003764677830168862	1	1	154	221	8	0	+T
barcode79_consensus_vsearch	2618	G	*/-T	375	11	2.7%	2	2	93	93	4.5425715087818366E-4	1	1	154	221	10	1	-T
barcode79_consensus_vsearch	2635	T	*/-A	375	20	4.93%	2	1	93	93	7.452374517509915E-7	1	1	182	193	0	20	-A
barcode79_consensus_vsearch	2637	A	*/-G	381	17	4.17%	2	1	93	93	6.407855928137532E-6	1	1	182	199	0	17	-G
barcode79_consensus_vsearch	2638	G	*/-TG	373	12	3.07%	2	1	93	93	2.2379428476008937E-4	1	1	183	190	0	12	-TG
barcode79_consensus_vsearch	2639	T	*/-G	360	19	4.82%	2	2	93	93	1.513542307305528E-6	1	1	177	183	5	14	-G
barcode79_consensus_vsearch	2643	A	*/-G	385	9	2.25%	2	2	93	93	0.001864972504119446	1	1	163	222	8	1	-G
barcode79_consensus_vsearch	2650	G	*/-C	382	10	2.46%	2	2	93	93	9.214378424824657E-4	1	1	172	210	5	5	-C
barcode79_consensus_vsearch	2653	C	*/-T	392	8	1.96%	2	1	93	93	0.0037706450711110975	1	1	184	208	0	8	-T
barcode79_consensus_vsearch	2690	A	*/-CA	384	16	3.93%	2	2	93	93	1.309436672524504E-5	1	1	179	205	2	14	-CA
barcode79_consensus_vsearch	2702	A	*/+G	319	17	4.19%	2	2	93	93	6.199765720397519E-6	1	1	114	205	11	6	+G
barcode79_consensus_vsearch	2702	A	*/-G	319	59	14.53%	2	2	93	93	1.4881056736091494E-19	1	1	114	205	49	10	-G
barcode79_consensus_vsearch	2705	G	*/-A	377	20	4.91%	2	2	93	93	7.461874627489505E-7	1	1	162	215	18	2	-A
barcode79_consensus_vsearch	2712	G	*/+A	370	16	3.97%	2	2	93	93	1.3020426605057041E-5	1	1	179	191	1	15	+A
barcode79_consensus_vsearch	2712	G	*/-A	370	11	2.73%	2	2	93	93	4.5382073751055476E-4	1	1	179	191	2	9	+A
barcode79_consensus_vsearch	2718	C	*/+A	388	10	2.46%	2	1	93	93	9.222551090526941E-4	1	1	181	207	0	10	+A
barcode79_consensus_vsearch	2746	G	*/-T	388	8	1.99%	2	1	93	93	0.0037692867193449852	1	1	181	207	0	8	-T
barcode79_consensus_vsearch	2753	C	*/-GC	391	14	3.44%	2	2	93	93	5.4445204224320063E-5	1	1	170	221	13	1	-GC
barcode79_consensus_vsearch	2758	C	*/+T	393	7	1.73%	2	1	93	93	0.007608451759263046	1	1	182	211	0	7	+T
barcode79_consensus_vsearch	2759	T	*/+C	385	7	1.73%	2	1	93	93	0.007604309052101333	1	1	182	203	0	7	+C
barcode79_consensus_vsearch	2771	T	*/-G	361	34	8.4%	2	2	93	93	2.772131921978608E-11	1	1	178	183	2	32	-G
barcode79_consensus_vsearch	2784	T	*/-GT	395	7	1.72%	2	1	93	93	0.007609461804174083	1	1	177	218	7	0	-GT
barcode79_consensus_vsearch	2794	G	*/-CG	400	7	1.72%	2	2	93	93	0.007611943705349879	1	1	180	220	4	3	-CG
barcode79_consensus_vsearch	2816	C	*/+A	385	13	3.19%	2	1	93	93	1.1050267709682812E-4	1	1	168	217	13	0	+A
barcode79_consensus_vsearch	2817	G	*/-A	390	15	3.69%	2	2	93	93	2.674381262774065E-5	1	1	168	222	14	1	-A
barcode79_consensus_vsearch	2835	C	*/-G	386	16	3.96%	2	1	93	93	1.310453350400098E-5	1	1	184	202	0	16	-G
barcode79_consensus_vsearch	2839	T	*/+G	360	13	3.19%	2	2	93	93	1.0975522426701472E-4	1	1	156	204	4	9	+G
barcode79_consensus_vsearch	2839	T	*/-G	360	28	6.86%	2	2	93	93	2.2479559788546667E-9	1	1	156	204	22	6	-G
barcode79_consensus_vsearch	2849	A	*/-G	381	12	2.96%	2	2	93	93	2.2419697823514463E-4	1	1	171	210	2	10	-G
barcode79_consensus_vsearch	2854	C	*/-T	386	15	3.68%	2	1	93	93	2.6707970567795604E-5	1	1	184	202	0	15	-T
barcode79_consensus_vsearch	2855	T	*/-C	370	10	2.54%	2	1	93	93	9.197272469938769E-4	1	1	177	193	0	10	-C
barcode79_consensus_vsearch	2856	C	*/-G	345	17	4.34%	2	2	93	93	6.295058894297572E-6	1	1	165	180	8	9	-G
barcode79_consensus_vsearch	2856	C	*/-GG	345	22	5.61%	2	2	93	93	1.7239154339675146E-7	1	1	165	180	6	16	-GG
barcode79_consensus_vsearch	2859	G	*/-A	392	9	2.21%	2	2	93	93	0.0018664928473143382	1	1	175	217	3	6	-A
barcode79_consensus_vsearch	2863	T	*/-C	364	33	8.11%	2	1	93	93	5.8182551504492375E-11	1	1	179	185	0	33	-C
barcode79_consensus_vsearch	2865	A	*/+G	390	7	1.72%	2	1	93	93	0.007606917708857565	1	1	181	209	0	7	+G
barcode79_consensus_vsearch	2866	G	*/-C	391	9	2.21%	2	1	93	93	0.0018662788735768444	1	1	181	210	0	9	-C
barcode79_consensus_vsearch	2868	T	*/-G	332	70	17.16%	2	1	93	93	3.1464702964741296E-23	1	1	183	149	0	70	-G
barcode79_consensus_vsearch	2876	T	*/-C	389	12	2.94%	2	1	93	93	2.245840498305788E-4	1	1	171	218	12	0	-C
barcode79_consensus_vsearch	2888	G	*/-C	386	19	4.66%	2	1	93	93	1.5367181468690816E-6	1	1	164	222	19	0	-C
barcode79_consensus_vsearch	2891	C	*/-G	384	13	3.19%	2	2	93	93	1.1047452382467976E-4	1	1	180	204	3	10	-G
barcode79_consensus_vsearch	2893	G	*/+A	392	7	1.72%	2	1	93	93	0.007607942959128091	1	1	172	220	7	0	+A
barcode79_consensus_vsearch	2901	T	*/+G	386	7	1.73%	2	1	93	93	0.0076048360660226225	1	1	180	206	0	7	+G
barcode79_consensus_vsearch	2901	T	*/-G	386	9	2.22%	2	2	93	93	0.0018651929543866046	1	1	180	206	3	6	-G
barcode79_consensus_vsearch	2903	G	*/-A	399	7	1.72%	2	2	93	93	0.007611452190916357	1	1	177	222	6	1	-A
barcode79_consensus_vsearch	2905	G	*/+C	275	14	3.47%	2	2	93	93	5.1947323848115916E-5	1	1	127	148	5	9	+C
barcode79_consensus_vsearch	2905	G	*/-C	275	80	19.8%	2	2	93	93	5.434490600826715E-27	1	1	127	148	22	58	-C
barcode79_consensus_vsearch	2905	G	*/-CC	275	30	7.43%	2	2	93	93	4.400680952347389E-10	1	1	127	148	26	4	-C
barcode79_consensus_vsearch	2909	C	*/+T	396	7	1.72%	2	1	93	93	0.007609963086240239	1	1	184	212	0	7	+T
barcode79_consensus_vsearch	2912	T	*/-G	363	31	7.77%	2	1	93	93	2.520006011047725E-10	1	1	183	180	0	31	-G
barcode79_consensus_vsearch	2958	C	*/+G	392	7	1.72%	2	1	93	93	0.007607942959128091	1	1	182	210	0	7	+G
barcode79_consensus_vsearch	2963	C	*/-A	390	11	2.7%	2	2	93	93	4.555025215794059E-4	1	1	168	222	10	1	-A
barcode79_consensus_vsearch	2965	A	*/-G	384	8	1.96%	2	1	93	93	0.0037679008816766993	1	1	163	221	8	0	-G
barcode79_consensus_vsearch	2967	G	*/-A	381	9	2.24%	2	1	93	93	0.0018640795393290628	1	1	158	223	9	0	-A
barcode79_consensus_vsearch	2967	G	*/-AG	381	7	1.74%	2	1	93	93	0.007602173974125566	1	1	158	223	7	0	-A
barcode79_consensus_vsearch	2969	G	*/-T	386	13	3.24%	2	1	93	93	1.1053069410618301E-4	1	1	175	211	0	13	-T
barcode79_consensus_vsearch	2975	C	*/-T	384	15	3.69%	2	2	93	93	2.6689793401728195E-5	1	1	181	203	2	13	-T
barcode79_consensus_vsearch	2991	A	*/-G	385	16	3.95%	2	2	93	93	1.3099462057416885E-5	1	1	175	210	6	10	-G
barcode79_consensus_vsearch	3002	T	*/-C	382	12	2.99%	2	2	93	93	2.2424619755304767E-4	1	1	166	216	10	2	-C
barcode79_consensus_vsearch	3005	C	*/-G	382	14	3.43%	2	1	93	93	5.430154987343997E-5	1	1	182	200	0	14	-G
barcode79_consensus_vsearch	3023	G	*/+A	371	7	1.75%	2	2	93	93	0.0075966396580781715	1	1	155	216	6	1	+A
barcode79_consensus_vsearch	3023	G	*/-A	371	18	4.51%	2	2	93	93	3.1194609634520567E-6	1	1	155	216	16	2	-A
barcode79_consensus_vsearch	3025	A	*/+G	383	7	1.72%	2	1	93	93	0.007603246958909687	1	1	172	211	0	7	+G
barcode79_consensus_vsearch	3025	A	*/-G	383	9	2.22%	2	2	93	93	0.001864528271344425	1	1	172	211	8	1	-G
barcode79_consensus_vsearch	3034	A	*/-C	375	24	5.9%	2	2	93	93	4.173416239328845E-8	1	1	180	195	1	23	-C
barcode79_consensus_vsearch	3054	A	*/-C	370	29	7.14%	2	1	93	93	1.098847424696706E-9	1	1	148	222	29	0	-C
barcode79_consensus_vsearch	3068	A	*/-G	392	7	1.74%	2	1	93	93	0.007607942959128091	1	1	170	222	7	0	-G
barcode79_consensus_vsearch	3081	A	*/-G	359	26	6.55%	2	2	93	93	9.629385304093858E-9	1	1	155	204	16	10	-G
barcode79_consensus_vsearch	3092	C	*/+G	389	11	2.7%	2	1	93	93	4.554223390235558E-4	1	1	181	208	0	11	+G
barcode79_consensus_vsearch	3093	G	*/-A	371	30	7.41%	2	2	93	93	5.30257233806281E-10	1	1	153	218	27	3	-A
barcode79_consensus_vsearch	3113	C	*/-G	382	14	3.43%	2	2	93	93	5.430154987343997E-5	1	1	182	200	1	13	-G
barcode79_consensus_vsearch	3117	T	*/+A	341	18	4.44%	2	2	93	93	3.0661518166784337E-6	1	1	130	211	17	1	+A
barcode79_consensus_vsearch	3117	T	*/-A	341	39	9.63%	2	2	93	93	6.510080151264767E-13	1	1	130	211	35	4	-A
barcode79_consensus_vsearch	3119	A	*/-G	391	7	1.72%	2	2	93	93	0.007607431615374521	1	1	176	215	6	1	-G
barcode79_consensus_vsearch	3128	C	*/+G	397	7	1.72%	2	1	93	93	0.00761046189928152	1	1	176	221	7	0	+G
barcode79_consensus_vsearch	3166	G	*/-TG	388	10	2.46%	2	1	93	93	9.222551090526941E-4	1	1	177	211	0	10	-TG
barcode79_consensus_vsearch	3180	T	*/-GT	387	7	1.75%	2	2	93	93	0.007605360418658285	1	1	179	208	1	6	-GT
barcode79_consensus_vsearch	3187	T	*/-GG	386	14	3.43%	2	1	93	93	5.4366161181224727E-5	1	1	181	205	0	14	-GG
barcode79_consensus_vsearch	3194	A	*/+G	357	8	1.97%	2	2	93	93	0.003757759247190633	1	1	157	200	7	1	+G
barcode79_consensus_vsearch	3194	A	*/-G	357	27	6.63%	2	2	93	93	4.6405207690959776E-9	1	1	157	200	11	16	-G
barcode79_consensus_vsearch	3200	G	*/+A	385	7	1.73%	2	1	93	93	0.007604309052101333	1	1	166	219	7	0	+A
barcode79_consensus_vsearch	3200	G	*/-A	385	10	2.48%	2	2	93	93	9.218495267512253E-4	1	1	166	219	9	1	-A
barcode79_consensus_vsearch	3205	A	*/+C	369	23	5.67%	2	2	93	93	8.550659354703449E-8	1	1	153	216	22	1	+C
barcode79_consensus_vsearch	3211	C	*/+A	396	7	1.73%	2	1	93	93	0.007609963086240239	1	1	174	222	7	0	+A
barcode79_consensus_vsearch	3212	G	*/-A	399	7	1.72%	2	1	93	93	0.007611452190916357	1	1	177	222	7	0	-A
barcode79_consensus_vsearch	3231	T	*/+C	182	164	40.29%	2	2	93	93	2.9195745080770715E-61	1	1	94	88	63	101	+C
barcode79_consensus_vsearch	3231	T	*/+CC	182	18	4.42%	2	2	93	93	2.556712983549592E-6	1	1	94	88	10	8	+C
barcode79_consensus_vsearch	3231	T	*/-C	182	24	5.9%	2	2	93	93	2.9279168899863584E-8	1	1	94	88	10	14	-C
barcode79_consensus_vsearch	3231	T	*/-CC	182	8	1.97%	2	2	93	93	0.003623372158916335	1	1	94	88	2	6	-C
barcode79_consensus_vsearch	3236	C	*/+A	352	10	2.45%	2	1	93	93	9.169526424135386E-4	1	1	153	199	10	0	+A
barcode79_consensus_vsearch	3236	C	*/+T	352	16	3.92%	2	2	93	93	1.2917615303784446E-5	1	1	153	199	1	15	+T
barcode79_consensus_vsearch	3236	C	*/-GA	352	10	2.45%	2	1	93	93	9.169526424135386E-4	1	1	153	199	10	0	+T
barcode79_consensus_vsearch	3243	T	*/+C	302	28	6.86%	2	2	93	93	2.048951764770447E-9	1	1	164	138	4	24	+C
barcode79_consensus_vsearch	3243	T	*/-C	302	56	13.73%	2	2	93	93	1.3444333970696062E-18	1	1	164	138	14	42	-C
barcode79_consensus_vsearch	3243	T	*/-CC	302	8	1.96%	2	1	93	93	0.003731694581518785	1	1	164	138	0	8	-C
barcode79_consensus_vsearch	3243	T	*/-CCCT	302	8	1.96%	2	1	93	93	0.003731694581518785	1	1	164	138	0	8	-C
barcode79_consensus_vsearch	3246	C	*/-T	386	10	2.5%	2	1	93	93	9.219853921161506E-4	1	1	184	202	0	10	-T
barcode79_consensus_vsearch	3298	A	*/-G	374	16	3.94%	2	2	93	93	1.3042061767525985E-5	1	1	171	203	4	12	-G
barcode79_consensus_vsearch	3306	C	*/-G	369	23	5.69%	2	2	93	93	8.550659354703449E-8	1	1	176	193	2	21	-G
barcode79_consensus_vsearch	3307	G	*/+A	345	12	3.12%	2	1	93	93	2.2224715474502605E-4	1	1	147	198	12	0	+A
barcode79_consensus_vsearch	3349	G	*/-TG	363	31	7.69%	2	2	93	93	2.520006011047725E-10	1	1	156	207	20	11	-TG
barcode79_consensus_vsearch	3355	A	*/+C	395	8	1.96%	2	1	93	93	0.00377164628554966	1	1	180	215	0	8	+C
barcode79_consensus_vsearch	3360	G	*/-CG	388	16	3.94%	2	2	93	93	1.3114605407806796E-5	1	1	170	218	12	4	-CG
barcode79_consensus_vsearch	3391	A	*/-G	382	15	3.68%	2	1	93	93	2.6671442214013996E-5	1	1	175	207	0	15	-G
barcode79_consensus_vsearch	3400	G	*/-TG	385	16	3.93%	2	1	93	93	1.3099462057416885E-5	1	1	180	205	0	16	-TG
barcode79_consensus_vsearch	3408	G	*/+T	351	16	3.93%	2	2	93	93	1.2911626608697888E-5	1	1	138	213	13	3	+T
barcode79_consensus_vsearch	3408	G	*/-T	351	35	8.6%	2	2	93	93	1.2985015777649107E-11	1	1	138	213	28	7	-T
barcode79_consensus_vsearch	3412	T	*/-G	381	21	5.15%	2	1	93	93	3.6471510100992486E-7	1	1	182	199	0	21	-G
barcode79_consensus_vsearch	3433	T	*/-G	374	14	3.49%	2	2	93	93	5.41685018001133E-5	1	1	173	201	6	8	-G
barcode79_consensus_vsearch	3439	C	*/-A	397	9	2.21%	2	1	93	93	0.0018675470949966115	1	1	173	224	9	0	-A
barcode79_consensus_vsearch	3452	T	*/-GT	391	10	2.46%	2	1	93	93	9.226547240173711E-4	1	1	180	211	0	10	-GT
barcode79_consensus_vsearch	3455	T	*/+A	375	10	2.45%	2	2	93	93	9.204527288502928E-4	1	1	161	214	9	1	+A
barcode79_consensus_vsearch	3455	T	*/-A	375	10	2.45%	2	2	93	93	9.204527288502928E-4	1	1	161	214	5	5	+A
barcode79_consensus_vsearch	3487	C	*/+A	350	10	2.48%	2	2	93	93	9.166275446693137E-4	1	1	137	213	8	2	+A
barcode79_consensus_vsearch	3487	C	*/-A	350	29	7.2%	2	2	93	93	1.0674906047435398E-9	1	1	137	213	23	6	-A
barcode79_consensus_vsearch	3487	C	*/-AA	350	11	2.73%	2	1	93	93	4.519571319415402E-4	1	1	137	213	11	0	-A
barcode79_consensus_vsearch	3497	T	*/-G	384	13	3.2%	2	2	93	93	1.1047452382467976E-4	1	1	180	204	3	10	-G
barcode79_consensus_vsearch	3527	T	*/-G	377	17	4.2%	2	2	93	93	6.396270971981517E-6	1	1	169	208	9	8	-G
barcode79_consensus_vsearch	3529	G	*/-A	392	9	2.23%	2	1	93	93	0.0018664928473143382	1	1	173	219	9	0	-A
barcode79_consensus_vsearch	3544	T	*/-A	389	8	1.98%	2	1	93	93	0.0037696288519149155	1	1	172	217	8	0	-A
barcode79_consensus_vsearch	3546	A	*/-GA	387	13	3.19%	2	1	93	93	1.1055857583867697E-4	1	1	163	224	13	0	-GA
barcode79_consensus_vsearch	3553	T	*/-GT	337	59	14.64%	2	2	93	93	1.67917648089902E-19	1	1	177	160	2	57	-GT
barcode79_consensus_vsearch	3561	C	*/-T	391	7	1.73%	2	1	93	93	0.007607431615374521	1	1	178	213	0	7	-T
barcode79_consensus_vsearch	3571	G	*/-A	393	7	1.73%	2	2	93	93	0.007608451759263046	1	1	172	221	6	1	-A
barcode79_consensus_vsearch	3575	C	*/+A	397	7	1.72%	2	1	93	93	0.00761046189928152	1	1	173	224	7	0	+A
barcode79_consensus_vsearch	3586	G	*/+A	354	14	3.44%	2	2	93	93	5.381171602376039E-5	1	1	178	176	1	13	+A
barcode79_consensus_vsearch	3586	G	*/+AA	354	13	3.19%	2	1	93	93	1.0956125007602598E-4	1	1	178	176	0	13	+A
barcode79_consensus_vsearch	3586	G	*/-A	354	22	5.41%	2	2	93	93	1.7377486846905932E-7	1	1	178	176	1	21	-A
barcode79_consensus_vsearch	3602	C	*/-A	382	7	1.72%	2	2	93	93	0.0076027118384171	1	1	181	201	1	6	-A
barcode79_consensus_vsearch	3602	C	*/-AA	382	15	3.69%	2	2	93	93	2.6671442214013996E-5	1	1	181	201	1	14	-AA
barcode79_consensus_vsearch	3606	C	*/+T	391	13	3.19%	2	1	93	93	1.1066876939038198E-4	1	1	182	209	0	13	+T
barcode79_consensus_vsearch	3619	C	*/-AC	383	18	4.41%	2	1	93	93	3.13872460829863E-6	1	1	165	218	18	0	-AC
barcode79_consensus_vsearch	3651	T	*/+A	382	12	2.95%	2	1	93	93	2.2424619755304767E-4	1	1	181	201	0	12	+A
barcode79_consensus_vsearch	3652	G	*/-TA	382	16	3.98%	2	1	93	93	1.3084103727632285E-5	1	1	182	200	0	16	-TA
barcode79_consensus_vsearch	3654	A	*/+G	185	140	36.55%	2	2	93	93	2.9651440424771966E-51	1	1	84	101	54	86	+G
barcode79_consensus_vsearch	3654	A	*/-G	185	40	10.44%	2	2	93	93	1.356160251041353E-13	1	1	84	101	26	14	+G
barcode79_consensus_vsearch	3658	G	*/+A	379	10	2.46%	2	1	93	93	9.21019917535404E-4	1	1	158	221	10	0	+A
barcode79_consensus_vsearch	3659	G	*/+AG	369	9	2.21%	2	1	93	93	0.001861288716262604	1	1	159	210	9	0	+AG
barcode79_consensus_vsearch	3659	G	*/-C	369	13	3.19%	2	1	93	93	1.1003517226665928E-4	1	1	159	210	0	13	-C
barcode79_consensus_vsearch	3661	G	*/-TG	383	11	2.7%	2	1	93	93	4.549328864195511E-4	1	1	178	205	0	11	-TG
barcode79_consensus_vsearch	3664	G	*/-AG	390	13	3.2%	2	2	93	93	1.1064141909323187E-4	1	1	170	220	12	1	-AG
barcode79_consensus_vsearch	3679	A	*/-G	394	8	1.97%	2	2	93	93	0.0037713141940397903	1	1	175	219	6	2	-G
barcode79_consensus_vsearch	3683	T	*/-G	382	13	3.23%	2	1	93	93	1.1041780449831012E-4	1	1	181	201	0	13	-G
barcode79_consensus_vsearch	3689	G	*/-T	392	9	2.21%	2	2	93	93	0.0018664928473143382	1	1	182	210	1	8	-T
barcode79_consensus_vsearch	3700	T	*/-G	372	24	5.91%	2	1	93	93	4.161815561556769E-8	1	1	181	191	0	24	-G
barcode79_consensus_vsearch	3702	G	*/-A	391	9	2.22%	2	2	93	93	0.0018662788735768444	1	1	173	218	7	2	-A
barcode79_consensus_vsearch	3707	G	*/-C	387	8	1.97%	2	1	93	93	0.0037689428690762675	1	1	173	214	0	8	-C
barcode79_consensus_vsearch	3711	C	*/-T	391	8	1.97%	2	1	93	93	0.003770308015149166	1	1	182	209	0	8	-T
barcode79_consensus_vsearch	3724	T	*/-G	393	8	1.96%	2	1	93	93	0.003770980459969231	1	1	182	211	0	8	-G
barcode79_consensus_vsearch	3736	C	*/-A	384	14	3.44%	2	1	93	93	5.433401108852574E-5	1	1	182	202	0	14	-A
barcode79_consensus_vsearch	3747	G	*/-TG	396	8	1.97%	2	1	93	93	0.0037719767465882576	1	1	174	222	8	0	-TG
barcode79_consensus_vsearch	3750	A	*/+G	394	7	1.73%	2	2	93	93	0.007608958034696689	1	1	173	221	6	1	+G
barcode79_consensus_vsearch	3753	A	*/-C	389	9	2.21%	2	2	93	93	0.0018658477399051397	1	1	180	209	1	8	-C
barcode79_consensus_vsearch	3764	T	*/+G	367	19	4.73%	2	2	93	93	1.5200610461929761E-6	1	1	180	187	3	16	+G
barcode79_consensus_vsearch	3769	T	*/-G	377	11	2.74%	2	1	93	93	4.544286380884945E-4	1	1	181	196	0	11	-G
barcode79_consensus_vsearch	3773	G	*/-A	367	28	6.9%	2	2	93	93	2.2689105892084044E-9	1	1	152	215	26	2	-A
barcode79_consensus_vsearch	3780	T	*/-C	385	14	3.43%	2	2	93	93	5.435012474528051E-5	1	1	176	209	6	8	-C
barcode79_consensus_vsearch	3802	C	*/+G	369	7	1.72%	2	1	93	93	0.007595497661975396	1	1	166	203	7	0	+G
barcode79_consensus_vsearch	3802	C	*/-G	369	17	4.19%	2	2	93	93	6.372431010407079E-6	1	1	166	203	8	9	-G
barcode79_consensus_vsearch	3815	T	*/-C	388	12	2.95%	2	2	93	93	2.2453648907484584E-4	1	1	167	221	10	2	-C
barcode79_consensus_vsearch	3817	C	*/-T	396	10	2.45%	2	1	93	93	9.233078414853612E-4	1	1	184	212	0	10	-T
barcode79_consensus_vsearch	3822	C	*/-G	361	27	6.75%	2	2	93	93	4.664041629263568E-9	1	1	171	190	9	18	-G
barcode79_consensus_vsearch	3826	A	*/+G	376	8	1.99%	2	2	93	93	0.0037650433430064176	1	1	161	215	6	2	+G
barcode79_consensus_vsearch	3826	A	*/-G	376	10	2.48%	2	1	93	93	9.205956089622115E-4	1	1	161	215	10	0	-G
barcode79_consensus_vsearch	3830	G	*/-A	383	15	3.72%	2	1	93	93	2.6680639716138052E-5	1	1	163	220	15	0	-A
barcode79_consensus_vsearch	3833	C	*/-T	372	11	2.73%	2	1	93	93	4.539966388795655E-4	1	1	181	191	0	11	-T
barcode79_consensus_vsearch	3833	C	*/-TC	372	11	2.73%	2	1	93	93	4.539966388795655E-4	1	1	181	191	0	11	-T
barcode79_consensus_vsearch	3834	T	*/+C	370	8	2.07%	2	2	93	93	0.003762821512880718	1	1	173	197	7	1	+C
barcode79_consensus_vsearch	3836	C	*/-T	391	8	1.98%	2	2	93	93	0.003770308015149166	1	1	182	209	1	7	-T
barcode79_consensus_vsearch	3838	C	*/+T	374	19	4.73%	2	1	93	93	1.5263684541229892E-6	1	1	181	193	0	19	+T
barcode79_consensus_vsearch	3838	C	*/-T	374	8	1.99%	2	2	93	93	0.003764310420345661	1	1	181	193	1	7	+T
barcode79_consensus_vsearch	3857	G	*/-CG	386	18	4.41%	2	2	93	93	3.143375425577397E-6	1	1	170	216	12	6	-CG
barcode79_consensus_vsearch	3872	G	*/+A	375	17	4.17%	2	2	93	93	6.390395927916272E-6	1	1	156	219	15	2	+A
barcode79_consensus_vsearch	3872	G	*/+AA	375	9	2.21%	2	2	93	93	0.001862705653908663	1	1	156	219	8	1	+A
barcode79_consensus_vsearch	3875	A	*/-G	300	92	22.55%	2	2	93	93	4.702635543138437E-31	1	1	127	173	51	41	-G
barcode79_consensus_vsearch	3878	G	*/+A	357	9	2.23%	2	2	93	93	0.0018583173294912504	1	1	171	186	1	8	+A
barcode79_consensus_vsearch	3878	G	*/-A	357	24	5.94%	2	2	93	93	4.1015090927093485E-8	1	1	171	186	8	16	-A
barcode79_consensus_vsearch	3882	G	*/-C	395	8	1.97%	2	2	93	93	0.00377164628554966	1	1	182	213	1	7	-C
barcode79_consensus_vsearch	3885	G	*/+T	388	11	2.71%	2	1	93	93	4.5534176337797E-4	1	1	183	205	0	11	+T
barcode79_consensus_vsearch	3887	C	*/-T	394	12	2.95%	2	1	93	93	2.2481843544276345E-4	1	1	183	211	0	12	-T
barcode79_consensus_vsearch	3914	T	*/-C	395	7	1.72%	2	2	93	93	0.007609461804174083	1	1	176	219	6	1	-C
barcode79_consensus_vsearch	3916	C	*/-AA	387	9	2.21%	2	2	93	93	0.0018654123049784304	1	1	172	215	2	7	-AA
barcode79_consensus_vsearch	3940	A	*/+G	315	11	2.74%	2	2	93	93	4.4816042013600066E-4	1	1	101	214	8	3	+G
barcode79_consensus_vsearch	3940	A	*/-G	315	73	18.16%	2	2	93	93	2.5094208017195108E-24	1	1	101	214	68	5	-G
barcode79_consensus_vsearch	3946	G	*/+A	398	8	1.97%	2	1	93	93	0.003772632825065396	1	1	175	223	8	0	+A
barcode79_consensus_vsearch	3947	G	*/-TG	383	20	4.9%	2	1	93	93	7.489865143008543E-7	1	1	183	200	0	20	-TG
barcode79_consensus_vsearch	3952	T	*/+C	393	7	1.73%	2	1	93	93	0.007608451759263046	1	1	175	218	7	0	+C
barcode79_consensus_vsearch	3954	A	*/-G	382	11	2.7%	2	1	93	93	4.548498903980809E-4	1	1	174	208	0	11	-G
barcode79_consensus_vsearch	3961	A	*/+G	365	19	4.71%	2	2	93	93	1.518220570262078E-6	1	1	158	207	16	3	+G
barcode79_consensus_vsearch	3961	A	*/-G	365	12	2.98%	2	2	93	93	2.2337500485281107E-4	1	1	158	207	4	8	+G
barcode79_consensus_vsearch	3965	C	*/-A	387	8	1.97%	2	2	93	93	0.0037689428690762675	1	1	179	208	1	7	-A
barcode79_consensus_vsearch	3998	C	*/-T	393	9	2.21%	2	2	93	93	0.0018667057694086889	1	1	181	212	2	7	-T
barcode79_consensus_vsearch	4000	T	*/-G	352	46	11.33%	2	2	93	93	3.5754110095087985E-15	1	1	164	188	16	30	-G
barcode79_consensus_vsearch	4016	A	*/+G	393	7	1.72%	2	1	93	93	0.007608451759263046	1	1	178	215	0	7	+G
barcode79_consensus_vsearch	4019	G	*/-AGAG	390	12	2.95%	2	2	93	93	2.2463138050531574E-4	1	1	169	221	10	2	-AGAG
barcode79_consensus_vsearch	4021	G	*/-A	299	10	2.58%	2	2	93	93	9.069465014723013E-4	1	1	104	195	9	1	-A
barcode79_consensus_vsearch	4021	G	*/-AG	299	73	18.86%	2	2	93	93	2.098106464725246E-24	1	1	104	195	48	25	-AG
barcode79_consensus_vsearch	4022	A	*/+G	273	10	3.29%	2	2	93	93	9.007001154101668E-4	1	1	86	187	9	1	+G
barcode79_consensus_vsearch	4022	A	*/-G	273	14	4.61%	2	2	93	93	5.188757919450994E-5	1	1	86	187	10	4	-G
barcode79_consensus_vsearch	4025	G	*/-C	394	7	1.72%	2	1	93	93	0.007608958034696689	1	1	174	220	7	0	-C
barcode79_consensus_vsearch	4037	A	*/-G	389	8	1.98%	2	2	93	93	0.0037696288519149155	1	1	170	219	5	3	-G
barcode79_consensus_vsearch	4039	G	*/-A	384	10	2.48%	2	1	93	93	9.217129834227815E-4	1	1	161	223	10	0	-A
barcode79_consensus_vsearch	4039	G	*/-AG	384	7	1.73%	2	1	93	93	0.007603779356567615	1	1	161	223	7	0	-A
barcode79_consensus_vsearch	4042	C	*/-G	390	7	1.74%	2	2	93	93	0.007606917708857565	1	1	182	208	1	6	-G
barcode79_consensus_vsearch	4046	C	*/-T	385	16	3.92%	2	2	93	93	1.3099462057416885E-5	1	1	170	215	12	4	-T
barcode79_consensus_vsearch	4058	C	*/+G	381	7	1.74%	2	1	93	93	0.007602173974125566	1	1	178	203	0	7	+G
barcode79_consensus_vsearch	4064	T	*/+C	383	10	2.46%	2	1	93	93	9.215757570452482E-4	1	1	172	211	10	0	+C
barcode79_consensus_vsearch	4064	T	*/-CT	383	8	1.97%	2	1	93	93	0.0037675500295774327	1	1	172	211	0	8	+C
barcode79_consensus_vsearch	4068	G	*/-TG	392	12	2.95%	2	1	93	93	2.2472535825225005E-4	1	1	182	210	0	12	-TG
barcode79_consensus_vsearch	4074	T	*/-C	383	16	3.94%	2	2	93	93	1.3089247338748483E-5	1	1	171	212	10	6	-C
barcode79_consensus_vsearch	4076	C	*/-T	388	8	1.96%	2	1	93	93	0.0037692867193449852	1	1	181	207	0	8	-T
barcode79_consensus_vsearch	4078	T	*/+G	386	10	2.46%	2	1	93	93	9.219853921161506E-4	1	1	179	207	0	10	+G
barcode79_consensus_vsearch	4079	G	*/+A	367	8	1.97%	2	1	93	93	0.0037616841729398503	1	1	181	186	0	8	+A
barcode79_consensus_vsearch	4079	G	*/-A	367	29	7.14%	2	2	93	93	1.094297585058097E-9	1	1	181	186	2	27	-A
barcode79_consensus_vsearch	4085	C	*/-T	400	7	1.72%	2	1	93	93	0.007611943705349879	1	1	184	216	0	7	-T
barcode79_consensus_vsearch	4099	T	*/+G	388	7	1.72%	2	1	93	93	0.007605882130108492	1	1	184	204	0	7	+G
barcode79_consensus_vsearch	4106	C	*/+A	386	8	1.97%	2	2	93	93	0.003768597288121233	1	1	170	216	3	5	+A
barcode79_consensus_vsearch	4144	T	*/+C	385	10	2.46%	2	2	93	93	9.218495267512253E-4	1	1	167	218	6	4	+C
barcode79_consensus_vsearch	4144	T	*/-C	385	9	2.22%	2	2	93	93	0.001864972504119446	1	1	167	218	7	2	+C
barcode79_consensus_vsearch	4152	G	*/-TG	397	8	1.96%	2	2	93	93	0.003772305589141729	1	1	181	216	1	7	-TG
barcode79_consensus_vsearch	4179	G	*/-TG	399	7	1.72%	2	2	93	93	0.007611452190916357	1	1	182	217	1	6	-TG
barcode79_consensus_vsearch	4180	T	*/-G	380	14	3.51%	2	2	93	93	5.426877300342222E-5	1	1	181	199	1	13	-G
barcode79_consensus_vsearch	4184	T	*/+A	373	8	1.98%	2	1	93	93	0.0037639410987491528	1	1	164	209	8	0	+A
barcode79_consensus_vsearch	4184	T	*/-A	373	16	3.96%	2	2	93	93	1.3036692196399446E-5	1	1	164	209	8	8	-A
barcode79_consensus_vsearch	4186	A	*/+G	325	16	3.95%	2	2	93	93	1.2744432932152994E-5	1	1	131	194	6	10	+G
barcode79_consensus_vsearch	4186	A	*/-G	325	43	10.62%	2	2	93	93	3.0893361441370014E-14	1	1	131	194	36	7	-G
barcode79_consensus_vsearch	4189	G	*/-A	391	8	1.97%	2	2	93	93	0.003770308015149166	1	1	176	215	7	1	-A
barcode79_consensus_vsearch	4189	G	*/-AAG	391	7	1.72%	2	1	93	93	0.007607431615374521	1	1	176	215	0	7	-A
barcode79_consensus_vsearch	4205	C	*/-T	390	13	3.23%	2	1	93	93	1.1064141909323187E-4	1	1	184	206	0	13	-T
barcode79_consensus_vsearch	4213	C	*/-T	386	12	2.94%	2	1	93	93	2.244406705806723E-4	1	1	174	212	0	12	-T
barcode79_consensus_vsearch	4213	C	*/-TT	386	7	1.72%	2	1	93	93	0.0076048360660226225	1	1	174	212	7	0	-T
barcode79_consensus_vsearch	4221	T	*/-A	380	23	5.64%	2	2	93	93	8.630835620165058E-8	1	1	162	218	21	2	-A
barcode79_consensus_vsearch	4223	A	*/+G	338	11	2.72%	2	2	93	93	4.5073902379692165E-4	1	1	159	179	2	9	+G
barcode79_consensus_vsearch	4223	A	*/-G	338	32	7.9%	2	2	93	93	1.1558548116368158E-10	1	1	159	179	18	14	-G
barcode79_consensus_vsearch	4223	A	*/-GG	338	14	3.46%	2	1	93	93	5.3498475308471755E-5	1	1	159	179	0	14	-G
barcode79_consensus_vsearch	4230	G	*/+C	395	9	2.21%	2	1	93	93	0.0018671284895574335	1	1	184	211	0	9	+C
barcode79_consensus_vsearch	4236	A	*/+G	383	8	1.98%	2	1	93	93	0.0037675500295774327	1	1	164	219	8	0	+G
barcode79_consensus_vsearch	4243	G	*/+A	383	14	3.46%	2	1	93	93	5.4317819652484023E-5	1	1	165	218	14	0	+A
barcode79_consensus_vsearch	4246	G	*/-CG	389	7	1.75%	2	2	93	93	0.0076064012202881484	1	1	180	209	1	6	-CG
barcode79_consensus_vsearch	4251	A	*/-G	390	7	1.72%	2	2	93	93	0.007606917708857565	1	1	178	212	3	4	-G
barcode79_consensus_vsearch	4256	T	*/-G	393	7	1.73%	2	2	93	93	0.007608451759263046	1	1	178	215	4	3	-G
barcode79_consensus_vsearch	4267	T	*/-C	383	20	4.9%	2	2	93	93	7.489865143008543E-7	1	1	160	223	19	1	-C
barcode79_consensus_vsearch	4269	C	*/-G	384	13	3.19%	2	1	93	93	1.1047452382467976E-4	1	1	180	204	0	13	-G
barcode79_consensus_vsearch	4274	G	*/-TG	397	9	2.21%	2	2	93	93	0.0018675470949966115	1	1	182	215	1	8	-TG
barcode79_consensus_vsearch	4280	C	*/+G	374	13	3.22%	2	2	93	93	1.1018527269038747E-4	1	1	174	200	2	11	+G
barcode79_consensus_vsearch	4283	A	*/-G	370	19	4.77%	2	2	93	93	1.5227894966289487E-6	1	1	161	209	7	12	-G
barcode79_consensus_vsearch	4289	T	*/-C	390	7	1.72%	2	1	93	93	0.007606917708857565	1	1	179	211	0	7	-C
barcode79_consensus_vsearch	4290	C	*/-G	377	13	3.25%	2	2	93	93	1.1027355068065241E-4	1	1	181	196	2	11	-G
barcode79_consensus_vsearch	4292	G	*/-C	392	8	1.97%	2	1	93	93	0.0037706450711110975	1	1	184	208	0	8	-C
barcode79_consensus_vsearch	4294	T	*/-C	377	15	3.73%	2	1	93	93	2.662478633010287E-5	1	1	178	199	0	15	-C
barcode79_consensus_vsearch	4295	C	*/-T	336	38	9.77%	2	1	93	93	1.351918749805126E-12	1	1	182	154	0	38	-T
barcode79_consensus_vsearch	4298	G	*/+C	387	13	3.19%	2	1	93	93	1.1055857583867697E-4	1	1	184	203	0	13	+C
barcode79_consensus_vsearch	4299	C	*/-T	374	12	2.95%	2	1	93	93	2.2384550798854884E-4	1	1	183	191	0	12	-T
barcode79_consensus_vsearch	4328	C	*/-T	385	12	2.95%	2	1	93	93	2.2439240943114192E-4	1	1	182	203	0	12	-T
barcode79_consensus_vsearch	4346	T	*/+C	398	7	1.72%	2	1	93	93	0.007610958261497833	1	1	176	222	7	0	+C
barcode79_consensus_vsearch	4350	C	*/-T	399	7	1.72%	2	2	93	93	0.007611452190916357	1	1	181	218	3	4	-T
barcode79_consensus_vsearch	4351	T	*/+C	381	11	2.75%	2	2	93	93	4.547664803982017E-4	1	1	176	205	2	9	+C
barcode79_consensus_vsearch	4363	C	*/-G	377	10	2.53%	2	1	93	93	9.207377634483318E-4	1	1	182	195	0	10	-G
barcode79_consensus_vsearch	4367	C	*/-A	392	7	1.72%	2	2	93	93	0.007607942959128091	1	1	174	218	3	4	-A
barcode79_consensus_vsearch	4369	A	*/+G	289	19	4.66%	2	2	93	93	1.4325787587441757E-6	1	1	95	194	16	3	+G
barcode79_consensus_vsearch	4369	A	*/-G	289	91	22.3%	2	2	93	93	8.744972318789451E-31	1	1	95	194	68	23	-G
barcode79_consensus_vsearch	4376	T	*/+C	396	7	1.72%	2	1	93	93	0.007609963086240239	1	1	177	219	7	0	+C
barcode79_consensus_vsearch	4390	T	*/+A	372	8	2%	2	1	93	93	0.003763569850402068	1	1	177	195	0	8	+A
barcode79_consensus_vsearch	4390	T	*/-A	372	19	4.74%	2	1	93	93	1.52458730307249E-6	1	1	177	195	0	19	-A
