Chrom	Position	Ref	Cons	Reads1	Reads2	VarFreq	Strands1	Strands2	Qual1	Qual2	Pvalue	MapQual1	MapQual2	Reads1Plus	Reads1Minus	Reads2Plus	Reads2Minus	VarAllele
barcode01_consensus_vsearch	5	G	*/+T	356	8	2.01%	2	1	93	93	0.0037573550023158714	1	1	194	162	8	0	+T
barcode01_consensus_vsearch	5	G	*/-T	356	30	7.54%	2	2	93	93	5.183201981318264E-10	1	1	194	162	29	1	-T
barcode01_consensus_vsearch	13	T	*/+G	543	7	1.26%	2	2	93	93	0.007663896355890601	1	1	231	312	6	1	+G
barcode01_consensus_vsearch	20	T	*/+C	547	11	1.95%	2	1	93	93	4.6458270396940393E-4	1	1	226	321	11	0	+C
barcode01_consensus_vsearch	21	C	*/-A	549	7	1.25%	2	2	93	93	0.007665494166045835	1	1	232	317	3	4	-A
barcode01_consensus_vsearch	26	T	*/+C	457	22	3.91%	2	2	93	93	1.862971849238602E-7	1	1	227	230	5	17	+C
barcode01_consensus_vsearch	26	T	*/-C	457	77	13.7%	2	2	93	93	3.449661515773473E-25	1	1	227	230	5	72	-C
barcode01_consensus_vsearch	34	T	*/-C	548	11	1.95%	2	2	93	93	4.6462444777002886E-4	1	1	225	323	10	1	-C
barcode01_consensus_vsearch	37	G	*/-TG	551	9	1.6%	2	1	93	93	0.0018908787761269387	1	1	238	313	0	9	-TG
barcode01_consensus_vsearch	46	C	*/+T	532	23	4.11%	2	1	93	93	9.446415617562604E-8	1	1	238	294	0	23	+T
barcode01_consensus_vsearch	47	T	*/+G	516	33	5.86%	2	2	93	93	7.091949900238436E-11	1	1	215	301	16	17	+G
barcode01_consensus_vsearch	52	T	*/-G	547	10	1.77%	2	2	93	93	9.375741446597724E-4	1	1	234	313	1	9	-G
barcode01_consensus_vsearch	67	C	*/-TGC	541	11	1.95%	2	2	93	93	4.643291149889421E-4	1	1	227	314	6	5	-TGC
barcode01_consensus_vsearch	74	C	*/-GC	547	9	1.6%	2	1	93	93	0.0018904348242880168	1	1	225	322	9	0	-GC
barcode01_consensus_vsearch	79	G	*/+A	547	7	1.24%	2	1	93	93	0.0076649653940683155	1	1	227	320	7	0	+A
barcode01_consensus_vsearch	81	T	*/-A	538	11	1.95%	2	2	93	93	4.642002747990287E-4	1	1	220	318	8	3	-A
barcode01_consensus_vsearch	84	T	*/+A	535	8	1.43%	2	1	93	93	0.0038061403627091955	1	1	221	314	8	0	+A
barcode01_consensus_vsearch	86	G	*/-A	540	14	2.51%	2	1	93	93	5.616562721441904E-5	1	1	215	325	14	0	-A
barcode01_consensus_vsearch	87	A	*/-G	528	13	2.38%	2	2	93	93	1.1348427629302528E-4	1	1	210	318	11	2	-G
barcode01_consensus_vsearch	90	C	*/-A	537	10	1.79%	2	2	93	93	9.368699288806099E-4	1	1	232	305	1	9	-A
barcode01_consensus_vsearch	103	A	*/-C	541	12	2.13%	2	2	93	93	2.2985341710330166E-4	1	1	224	317	10	2	-C
barcode01_consensus_vsearch	110	C	*/+G	519	17	3.02%	2	1	93	93	6.707017638951936E-6	1	1	221	298	0	17	+G
barcode01_consensus_vsearch	110	C	*/-GAA	519	11	1.95%	2	2	93	93	4.6335097108045754E-4	1	1	221	298	9	2	+G
barcode01_consensus_vsearch	121	C	*/+G	536	8	1.42%	2	1	93	93	0.003806323277364471	1	1	238	298	0	8	+G
barcode01_consensus_vsearch	131	G	*/-C	536	13	2.33%	2	1	93	93	1.1360634434982232E-4	1	1	215	321	13	0	-C
barcode01_consensus_vsearch	139	T	*/+C	512	7	1.24%	2	2	93	93	0.007655054778413619	1	1	202	310	4	3	+C
barcode01_consensus_vsearch	139	T	*/-C	512	41	7.27%	2	2	93	93	2.1060093220186265E-13	1	1	202	310	29	12	-C
barcode01_consensus_vsearch	160	G	*/+C	512	17	3.02%	2	2	93	93	6.695409670242033E-6	1	1	220	292	1	16	+C
barcode01_consensus_vsearch	160	G	*/-C	512	22	3.91%	2	2	93	93	1.911917032643177E-7	1	1	220	292	4	18	-C
barcode01_consensus_vsearch	163	C	*/-T	552	7	1.24%	2	2	93	93	0.007666280255386365	1	1	233	319	2	5	-T
barcode01_consensus_vsearch	164	T	*/-C	534	7	1.25%	2	1	93	93	0.007661433438157596	1	1	227	307	0	7	-C
barcode01_consensus_vsearch	166	A	*/+G	535	16	2.86%	2	1	93	93	1.3663192825097823E-5	1	1	232	303	0	16	+G
barcode01_consensus_vsearch	167	G	*/-A	550	12	2.13%	2	1	93	93	2.3007779846877656E-4	1	1	224	326	12	0	-A
barcode01_consensus_vsearch	169	G	*/-C	549	7	1.25%	2	2	93	93	0.007665494166045835	1	1	228	321	5	2	-C
barcode01_consensus_vsearch	172	A	*/+C	486	16	2.85%	2	2	93	93	1.3514385023969475E-5	1	1	200	286	11	5	+C
barcode01_consensus_vsearch	172	A	*/-C	486	36	6.41%	2	2	93	93	7.790488673741335E-12	1	1	200	286	10	26	-C
barcode01_consensus_vsearch	172	A	*/-CC	486	15	2.67%	2	2	93	93	2.743912586854087E-5	1	1	200	286	10	5	-C
barcode01_consensus_vsearch	176	C	*/-T	514	38	6.73%	2	2	93	93	1.881608574480191E-12	1	1	234	280	2	36	-T
barcode01_consensus_vsearch	180	T	*/+C	530	7	1.24%	2	2	93	93	0.007660312408999644	1	1	212	318	6	1	+C
barcode01_consensus_vsearch	180	T	*/-C	530	22	3.9%	2	2	93	93	1.9260066777154738E-7	1	1	212	318	18	4	-C
barcode01_consensus_vsearch	184	T	*/+G	546	8	1.43%	2	1	93	93	0.00380811632202169	1	1	222	324	8	0	+G
barcode01_consensus_vsearch	185	A	*/-G	541	9	1.6%	2	2	93	93	0.0018897568952923375	1	1	224	317	7	2	-G
barcode01_consensus_vsearch	193	G	*/-A	542	17	3.01%	2	1	93	93	6.743208849693524E-6	1	1	221	321	17	0	-A
barcode01_consensus_vsearch	200	C	*/-T	543	14	2.48%	2	2	93	93	5.619109483854551E-5	1	1	230	313	6	8	-T
barcode01_consensus_vsearch	208	C	*/-T	548	7	1.24%	2	2	93	93	0.007665230254675653	1	1	226	322	2	5	-T
barcode01_consensus_vsearch	210	T	*/+C	427	23	4.13%	2	2	93	93	8.934721786040063E-8	1	1	214	213	5	18	+C
barcode01_consensus_vsearch	210	T	*/-C	427	88	15.8%	2	2	93	93	5.532413352959577E-29	1	1	214	213	8	80	-C
barcode01_consensus_vsearch	210	T	*/-CC	427	12	2.15%	2	2	93	93	2.2623486621516718E-4	1	1	214	213	1	11	-C
barcode01_consensus_vsearch	213	C	*/+T	507	9	1.6%	2	1	93	93	0.0018856202933944005	1	1	223	284	0	9	+T
barcode01_consensus_vsearch	213	C	*/-T	507	32	5.7%	2	2	93	93	1.449340840287827E-10	1	1	223	284	7	25	-T
barcode01_consensus_vsearch	216	A	*/+C	533	9	1.61%	2	1	93	93	0.0018888298504045951	1	1	212	321	9	0	+C
barcode01_consensus_vsearch	216	A	*/-C	533	9	1.61%	2	2	93	93	0.0018888298504045951	1	1	212	321	7	2	+C
barcode01_consensus_vsearch	217	C	*/+T	536	9	1.64%	2	1	93	93	0.001889180653273128	1	1	223	313	0	9	+T
barcode01_consensus_vsearch	220	A	*/-CA	531	19	3.41%	2	2	93	93	1.6283915100677932E-6	1	1	210	321	17	2	-CA
barcode01_consensus_vsearch	221	C	*/+G	530	7	1.29%	2	1	93	93	0.007660312408999644	1	1	207	323	7	0	+G
barcode01_consensus_vsearch	222	A	*/-T	525	7	1.29%	2	1	93	93	0.007658887507292351	1	1	204	321	7	0	-T
barcode01_consensus_vsearch	233	A	*/-GA	544	9	1.61%	2	1	93	93	0.0018900976825545202	1	1	234	310	0	9	-GA
barcode01_consensus_vsearch	237	T	*/-A	528	8	1.43%	2	2	93	93	0.0038048409676247133	1	1	226	302	7	1	-A
barcode01_consensus_vsearch	238	A	*/+G	540	11	1.98%	2	2	93	93	4.6428632168686156E-4	1	1	221	319	8	3	+G
barcode01_consensus_vsearch	239	G	*/-A	542	13	2.31%	2	2	93	93	1.1369564258376639E-4	1	1	220	322	12	1	-A
barcode01_consensus_vsearch	242	G	*/+T	538	8	1.42%	2	1	93	93	0.0038066871088034355	1	1	217	321	8	0	+T
barcode01_consensus_vsearch	245	G	*/+C	535	14	2.49%	2	1	93	93	5.61225811719022E-5	1	1	235	300	0	14	+C
barcode01_consensus_vsearch	245	G	*/-C	535	7	1.24%	2	1	93	93	0.00766171111974148	1	1	235	300	0	7	+C
barcode01_consensus_vsearch	247	T	*/-C	543	10	1.79%	2	1	93	93	9.372954779492018E-4	1	1	234	309	0	10	-C
barcode01_consensus_vsearch	248	C	*/+G	533	7	1.27%	2	2	93	93	0.007661154731964119	1	1	232	301	1	6	+G
barcode01_consensus_vsearch	249	G	*/+C	548	9	1.6%	2	1	93	93	0.0018905464048331274	1	1	225	323	9	0	+C
barcode01_consensus_vsearch	250	C	*/+T	540	17	3.04%	2	1	93	93	6.740174767448187E-6	1	1	234	306	0	17	+T
barcode01_consensus_vsearch	251	C	*/-T	539	18	3.2%	2	2	93	93	3.3178617815960446E-6	1	1	235	304	1	17	-T
barcode01_consensus_vsearch	252	T	*/-A	518	7	1.28%	2	2	93	93	0.007656847224773479	1	1	228	290	6	1	-A
barcode01_consensus_vsearch	253	A	*/+G	491	17	3.06%	2	2	93	93	6.658766873142193E-6	1	1	226	265	2	15	+G
barcode01_consensus_vsearch	253	A	*/-G	491	45	8.09%	2	2	93	93	1.0841143269960838E-14	1	1	226	265	1	44	-G
barcode01_consensus_vsearch	258	A	*/-C	543	8	1.42%	2	2	93	93	0.003807585201342346	1	1	229	314	1	7	-C
barcode01_consensus_vsearch	272	C	*/+G	537	9	1.6%	2	2	93	93	0.0018892967385001622	1	1	227	310	1	8	+G
barcode01_consensus_vsearch	272	C	*/-G	537	10	1.77%	2	2	93	93	9.368699288806099E-4	1	1	227	310	7	3	-G
barcode01_consensus_vsearch	276	T	*/+A	544	8	1.42%	2	1	93	93	0.0038077628791647437	1	1	234	310	0	8	+A
barcode01_consensus_vsearch	291	C	*/-G	538	13	2.32%	2	1	93	93	1.136363211850464E-4	1	1	229	309	0	13	-G
barcode01_consensus_vsearch	298	A	*/-G	545	8	1.42%	2	2	93	93	0.003807939918250496	1	1	227	318	6	2	-G
barcode01_consensus_vsearch	311	G	*/-A	548	7	1.24%	2	1	93	93	0.007665230254675653	1	1	225	323	7	0	-A
barcode01_consensus_vsearch	314	G	*/-T	528	27	4.79%	2	2	93	93	5.38872914092509E-9	1	1	215	313	15	12	-T
barcode01_consensus_vsearch	319	C	*/-A	543	7	1.24%	2	2	93	93	0.007663896355890601	1	1	228	315	4	3	-A
barcode01_consensus_vsearch	321	A	*/-G	482	54	9.59%	2	2	93	93	1.3611705518498598E-17	1	1	192	290	40	14	-G
barcode01_consensus_vsearch	321	A	*/-GG	482	10	1.78%	2	1	93	93	9.324919401133498E-4	1	1	192	290	0	10	-G
barcode01_consensus_vsearch	324	G	*/+A	551	7	1.24%	2	1	93	93	0.007666019161359943	1	1	228	323	7	0	+A
barcode01_consensus_vsearch	326	C	*/-GC	549	7	1.24%	2	2	93	93	0.007665494166045835	1	1	233	316	3	4	-GC
barcode01_consensus_vsearch	333	G	*/-A	546	8	1.43%	2	2	93	93	0.00380811632202169	1	1	225	321	6	2	-A
barcode01_consensus_vsearch	339	C	*/+A	537	9	1.6%	2	1	93	93	0.0018892967385001622	1	1	219	318	9	0	+A
barcode01_consensus_vsearch	344	C	*/-GC	540	15	2.66%	2	1	93	93	2.7728296573401545E-5	1	1	219	321	15	0	-GC
barcode01_consensus_vsearch	350	A	*/-G	470	58	10.43%	2	2	93	93	6.620569256338629E-19	1	1	219	251	1	57	-G
barcode01_consensus_vsearch	352	G	*/+T	489	10	1.81%	2	1	93	93	9.331020233624242E-4	1	1	233	256	0	10	+T
barcode01_consensus_vsearch	354	C	*/-G	388	26	4.7%	2	2	93	93	9.938208002589169E-9	1	1	231	157	1	25	-G
barcode01_consensus_vsearch	354	C	*/-GC	388	16	2.89%	2	2	93	93	1.3114605407806796E-5	1	1	231	157	2	14	-G
barcode01_consensus_vsearch	354	C	*/-GCTCC	388	7	1.27%	2	1	93	93	0.007605882130108492	1	1	231	157	0	7	-G
barcode01_consensus_vsearch	356	C	*/+T	435	39	7.29%	2	2	93	93	8.051751045543314E-13	1	1	233	202	1	38	+T
barcode01_consensus_vsearch	356	C	*/-T	435	19	3.55%	2	1	93	93	1.5737440147383591E-6	1	1	233	202	0	19	+T
barcode01_consensus_vsearch	356	C	*/-TC	435	13	2.43%	2	1	93	93	1.1175501046296811E-4	1	1	233	202	0	13	+T
barcode01_consensus_vsearch	357	T	*/-C	447	25	4.78%	2	2	93	93	2.150495868927303E-8	1	1	227	220	3	22	-C
barcode01_consensus_vsearch	357	T	*/-CCT	447	40	7.65%	2	2	93	93	3.946383536308111E-13	1	1	227	220	2	38	-CCT
barcode01_consensus_vsearch	359	C	*/+T	469	12	2.33%	2	1	93	93	2.2776299237076134E-4	1	1	233	236	0	12	+T
barcode01_consensus_vsearch	368	C	*/+G	552	8	1.42%	2	1	93	93	0.0038091615924873046	1	1	227	325	8	0	+G
barcode01_consensus_vsearch	369	A	*/-G	547	10	1.77%	2	2	93	93	9.375741446597724E-4	1	1	226	321	8	2	-G
barcode01_consensus_vsearch	371	G	*/+C	325	17	3.02%	2	2	93	93	6.22294053128114E-6	1	1	173	152	7	10	+C
barcode01_consensus_vsearch	371	G	*/-C	325	128	22.78%	2	2	93	93	8.191827216393513E-44	1	1	173	152	49	79	-C
barcode01_consensus_vsearch	371	G	*/-CC	325	61	10.85%	2	2	93	93	3.3021902515238374E-20	1	1	173	152	2	59	-C
barcode01_consensus_vsearch	371	G	*/-CCC	325	25	4.45%	2	2	93	93	1.9113095257973196E-8	1	1	173	152	3	22	-C
barcode01_consensus_vsearch	376	C	*/-T	515	49	8.67%	2	2	93	93	5.973839672453348E-16	1	1	234	281	3	46	-T
barcode01_consensus_vsearch	379	T	*/-CT	497	50	8.99%	2	2	93	93	2.747670376926056E-16	1	1	220	277	14	36	-CT
barcode01_consensus_vsearch	383	C	*/+A	543	7	1.25%	2	2	93	93	0.007663896355890601	1	1	227	316	6	1	+A
barcode01_consensus_vsearch	391	A	*/-T	515	28	5%	2	1	93	93	2.606466763763818E-9	1	1	230	285	0	28	-T
barcode01_consensus_vsearch	394	T	*/-C	496	60	10.64%	2	2	93	93	1.612328263844456E-19	1	1	222	274	13	47	-C
barcode01_consensus_vsearch	396	C	*/+G	532	12	2.13%	2	2	93	93	2.296217615481528E-4	1	1	225	307	2	10	+G
barcode01_consensus_vsearch	396	C	*/-G	532	9	1.6%	2	2	93	93	0.0018887120592700076	1	1	225	307	8	1	+G
barcode01_consensus_vsearch	398	A	*/+G	532	10	1.79%	2	2	93	93	9.365081955943183E-4	1	1	224	308	3	7	+G
barcode01_consensus_vsearch	398	A	*/-G	532	9	1.61%	2	2	93	93	0.0018887120592700076	1	1	224	308	7	2	+G
barcode01_consensus_vsearch	401	C	*/+T	541	16	2.85%	2	1	93	93	1.3679689269215653E-5	1	1	235	306	0	16	+T
barcode01_consensus_vsearch	402	C	*/-T	545	18	3.19%	2	2	93	93	3.3228779155975013E-6	1	1	236	309	1	17	-T
barcode01_consensus_vsearch	410	G	*/-A	556	8	1.42%	2	1	93	93	0.0038098461564736973	1	1	230	326	8	0	-A
barcode01_consensus_vsearch	415	C	*/-G	536	8	1.42%	2	2	93	93	0.003806323277364471	1	1	221	315	7	1	-G
barcode01_consensus_vsearch	421	C	*/+A	542	9	1.6%	2	2	93	93	0.0018898708997509422	1	1	221	321	7	2	+A
barcode01_consensus_vsearch	421	C	*/-A	542	8	1.42%	2	2	93	93	0.003807406881292934	1	1	221	321	7	1	+A
barcode01_consensus_vsearch	428	A	*/+T	532	7	1.25%	2	1	93	93	0.007660874995560234	1	1	217	315	0	7	+T
barcode01_consensus_vsearch	429	C	*/+T	532	12	2.13%	2	2	93	93	2.296217615481528E-4	1	1	222	310	5	7	+T
barcode01_consensus_vsearch	429	C	*/-T	532	9	1.6%	2	2	93	93	0.0018887120592700076	1	1	222	310	5	4	+T
barcode01_consensus_vsearch	433	T	*/+C	542	7	1.25%	2	1	93	93	0.0076636266713165585	1	1	229	313	0	7	+C
barcode01_consensus_vsearch	440	T	*/-C	537	23	4.08%	2	1	93	93	9.466465233641151E-8	1	1	212	325	23	0	-C
barcode01_consensus_vsearch	443	T	*/-G	525	19	3.38%	2	2	93	93	1.625504770701967E-6	1	1	230	295	1	18	-G
barcode01_consensus_vsearch	453	T	*/-C	513	43	7.64%	2	2	93	93	4.885739340294441E-14	1	1	202	311	33	10	-C
barcode01_consensus_vsearch	455	C	*/+G	549	8	1.42%	2	1	93	93	0.003808641755461624	1	1	227	322	8	0	+G
barcode01_consensus_vsearch	456	C	*/-T	534	20	3.55%	2	2	93	93	8.009197822250914E-7	1	1	230	304	3	17	-T
barcode01_consensus_vsearch	458	T	*/-G	530	10	1.78%	2	2	93	93	9.363616496764544E-4	1	1	225	305	2	8	-G
barcode01_consensus_vsearch	469	G	*/-CG	538	7	1.26%	2	1	93	93	0.007662538073238661	1	1	231	307	0	7	-CG
barcode01_consensus_vsearch	487	A	*/+C	544	7	1.24%	2	2	93	93	0.007664165065188001	1	1	227	317	3	4	+C
barcode01_consensus_vsearch	488	C	*/+T	538	16	2.86%	2	1	93	93	1.3671483862754112E-5	1	1	234	304	0	16	+T
barcode01_consensus_vsearch	504	G	*/-A	556	8	1.42%	2	2	93	93	0.0038098461564736973	1	1	234	322	4	4	-A
barcode01_consensus_vsearch	508	C	*/+T	510	9	1.6%	2	1	93	93	0.001886006885374921	1	1	234	276	0	9	+T
barcode01_consensus_vsearch	508	C	*/-T	510	41	7.28%	2	2	93	93	2.0999062932873556E-13	1	1	234	276	1	40	-T
barcode01_consensus_vsearch	513	C	*/-G	538	8	1.44%	2	1	93	93	0.0038066871088034355	1	1	230	308	0	8	-G
barcode01_consensus_vsearch	515	G	*/-C	556	7	1.24%	2	1	93	93	0.0076673153898888695	1	1	238	318	0	7	-C
barcode01_consensus_vsearch	516	C	*/-T	509	24	4.31%	2	2	93	93	4.57395315547895E-8	1	1	224	285	1	23	-T
barcode01_consensus_vsearch	519	T	*/+C	442	11	1.95%	2	2	93	93	4.591936353588643E-4	1	1	210	232	3	8	+C
barcode01_consensus_vsearch	519	T	*/-C	442	101	17.94%	2	2	93	93	2.3261697286722825E-33	1	1	210	232	20	81	-C
barcode01_consensus_vsearch	522	C	*/+T	509	12	2.12%	2	2	93	93	2.289941597784763E-4	1	1	231	278	1	11	+T
barcode01_consensus_vsearch	522	C	*/-T	509	23	4.07%	2	2	93	93	9.349827467527904E-8	1	1	231	278	1	22	-T
barcode01_consensus_vsearch	522	C	*/-TT	509	11	1.95%	2	2	93	93	4.628794569501745E-4	1	1	231	278	2	9	-T
barcode01_consensus_vsearch	529	C	*/-G	541	10	1.78%	2	2	93	93	9.371546456216187E-4	1	1	228	313	3	7	-G
barcode01_consensus_vsearch	531	G	*/-C	549	7	1.24%	2	2	93	93	0.007665494166045835	1	1	224	325	5	2	-C
barcode01_consensus_vsearch	533	C	*/-A	526	28	4.96%	2	2	93	93	2.6254939567174794E-9	1	1	213	313	17	11	-A
barcode01_consensus_vsearch	535	A	*/-G	547	8	1.42%	2	1	93	93	0.003808292093894457	1	1	234	313	0	8	-G
barcode01_consensus_vsearch	538	A	*/+T	548	7	1.25%	2	1	93	93	0.007665230254675653	1	1	237	311	0	7	+T
barcode01_consensus_vsearch	541	C	*/-GC	512	23	4.07%	2	2	93	93	9.36284907938922E-8	1	1	211	301	9	14	-GC
barcode01_consensus_vsearch	542	G	*/+C	512	7	1.31%	2	1	93	93	0.007655054778413619	1	1	206	306	7	0	+C
barcode01_consensus_vsearch	543	C	*/+A	513	9	1.69%	2	1	93	93	0.001886389075032373	1	1	208	305	9	0	+A
barcode01_consensus_vsearch	545	G	*/-A	545	7	1.26%	2	1	93	93	0.007664432804486939	1	1	224	321	7	0	-A
barcode01_consensus_vsearch	546	A	*/-G	514	31	5.57%	2	2	93	93	3.002188557725469E-10	1	1	199	315	30	1	-G
barcode01_consensus_vsearch	546	A	*/-GA	514	11	1.97%	2	1	93	93	4.6311742211065505E-4	1	1	199	315	0	11	-G
barcode01_consensus_vsearch	550	G	*/-C	523	13	2.33%	2	2	93	93	1.1340618031334358E-4	1	1	201	322	12	1	-C
barcode01_consensus_vsearch	552	C	*/+T	514	14	2.49%	2	1	93	93	5.5933162205555704E-5	1	1	220	294	0	14	+T
barcode01_consensus_vsearch	552	C	*/-T	514	16	2.84%	2	2	93	93	1.3602641158470232E-5	1	1	220	294	4	12	-T
barcode01_consensus_vsearch	555	G	*/-A	531	8	1.44%	2	2	93	93	0.003805401958573046	1	1	217	314	2	6	-A
barcode01_consensus_vsearch	558	A	*/-T	539	14	2.48%	2	2	93	93	5.6157078426883895E-5	1	1	229	310	1	13	-T
barcode01_consensus_vsearch	560	T	*/-C	507	22	3.9%	2	2	93	93	1.9078488332450523E-7	1	1	233	274	1	21	-C
barcode01_consensus_vsearch	560	T	*/-CAA	507	28	4.96%	2	1	93	93	2.592215428144562E-9	1	1	233	274	0	28	-CAA
barcode01_consensus_vsearch	561	C	*/-A	479	14	2.72%	2	2	93	93	5.5582799321315175E-5	1	1	227	252	3	11	-A
barcode01_consensus_vsearch	561	C	*/-AA	479	12	2.33%	2	2	93	93	2.2808916757551884E-4	1	1	227	252	1	11	-A
barcode01_consensus_vsearch	570	A	*/+G	502	32	5.7%	2	1	93	93	1.442725548369725E-10	1	1	219	283	0	32	+G
barcode01_consensus_vsearch	570	A	*/-G	502	13	2.32%	2	2	93	93	1.1306205500003354E-4	1	1	219	283	3	10	+G
barcode01_consensus_vsearch	577	C	*/-GC	535	11	1.96%	2	1	93	93	4.640700413183075E-4	1	1	213	322	11	0	-GC
barcode01_consensus_vsearch	579	C	*/-T	529	10	1.81%	2	2	93	93	9.362879739115975E-4	1	1	212	317	5	5	-T
barcode01_consensus_vsearch	581	T	*/-A	539	9	1.6%	2	2	93	93	0.0018895276491797967	1	1	219	320	8	1	-A
barcode01_consensus_vsearch	582	A	*/+G	467	17	3.07%	2	1	93	93	6.613209960094712E-6	1	1	225	242	0	17	+G
barcode01_consensus_vsearch	582	A	*/-G	467	67	12.09%	2	2	93	93	7.438713895519819E-22	1	1	225	242	3	64	-G
barcode01_consensus_vsearch	593	A	*/+C	519	10	1.78%	2	2	93	93	9.355360884142277E-4	1	1	223	296	3	7	+C
barcode01_consensus_vsearch	593	A	*/-C	519	17	3.03%	2	2	93	93	6.707017638951936E-6	1	1	223	296	3	14	-C
barcode01_consensus_vsearch	594	C	*/+T	524	11	2.04%	2	1	93	93	4.635802256328469E-4	1	1	230	294	0	11	+T
barcode01_consensus_vsearch	617	A	*/-G	484	57	10.23%	2	2	93	93	1.462343824248372E-18	1	1	210	274	7	50	-G
barcode01_consensus_vsearch	623	C	*/+T	505	18	3.2%	2	2	93	93	3.2873896799401502E-6	1	1	231	274	2	16	+T
barcode01_consensus_vsearch	623	C	*/-T	505	38	6.75%	2	2	93	93	1.8604228054914524E-12	1	1	231	274	3	35	-T
barcode01_consensus_vsearch	634	T	*/+C	530	25	4.46%	2	2	93	93	2.260548522244661E-8	1	1	209	321	21	4	+C
barcode01_consensus_vsearch	639	C	*/-T	549	8	1.42%	2	1	93	93	0.003808641755461624	1	1	233	316	0	8	-T
barcode01_consensus_vsearch	641	T	*/+C	525	7	1.25%	2	2	93	93	0.007658887507292351	1	1	215	310	5	2	+C
barcode01_consensus_vsearch	641	T	*/-C	525	23	4.09%	2	2	93	93	9.417792340750421E-8	1	1	215	310	13	10	-C
barcode01_consensus_vsearch	648	T	*/-C	548	13	2.3%	2	1	93	93	1.1378307698217953E-4	1	1	237	311	0	13	-C
barcode01_consensus_vsearch	659	T	*/-A	550	8	1.42%	2	1	93	93	0.003808815651854499	1	1	227	323	8	0	-A
barcode01_consensus_vsearch	660	A	*/+T	522	14	2.52%	2	2	93	93	5.600701822831767E-5	1	1	211	311	5	9	+T
barcode01_consensus_vsearch	660	A	*/-T	522	17	3.06%	2	2	93	93	6.71190474743033E-6	1	1	211	311	12	5	-T
barcode01_consensus_vsearch	672	C	*/-A	551	9	1.6%	2	2	93	93	0.0018908787761269387	1	1	231	320	6	3	-A
barcode01_consensus_vsearch	675	C	*/-A	553	7	1.24%	2	2	93	93	0.00766654042031271	1	1	230	323	6	1	-A
barcode01_consensus_vsearch	685	A	*/+C	542	10	1.78%	2	1	93	93	9.372251878177806E-4	1	1	231	311	0	10	+C
barcode01_consensus_vsearch	687	T	*/+C	478	11	1.96%	2	1	93	93	4.612973880138499E-4	1	1	223	255	0	11	+C
barcode01_consensus_vsearch	687	T	*/-A	478	14	2.5%	2	2	93	93	5.557208101151187E-5	1	1	223	255	10	4	-A
barcode01_consensus_vsearch	690	A	*/-G	537	11	1.98%	2	2	93	93	4.641570195599558E-4	1	1	217	320	9	2	-G
barcode01_consensus_vsearch	696	C	*/-T	542	11	1.97%	2	1	93	93	4.643717559554366E-4	1	1	237	305	0	11	-T
barcode01_consensus_vsearch	697	T	*/-C	524	23	4.16%	2	2	93	93	9.41364943436732E-8	1	1	214	310	22	1	-C
barcode01_consensus_vsearch	706	G	*/+C	545	17	3.01%	2	2	93	93	6.747721399012676E-6	1	1	236	309	1	16	+C
barcode01_consensus_vsearch	708	T	*/-C	542	10	1.79%	2	1	93	93	9.372251878177806E-4	1	1	233	309	0	10	-C
barcode01_consensus_vsearch	712	G	*/-CG	527	35	6.21%	2	2	93	93	1.6855155104450634E-11	1	1	230	297	6	29	-CG
barcode01_consensus_vsearch	716	C	*/-A	544	7	1.25%	2	2	93	93	0.007664165065188001	1	1	228	316	2	5	-A
barcode01_consensus_vsearch	721	C	*/-T	543	9	1.6%	2	1	93	93	0.0018899844947723675	1	1	237	306	0	9	-T
barcode01_consensus_vsearch	724	C	*/-TC	514	43	7.66%	2	2	93	93	4.89345121136514E-14	1	1	236	278	1	42	-TC
barcode01_consensus_vsearch	725	T	*/+C	485	28	5.36%	2	1	93	93	2.5511115521824705E-9	1	1	205	280	28	0	+C
barcode01_consensus_vsearch	736	A	*/+C	537	8	1.42%	2	2	93	93	0.003806505524841473	1	1	229	308	1	7	+C
barcode01_consensus_vsearch	736	A	*/-C	537	9	1.6%	2	2	93	93	0.0018892967385001622	1	1	229	308	1	8	-C
barcode01_consensus_vsearch	739	T	*/-C	544	7	1.25%	2	1	93	93	0.007664165065188001	1	1	221	323	7	0	-C
barcode01_consensus_vsearch	741	C	*/-AC	550	11	1.95%	2	1	93	93	4.647074958288269E-4	1	1	225	325	11	0	-AC
barcode01_consensus_vsearch	744	G	*/+C	483	26	4.63%	2	2	93	93	1.0739701378663705E-8	1	1	218	265	8	18	+C
barcode01_consensus_vsearch	744	G	*/-C	483	43	7.66%	2	2	93	93	4.646415861552238E-14	1	1	218	265	5	38	-C
barcode01_consensus_vsearch	745	C	*/+T	465	34	6.59%	2	1	93	93	3.2532891769785695E-11	1	1	226	239	0	34	+T
barcode01_consensus_vsearch	748	T	*/-C	522	18	3.21%	2	2	93	93	3.3030782399307127E-6	1	1	214	308	13	5	-C
barcode01_consensus_vsearch	748	T	*/-CCT	522	11	1.96%	2	1	93	93	4.6348903153335794E-4	1	1	214	308	0	11	-C
barcode01_consensus_vsearch	750	C	*/+T	527	17	3.07%	2	1	93	93	6.7199360108384015E-6	1	1	235	292	0	17	+T
barcode01_consensus_vsearch	752	A	*/-C	544	7	1.25%	2	2	93	93	0.007664165065188001	1	1	229	315	2	5	-C
barcode01_consensus_vsearch	753	C	*/-T	527	24	4.33%	2	2	93	93	4.6145632803908955E-8	1	1	233	294	1	23	-T
barcode01_consensus_vsearch	754	T	*/+C	518	8	1.49%	2	2	93	93	0.0038029250726284375	1	1	228	290	3	5	+C
barcode01_consensus_vsearch	759	G	*/+TG	545	7	1.24%	2	2	93	93	0.007664432804486939	1	1	228	317	2	5	+TG
barcode01_consensus_vsearch	761	C	*/-G	548	7	1.24%	2	2	93	93	0.007665230254675653	1	1	231	317	2	5	-G
barcode01_consensus_vsearch	767	G	*/-C	546	8	1.42%	2	2	93	93	0.00380811632202169	1	1	227	319	3	5	-C
barcode01_consensus_vsearch	769	C	*/-G	530	28	4.96%	2	1	93	93	2.6322553713172326E-9	1	1	236	294	0	28	-G
barcode01_consensus_vsearch	786	T	*/+C	539	10	1.78%	2	1	93	93	9.370127995938237E-4	1	1	221	318	10	0	+C
barcode01_consensus_vsearch	794	A	*/-G	527	14	2.51%	2	2	93	93	5.605210279030548E-5	1	1	223	304	1	13	-G
barcode01_consensus_vsearch	799	T	*/-A	525	24	4.29%	2	2	93	93	4.610168174093047E-8	1	1	210	315	19	5	-A
barcode01_consensus_vsearch	811	A	*/+T	501	20	3.55%	2	2	93	93	7.919449971423183E-7	1	1	190	311	19	1	+T
barcode01_consensus_vsearch	811	A	*/+TT	501	8	1.42%	2	1	93	93	0.003799496405528544	1	1	190	311	8	0	+T
barcode01_consensus_vsearch	811	A	*/-T	501	26	4.61%	2	2	93	93	1.086354491975161E-8	1	1	190	311	20	6	-T
barcode01_consensus_vsearch	815	T	*/+C	544	10	1.78%	2	1	93	93	9.373655173650468E-4	1	1	222	322	10	0	+C
barcode01_consensus_vsearch	817	A	*/-G	532	12	2.14%	2	2	93	93	2.296217615481528E-4	1	1	230	302	1	11	-G
barcode01_consensus_vsearch	826	C	*/+G	538	10	1.78%	2	1	93	93	9.369414930158851E-4	1	1	234	304	0	10	+G
barcode01_consensus_vsearch	828	A	*/-T	549	7	1.25%	2	1	93	93	0.007665494166045835	1	1	234	315	0	7	-T
barcode01_consensus_vsearch	829	T	*/+C	540	10	1.8%	2	1	93	93	9.370838500036545E-4	1	1	238	302	0	10	+C
barcode01_consensus_vsearch	830	T	*/-C	542	12	2.13%	2	2	93	93	2.2987870123184875E-4	1	1	234	308	1	11	-C
barcode01_consensus_vsearch	838	T	*/-A	534	12	2.13%	2	1	93	93	2.2967388723850522E-4	1	1	222	312	12	0	-A
barcode01_consensus_vsearch	838	T	*/-AA	534	8	1.42%	2	1	93	93	0.003805956777213485	1	1	222	312	0	8	-A
barcode01_consensus_vsearch	850	C	*/-AC	479	75	13.39%	2	2	93	93	1.8015067678739967E-24	1	1	163	316	71	4	-AC
barcode01_consensus_vsearch	852	C	*/-T	464	9	1.87%	2	1	93	93	0.0018795457786723107	1	1	162	302	0	9	-T
barcode01_consensus_vsearch	854	T	*/-C	501	7	1.25%	2	1	93	93	0.007651659097839623	1	1	233	268	0	7	-C
barcode01_consensus_vsearch	854	T	*/-CT	501	36	6.41%	2	2	93	93	7.932437602484316E-12	1	1	233	268	1	35	-CT
barcode01_consensus_vsearch	855	C	*/-T	495	13	2.53%	2	1	93	93	1.129411933973149E-4	1	1	236	259	0	13	-T
barcode01_consensus_vsearch	860	C	*/-G	519	25	4.51%	2	2	93	93	2.2476582562390846E-8	1	1	211	308	16	9	-G
barcode01_consensus_vsearch	869	A	*/+T	540	7	1.25%	2	1	93	93	0.007663084355008458	1	1	230	310	0	7	+T
barcode01_consensus_vsearch	870	C	*/-T	535	13	2.33%	2	2	93	93	1.1359127591436588E-4	1	1	232	303	4	9	-T
barcode01_consensus_vsearch	872	T	*/-C	526	29	5.15%	2	2	93	93	1.279602780526698E-9	1	1	225	301	6	23	-C
barcode01_consensus_vsearch	876	T	*/-G	553	7	1.24%	2	2	93	93	0.00766654042031271	1	1	232	321	4	3	-G
barcode01_consensus_vsearch	885	T	*/+C	547	7	1.24%	2	2	93	93	0.0076649653940683155	1	1	227	320	3	4	+C
barcode01_consensus_vsearch	885	T	*/-C	547	7	1.24%	2	1	93	93	0.0076649653940683155	1	1	227	320	7	0	+C
barcode01_consensus_vsearch	904	C	*/+G	537	9	1.59%	2	1	93	93	0.0018892967385001622	1	1	235	302	0	9	+G
barcode01_consensus_vsearch	910	C	*/+T	426	30	5.32%	2	2	93	93	5.688382919929854E-10	1	1	190	236	21	9	+T
barcode01_consensus_vsearch	910	C	*/+TT	426	7	1.24%	2	2	93	93	0.007623929979105209	1	1	190	236	4	3	+T
barcode01_consensus_vsearch	910	C	*/-T	426	70	12.41%	2	2	93	93	6.164377110427338E-23	1	1	190	236	14	56	-T
barcode01_consensus_vsearch	910	C	*/-TT	426	23	4.08%	2	2	93	93	8.928837038302003E-8	1	1	190	236	8	15	-T
barcode01_consensus_vsearch	910	C	*/-TTT	426	7	1.24%	2	1	93	93	0.007623929979105209	1	1	190	236	0	7	-T
barcode01_consensus_vsearch	926	G	*/-C	543	16	2.83%	2	1	93	93	1.3685112619426907E-5	1	1	221	322	16	0	-C
barcode01_consensus_vsearch	929	T	*/+G	534	11	1.96%	2	1	93	93	4.6402631662478475E-4	1	1	223	311	11	0	+G
barcode01_consensus_vsearch	930	A	*/-G	550	11	1.95%	2	2	93	93	4.647074958288269E-4	1	1	227	323	10	1	-G
barcode01_consensus_vsearch	933	C	*/+T	536	7	1.24%	2	2	93	93	0.007661987782401454	1	1	237	299	1	6	+T
barcode01_consensus_vsearch	933	C	*/-T	536	14	2.49%	2	1	93	93	5.613125112106641E-5	1	1	237	299	0	14	-T
barcode01_consensus_vsearch	936	T	*/-G	541	9	1.59%	2	2	93	93	0.0018897568952923375	1	1	234	307	2	7	-G
barcode01_consensus_vsearch	939	C	*/+A	546	7	1.25%	2	1	93	93	0.0076646995790388295	1	1	238	308	0	7	+A
barcode01_consensus_vsearch	940	A	*/-C	544	7	1.24%	2	2	93	93	0.007664165065188001	1	1	229	315	3	4	-C
barcode01_consensus_vsearch	942	C	*/+T	525	11	1.95%	2	1	93	93	4.636255716146247E-4	1	1	230	295	0	11	+T
barcode01_consensus_vsearch	942	C	*/-T	525	12	2.13%	2	2	93	93	2.2943632667974108E-4	1	1	230	295	3	9	-T
barcode01_consensus_vsearch	954	T	*/+C	542	13	2.31%	2	1	93	93	1.1369564258376639E-4	1	1	234	308	0	13	+C
barcode01_consensus_vsearch	955	T	*/-C	542	13	2.3%	2	1	93	93	1.1369564258376639E-4	1	1	232	310	0	13	-C
barcode01_consensus_vsearch	956	C	*/-G	535	8	1.45%	2	2	93	93	0.0038061403627091955	1	1	233	302	1	7	-G
barcode01_consensus_vsearch	963	T	*/+C	521	9	1.6%	2	2	93	93	0.001887387288255386	1	1	210	311	4	5	+C
barcode01_consensus_vsearch	963	T	*/-C	521	24	4.28%	2	2	93	93	4.601291823103986E-8	1	1	210	311	21	3	-C
barcode01_consensus_vsearch	966	C	*/-GC	488	10	1.77%	2	2	93	93	9.330159046450721E-4	1	1	231	257	2	8	-GC
barcode01_consensus_vsearch	982	C	*/+T	520	11	1.97%	2	2	93	93	4.633971617249264E-4	1	1	212	308	5	6	+T
barcode01_consensus_vsearch	982	C	*/-T	520	18	3.23%	2	2	93	93	3.30128106187894E-6	1	1	212	308	14	4	-T
barcode01_consensus_vsearch	984	T	*/-A	519	25	4.46%	2	2	93	93	2.2476582562390846E-8	1	1	199	320	24	1	-A
barcode01_consensus_vsearch	985	A	*/-C	518	15	2.79%	2	2	93	93	2.7617299344696136E-5	1	1	199	319	11	4	-C
barcode01_consensus_vsearch	987	C	*/+A	449	22	3.91%	2	2	93	93	1.8549993995099648E-7	1	1	222	227	1	21	+A
barcode01_consensus_vsearch	987	C	*/-A	449	71	12.61%	2	2	93	93	3.2562214699444913E-23	1	1	222	227	9	62	-A
barcode01_consensus_vsearch	995	G	*/-C	543	10	1.78%	2	2	93	93	9.372954779492018E-4	1	1	221	322	8	2	-C
barcode01_consensus_vsearch	998	C	*/-AC	538	13	2.3%	2	1	93	93	1.136363211850464E-4	1	1	217	321	13	0	-AC
barcode01_consensus_vsearch	1005	G	*/+CG	546	7	1.25%	2	1	93	93	0.0076646995790388295	1	1	233	313	0	7	+CG
barcode01_consensus_vsearch	1006	T	*/-C	547	11	1.95%	2	2	93	93	4.6458270396940393E-4	1	1	228	319	9	2	-C
barcode01_consensus_vsearch	1013	A	*/+T	493	19	3.39%	2	2	93	93	1.6090435525242452E-6	1	1	195	298	18	1	+T
barcode01_consensus_vsearch	1013	A	*/-T	493	39	6.96%	2	2	93	93	8.829710067452183E-13	1	1	195	298	19	20	-T
barcode01_consensus_vsearch	1017	T	*/+C	504	11	1.95%	2	2	93	93	4.6263694917115237E-4	1	1	233	271	1	10	+C
barcode01_consensus_vsearch	1017	T	*/-C	504	36	6.37%	2	2	93	93	7.960144822483055E-12	1	1	233	271	1	35	-C
barcode01_consensus_vsearch	1024	G	*/-TG	548	9	1.6%	2	1	93	93	0.0018905464048331274	1	1	235	313	0	9	-TG
barcode01_consensus_vsearch	1029	A	*/-CA	531	14	2.5%	2	1	93	93	5.608759281149405E-5	1	1	232	299	0	14	-CA
barcode01_consensus_vsearch	1030	C	*/+A	523	16	2.93%	2	2	93	93	1.3629145012920972E-5	1	1	219	304	14	2	+A
barcode01_consensus_vsearch	1044	C	*/-G	527	27	4.79%	2	2	93	93	5.385500886553299E-9	1	1	231	296	1	26	-G
barcode01_consensus_vsearch	1056	C	*/-A	531	13	2.33%	2	2	93	93	1.1353046202906254E-4	1	1	230	301	1	12	-A
barcode01_consensus_vsearch	1060	T	*/+C	531	7	1.24%	2	2	93	93	0.007660594223165221	1	1	228	303	6	1	+C
barcode01_consensus_vsearch	1060	T	*/-C	531	13	2.3%	2	2	93	93	1.1353046202906254E-4	1	1	228	303	1	12	-C
barcode01_consensus_vsearch	1061	C	*/+G	521	8	1.46%	2	1	93	93	0.0038035073991726275	1	1	234	287	0	8	+G
barcode01_consensus_vsearch	1061	C	*/-G	521	14	2.56%	2	1	93	93	5.59979033015693E-5	1	1	234	287	0	14	-G
barcode01_consensus_vsearch	1063	G	*/-A	511	49	8.7%	2	1	93	93	5.925398916540544E-16	1	1	187	324	49	0	-A
barcode01_consensus_vsearch	1065	G	*/-T	545	10	1.78%	2	2	93	93	9.374353074031662E-4	1	1	222	323	9	1	-T
barcode01_consensus_vsearch	1075	G	*/-A	553	9	1.6%	2	2	93	93	0.0018910984026092464	1	1	233	320	4	5	-A
barcode01_consensus_vsearch	1080	G	*/-A	539	7	1.25%	2	1	93	93	0.007662811712528587	1	1	219	320	7	0	-A
barcode01_consensus_vsearch	1090	T	*/-G	551	7	1.25%	2	2	93	93	0.007666019161359943	1	1	231	320	4	3	-G
barcode01_consensus_vsearch	1092	G	*/+C	543	8	1.42%	2	2	93	93	0.003807585201342346	1	1	223	320	4	4	+C
barcode01_consensus_vsearch	1092	G	*/-C	543	10	1.77%	2	2	93	93	9.372954779492018E-4	1	1	223	320	9	1	-C
barcode01_consensus_vsearch	1095	C	*/+T	550	8	1.42%	2	1	93	93	0.003808815651854499	1	1	237	313	0	8	+T
barcode01_consensus_vsearch	1096	C	*/+G	467	17	3.01%	2	2	93	93	6.613209960094712E-6	1	1	226	241	1	16	+G
barcode01_consensus_vsearch	1097	G	*/-A	553	7	1.25%	2	2	93	93	0.00766654042031271	1	1	227	326	6	1	-A
barcode01_consensus_vsearch	1102	A	*/+C	519	16	2.84%	2	2	93	93	1.3617470884033441E-5	1	1	202	317	14	2	+C
barcode01_consensus_vsearch	1102	A	*/-C	519	19	3.37%	2	2	93	93	1.6225577997907453E-6	1	1	202	317	17	2	-C
barcode01_consensus_vsearch	1114	G	*/+C	551	10	1.78%	2	1	93	93	9.378488845021741E-4	1	1	235	316	0	10	+C
barcode01_consensus_vsearch	1117	C	*/-T	550	10	1.77%	2	2	93	93	9.377805631370637E-4	1	1	236	314	1	9	-T
barcode01_consensus_vsearch	1136	T	*/+C	531	11	1.97%	2	1	93	93	4.63894189996619E-4	1	1	233	298	0	11	+C
barcode01_consensus_vsearch	1137	C	*/-TC	535	17	3.06%	2	2	93	93	6.732498005838406E-6	1	1	231	304	6	11	-TC
barcode01_consensus_vsearch	1139	C	*/-A	512	23	4.23%	2	2	93	93	9.36284907938922E-8	1	1	207	305	21	2	-A
barcode01_consensus_vsearch	1142	T	*/-AG	551	7	1.25%	2	2	93	93	0.007666019161359943	1	1	229	322	4	3	-AG
barcode01_consensus_vsearch	1143	A	*/-G	512	23	4.14%	2	2	93	93	9.36284907938922E-8	1	1	212	300	5	18	-G
barcode01_consensus_vsearch	1148	C	*/+AC	541	11	1.95%	2	1	93	93	4.643291149889421E-4	1	1	216	325	11	0	+AC
barcode01_consensus_vsearch	1160	G	*/-A	548	9	1.6%	2	2	93	93	0.0018905464048331274	1	1	224	324	8	1	-A
barcode01_consensus_vsearch	1161	A	*/+G	410	27	4.88%	2	2	93	93	4.923724830551064E-9	1	1	116	294	20	7	+G
barcode01_consensus_vsearch	1161	A	*/-G	410	98	17.72%	2	2	93	93	1.7679087334579008E-32	1	1	116	294	76	22	-G
barcode01_consensus_vsearch	1161	A	*/-GG	410	7	1.27%	2	2	93	93	0.007616729829810889	1	1	116	294	6	1	-G
barcode01_consensus_vsearch	1168	C	*/-T	532	25	4.44%	2	2	93	93	2.2628439748926713E-8	1	1	235	297	1	24	-T
barcode01_consensus_vsearch	1170	T	*/+C	513	15	2.67%	2	1	93	93	2.7590830493002055E-5	1	1	215	298	15	0	+C
barcode01_consensus_vsearch	1170	T	*/-C	513	20	3.57%	2	2	93	93	7.95327670110173E-7	1	1	215	298	1	19	-C
barcode01_consensus_vsearch	1171	C	*/-G	449	72	13.36%	2	1	93	93	1.5170676396986468E-23	1	1	234	215	0	72	-G
barcode01_consensus_vsearch	1174	A	*/+G	458	8	1.42%	2	2	93	93	0.0037897152001668	1	1	181	277	4	4	+G
barcode01_consensus_vsearch	1174	A	*/-G	458	90	16.01%	2	2	93	93	1.5027945495273417E-29	1	1	181	277	49	41	-G
barcode01_consensus_vsearch	1175	G	*/+T	454	10	2.12%	2	1	93	93	9.298701683765745E-4	1	1	179	275	0	10	+T
barcode01_consensus_vsearch	1195	T	*/+C	545	12	2.13%	2	1	93	93	2.2995401966340216E-4	1	1	238	307	0	12	+C
barcode01_consensus_vsearch	1196	T	*/-C	549	11	1.95%	2	1	93	93	4.646660447990897E-4	1	1	237	312	0	11	-C
barcode01_consensus_vsearch	1201	A	*/+G	510	23	4.11%	2	2	93	93	9.35418262974563E-8	1	1	218	292	1	22	+G
barcode01_consensus_vsearch	1201	A	*/-G	510	9	1.61%	2	2	93	93	0.001886006885374921	1	1	218	292	4	5	+G
barcode01_consensus_vsearch	1203	G	*/+T	515	26	4.65%	2	1	93	93	1.0954932918519869E-8	1	1	235	280	0	26	+T
barcode01_consensus_vsearch	1203	G	*/-T	515	7	1.25%	2	1	93	93	0.0076559561322145355	1	1	235	280	0	7	+T
barcode01_consensus_vsearch	1204	T	*/-CTT	528	16	2.88%	2	1	93	93	1.364350644623287E-5	1	1	236	292	0	16	-CTT
barcode01_consensus_vsearch	1205	C	*/+T	453	23	4.23%	2	1	93	93	9.080050422769434E-8	1	1	234	219	0	23	+T
barcode01_consensus_vsearch	1205	C	*/-T	453	45	8.27%	2	2	93	93	1.0037334091884279E-14	1	1	234	219	1	44	-T
barcode01_consensus_vsearch	1205	C	*/-TT	453	12	2.21%	2	2	93	93	2.2721262456584418E-4	1	1	234	219	3	9	-T
barcode01_consensus_vsearch	1208	T	*/-C	539	15	2.66%	2	1	93	93	2.7723435736556597E-5	1	1	235	304	0	15	-C
barcode01_consensus_vsearch	1209	C	*/+T	524	8	1.46%	2	2	93	93	0.0038040831989871004	1	1	230	294	2	6	+T
barcode01_consensus_vsearch	1210	G	*/+C	516	9	1.6%	2	2	93	93	0.0018867669371326681	1	1	216	300	1	8	+C
barcode01_consensus_vsearch	1210	G	*/-C	516	19	3.39%	2	2	93	93	1.621061136832665E-6	1	1	216	300	8	11	-C
barcode01_consensus_vsearch	1214	C	*/-T	554	7	1.24%	2	1	93	93	0.007666799661120067	1	1	238	316	0	7	-T
barcode01_consensus_vsearch	1219	C	*/+T	544	11	1.97%	2	2	93	93	4.6445658412336564E-4	1	1	229	315	1	10	+T
barcode01_consensus_vsearch	1229	G	*/-CG	551	7	1.24%	2	2	93	93	0.007666019161359943	1	1	233	318	1	6	-CG
barcode01_consensus_vsearch	1241	C	*/-AC	543	11	1.96%	2	1	93	93	4.644142453977102E-4	1	1	225	318	11	0	-AC
barcode01_consensus_vsearch	1242	A	*/+T	537	7	1.27%	2	2	93	93	0.007662263431712945	1	1	222	315	1	6	+T
barcode01_consensus_vsearch	1247	A	*/+G	544	7	1.24%	2	1	93	93	0.007664165065188001	1	1	231	313	0	7	+G
barcode01_consensus_vsearch	1257	C	*/+G	552	7	1.24%	2	1	93	93	0.007666280255386365	1	1	228	324	7	0	+G
barcode01_consensus_vsearch	1258	A	*/-G	547	9	1.6%	2	2	93	93	0.0018904348242880168	1	1	225	322	6	3	-G
barcode01_consensus_vsearch	1260	G	*/-C	551	7	1.24%	2	2	93	93	0.007666019161359943	1	1	236	315	1	6	-C
barcode01_consensus_vsearch	1263	T	*/-C	543	8	1.43%	2	2	93	93	0.003807585201342346	1	1	233	310	2	6	-C
barcode01_consensus_vsearch	1270	G	*/-CG	554	8	1.42%	2	1	93	93	0.0038095050853976346	1	1	235	319	0	8	-CG
barcode01_consensus_vsearch	1287	A	*/-C	541	13	2.32%	2	2	93	93	1.136808905722468E-4	1	1	224	317	4	9	-C
barcode01_consensus_vsearch	1289	C	*/+T	461	32	5.67%	2	2	93	93	1.3845887450547866E-10	1	1	228	233	2	30	+T
barcode01_consensus_vsearch	1289	C	*/-T	461	61	10.82%	2	2	93	93	6.73856868654054E-20	1	1	228	233	5	56	-T
barcode01_consensus_vsearch	1292	A	*/-C	515	23	4.11%	2	2	93	93	9.375740159832836E-8	1	1	198	317	20	3	-C
barcode01_consensus_vsearch	1292	A	*/-CC	515	8	1.43%	2	2	93	93	0.0038023361077742447	1	1	198	317	7	1	-C
barcode01_consensus_vsearch	1295	C	*/-G	526	9	1.59%	2	2	93	93	0.0018879961490473396	1	1	231	295	1	8	-G
barcode01_consensus_vsearch	1295	C	*/-GG	526	16	2.83%	2	1	93	93	1.3637792322447935E-5	1	1	231	295	0	16	-GG
barcode01_consensus_vsearch	1312	C	*/-T	522	31	5.5%	2	2	93	93	3.021862694714269E-10	1	1	232	290	1	30	-T
barcode01_consensus_vsearch	1315	T	*/+C	547	8	1.42%	2	1	93	93	0.003808292093894457	1	1	225	322	8	0	+C
barcode01_consensus_vsearch	1316	C	*/-G	543	8	1.43%	2	2	93	93	0.003807585201342346	1	1	235	308	2	6	-G
barcode01_consensus_vsearch	1329	A	*/-CA	540	12	2.14%	2	2	93	93	2.2982804319169583E-4	1	1	223	317	8	4	-CA
barcode01_consensus_vsearch	1336	C	*/-T	548	8	1.42%	2	2	93	93	0.003808467237244324	1	1	233	315	4	4	-T
barcode01_consensus_vsearch	1340	C	*/-T	548	9	1.59%	2	2	93	93	0.0018905464048331274	1	1	235	313	1	8	-T
barcode01_consensus_vsearch	1351	C	*/-G	523	36	6.41%	2	2	93	93	8.130579936972026E-12	1	1	235	288	3	33	-G
barcode01_consensus_vsearch	1357	C	*/-G	527	28	4.97%	2	2	93	93	2.627192046551503E-9	1	1	231	296	4	24	-G
barcode01_consensus_vsearch	1361	T	*/-G	546	9	1.6%	2	1	93	93	0.001890322845155412	1	1	237	309	0	9	-G
barcode01_consensus_vsearch	1362	G	*/+T	529	24	4.32%	2	1	93	93	4.618930041571234E-8	1	1	238	291	0	24	+T
barcode01_consensus_vsearch	1364	C	*/-T	521	34	6.06%	2	2	93	93	3.456355008384881E-11	1	1	234	287	3	31	-T
barcode01_consensus_vsearch	1370	C	*/-A	514	25	4.51%	2	2	93	93	2.2416463241979445E-8	1	1	205	309	23	2	-A
barcode01_consensus_vsearch	1379	T	*/+C	510	14	2.48%	2	2	93	93	5.5895415073951277E-5	1	1	225	285	3	11	+C
barcode01_consensus_vsearch	1379	T	*/-C	510	34	6.03%	2	2	93	93	3.4189613640517565E-11	1	1	225	285	7	27	-C
barcode01_consensus_vsearch	1394	T	*/-C	547	9	1.6%	2	2	93	93	0.0018904348242880168	1	1	236	311	1	8	-C
barcode01_consensus_vsearch	1404	T	*/-C	514	40	7.12%	2	2	93	93	4.382228968063199E-13	1	1	194	320	39	1	-C
barcode01_consensus_vsearch	1407	A	*/-G	524	11	1.96%	2	1	93	93	4.635802256328469E-4	1	1	203	321	11	0	-G
barcode01_consensus_vsearch	1409	G	*/+T	533	17	3.01%	2	1	93	93	6.729390109352399E-6	1	1	209	324	17	0	+T
barcode01_consensus_vsearch	1409	G	*/-T	533	8	1.42%	2	2	93	93	0.003805772517181644	1	1	209	324	7	1	+T
barcode01_consensus_vsearch	1413	C	*/-A	534	22	3.91%	2	2	93	93	1.9290247591734125E-7	1	1	224	310	9	13	-A
barcode01_consensus_vsearch	1416	A	*/-TC	533	16	2.83%	2	1	93	93	1.36576172302143E-5	1	1	233	300	0	16	-TC
barcode01_consensus_vsearch	1417	T	*/+C	505	7	1.3%	2	2	93	93	0.007652910705556474	1	1	223	282	3	4	+C
barcode01_consensus_vsearch	1417	T	*/-C	505	26	4.81%	2	2	93	93	1.0890080789010404E-8	1	1	223	282	11	15	-C
barcode01_consensus_vsearch	1420	C	*/-T	543	15	2.65%	2	1	93	93	2.7742778214014144E-5	1	1	236	307	0	15	-T
barcode01_consensus_vsearch	1427	T	*/-C	550	7	1.24%	2	2	93	93	0.007665757133253386	1	1	235	315	1	6	-C
barcode01_consensus_vsearch	1434	C	*/+A	522	8	1.44%	2	1	93	93	0.0038037000521996237	1	1	205	317	8	0	+A
barcode01_consensus_vsearch	1434	C	*/-A	522	21	3.77%	2	2	93	93	3.915340037637537E-7	1	1	205	317	16	5	-A
barcode01_consensus_vsearch	1441	C	*/-A	533	20	3.58%	2	1	93	93	8.006624381481838E-7	1	1	216	317	20	0	-A
barcode01_consensus_vsearch	1443	C	*/-T	519	20	3.55%	2	2	93	93	7.969666444646934E-7	1	1	235	284	1	19	-T
barcode01_consensus_vsearch	1443	C	*/-TC	519	16	2.84%	2	2	93	93	1.3617470884033441E-5	1	1	235	284	1	15	-T
barcode01_consensus_vsearch	1444	T	*/-C	497	20	3.78%	2	2	93	93	7.907851940030859E-7	1	1	231	266	3	17	-C
barcode01_consensus_vsearch	1446	C	*/-T	522	19	3.41%	2	1	93	93	1.6240389311041278E-6	1	1	234	288	0	19	-T
barcode01_consensus_vsearch	1459	T	*/+C	546	13	2.3%	2	2	93	93	1.1375413566253189E-4	1	1	232	314	4	9	+C
barcode01_consensus_vsearch	1465	C	*/+G	531	8	1.42%	2	1	93	93	0.003805401958573046	1	1	236	295	0	8	+G
barcode01_consensus_vsearch	1465	C	*/-G	531	15	2.66%	2	1	93	93	2.7683931007376995E-5	1	1	236	295	0	15	-G
barcode01_consensus_vsearch	1469	C	*/-G	554	9	1.59%	2	2	93	93	0.0018912076357286557	1	1	236	318	2	7	-G
barcode01_consensus_vsearch	1486	A	*/-C	545	8	1.42%	2	2	93	93	0.003807939918250496	1	1	227	318	5	3	-C
barcode01_consensus_vsearch	1498	A	*/-CA	531	14	2.5%	2	2	93	93	5.608759281149405E-5	1	1	212	319	13	1	-CA
barcode01_consensus_vsearch	1499	C	*/-A	526	7	1.28%	2	2	93	93	0.007659174618154892	1	1	205	321	6	1	-A
barcode01_consensus_vsearch	1508	A	*/+G	540	8	1.43%	2	2	93	93	0.003807048300577348	1	1	227	313	3	5	+G
barcode01_consensus_vsearch	1525	C	*/+G	536	10	1.78%	2	1	93	93	9.367981057926079E-4	1	1	223	313	10	0	+G
barcode01_consensus_vsearch	1526	A	*/-G	530	15	2.68%	2	2	93	93	2.7678914296373578E-5	1	1	218	312	10	5	-G
barcode01_consensus_vsearch	1540	T	*/-C	535	23	4.09%	2	2	93	93	9.458484309106015E-8	1	1	212	323	22	1	-C
barcode01_consensus_vsearch	1542	C	*/+G	547	10	1.77%	2	1	93	93	9.375741446597724E-4	1	1	235	312	0	10	+G
barcode01_consensus_vsearch	1545	A	*/-GA	548	8	1.42%	2	1	93	93	0.003808467237244324	1	1	224	324	8	0	-GA
barcode01_consensus_vsearch	1548	C	*/+A	551	7	1.24%	2	2	93	93	0.007666019161359943	1	1	231	320	2	5	+A
barcode01_consensus_vsearch	1552	C	*/-G	532	11	1.95%	2	2	93	93	4.639383918277511E-4	1	1	219	313	10	1	-G
barcode01_consensus_vsearch	1553	G	*/-A	540	7	1.26%	2	2	93	93	0.007663084355008458	1	1	218	322	6	1	-A
barcode01_consensus_vsearch	1557	T	*/+C	491	20	3.54%	2	2	93	93	7.890140618346628E-7	1	1	213	278	16	4	+C
barcode01_consensus_vsearch	1557	T	*/-C	491	46	8.14%	2	2	93	93	5.193241044514875E-15	1	1	213	278	3	43	-C
barcode01_consensus_vsearch	1566	G	*/-CG	531	28	4.97%	2	2	93	93	2.6339329083860277E-9	1	1	228	303	8	20	-CG
barcode01_consensus_vsearch	1570	C	*/-T	551	8	1.42%	2	2	93	93	0.0038089889297735855	1	1	232	319	2	6	-T
barcode01_consensus_vsearch	1575	G	*/-CC	534	20	3.55%	2	1	93	93	8.009197822250914E-7	1	1	210	324	20	0	-CC
barcode01_consensus_vsearch	1587	A	*/+C	500	13	2.31%	2	1	93	93	1.1302785074556576E-4	1	1	218	282	0	13	+C
barcode01_consensus_vsearch	1587	A	*/-C	500	31	5.51%	2	2	93	93	2.9666190519248394E-10	1	1	218	282	6	25	-C
barcode01_consensus_vsearch	1594	C	*/-G	523	23	4.1%	2	1	93	93	9.409492862523217E-8	1	1	231	292	0	23	-G
barcode01_consensus_vsearch	1603	T	*/+C	515	10	1.79%	2	2	93	93	9.352274155228977E-4	1	1	217	298	1	9	+C
barcode01_consensus_vsearch	1603	T	*/-C	515	22	3.94%	2	2	93	93	1.9143249139352642E-7	1	1	217	298	18	4	-C
barcode01_consensus_vsearch	1605	C	*/+T	543	9	1.6%	2	1	93	93	0.0018899844947723675	1	1	233	310	0	9	+T
barcode01_consensus_vsearch	1607	A	*/+G	507	10	1.81%	2	2	93	93	9.345959247019007E-4	1	1	185	322	8	2	+G
barcode01_consensus_vsearch	1607	A	*/-G	507	31	5.62%	2	2	93	93	2.984589072645603E-10	1	1	185	322	29	2	-G
barcode01_consensus_vsearch	1617	T	*/+A	459	33	5.91%	2	2	93	93	6.682939915769552E-11	1	1	177	282	27	6	+A
barcode01_consensus_vsearch	1617	T	*/+AA	459	8	1.43%	2	2	93	93	0.0037899629824653274	1	1	177	282	7	1	+A
barcode01_consensus_vsearch	1617	T	*/-A	459	28	5.02%	2	2	93	93	2.4985801206416047E-9	1	1	177	282	19	9	-A
barcode01_consensus_vsearch	1617	T	*/-AA	459	11	1.97%	2	2	93	93	4.6022648896240235E-4	1	1	177	282	3	8	-A
barcode01_consensus_vsearch	1620	A	*/-G	545	11	1.95%	2	1	93	93	4.6449877293201324E-4	1	1	218	327	11	0	-G
barcode01_consensus_vsearch	1624	C	*/-AC	545	10	1.77%	2	2	93	93	9.374353074031662E-4	1	1	226	319	6	4	-AC
barcode01_consensus_vsearch	1625	A	*/-C	536	8	1.45%	2	2	93	93	0.003806323277364471	1	1	221	315	5	3	-C
barcode01_consensus_vsearch	1628	C	*/+A	494	7	1.24%	2	2	93	93	0.007649420889133695	1	1	176	318	6	1	+A
barcode01_consensus_vsearch	1628	C	*/-A	494	51	9.03%	2	2	93	93	1.3018957363939387E-16	1	1	176	318	49	2	-A
barcode01_consensus_vsearch	1634	G	*/-C	539	13	2.32%	2	2	93	93	1.1365123014973769E-4	1	1	225	314	5	8	-C
barcode01_consensus_vsearch	1642	A	*/-C	546	8	1.43%	2	2	93	93	0.00380811632202169	1	1	230	316	3	5	-C
barcode01_consensus_vsearch	1650	G	*/+C	541	10	1.79%	2	2	93	93	9.371546456216187E-4	1	1	223	318	8	2	+C
barcode01_consensus_vsearch	1653	C	*/-T	541	14	2.48%	2	2	93	93	5.617414610812759E-5	1	1	232	309	3	11	-T
barcode01_consensus_vsearch	1657	T	*/-C	539	10	1.77%	2	2	93	93	9.370127995938237E-4	1	1	215	324	9	1	-C
barcode01_consensus_vsearch	1657	T	*/-CC	539	12	2.13%	2	1	93	93	2.2980257902033605E-4	1	1	215	324	12	0	-CC
barcode01_consensus_vsearch	1679	G	*/-T	544	13	2.3%	2	1	93	93	1.1372499157560235E-4	1	1	220	324	13	0	-T
barcode01_consensus_vsearch	1685	A	*/-C	545	10	1.77%	2	2	93	93	9.374353074031662E-4	1	1	223	322	7	3	-C
barcode01_consensus_vsearch	1689	A	*/+T	473	7	1.24%	2	2	93	93	0.007642316239083064	1	1	161	312	4	3	+T
barcode01_consensus_vsearch	1689	A	*/-T	473	69	12.21%	2	2	93	93	1.6782810554417848E-22	1	1	161	312	58	11	-T
barcode01_consensus_vsearch	1697	T	*/+A	545	8	1.43%	2	1	93	93	0.003807939918250496	1	1	224	321	8	0	+A
barcode01_consensus_vsearch	1703	C	*/+T	511	28	4.97%	2	2	93	93	2.599385613027195E-9	1	1	201	310	23	5	+T
barcode01_consensus_vsearch	1703	C	*/-T	511	19	3.37%	2	2	93	93	1.6185315161337239E-6	1	1	201	310	13	6	+T
barcode01_consensus_vsearch	1711	C	*/-T	505	50	8.9%	2	2	93	93	2.7967763464503155E-16	1	1	227	278	4	46	-T
barcode01_consensus_vsearch	1714	T	*/+C	446	21	3.72%	2	2	93	93	3.7889941306942195E-7	1	1	222	224	5	16	+C
barcode01_consensus_vsearch	1714	T	*/-C	446	69	12.21%	2	2	93	93	1.4736046769622155E-22	1	1	222	224	10	59	-C
barcode01_consensus_vsearch	1714	T	*/-CC	446	16	2.83%	2	2	93	93	1.3370669320085908E-5	1	1	222	224	1	15	-C
barcode01_consensus_vsearch	1731	G	*/-TG	533	24	4.25%	2	2	93	93	4.627579610948728E-8	1	1	217	316	16	8	-TG
barcode01_consensus_vsearch	1760	C	*/+T	542	7	1.24%	2	1	93	93	0.0076636266713165585	1	1	233	309	0	7	+T
barcode01_consensus_vsearch	1760	C	*/-T	542	10	1.78%	2	2	93	93	9.372251878177806E-4	1	1	233	309	1	9	-T
barcode01_consensus_vsearch	1762	T	*/-A	545	11	1.96%	2	2	93	93	4.6449877293201324E-4	1	1	226	319	7	4	-A
barcode01_consensus_vsearch	1763	A	*/+G	537	14	2.53%	2	1	93	93	5.6139890539508915E-5	1	1	229	308	0	14	+G
barcode01_consensus_vsearch	1764	G	*/-A	542	13	2.3%	2	2	93	93	1.1369564258376639E-4	1	1	220	322	12	1	-A
barcode01_consensus_vsearch	1769	T	*/-C	548	7	1.24%	2	1	93	93	0.007665230254675653	1	1	236	312	0	7	-C
barcode01_consensus_vsearch	1772	C	*/-T	542	12	2.15%	2	2	93	93	2.2987870123184875E-4	1	1	233	309	2	10	-T
barcode01_consensus_vsearch	1774	A	*/-C	535	19	3.36%	2	2	93	93	1.6302834445702359E-6	1	1	233	302	3	16	-C
barcode01_consensus_vsearch	1775	C	*/+T	527	8	1.47%	2	1	93	93	0.003804652581188002	1	1	228	299	0	8	+T
barcode01_consensus_vsearch	1776	C	*/-TC	533	15	2.66%	2	2	93	93	2.7693911463208213E-5	1	1	231	302	2	13	-TC
barcode01_consensus_vsearch	1777	T	*/+C	508	11	2.03%	2	2	93	93	4.628313229335904E-4	1	1	214	294	7	4	+C
barcode01_consensus_vsearch	1777	T	*/-C	508	13	2.4%	2	2	93	93	1.1316313332709738E-4	1	1	214	294	8	5	-C
barcode01_consensus_vsearch	1797	C	*/+A	496	27	4.82%	2	2	93	93	5.280215250363931E-9	1	1	230	266	1	26	+A
barcode01_consensus_vsearch	1797	C	*/-A	496	31	5.54%	2	2	93	93	2.9561797023301876E-10	1	1	230	266	5	26	-A
barcode01_consensus_vsearch	1816	G	*/-AG	546	11	1.95%	2	1	93	93	4.6454081261780003E-4	1	1	220	326	11	0	-AG
barcode01_consensus_vsearch	1821	C	*/+T	548	8	1.42%	2	1	93	93	0.003808467237244324	1	1	235	313	0	8	+T
barcode01_consensus_vsearch	1826	C	*/+G	513	26	4.61%	2	1	93	93	1.0942129255863541E-8	1	1	189	324	26	0	+G
barcode01_consensus_vsearch	1826	C	*/-A	513	20	3.55%	2	1	93	93	7.95327670110173E-7	1	1	189	324	20	0	+G
barcode01_consensus_vsearch	1827	A	*/-T	508	25	4.6%	2	1	93	93	2.2343014934175096E-8	1	1	186	322	25	0	-T
barcode01_consensus_vsearch	1833	G	*/-CG	551	11	1.95%	2	2	93	93	4.647488016251458E-4	1	1	234	317	4	7	-CG
barcode01_consensus_vsearch	1854	A	*/+G	535	7	1.24%	2	1	93	93	0.00766171111974148	1	1	229	306	0	7	+G
barcode01_consensus_vsearch	1854	A	*/-G	535	12	2.12%	2	1	93	93	2.296998100207781E-4	1	1	229	306	0	12	-G
barcode01_consensus_vsearch	1857	A	*/-C	530	26	4.62%	2	1	93	93	1.1048405468771383E-8	1	1	233	297	0	26	-C
barcode01_consensus_vsearch	1863	A	*/-C	494	61	10.82%	2	2	93	93	7.576639822113855E-20	1	1	225	269	10	51	-C
barcode01_consensus_vsearch	1867	T	*/-CT	533	17	3.04%	2	1	93	93	6.729390109352399E-6	1	1	237	296	0	17	-CT
barcode01_consensus_vsearch	1871	A	*/+G	536	7	1.26%	2	2	93	93	0.007661987782401454	1	1	215	321	6	1	+G
barcode01_consensus_vsearch	1879	T	*/-GT	539	12	2.14%	2	1	93	93	2.2980257902033605E-4	1	1	233	306	0	12	-GT
barcode01_consensus_vsearch	1883	T	*/+C	530	17	3.02%	2	2	93	93	6.724687724117377E-6	1	1	210	320	16	1	+C
barcode01_consensus_vsearch	1887	C	*/-G	534	15	2.67%	2	2	93	93	2.769887539390586E-5	1	1	233	301	1	14	-G
barcode01_consensus_vsearch	1891	C	*/-T	546	14	2.5%	2	2	93	93	5.621629760633941E-5	1	1	237	309	1	13	-T
barcode01_consensus_vsearch	1893	T	*/-C	529	26	4.6%	2	2	93	93	1.1042310753818546E-8	1	1	223	306	7	19	-C
barcode01_consensus_vsearch	1895	C	*/-AC	551	8	1.42%	2	1	93	93	0.0038089889297735855	1	1	225	326	8	0	-AC
barcode01_consensus_vsearch	1899	G	*/-C	549	7	1.25%	2	2	93	93	0.007665494166045835	1	1	234	315	2	5	-C
barcode01_consensus_vsearch	1901	C	*/+T	511	16	2.84%	2	2	93	93	1.3593614138575698E-5	1	1	228	283	4	12	+T
barcode01_consensus_vsearch	1901	C	*/-T	511	23	4.08%	2	2	93	93	9.358523142574779E-8	1	1	228	283	1	22	-T
barcode01_consensus_vsearch	1906	C	*/-A	550	9	1.6%	2	2	93	93	0.0018907683786527404	1	1	235	315	2	7	-A
barcode01_consensus_vsearch	1937	C	*/+T	543	9	1.6%	2	1	93	93	0.0018899844947723675	1	1	235	308	0	9	+T
barcode01_consensus_vsearch	1937	C	*/-T	543	8	1.42%	2	2	93	93	0.003807585201342346	1	1	235	308	2	6	+T
barcode01_consensus_vsearch	1938	T	*/+C	534	12	2.16%	2	2	93	93	2.2967388723850522E-4	1	1	225	309	11	1	+C
barcode01_consensus_vsearch	1939	C	*/-G	502	48	8.63%	2	1	93	93	1.2160573361995314E-15	1	1	236	266	0	48	-G
barcode01_consensus_vsearch	1942	A	*/-C	528	30	5.34%	2	2	93	93	6.240237553892686E-10	1	1	224	304	10	20	-C
barcode01_consensus_vsearch	1943	C	*/+T	523	7	1.32%	2	1	93	93	0.0076583100477239955	1	1	225	298	0	7	+T
barcode01_consensus_vsearch	1945	C	*/-G	452	59	10.44%	2	2	93	93	2.934460594242097E-19	1	1	233	219	2	57	-G
barcode01_consensus_vsearch	1945	C	*/-GG	452	47	8.32%	2	1	93	93	2.2802970630088162E-15	1	1	233	219	0	47	-G
barcode01_consensus_vsearch	1953	A	*/+C	480	7	1.26%	2	2	93	93	0.007644752250974145	1	1	200	280	2	5	+C
barcode01_consensus_vsearch	1953	A	*/-C	480	40	7.19%	2	2	93	93	4.1699596697263154E-13	1	1	200	280	16	24	-C
barcode01_consensus_vsearch	1953	A	*/-CC	480	15	2.7%	2	2	93	93	2.7403255204375622E-5	1	1	200	280	6	9	-C
barcode01_consensus_vsearch	1957	C	*/-A	494	27	4.79%	2	2	93	93	5.273057047564391E-9	1	1	224	270	4	23	-A
barcode01_consensus_vsearch	1971	A	*/-CA	512	45	7.96%	2	2	93	93	1.125958796752762E-14	1	1	218	294	17	28	-CA
barcode01_consensus_vsearch	1976	G	*/-A	554	7	1.25%	2	2	93	93	0.007666799661120067	1	1	232	322	6	1	-A
barcode01_consensus_vsearch	1983	T	*/-C	511	37	6.58%	2	2	93	93	3.880068490431651E-12	1	1	192	319	32	5	-C
barcode01_consensus_vsearch	1986	C	*/-GC	523	17	3.01%	2	1	93	93	6.7135223117542484E-6	1	1	220	303	17	0	-GC
barcode01_consensus_vsearch	1991	C	*/-A	544	13	2.31%	2	1	93	93	1.1372499157560235E-4	1	1	218	326	13	0	-A
barcode01_consensus_vsearch	1994	T	*/-C	541	17	3.02%	2	1	93	93	6.741694397707556E-6	1	1	235	306	0	17	-C
barcode01_consensus_vsearch	2004	T	*/+G	530	8	1.44%	2	1	93	93	0.0038052156524719656	1	1	229	301	0	8	+G
barcode01_consensus_vsearch	2005	G	*/-A	542	16	2.84%	2	2	93	93	1.3682405604174076E-5	1	1	216	326	15	1	-A
barcode01_consensus_vsearch	2006	A	*/+G	481	11	2.01%	2	2	93	93	4.61459050447595E-4	1	1	168	313	9	2	+G
barcode01_consensus_vsearch	2006	A	*/-G	481	46	8.42%	2	2	93	93	5.09052662347079E-15	1	1	168	313	35	11	-G
barcode01_consensus_vsearch	2011	A	*/-T	535	13	2.3%	2	1	93	93	1.1359127591436588E-4	1	1	236	299	0	13	-T
barcode01_consensus_vsearch	2011	A	*/-TC	535	12	2.12%	2	1	93	93	2.296998100207781E-4	1	1	236	299	0	12	-T
barcode01_consensus_vsearch	2012	T	*/+C	502	7	1.3%	2	2	93	93	0.007651973836625606	1	1	211	291	3	4	+C
barcode01_consensus_vsearch	2012	T	*/-C	502	30	5.56%	2	2	93	93	6.115861416138716E-10	1	1	211	291	24	6	-C
barcode01_consensus_vsearch	2015	T	*/-G	520	25	4.49%	2	1	93	93	2.248849005473451E-8	1	1	236	284	0	25	-G
barcode01_consensus_vsearch	2019	T	*/+A	526	7	1.25%	2	1	93	93	0.007659174618154892	1	1	231	295	0	7	+A
barcode01_consensus_vsearch	2019	T	*/+G	526	9	1.61%	2	2	93	93	0.0018879961490473396	1	1	231	295	5	4	+G
barcode01_consensus_vsearch	2019	T	*/-A	526	11	1.96%	2	1	93	93	4.636707514459565E-4	1	1	231	295	0	11	-A
barcode01_consensus_vsearch	2020	A	*/-G	520	13	2.36%	2	2	93	93	1.1335863736764801E-4	1	1	226	294	5	8	-G
barcode01_consensus_vsearch	2021	G	*/+T	524	10	1.81%	2	2	93	93	9.35915507459734E-4	1	1	218	306	8	2	+T
barcode01_consensus_vsearch	2024	T	*/-CT	534	8	1.42%	2	1	93	93	0.003805956777213485	1	1	233	301	0	8	-CT
barcode01_consensus_vsearch	2024	T	*/-CTT	534	8	1.42%	2	1	93	93	0.003805956777213485	1	1	233	301	0	8	-CT
barcode01_consensus_vsearch	2025	C	*/+T	448	32	5.9%	2	2	93	93	1.364576160859697E-10	1	1	214	234	11	21	+T
barcode01_consensus_vsearch	2025	C	*/+TT	448	9	1.66%	2	2	93	93	0.0018769967833365436	1	1	214	234	1	8	+T
barcode01_consensus_vsearch	2025	C	*/-T	448	46	8.49%	2	2	93	93	4.737152745001445E-15	1	1	214	234	10	36	-T
barcode01_consensus_vsearch	2025	C	*/-TT	448	7	1.29%	2	2	93	93	0.00763300706774014	1	1	214	234	1	6	-T
barcode01_consensus_vsearch	2029	T	*/-C	542	14	2.48%	2	2	93	93	5.6182635264271E-5	1	1	235	307	1	13	-C
barcode01_consensus_vsearch	2050	T	*/-A	542	7	1.24%	2	2	93	93	0.0076636266713165585	1	1	228	314	2	5	-A
barcode01_consensus_vsearch	2053	G	*/+T	542	12	2.14%	2	1	93	93	2.2987870123184875E-4	1	1	232	310	0	12	+T
barcode01_consensus_vsearch	2054	T	*/+C	539	11	1.96%	2	1	93	93	4.6424337523153793E-4	1	1	220	319	11	0	+C
barcode01_consensus_vsearch	2055	C	*/-T	538	19	3.38%	2	2	93	93	1.6316856754432163E-6	1	1	228	310	5	14	-T
barcode01_consensus_vsearch	2059	C	*/+G	522	10	1.78%	2	1	93	93	9.357645849939003E-4	1	1	225	297	0	10	+G
barcode01_consensus_vsearch	2059	C	*/-G	522	14	2.5%	2	2	93	93	5.600701822831767E-5	1	1	225	297	2	12	-G
barcode01_consensus_vsearch	2062	G	*/+T	534	11	1.95%	2	1	93	93	4.6402631662478475E-4	1	1	216	318	11	0	+T
barcode01_consensus_vsearch	2066	T	*/+C	533	19	3.36%	2	2	93	93	1.6293406890487803E-6	1	1	209	324	18	1	+C
barcode01_consensus_vsearch	2066	T	*/-C	533	11	1.95%	2	1	93	93	4.6398243374788086E-4	1	1	209	324	11	0	+C
barcode01_consensus_vsearch	2068	C	*/-T	549	10	1.77%	2	2	93	93	9.37712000234479E-4	1	1	231	318	4	6	-T
barcode01_consensus_vsearch	2070	A	*/+C	475	10	1.79%	2	2	93	93	9.318644876872256E-4	1	1	172	303	3	7	+C
barcode01_consensus_vsearch	2070	A	*/-C	475	59	10.54%	2	2	93	93	3.1822396496548614E-19	1	1	172	303	45	14	-C
barcode01_consensus_vsearch	2070	A	*/-CC	475	8	1.43%	2	2	93	93	0.0037937889200904415	1	1	172	303	6	2	-C
barcode01_consensus_vsearch	2086	G	*/-CG	542	14	2.48%	2	2	93	93	5.6182635264271E-5	1	1	228	314	1	13	-CG
barcode01_consensus_vsearch	2105	T	*/-A	539	14	2.49%	2	2	93	93	5.6157078426883895E-5	1	1	230	309	3	11	-A
barcode01_consensus_vsearch	2107	A	*/-G	545	7	1.25%	2	2	93	93	0.007664432804486939	1	1	234	311	3	4	-G
barcode01_consensus_vsearch	2114	C	*/-T	548	9	1.59%	2	2	93	93	0.0018905464048331274	1	1	235	313	1	8	-T
barcode01_consensus_vsearch	2124	C	*/+A	515	32	5.72%	2	1	93	93	1.4597268565571893E-10	1	1	193	322	32	0	+A
barcode01_consensus_vsearch	2125	G	*/-A	519	28	5.06%	2	1	93	93	2.6134605029929772E-9	1	1	199	320	28	0	-A
barcode01_consensus_vsearch	2126	A	*/-G	523	9	1.68%	2	2	93	93	0.0018876321934375318	1	1	202	321	6	3	-G
barcode01_consensus_vsearch	2129	T	*/-C	546	7	1.25%	2	2	93	93	0.0076646995790388295	1	1	229	317	1	6	-C
barcode01_consensus_vsearch	2133	C	*/+T	520	7	1.25%	2	1	93	93	0.0076574356719944486	1	1	199	321	7	0	+T
barcode01_consensus_vsearch	2133	C	*/+TT	520	9	1.6%	2	1	93	93	0.0018872641475916499	1	1	199	321	9	0	+TT
barcode01_consensus_vsearch	2133	C	*/-AC	520	17	3.02%	2	1	93	93	6.708652441435347E-6	1	1	199	321	17	0	-AC
barcode01_consensus_vsearch	2134	A	*/-C	493	28	5.15%	2	2	93	93	2.566394267481016E-9	1	1	179	314	23	5	-C
barcode01_consensus_vsearch	2135	C	*/+T	499	9	1.74%	2	1	93	93	0.0018845672715538187	1	1	189	310	0	9	+T
barcode01_consensus_vsearch	2136	C	*/+T	526	8	1.43%	2	2	93	93	0.003804463493552888	1	1	213	313	1	7	+T
barcode01_consensus_vsearch	2140	T	*/+C	546	13	2.3%	2	1	93	93	1.1375413566253189E-4	1	1	222	324	13	0	+C
barcode01_consensus_vsearch	2141	C	*/-A	538	14	2.48%	2	2	93	93	5.6148499588288346E-5	1	1	224	314	3	11	-A
barcode01_consensus_vsearch	2143	A	*/-G	543	14	2.49%	2	2	93	93	5.619109483854551E-5	1	1	230	313	6	8	-G
barcode01_consensus_vsearch	2145	C	*/-AC	533	14	2.51%	2	1	93	93	5.6105149032658256E-5	1	1	218	315	14	0	-AC
barcode01_consensus_vsearch	2151	T	*/+C	531	18	3.22%	2	1	93	93	3.3110125246247506E-6	1	1	215	316	18	0	+C
barcode01_consensus_vsearch	2152	C	*/-G	517	32	5.72%	2	1	93	93	1.4622859949042457E-10	1	1	229	288	0	32	-G
barcode01_consensus_vsearch	2157	T	*/+C	544	10	1.77%	2	2	93	93	9.373655173650468E-4	1	1	237	307	1	9	+C
barcode01_consensus_vsearch	2159	T	*/+G	517	36	6.39%	2	2	93	93	8.077680866528898E-12	1	1	231	286	4	32	+G
barcode01_consensus_vsearch	2162	A	*/-G	549	9	1.6%	2	2	93	93	0.001890657588920399	1	1	230	319	3	6	-G
barcode01_consensus_vsearch	2167	C	*/-T	525	34	6.03%	2	1	93	93	3.4696740057395264E-11	1	1	236	289	0	34	-T
barcode01_consensus_vsearch	2168	T	*/-C	504	16	3.02%	2	2	93	93	1.357216392776547E-5	1	1	222	282	7	9	-C
barcode01_consensus_vsearch	2177	A	*/+G	536	17	3.02%	2	1	93	93	6.73404392961064E-6	1	1	233	303	0	17	+G
barcode01_consensus_vsearch	2184	A	*/+G	549	7	1.25%	2	1	93	93	0.007665494166045835	1	1	233	316	0	7	+G
barcode01_consensus_vsearch	2195	C	*/+G	549	10	1.77%	2	1	93	93	9.37712000234479E-4	1	1	223	326	10	0	+G
barcode01_consensus_vsearch	2196	A	*/-G	533	12	2.12%	2	2	93	93	2.2964787124895103E-4	1	1	219	314	7	5	-G
barcode01_consensus_vsearch	2197	G	*/+A	519	8	1.45%	2	2	93	93	0.003803119913505049	1	1	218	301	5	3	+A
barcode01_consensus_vsearch	2198	G	*/+C	501	8	1.42%	2	1	93	93	0.003799496405528544	1	1	203	298	8	0	+C
barcode01_consensus_vsearch	2198	G	*/-CG	501	7	1.24%	2	1	93	93	0.007651659097839623	1	1	203	298	0	7	+C
barcode01_consensus_vsearch	2199	C	*/+T	518	7	1.26%	2	1	93	93	0.007656847224773479	1	1	222	296	7	0	+T
barcode01_consensus_vsearch	2215	T	*/+C	553	8	1.42%	2	1	93	93	0.00380933364327884	1	1	229	324	8	0	+C
barcode01_consensus_vsearch	2216	C	*/-T	552	7	1.24%	2	2	93	93	0.007666280255386365	1	1	237	315	1	6	-T
barcode01_consensus_vsearch	2217	T	*/+A	510	11	1.97%	2	2	93	93	4.629274092769525E-4	1	1	199	311	10	1	+A
barcode01_consensus_vsearch	2217	T	*/-A	510	23	4.12%	2	1	93	93	9.35418262974563E-8	1	1	199	311	23	0	-A
barcode01_consensus_vsearch	2219	A	*/-G	542	12	2.13%	2	1	93	93	2.2987870123184875E-4	1	1	220	322	12	0	-G
barcode01_consensus_vsearch	2220	G	*/+A	532	16	2.9%	2	1	93	93	1.3654814810178322E-5	1	1	205	327	16	0	+A
barcode01_consensus_vsearch	2221	A	*/-GA	539	13	2.31%	2	2	93	93	1.1365123014973769E-4	1	1	217	322	12	1	-GA
barcode01_consensus_vsearch	2227	C	*/+G	546	7	1.25%	2	1	93	93	0.0076646995790388295	1	1	233	313	0	7	+G
barcode01_consensus_vsearch	2230	T	*/-C	498	62	10.97%	2	1	93	93	3.629447147652552E-20	1	1	173	325	62	0	-C
barcode01_consensus_vsearch	2237	G	*/-A	549	7	1.25%	2	1	93	93	0.007665494166045835	1	1	223	326	7	0	-A
barcode01_consensus_vsearch	2238	A	*/-G	543	7	1.26%	2	1	93	93	0.007663896355890601	1	1	225	318	0	7	-G
barcode01_consensus_vsearch	2243	C	*/+G	523	25	4.43%	2	2	93	93	2.252398312148111E-8	1	1	231	292	1	24	+G
barcode01_consensus_vsearch	2245	A	*/+G	525	12	2.15%	2	1	93	93	2.2943632667974108E-4	1	1	227	298	0	12	+G
barcode01_consensus_vsearch	2245	A	*/-G	525	12	2.15%	2	2	93	93	2.2943632667974108E-4	1	1	227	298	3	9	+G
barcode01_consensus_vsearch	2249	C	*/-T	488	17	3.04%	2	1	93	93	6.65329653708951E-6	1	1	236	252	0	17	-T
barcode01_consensus_vsearch	2250	T	*/-C	378	162	29.72%	2	2	93	93	1.0834104395241945E-55	1	1	173	205	61	101	-C
barcode01_consensus_vsearch	2252	C	*/+G	513	10	1.78%	2	2	93	93	9.350713309727379E-4	1	1	228	285	1	9	+G
barcode01_consensus_vsearch	2256	C	*/-T	553	9	1.59%	2	1	93	93	0.0018910984026092464	1	1	236	317	0	9	-T
barcode01_consensus_vsearch	2257	T	*/+C	537	9	1.62%	2	1	93	93	0.0018892967385001622	1	1	227	310	9	0	+C
barcode01_consensus_vsearch	2262	T	*/-C	553	9	1.59%	2	2	93	93	0.0018910984026092464	1	1	230	323	7	2	-C
barcode01_consensus_vsearch	2264	C	*/-T	533	27	4.78%	2	2	93	93	5.404721695387506E-9	1	1	231	302	4	23	-T
barcode01_consensus_vsearch	2268	T	*/+A	431	24	4.35%	2	2	93	93	4.365685995159142E-8	1	1	152	279	12	12	+A
barcode01_consensus_vsearch	2268	T	*/-A	431	65	11.78%	2	2	93	93	2.8729010166222694E-21	1	1	152	279	47	18	-A
barcode01_consensus_vsearch	2268	T	*/-AA	431	15	2.72%	2	2	93	93	2.70757726321695E-5	1	1	152	279	12	3	-A
barcode01_consensus_vsearch	2272	A	*/-G	528	25	4.44%	2	2	93	93	2.2582384399223936E-8	1	1	211	317	20	5	-G
barcode01_consensus_vsearch	2273	G	*/+C	520	8	1.49%	2	1	93	93	0.0038033140209771956	1	1	211	309	0	8	+C
barcode01_consensus_vsearch	2276	C	*/-T	550	7	1.24%	2	2	93	93	0.007665757133253386	1	1	234	316	1	6	-T
barcode01_consensus_vsearch	2277	T	*/+C	452	13	2.35%	2	2	93	93	1.121212624491629E-4	1	1	199	253	6	7	+C
barcode01_consensus_vsearch	2277	T	*/-C	452	67	12.12%	2	2	93	93	6.947410367926697E-22	1	1	199	253	10	57	-C
barcode01_consensus_vsearch	2277	T	*/-CC	452	19	3.44%	2	1	93	93	1.584924340620726E-6	1	1	199	253	19	0	-C
barcode01_consensus_vsearch	2283	A	*/-G	532	15	2.66%	2	2	93	93	2.768893003185188E-5	1	1	216	316	14	1	-G
barcode01_consensus_vsearch	2284	G	*/+A	530	7	1.29%	2	1	93	93	0.007660312408999644	1	1	209	321	7	0	+A
barcode01_consensus_vsearch	2297	G	*/+C	541	11	1.96%	2	1	93	93	4.643291149889421E-4	1	1	232	309	0	11	+C
barcode01_consensus_vsearch	2300	C	*/+A	454	19	3.39%	2	2	93	93	1.586190748504768E-6	1	1	163	291	8	11	+A
barcode01_consensus_vsearch	2300	C	*/-A	454	75	13.39%	2	2	93	93	1.5710501748727945E-24	1	1	163	291	64	11	-A
barcode01_consensus_vsearch	2303	A	*/+G	464	9	1.6%	2	2	93	93	0.0018795457786723107	1	1	185	279	7	2	+G
barcode01_consensus_vsearch	2303	A	*/-G	464	39	6.94%	2	2	93	93	8.4551242098176E-13	1	1	185	279	23	16	-G
barcode01_consensus_vsearch	2303	A	*/-GG	464	29	5.16%	2	2	93	93	1.2188578298184865E-9	1	1	185	279	4	25	-G
barcode01_consensus_vsearch	2321	G	*/+T	552	7	1.24%	2	2	93	93	0.007666280255386365	1	1	231	321	5	2	+T
barcode01_consensus_vsearch	2325	A	*/+G	470	20	3.55%	2	2	93	93	7.825008890635863E-7	1	1	222	248	3	17	+G
barcode01_consensus_vsearch	2325	A	*/-G	470	63	11.17%	2	2	93	93	1.5464802260618644E-20	1	1	222	248	3	60	-G
barcode01_consensus_vsearch	2330	G	*/-CG	547	9	1.59%	2	2	93	93	0.0018904348242880168	1	1	234	313	1	8	-CG
barcode01_consensus_vsearch	2340	G	*/-CG	541	8	1.43%	2	1	93	93	0.003807227915540985	1	1	228	313	0	8	-CG
barcode01_consensus_vsearch	2367	T	*/-A	530	17	3.04%	2	1	93	93	6.724687724117377E-6	1	1	232	298	0	17	-A
barcode01_consensus_vsearch	2369	A	*/-G	531	16	2.85%	2	2	93	93	1.3652002573616156E-5	1	1	235	296	1	15	-G
barcode01_consensus_vsearch	2374	T	*/-G	543	8	1.42%	2	1	93	93	0.003807585201342346	1	1	234	309	0	8	-G
barcode01_consensus_vsearch	2378	C	*/-T	550	7	1.24%	2	2	93	93	0.007665757133253386	1	1	233	317	1	6	-T
barcode01_consensus_vsearch	2380	T	*/+G	538	11	1.95%	2	1	93	93	4.642002747990287E-4	1	1	232	306	0	11	+G
barcode01_consensus_vsearch	2381	G	*/-C	545	9	1.61%	2	1	93	93	0.001890210465296116	1	1	233	312	0	9	-C
barcode01_consensus_vsearch	2386	T	*/+C	549	11	1.95%	2	1	93	93	4.646660447990897E-4	1	1	225	324	11	0	+C
barcode01_consensus_vsearch	2387	C	*/-A	548	8	1.42%	2	2	93	93	0.003808467237244324	1	1	229	319	7	1	-A
barcode01_consensus_vsearch	2388	A	*/-CA	527	13	2.34%	2	1	93	93	1.1346876988055956E-4	1	1	208	319	13	0	-CA
barcode01_consensus_vsearch	2430	G	*/-TG	521	40	7.09%	2	1	93	93	4.423825884492958E-13	1	1	236	285	0	40	-TG
barcode01_consensus_vsearch	2434	C	*/+A	518	24	4.26%	2	1	93	93	4.5945580835539886E-8	1	1	204	314	24	0	+A
barcode01_consensus_vsearch	2434	C	*/-A	518	9	1.6%	2	2	93	93	0.001887016477158895	1	1	204	314	1	8	+A
barcode01_consensus_vsearch	2436	A	*/+G	480	18	3.21%	2	2	93	93	3.2624917395063744E-6	1	1	214	266	8	10	+G
barcode01_consensus_vsearch	2436	A	*/-G	480	52	9.27%	2	2	93	93	5.990043328611715E-17	1	1	214	266	13	39	-G
barcode01_consensus_vsearch	2458	T	*/+A	434	7	1.25%	2	2	93	93	0.007627335039353406	1	1	161	273	2	5	+A
barcode01_consensus_vsearch	2458	T	*/-A	434	89	15.89%	2	2	93	93	2.689107941744591E-29	1	1	161	273	62	27	-A
barcode01_consensus_vsearch	2458	T	*/-AA	434	23	4.11%	2	2	93	93	8.975280584142565E-8	1	1	161	273	10	13	-A
barcode01_consensus_vsearch	2464	G	*/+T	551	9	1.59%	2	2	93	93	0.0018908787761269387	1	1	234	317	1	8	+T
barcode01_consensus_vsearch	2484	A	*/+C	548	7	1.24%	2	1	93	93	0.007665230254675653	1	1	230	318	0	7	+C
barcode01_consensus_vsearch	2486	T	*/+C	523	24	4.29%	2	2	93	93	4.605744447814724E-8	1	1	230	293	5	19	+C
barcode01_consensus_vsearch	2486	T	*/-C	523	7	1.25%	2	2	93	93	0.0076583100477239955	1	1	230	293	1	6	+C
barcode01_consensus_vsearch	2487	C	*/-A	531	12	2.16%	2	1	93	93	2.2959555763000012E-4	1	1	220	311	12	0	-A
barcode01_consensus_vsearch	2493	G	*/+C	530	7	1.24%	2	1	93	93	0.007660312408999644	1	1	213	317	7	0	+C
barcode01_consensus_vsearch	2493	G	*/-CG	530	14	2.49%	2	2	93	93	5.607876775587383E-5	1	1	213	317	10	4	-CG
barcode01_consensus_vsearch	2503	C	*/-T	544	11	1.96%	2	2	93	93	4.6445658412336564E-4	1	1	236	308	1	10	-T
barcode01_consensus_vsearch	2512	G	*/-TG	518	30	5.36%	2	2	93	93	6.193543383816422E-10	1	1	229	289	2	28	-TG
barcode01_consensus_vsearch	2516	C	*/-T	555	7	1.24%	2	1	93	93	0.007667057982678975	1	1	238	317	0	7	-T
barcode01_consensus_vsearch	2517	T	*/+C	526	7	1.26%	2	1	93	93	0.007659174618154892	1	1	228	298	7	0	+C
barcode01_consensus_vsearch	2517	T	*/-C	526	11	1.97%	2	1	93	93	4.636707514459565E-4	1	1	228	298	0	11	-C
barcode01_consensus_vsearch	2517	T	*/-CG	526	7	1.26%	2	2	93	93	0.007659174618154892	1	1	228	298	1	6	-C
barcode01_consensus_vsearch	2518	C	*/-G	507	28	5.13%	2	2	93	93	2.592215428144562E-9	1	1	222	285	6	22	-G
barcode01_consensus_vsearch	2520	G	*/-A	546	12	2.13%	2	2	93	93	2.2997894938551927E-4	1	1	228	318	9	3	-A
barcode01_consensus_vsearch	2522	A	*/-G	547	9	1.6%	2	2	93	93	0.0018904348242880168	1	1	229	318	7	2	-G
barcode01_consensus_vsearch	2532	G	*/-A	550	13	2.3%	2	1	93	93	1.1381181764247677E-4	1	1	224	326	13	0	-A
barcode01_consensus_vsearch	2538	C	*/+G	544	8	1.43%	2	1	93	93	0.0038077628791647437	1	1	221	323	8	0	+G
barcode01_consensus_vsearch	2539	A	*/-G	520	14	2.5%	2	2	93	93	5.5988755288454006E-5	1	1	208	312	7	7	-G
barcode01_consensus_vsearch	2541	G	*/+T	496	8	1.42%	2	2	93	93	0.003798444244463843	1	1	185	311	6	2	+T
barcode01_consensus_vsearch	2541	G	*/-T	496	52	9.22%	2	2	93	93	6.235580718409024E-17	1	1	185	311	43	9	-T
barcode01_consensus_vsearch	2546	A	*/-C	538	16	2.84%	2	2	93	93	1.3671483862754112E-5	1	1	234	304	2	14	-C
barcode01_consensus_vsearch	2548	C	*/-TC	536	16	2.83%	2	1	93	93	1.3665966101390013E-5	1	1	237	299	0	16	-TC
barcode01_consensus_vsearch	2553	T	*/+C	533	23	4.09%	2	1	93	93	9.45045157243975E-8	1	1	214	319	23	0	+C
barcode01_consensus_vsearch	2555	A	*/+G	536	11	1.96%	2	2	93	93	4.6411360868119984E-4	1	1	227	309	4	7	+G
barcode01_consensus_vsearch	2557	A	*/+G	428	11	1.97%	2	2	93	93	4.5828417992626897E-4	1	1	129	299	6	5	+G
barcode01_consensus_vsearch	2557	A	*/-G	428	103	18.46%	2	2	93	93	4.090013380578768E-34	1	1	129	299	93	10	-G
barcode01_consensus_vsearch	2557	A	*/-GG	428	14	2.51%	2	2	93	93	5.49766339423539E-5	1	1	129	299	5	9	-G
barcode01_consensus_vsearch	2564	A	*/-T	530	17	3.04%	2	2	93	93	6.724687724117377E-6	1	1	219	311	9	8	-T
barcode01_consensus_vsearch	2569	T	*/+C	547	9	1.6%	2	2	93	93	0.0018904348242880168	1	1	230	317	1	8	+C
barcode01_consensus_vsearch	2572	T	*/-C	539	7	1.26%	2	1	93	93	0.007662811712528587	1	1	234	305	0	7	-C
barcode01_consensus_vsearch	2575	A	*/-C	552	7	1.24%	2	1	93	93	0.007666280255386365	1	1	226	326	7	0	-C
barcode01_consensus_vsearch	2583	A	*/-CA	539	17	3.01%	2	2	93	93	6.738649932331364E-6	1	1	223	316	13	4	-CA
barcode01_consensus_vsearch	2592	T	*/-C	508	25	4.44%	2	2	93	93	2.2343014934175096E-8	1	1	185	323	24	1	-C
barcode01_consensus_vsearch	2592	T	*/-CC	508	25	4.44%	2	1	93	93	2.2343014934175096E-8	1	1	185	323	25	0	-C
barcode01_consensus_vsearch	2595	C	*/+G	509	20	3.54%	2	1	93	93	7.942158977765082E-7	1	1	225	284	0	20	+G
barcode01_consensus_vsearch	2595	C	*/-G	509	8	1.42%	2	1	93	93	0.0038011378038331415	1	1	225	284	8	0	+G
barcode01_consensus_vsearch	2596	G	*/-A	547	7	1.26%	2	2	93	93	0.0076649653940683155	1	1	221	326	6	1	-A
barcode01_consensus_vsearch	2606	G	*/+A	395	11	1.95%	2	2	93	93	4.558976374421885E-4	1	1	214	181	2	9	+A
barcode01_consensus_vsearch	2606	G	*/-A	395	131	23.23%	2	2	93	93	3.4554778979947665E-44	1	1	214	181	18	113	-A
barcode01_consensus_vsearch	2606	G	*/-AA	395	19	3.37%	2	1	93	93	1.544120237068303E-6	1	1	214	181	0	19	-A
barcode01_consensus_vsearch	2612	G	*/-C	542	17	3.01%	2	1	93	93	6.743208849693524E-6	1	1	234	308	0	17	-C
barcode01_consensus_vsearch	2620	C	*/-A	551	7	1.24%	2	2	93	93	0.007666019161359943	1	1	226	325	6	1	-A
barcode01_consensus_vsearch	2631	A	*/-CTA	550	7	1.24%	2	2	93	93	0.007665757133253386	1	1	227	323	4	3	-CTA
barcode01_consensus_vsearch	2638	T	*/+C	545	10	1.77%	2	2	93	93	9.374353074031662E-4	1	1	224	321	7	3	+C
barcode01_consensus_vsearch	2647	A	*/-G	543	9	1.59%	2	1	93	93	0.0018899844947723675	1	1	222	321	9	0	-G
barcode01_consensus_vsearch	2651	T	*/+C	549	7	1.24%	2	2	93	93	0.007665494166045835	1	1	232	317	3	4	+C
barcode01_consensus_vsearch	2655	C	*/-T	549	9	1.6%	2	2	93	93	0.001890657588920399	1	1	235	314	1	8	-T
barcode01_consensus_vsearch	2658	C	*/+G	539	9	1.6%	2	2	93	93	0.0018895276491797967	1	1	222	317	1	8	+G
barcode01_consensus_vsearch	2658	C	*/-G	539	11	1.96%	2	2	93	93	4.6424337523153793E-4	1	1	222	317	10	1	-G
barcode01_consensus_vsearch	2665	C	*/+T	543	10	1.77%	2	1	93	93	9.372954779492018E-4	1	1	233	310	0	10	+T
barcode01_consensus_vsearch	2675	C	*/+T	535	8	1.42%	2	2	93	93	0.0038061403627091955	1	1	233	302	1	7	+T
barcode01_consensus_vsearch	2678	G	*/-TA	545	11	1.95%	2	2	93	93	4.6449877293201324E-4	1	1	225	320	10	1	-TA
barcode01_consensus_vsearch	2683	T	*/+C	517	9	1.61%	2	2	93	93	0.0018868919421650878	1	1	231	286	2	7	+C
barcode01_consensus_vsearch	2683	T	*/-C	517	15	2.68%	2	2	93	93	2.761204391196279E-5	1	1	231	286	3	12	-C
barcode01_consensus_vsearch	2683	T	*/-CC	517	7	1.25%	2	1	93	93	0.0076565513232377735	1	1	231	286	0	7	-C
barcode01_consensus_vsearch	2683	T	*/-CCT	517	8	1.43%	2	1	93	93	0.003802729494186316	1	1	231	286	0	8	-CCT
barcode01_consensus_vsearch	2685	C	*/-T	530	8	1.47%	2	1	93	93	0.0038052156524719656	1	1	237	293	0	8	-T
barcode01_consensus_vsearch	2687	C	*/-T	530	12	2.18%	2	2	93	93	2.295692589828977E-4	1	1	235	295	1	11	-T
barcode01_consensus_vsearch	2703	G	*/-A	539	14	2.49%	2	2	93	93	5.6157078426883895E-5	1	1	221	318	13	1	-A
barcode01_consensus_vsearch	2710	T	*/+C	523	15	2.7%	2	1	93	93	2.7643294122323196E-5	1	1	234	289	0	15	+C
barcode01_consensus_vsearch	2711	T	*/-C	537	19	3.36%	2	1	93	93	1.631219841459542E-6	1	1	235	302	0	19	-C
barcode01_consensus_vsearch	2712	C	*/+G	528	7	1.28%	2	1	93	93	0.007659745632203721	1	1	234	294	0	7	+G
barcode01_consensus_vsearch	2714	C	*/-T	519	26	4.63%	2	2	93	93	1.0980295613608406E-8	1	1	235	284	1	25	-T
barcode01_consensus_vsearch	2717	C	*/+G	534	7	1.25%	2	1	93	93	0.007661433438157596	1	1	229	305	0	7	+G
barcode01_consensus_vsearch	2717	C	*/-GC	534	7	1.25%	2	2	93	93	0.007661433438157596	1	1	229	305	5	2	+G
barcode01_consensus_vsearch	2720	A	*/-T	548	11	1.95%	2	2	93	93	4.6462444777002886E-4	1	1	235	313	1	10	-T
barcode01_consensus_vsearch	2742	G	*/-CGCG	531	25	4.45%	2	1	93	93	2.261698068654656E-8	1	1	236	295	0	25	-CGCG
barcode01_consensus_vsearch	2744	G	*/-CG	434	91	17.14%	2	2	93	93	5.6235452021317535E-30	1	1	211	223	22	69	-CG
barcode01_consensus_vsearch	2746	G	*/+CG	396	11	2.54%	2	2	93	93	4.5597552073400974E-4	1	1	187	209	3	8	+CG
barcode01_consensus_vsearch	2746	G	*/+T	396	8	1.85%	2	1	93	93	0.0037719767465882576	1	1	187	209	8	0	+CG
barcode01_consensus_vsearch	2748	T	*/-G	535	8	1.42%	2	2	93	93	0.0038061403627091955	1	1	224	311	7	1	-G
barcode01_consensus_vsearch	2749	G	*/-C	518	8	1.45%	2	1	93	93	0.0038029250726284375	1	1	211	307	0	8	-C
barcode01_consensus_vsearch	2750	C	*/-T	524	7	1.27%	2	2	93	93	0.007658599319160323	1	1	231	293	2	5	-T
barcode01_consensus_vsearch	2751	T	*/-C	507	35	6.31%	2	2	93	93	1.6507769662796148E-11	1	1	195	312	30	5	-C
barcode01_consensus_vsearch	2753	C	*/-T	546	8	1.42%	2	2	93	93	0.00380811632202169	1	1	231	315	5	3	-T
barcode01_consensus_vsearch	2765	C	*/+G	540	7	1.25%	2	1	93	93	0.007663084355008458	1	1	233	307	0	7	+G
barcode01_consensus_vsearch	2774	C	*/+G	546	7	1.24%	2	1	93	93	0.0076646995790388295	1	1	234	312	0	7	+G
barcode01_consensus_vsearch	2778	C	*/-G	546	10	1.77%	2	2	93	93	9.375048493952046E-4	1	1	229	317	3	7	-G
barcode01_consensus_vsearch	2790	C	*/-G	548	11	1.95%	2	2	93	93	4.6462444777002886E-4	1	1	236	312	1	10	-G
barcode01_consensus_vsearch	2799	T	*/-GT	504	51	9.06%	2	2	93	93	1.3324264669393242E-16	1	1	223	281	13	38	-GT
barcode01_consensus_vsearch	2803	C	*/+A	443	9	1.6%	2	1	93	93	0.001876163611738018	1	1	132	311	9	0	+A
barcode01_consensus_vsearch	2803	C	*/-A	443	101	17.91%	2	2	93	93	2.3505646548150416E-33	1	1	132	311	94	7	-A
barcode01_consensus_vsearch	2806	A	*/-G	524	17	3.01%	2	2	93	93	6.715134190482123E-6	1	1	219	305	8	9	-G
barcode01_consensus_vsearch	2811	A	*/+G	422	18	3.23%	2	2	93	93	3.1945872707708225E-6	1	1	207	215	5	13	+G
barcode01_consensus_vsearch	2811	A	*/-G	422	90	16.16%	2	2	93	93	1.104544096439727E-29	1	1	207	215	5	85	-G
barcode01_consensus_vsearch	2815	A	*/+T	544	16	2.83%	2	1	93	93	1.3687810362809956E-5	1	1	237	307	0	16	+T
barcode01_consensus_vsearch	2826	G	*/-TG	545	10	1.78%	2	1	93	93	9.374353074031662E-4	1	1	230	315	0	10	-TG
barcode01_consensus_vsearch	2830	G	*/-T	551	8	1.42%	2	1	93	93	0.0038089889297735855	1	1	236	315	0	8	-T
barcode01_consensus_vsearch	2848	C	*/+A	537	13	2.32%	2	2	93	93	1.1362135934538324E-4	1	1	216	321	12	1	+A
barcode01_consensus_vsearch	2848	C	*/-A	537	8	1.43%	2	2	93	93	0.003806505524841473	1	1	216	321	7	1	+A
barcode01_consensus_vsearch	2850	A	*/-G	537	8	1.42%	2	2	93	93	0.003806505524841473	1	1	224	313	6	2	-G
barcode01_consensus_vsearch	2851	G	*/+A	537	8	1.44%	2	1	93	93	0.003806505524841473	1	1	215	322	8	0	+A
barcode01_consensus_vsearch	2854	A	*/+T	535	7	1.25%	2	2	93	93	0.00766171111974148	1	1	226	309	1	6	+T
barcode01_consensus_vsearch	2854	A	*/-T	535	7	1.25%	2	2	93	93	0.00766171111974148	1	1	226	309	3	4	+T
barcode01_consensus_vsearch	2855	T	*/+C	535	11	1.99%	2	2	93	93	4.640700413183075E-4	1	1	225	310	1	10	+C
barcode01_consensus_vsearch	2856	T	*/-C	530	19	3.39%	2	2	93	93	1.627914491273952E-6	1	1	226	304	6	13	-C
barcode01_consensus_vsearch	2876	T	*/-C	540	19	3.37%	2	1	93	93	1.6326126540539844E-6	1	1	218	322	19	0	-C
barcode01_consensus_vsearch	2882	G	*/+C	548	8	1.42%	2	1	93	93	0.003808467237244324	1	1	233	315	0	8	+C
barcode01_consensus_vsearch	2884	T	*/+C	541	7	1.25%	2	2	93	93	0.007663356006147005	1	1	228	313	6	1	+C
barcode01_consensus_vsearch	2884	T	*/-C	541	10	1.78%	2	1	93	93	9.371546456216187E-4	1	1	228	313	0	10	-C
barcode01_consensus_vsearch	2885	C	*/+G	538	9	1.62%	2	1	93	93	0.0018894124030413505	1	1	234	304	0	9	+G
barcode01_consensus_vsearch	2888	T	*/-C	489	64	11.41%	2	2	93	93	7.829176956113781E-21	1	1	212	277	22	42	-C
barcode01_consensus_vsearch	2895	C	*/-AC	536	10	1.79%	2	1	93	93	9.367981057926079E-4	1	1	213	323	10	0	-AC
barcode01_consensus_vsearch	2898	G	*/-A	549	13	2.31%	2	1	93	93	1.1379747226400809E-4	1	1	222	327	13	0	-A
barcode01_consensus_vsearch	2911	A	*/-G	524	9	1.63%	2	2	93	93	0.0018877539630633598	1	1	223	301	1	8	-G
barcode01_consensus_vsearch	2913	G	*/-A	552	10	1.77%	2	1	93	93	9.379169655984871E-4	1	1	225	327	10	0	-A
barcode01_consensus_vsearch	2920	C	*/-G	525	15	2.65%	2	1	93	93	2.7653562132972184E-5	1	1	234	291	0	15	-G
barcode01_consensus_vsearch	2922	G	*/+C	523	19	3.36%	2	2	93	93	1.6245292316757518E-6	1	1	231	292	3	16	+C
barcode01_consensus_vsearch	2922	G	*/-C	523	16	2.83%	2	2	93	93	1.3629145012920972E-5	1	1	231	292	3	13	+C
barcode01_consensus_vsearch	2923	C	*/+T	520	19	3.46%	2	1	93	93	1.6230532240140746E-6	1	1	235	285	0	19	+T
barcode01_consensus_vsearch	2925	C	*/+T	546	10	1.77%	2	1	93	93	9.375048493952046E-4	1	1	238	308	0	10	+T
barcode01_consensus_vsearch	2925	C	*/-T	546	7	1.24%	2	1	93	93	0.0076646995790388295	1	1	238	308	0	7	+T
barcode01_consensus_vsearch	2927	C	*/-T	521	15	2.68%	2	1	93	93	2.763295228280164E-5	1	1	226	295	0	15	-T
barcode01_consensus_vsearch	2927	C	*/-TC	521	19	3.39%	2	2	93	93	1.6235469314922575E-6	1	1	226	295	10	9	-TC
barcode01_consensus_vsearch	2928	T	*/+C	496	17	3.2%	2	1	93	93	6.667749318419835E-6	1	1	201	295	17	0	+C
barcode01_consensus_vsearch	2928	T	*/+CC	496	8	1.51%	2	1	93	93	0.003798444244463843	1	1	201	295	8	0	+C
barcode01_consensus_vsearch	2929	C	*/-G	508	8	1.47%	2	1	93	93	0.003800935394555615	1	1	220	288	0	8	-G
barcode01_consensus_vsearch	2929	C	*/-GG	508	13	2.39%	2	1	93	93	1.1316313332709738E-4	1	1	220	288	0	13	-GG
barcode01_consensus_vsearch	2938	C	*/-A	536	17	3.01%	2	2	93	93	6.73404392961064E-6	1	1	236	300	1	16	-A
barcode01_consensus_vsearch	2969	G	*/-CG	450	97	17.45%	2	2	93	93	5.885375245307471E-32	1	1	193	257	33	64	-CG
barcode01_consensus_vsearch	2971	G	*/+A	430	14	3.03%	2	1	93	93	5.500293094702783E-5	1	1	179	251	14	0	+A
barcode01_consensus_vsearch	2976	G	*/-C	541	12	2.14%	2	2	93	93	2.2985341710330166E-4	1	1	218	323	9	3	-C
barcode01_consensus_vsearch	2980	A	*/-G	540	9	1.6%	2	2	93	93	0.0018896424791788363	1	1	229	311	1	8	-G
barcode01_consensus_vsearch	2988	T	*/-A	544	7	1.25%	2	2	93	93	0.007664165065188001	1	1	230	314	4	3	-A
barcode01_consensus_vsearch	2990	A	*/-G	544	11	1.95%	2	2	93	93	4.6445658412336564E-4	1	1	232	312	4	7	-G
barcode01_consensus_vsearch	3002	A	*/+C	544	9	1.6%	2	2	93	93	0.0018900976825545202	1	1	229	315	3	6	+C
barcode01_consensus_vsearch	3006	G	*/-T	552	9	1.6%	2	2	93	93	0.0018909887834267728	1	1	232	320	5	4	-T
barcode01_consensus_vsearch	3008	T	*/-A	534	13	2.31%	2	1	93	93	1.1357615375318739E-4	1	1	217	317	13	0	-A
barcode01_consensus_vsearch	3011	T	*/-G	534	8	1.44%	2	1	93	93	0.003805956777213485	1	1	224	310	0	8	-G
barcode01_consensus_vsearch	3012	G	*/-C	520	27	4.87%	2	2	93	93	5.362619916727509E-9	1	1	229	291	2	25	-C
barcode01_consensus_vsearch	3014	C	*/+A	464	10	1.78%	2	1	93	93	9.308415735987439E-4	1	1	218	246	10	0	+A
barcode01_consensus_vsearch	3014	C	*/-A	464	39	6.93%	2	2	93	93	8.4551242098176E-13	1	1	218	246	3	36	-A
barcode01_consensus_vsearch	3016	A	*/-G	510	39	6.93%	2	2	93	93	9.036987231603833E-13	1	1	230	280	4	35	-G
barcode01_consensus_vsearch	3019	A	*/+C	541	8	1.44%	2	1	93	93	0.003807227915540985	1	1	231	310	0	8	+C
barcode01_consensus_vsearch	3022	T	*/+C	537	8	1.45%	2	2	93	93	0.003806505524841473	1	1	227	310	5	3	+C
barcode01_consensus_vsearch	3024	C	*/-AC	545	11	1.96%	2	1	93	93	4.6449877293201324E-4	1	1	220	325	11	0	-AC
barcode01_consensus_vsearch	3028	C	*/+T	541	8	1.45%	2	1	93	93	0.003807227915540985	1	1	229	312	0	8	+T
barcode01_consensus_vsearch	3029	C	*/+T	537	17	3.04%	2	1	93	93	6.735584540454959E-6	1	1	232	305	0	17	+T
barcode01_consensus_vsearch	3030	C	*/-T	508	43	7.64%	2	2	93	93	4.8469286244321686E-14	1	1	230	278	2	41	-T
barcode01_consensus_vsearch	3034	A	*/-C	547	8	1.42%	2	2	93	93	0.003808292093894457	1	1	229	318	2	6	-C
barcode01_consensus_vsearch	3036	C	*/-G	532	12	2.13%	2	2	93	93	2.296217615481528E-4	1	1	234	298	2	10	-G
barcode01_consensus_vsearch	3046	T	*/-C	498	46	8.19%	2	2	93	93	5.2639682483304735E-15	1	1	187	311	34	12	-C
barcode01_consensus_vsearch	3046	T	*/-CC	498	8	1.42%	2	1	93	93	0.00379886758778857	1	1	187	311	8	0	-C
barcode01_consensus_vsearch	3049	C	*/+T	543	7	1.24%	2	1	93	93	0.007663896355890601	1	1	235	308	0	7	+T
barcode01_consensus_vsearch	3050	C	*/+A	492	9	1.59%	2	1	93	93	0.0018836185577598766	1	1	208	284	9	0	+A
barcode01_consensus_vsearch	3050	C	*/-A	492	17	3.01%	2	2	93	93	6.660576740150777E-6	1	1	208	284	5	12	-A
barcode01_consensus_vsearch	3055	C	*/-GC	535	13	2.3%	2	1	93	93	1.1359127591436588E-4	1	1	233	302	0	13	-GC
barcode01_consensus_vsearch	3057	C	*/-A	511	15	2.74%	2	2	93	93	2.7580107298560767E-5	1	1	221	290	10	5	-A
barcode01_consensus_vsearch	3060	G	*/+A	531	15	2.66%	2	1	93	93	2.7683931007376995E-5	1	1	208	323	15	0	+A
barcode01_consensus_vsearch	3060	G	*/-A	531	10	1.78%	2	1	93	93	9.364350564143713E-4	1	1	208	323	10	0	+A
barcode01_consensus_vsearch	3063	G	*/-A	529	21	3.76%	2	2	93	93	3.9253625130856997E-7	1	1	210	319	19	2	-A
barcode01_consensus_vsearch	3066	C	*/-GC	542	7	1.26%	2	2	93	93	0.0076636266713165585	1	1	227	315	3	4	-GC
barcode01_consensus_vsearch	3069	C	*/-GCC	537	16	2.83%	2	2	93	93	1.3668729763994065E-5	1	1	232	305	2	14	-GCC
barcode01_consensus_vsearch	3070	G	*/+C	504	8	1.47%	2	2	93	93	0.003800117901971959	1	1	225	279	3	5	+C
barcode01_consensus_vsearch	3070	G	*/-C	504	30	5.51%	2	2	93	93	6.125778805807757E-10	1	1	225	279	5	25	-C
barcode01_consensus_vsearch	3073	C	*/-T	545	8	1.42%	2	2	93	93	0.003807939918250496	1	1	236	309	1	7	-T
barcode01_consensus_vsearch	3073	C	*/-TC	545	7	1.24%	2	1	93	93	0.007664432804486939	1	1	236	309	0	7	-T
barcode01_consensus_vsearch	3074	T	*/+C	529	10	1.82%	2	1	93	93	9.362879739115975E-4	1	1	226	303	10	0	+C
barcode01_consensus_vsearch	3075	C	*/-G	528	13	2.34%	2	2	93	93	1.1348427629302528E-4	1	1	217	311	12	1	-G
barcode01_consensus_vsearch	3076	G	*/+A	531	7	1.28%	2	1	93	93	0.007660594223165221	1	1	210	321	7	0	+A
barcode01_consensus_vsearch	3079	G	*/-C	485	24	4.32%	2	2	93	93	4.5158627963619844E-8	1	1	159	326	23	1	-C
barcode01_consensus_vsearch	3079	G	*/-CC	485	35	6.29%	2	1	93	93	1.6103045336591476E-11	1	1	159	326	35	0	-CC
barcode01_consensus_vsearch	3082	C	*/+A	411	13	2.3%	2	2	93	93	1.1118956033481172E-4	1	1	118	293	1	12	+A
barcode01_consensus_vsearch	3082	C	*/-A	411	114	20.18%	2	2	93	93	4.87823800417825E-38	1	1	118	293	97	17	-A
barcode01_consensus_vsearch	3082	C	*/-AA	411	10	1.77%	2	1	93	93	9.251755912194793E-4	1	1	118	293	10	0	-A
barcode01_consensus_vsearch	3092	T	*/-G	536	11	1.96%	2	1	93	93	4.6411360868119984E-4	1	1	216	320	11	0	-G
barcode01_consensus_vsearch	3093	G	*/-A	501	23	4.17%	2	1	93	93	9.31444983018856E-8	1	1	174	327	23	0	-A
barcode01_consensus_vsearch	3093	G	*/-AG	501	24	4.35%	2	1	93	93	4.555112262052916E-8	1	1	174	327	24	0	-AG
barcode01_consensus_vsearch	3094	A	*/+G	424	9	1.74%	2	2	93	93	0.0018728240442215458	1	1	120	304	1	8	+G
barcode01_consensus_vsearch	3094	A	*/-G	424	46	8.88%	2	2	93	93	4.4657449375344205E-15	1	1	120	304	35	11	-G
barcode01_consensus_vsearch	3094	A	*/-GG	424	7	1.35%	2	2	93	93	0.007623059056742502	1	1	120	304	6	1	-G
barcode01_consensus_vsearch	3094	A	*/-GGGA	424	21	4.05%	2	1	93	93	3.745160444570394E-7	1	1	120	304	21	0	-GGGA
barcode01_consensus_vsearch	3107	C	*/-A	547	7	1.24%	2	2	93	93	0.0076649653940683155	1	1	229	318	6	1	-A
barcode01_consensus_vsearch	3111	C	*/+T	522	8	1.42%	2	1	93	93	0.0038037000521996237	1	1	225	297	0	8	+T
barcode01_consensus_vsearch	3111	C	*/-T	522	24	4.25%	2	2	93	93	4.603521765294462E-8	1	1	225	297	2	22	-T
barcode01_consensus_vsearch	3111	C	*/-TT	522	11	1.95%	2	1	93	93	4.6348903153335794E-4	1	1	225	297	11	0	-T
barcode01_consensus_vsearch	3113	T	*/-G	537	11	1.99%	2	2	93	93	4.641570195599558E-4	1	1	221	316	1	10	-G
barcode01_consensus_vsearch	3119	T	*/+C	542	11	1.95%	2	1	93	93	4.643717559554366E-4	1	1	220	322	11	0	+C
barcode01_consensus_vsearch	3125	T	*/-C	553	8	1.42%	2	2	93	93	0.00380933364327884	1	1	237	316	1	7	-C
barcode01_consensus_vsearch	3127	G	*/+C	553	9	1.6%	2	1	93	93	0.0018910984026092464	1	1	238	315	0	9	+C
barcode01_consensus_vsearch	3129	T	*/-C	552	7	1.24%	2	1	93	93	0.007666280255386365	1	1	236	316	0	7	-C
barcode01_consensus_vsearch	3135	T	*/+C	547	11	1.95%	2	1	93	93	4.6458270396940393E-4	1	1	223	324	11	0	+C
barcode01_consensus_vsearch	3136	C	*/-G	547	10	1.78%	2	2	93	93	9.375741446597724E-4	1	1	229	318	5	5	-G
barcode01_consensus_vsearch	3142	C	*/-A	556	7	1.24%	2	2	93	93	0.0076673153898888695	1	1	232	324	6	1	-A
barcode01_consensus_vsearch	3147	A	*/+G	554	7	1.24%	2	2	93	93	0.007666799661120067	1	1	235	319	1	6	+G
barcode01_consensus_vsearch	3156	A	*/+C	511	9	1.6%	2	2	93	93	0.0018861347673471657	1	1	198	313	3	6	+C
barcode01_consensus_vsearch	3156	A	*/-C	511	39	6.91%	2	2	93	93	9.048911267754094E-13	1	1	198	313	34	5	-C
barcode01_consensus_vsearch	3157	C	*/+T	511	9	1.72%	2	1	93	93	0.0018861347673471657	1	1	202	309	0	9	+T
barcode01_consensus_vsearch	3181	C	*/-AC	550	10	1.78%	2	1	93	93	9.377805631370637E-4	1	1	224	326	10	0	-AC
barcode01_consensus_vsearch	3188	A	*/-C	547	7	1.25%	2	2	93	93	0.0076649653940683155	1	1	227	320	5	2	-C
barcode01_consensus_vsearch	3195	A	*/-GA	546	14	2.48%	2	1	93	93	5.621629760633941E-5	1	1	237	309	0	14	-GA
barcode01_consensus_vsearch	3202	G	*/-A	538	12	2.13%	2	1	93	93	2.2977702410449847E-4	1	1	216	322	12	0	-A
barcode01_consensus_vsearch	3207	A	*/+T	554	7	1.24%	2	1	93	93	0.007666799661120067	1	1	235	319	0	7	+T
barcode01_consensus_vsearch	3209	C	*/-T	555	7	1.24%	2	1	93	93	0.007667057982678975	1	1	235	320	0	7	-T
barcode01_consensus_vsearch	3216	G	*/+T	553	7	1.24%	2	1	93	93	0.00766654042031271	1	1	236	317	0	7	+T
barcode01_consensus_vsearch	3218	C	*/-T	555	7	1.24%	2	1	93	93	0.007667057982678975	1	1	236	319	0	7	-T
barcode01_consensus_vsearch	3225	T	*/+C	509	14	2.5%	2	1	93	93	5.588589091343402E-5	1	1	195	314	14	0	+C
barcode01_consensus_vsearch	3225	T	*/-C	509	28	5%	2	2	93	93	2.5958117528056396E-9	1	1	195	314	24	4	-C
barcode01_consensus_vsearch	3240	G	*/+C	538	7	1.24%	2	1	93	93	0.007662538073238661	1	1	220	318	0	7	+C
barcode01_consensus_vsearch	3240	G	*/-C	538	14	2.48%	2	1	93	93	5.6148499588288346E-5	1	1	220	318	14	0	-C
barcode01_consensus_vsearch	3244	T	*/+G	533	7	1.24%	2	1	93	93	0.007661154731964119	1	1	235	298	0	7	+G
barcode01_consensus_vsearch	3244	T	*/-G	533	17	3.01%	2	1	93	93	6.729390109352399E-6	1	1	235	298	0	17	-G
barcode01_consensus_vsearch	3245	G	*/+A	535	9	1.64%	2	1	93	93	0.0018890641450573862	1	1	227	308	9	0	+A
barcode01_consensus_vsearch	3251	C	*/-T	553	7	1.25%	2	1	93	93	0.00766654042031271	1	1	237	316	0	7	-T
barcode01_consensus_vsearch	3253	T	*/+C	392	20	3.54%	2	2	93	93	7.530470174873145E-7	1	1	203	189	1	19	+C
barcode01_consensus_vsearch	3253	T	*/-C	392	141	24.96%	2	2	93	93	8.040449142067797E-48	1	1	203	189	33	108	-C
barcode01_consensus_vsearch	3253	T	*/-CC	392	7	1.24%	2	1	93	93	0.007607942959128091	1	1	203	189	0	7	-C
barcode01_consensus_vsearch	3263	G	*/-A	554	8	1.42%	2	2	93	93	0.0038095050853976346	1	1	231	323	5	3	-A
barcode01_consensus_vsearch	3267	C	*/-A	483	61	10.82%	2	2	93	93	7.298522235503989E-20	1	1	228	255	4	57	-A
barcode01_consensus_vsearch	3267	C	*/-AA	483	13	2.3%	2	1	93	93	1.1272628320445117E-4	1	1	228	255	0	13	-A
barcode01_consensus_vsearch	3272	T	*/+C	473	7	1.25%	2	1	93	93	0.007642316239083064	1	1	231	242	0	7	+C
barcode01_consensus_vsearch	3272	T	*/-A	473	14	2.49%	2	2	93	93	5.551785156036872E-5	1	1	231	242	3	11	-A
barcode01_consensus_vsearch	3272	T	*/-AA	473	43	7.65%	2	1	93	93	4.5630894458743133E-14	1	1	231	242	0	43	-AA
barcode01_consensus_vsearch	3286	C	*/-A	529	8	1.42%	2	2	93	93	0.003805028656772291	1	1	208	321	6	2	-A
barcode01_consensus_vsearch	3286	C	*/-AC	529	23	4.08%	2	1	93	93	9.434228643144391E-8	1	1	208	321	23	0	-AC
barcode01_consensus_vsearch	3289	G	*/+C	531	10	1.8%	2	2	93	93	9.364350564143713E-4	1	1	211	320	9	1	+C
barcode01_consensus_vsearch	3292	T	*/-G	538	8	1.42%	2	2	93	93	0.0038066871088034355	1	1	228	310	3	5	-G
barcode01_consensus_vsearch	3296	T	*/+A	541	18	3.19%	2	2	93	93	3.319545137624332E-6	1	1	218	323	17	1	+A
barcode01_consensus_vsearch	3299	G	*/-C	532	10	1.79%	2	2	93	93	9.365081955943183E-4	1	1	228	304	4	6	-C
barcode01_consensus_vsearch	3309	C	*/-A	553	8	1.42%	2	2	93	93	0.00380933364327884	1	1	234	319	3	5	-A
barcode01_consensus_vsearch	3315	C	*/+T	535	10	1.77%	2	2	93	93	9.367260223435176E-4	1	1	235	300	1	9	+T
barcode01_consensus_vsearch	3315	C	*/-T	535	17	3.01%	2	2	93	93	6.732498005838406E-6	1	1	235	300	2	15	-T
barcode01_consensus_vsearch	3329	C	*/+T	550	7	1.24%	2	1	93	93	0.007665757133253386	1	1	236	314	0	7	+T
barcode01_consensus_vsearch	3331	T	*/+G	543	13	2.31%	2	1	93	93	1.1371034282771197E-4	1	1	236	307	0	13	+G
barcode01_consensus_vsearch	3340	A	*/+T	539	14	2.5%	2	1	93	93	5.6157078426883895E-5	1	1	235	304	0	14	+T
barcode01_consensus_vsearch	3341	C	*/+T	494	25	4.46%	2	1	93	93	2.2165867916498108E-8	1	1	232	262	0	25	+T
barcode01_consensus_vsearch	3341	C	*/-T	494	18	3.21%	2	1	93	93	3.2767162223415424E-6	1	1	232	262	0	18	+T
barcode01_consensus_vsearch	3341	C	*/-TC	494	7	1.25%	2	2	93	93	0.007649420889133695	1	1	232	262	4	3	+T
barcode01_consensus_vsearch	3342	T	*/+C	278	174	32.28%	2	2	93	93	3.860374776996399E-62	1	1	109	169	96	78	+C
barcode01_consensus_vsearch	3342	T	*/-C	278	64	11.87%	2	2	93	93	2.092129036963871E-21	1	1	109	169	21	43	+C
barcode01_consensus_vsearch	3342	T	*/-CC	278	8	1.48%	2	2	93	93	0.0037172160087077582	1	1	109	169	1	7	+C
barcode01_consensus_vsearch	3349	G	*/-A	547	13	2.31%	2	1	93	93	1.1376863153597855E-4	1	1	220	327	13	0	-A
barcode01_consensus_vsearch	3352	T	*/-C	543	17	3.02%	2	1	93	93	6.744718149796163E-6	1	1	219	324	17	0	-C
barcode01_consensus_vsearch	3354	C	*/-A	533	18	3.19%	2	2	93	93	3.312742451643524E-6	1	1	215	318	16	2	-A
barcode01_consensus_vsearch	3361	T	*/+C	497	18	3.23%	2	2	93	93	3.279669696978984E-6	1	1	213	284	16	2	+C
barcode01_consensus_vsearch	3361	T	*/-C	497	29	5.2%	2	1	93	93	1.2526588436827019E-9	1	1	213	284	0	29	-C
barcode01_consensus_vsearch	3362	C	*/+T	504	11	2.07%	2	2	93	93	4.6263694917115237E-4	1	1	234	270	1	10	+T
barcode01_consensus_vsearch	3362	C	*/-T	504	10	1.88%	2	2	93	93	9.343541132389128E-4	1	1	234	270	1	9	+T
barcode01_consensus_vsearch	3363	T	*/-A	498	39	7.12%	2	2	93	93	8.891582759445203E-13	1	1	228	270	3	36	-A
barcode01_consensus_vsearch	3368	T	*/-CT	535	21	3.72%	2	1	93	93	3.9337682472130574E-7	1	1	237	298	0	21	-CT
barcode01_consensus_vsearch	3369	C	*/-T	532	7	1.3%	2	2	93	93	0.007660874995560234	1	1	235	297	2	5	-T
barcode01_consensus_vsearch	3372	T	*/-A	544	10	1.79%	2	1	93	93	9.373655173650468E-4	1	1	224	320	10	0	-A
barcode01_consensus_vsearch	3376	C	*/-T	543	16	2.84%	2	2	93	93	1.3685112619426907E-5	1	1	234	309	2	14	-T
barcode01_consensus_vsearch	3377	T	*/+C	488	21	3.85%	2	2	93	93	3.863076099311427E-7	1	1	210	278	9	12	+C
barcode01_consensus_vsearch	3377	T	*/-C	488	14	2.56%	2	2	93	93	5.567740566555591E-5	1	1	210	278	4	10	+C
barcode01_consensus_vsearch	3377	T	*/-CC	488	10	1.83%	2	2	93	93	9.330159046450721E-4	1	1	210	278	8	2	+C
barcode01_consensus_vsearch	3380	C	*/+G	534	11	1.95%	2	2	93	93	4.6402631662478475E-4	1	1	231	303	2	9	+G
barcode01_consensus_vsearch	3381	G	*/-A	537	10	1.77%	2	2	93	93	9.368699288806099E-4	1	1	220	317	7	3	-A
barcode01_consensus_vsearch	3387	T	*/-GCT	523	8	1.43%	2	1	93	93	0.003803891984112379	1	1	236	287	0	8	-GCT
barcode01_consensus_vsearch	3393	C	*/-A	530	28	4.96%	2	1	93	93	2.6322553713172326E-9	1	1	206	324	28	0	-A
barcode01_consensus_vsearch	3396	A	*/-G	510	10	1.79%	2	1	93	93	9.348349816829582E-4	1	1	189	321	10	0	-G
barcode01_consensus_vsearch	3397	G	*/+A	516	34	6.16%	2	1	93	93	3.439498905206985E-11	1	1	191	325	34	0	+A
barcode01_consensus_vsearch	3399	C	*/+A	554	7	1.24%	2	1	93	93	0.007666799661120067	1	1	235	319	0	7	+A
barcode01_consensus_vsearch	3400	A	*/-C	548	10	1.77%	2	2	93	93	9.376431945058487E-4	1	1	226	322	6	4	-C
barcode01_consensus_vsearch	3418	A	*/-T	555	7	1.24%	2	1	93	93	0.007667057982678975	1	1	237	318	0	7	-T
barcode01_consensus_vsearch	3421	G	*/+T	554	7	1.24%	2	2	93	93	0.007666799661120067	1	1	231	323	6	1	+T
barcode01_consensus_vsearch	3427	T	*/-G	533	11	1.96%	2	1	93	93	4.6398243374788086E-4	1	1	228	305	0	11	-G
barcode01_consensus_vsearch	3430	T	*/-G	529	15	2.68%	2	2	93	93	2.767387980503683E-5	1	1	232	297	2	13	-G
barcode01_consensus_vsearch	3455	C	*/+T	526	16	2.84%	2	2	93	93	1.3637792322447935E-5	1	1	210	316	12	4	+T
barcode01_consensus_vsearch	3455	C	*/-T	526	17	3.01%	2	2	93	93	6.7183410104665195E-6	1	1	210	316	11	6	-T
barcode01_consensus_vsearch	3457	T	*/+C	552	9	1.59%	2	2	93	93	0.0018909887834267728	1	1	229	323	7	2	+C
barcode01_consensus_vsearch	3458	T	*/+AA	15	25	4.42%	2	1	93	93	1.1068746613360668E-10	1	1	12	3	25	0	+AA
barcode01_consensus_vsearch	3458	T	+G/+G	15	429	75.93%	2	2	93	93	9.290344622726606E-239	1	1	12	3	146	283	+G
barcode01_consensus_vsearch	3458	T	*/-C	15	10	1.77%	2	2	93	93	3.1821178767786634E-4	1	1	12	3	3	7	+G
barcode01_consensus_vsearch	3460	T	*/+C	366	10	1.8%	2	2	93	93	9.191332166898884E-4	1	1	146	220	7	3	+C
barcode01_consensus_vsearch	3460	T	*/-C	366	118	21.18%	2	2	93	93	8.75495199133744E-40	1	1	146	220	71	47	-C
barcode01_consensus_vsearch	3460	T	*/-CC	366	44	7.9%	2	2	93	93	1.6799948609779627E-14	1	1	146	220	3	41	-C
barcode01_consensus_vsearch	3466	A	*/-C	529	15	2.69%	2	2	93	93	2.767387980503683E-5	1	1	223	306	5	10	-C
barcode01_consensus_vsearch	3469	C	*/-T	551	8	1.42%	2	2	93	93	0.0038089889297735855	1	1	233	318	2	6	-T
barcode01_consensus_vsearch	3476	C	*/-T	546	7	1.25%	2	2	93	93	0.0076646995790388295	1	1	231	315	1	6	-T
barcode01_consensus_vsearch	3481	T	*/+C	557	7	1.24%	2	2	93	93	0.007667571887622288	1	1	231	326	6	1	+C
barcode01_consensus_vsearch	3492	A	*/+C	436	7	1.25%	2	2	93	93	0.007628167177128368	1	1	158	278	4	3	+C
barcode01_consensus_vsearch	3492	A	*/-C	436	97	17.29%	2	2	93	93	5.139783079610085E-32	1	1	158	278	73	24	-C
barcode01_consensus_vsearch	3493	C	*/+T	428	24	5.16%	2	1	93	93	4.356430553412235E-8	1	1	162	266	0	24	+T
barcode01_consensus_vsearch	3494	C	*/+T	537	12	2.13%	2	1	93	93	2.297513779597955E-4	1	1	237	300	0	12	+T
barcode01_consensus_vsearch	3495	C	*/-T	502	54	9.57%	2	1	93	93	1.4354952428091862E-17	1	1	238	264	0	54	-T
barcode01_consensus_vsearch	3509	T	*/-C	548	9	1.6%	2	1	93	93	0.0018905464048331274	1	1	236	312	0	9	-C
barcode01_consensus_vsearch	3526	C	*/-T	538	10	1.78%	2	1	93	93	9.369414930158851E-4	1	1	232	306	0	10	-T
barcode01_consensus_vsearch	3527	T	*/+G	519	12	2.16%	2	1	93	93	2.2927357192867824E-4	1	1	226	293	0	12	+G
barcode01_consensus_vsearch	3529	A	*/+G	516	9	1.62%	2	1	93	93	0.0018867669371326681	1	1	196	320	9	0	+G
barcode01_consensus_vsearch	3529	A	*/-G	516	22	3.95%	2	2	93	93	1.915122117926581E-7	1	1	196	320	18	4	-G
barcode01_consensus_vsearch	3533	T	*/+C	545	7	1.24%	2	1	93	93	0.007664432804486939	1	1	224	321	7	0	+C
barcode01_consensus_vsearch	3534	C	*/-A	537	13	2.32%	2	2	93	93	1.1362135934538324E-4	1	1	220	317	11	2	-A
barcode01_consensus_vsearch	3535	A	*/+G	517	7	1.28%	2	1	93	93	0.0076565513232377735	1	1	207	310	0	7	+G
barcode01_consensus_vsearch	3539	G	*/-A	555	8	1.42%	2	1	93	93	0.0038096759220663046	1	1	228	327	8	0	-A
barcode01_consensus_vsearch	3545	A	*/+C	430	20	3.55%	2	2	93	93	7.685596503616361E-7	1	1	176	254	8	12	+C
barcode01_consensus_vsearch	3545	A	*/-C	430	87	15.45%	2	2	93	93	1.2396033376164037E-28	1	1	176	254	32	55	-C
barcode01_consensus_vsearch	3545	A	*/-CCC	430	15	2.66%	2	1	93	93	2.7068371529022044E-5	1	1	176	254	15	0	-C
barcode01_consensus_vsearch	3549	C	*/-T	540	11	1.95%	2	2	93	93	4.6428632168686156E-4	1	1	232	308	3	8	-T
barcode01_consensus_vsearch	3552	G	*/+C	541	12	2.13%	2	2	93	93	2.2985341710330166E-4	1	1	218	323	11	1	+C
barcode01_consensus_vsearch	3552	G	*/-C	541	8	1.42%	2	2	93	93	0.003807227915540985	1	1	218	323	6	2	+C
barcode01_consensus_vsearch	3556	C	*/-A	552	7	1.24%	2	2	93	93	0.007666280255386365	1	1	229	323	6	1	-A
barcode01_consensus_vsearch	3558	G	*/-A	545	12	2.14%	2	1	93	93	2.2995401966340216E-4	1	1	219	326	12	0	-A
barcode01_consensus_vsearch	3563	C	*/-G	549	7	1.24%	2	2	93	93	0.007665494166045835	1	1	235	314	1	6	-G
barcode01_consensus_vsearch	3569	G	*/+C	501	15	2.67%	2	2	93	93	2.7525291760534587E-5	1	1	187	314	12	3	+C
barcode01_consensus_vsearch	3569	G	*/-C	501	35	6.24%	2	2	93	93	1.639981801053249E-11	1	1	187	314	33	2	-C
barcode01_consensus_vsearch	3573	C	*/+G	439	12	2.12%	2	1	93	93	2.266998039975627E-4	1	1	152	287	0	12	+G
barcode01_consensus_vsearch	3573	C	*/+T	439	7	1.24%	2	1	93	93	0.00762940145447119	1	1	152	287	0	7	+G
barcode01_consensus_vsearch	3573	C	*/-G	439	80	14.16%	2	2	93	93	3.04905170476478E-26	1	1	152	287	77	3	-G
barcode01_consensus_vsearch	3574	G	*/+A	458	15	3.09%	2	2	93	93	2.7264266290551257E-5	1	1	140	318	13	2	+A
barcode01_consensus_vsearch	3578	A	*/+C	478	21	3.74%	2	2	93	93	3.8464683454624837E-7	1	1	181	297	17	4	+C
barcode01_consensus_vsearch	3578	A	*/-C	478	44	7.83%	2	2	93	93	2.2075653878037354E-14	1	1	181	297	27	17	-C
barcode01_consensus_vsearch	3578	A	*/-CC	478	7	1.25%	2	2	93	93	0.0076440633927143216	1	1	181	297	6	1	-C
barcode01_consensus_vsearch	3604	C	*/-T	547	7	1.24%	2	2	93	93	0.0076649653940683155	1	1	233	314	1	6	-T
barcode01_consensus_vsearch	3616	A	*/-CAA	544	11	1.95%	2	2	93	93	4.6445658412336564E-4	1	1	233	311	2	9	-CAA
barcode01_consensus_vsearch	3630	T	*/-C	552	7	1.24%	2	2	93	93	0.007666280255386365	1	1	229	323	6	1	-C
barcode01_consensus_vsearch	3636	T	*/-GT	529	18	3.2%	2	2	93	93	3.3092706534524426E-6	1	1	219	310	7	11	-GT
barcode01_consensus_vsearch	3642	T	*/-C	550	8	1.42%	2	1	93	93	0.003808815651854499	1	1	226	324	8	0	-C
barcode01_consensus_vsearch	3659	C	*/-G	543	11	1.95%	2	2	93	93	4.644142453977102E-4	1	1	233	310	1	10	-G
barcode01_consensus_vsearch	3668	G	*/-TG	547	9	1.6%	2	1	93	93	0.0018904348242880168	1	1	236	311	0	9	-TG
barcode01_consensus_vsearch	3672	C	*/-T	550	7	1.24%	2	2	93	93	0.007665757133253386	1	1	233	317	2	5	-T
barcode01_consensus_vsearch	3683	G	*/+C	542	11	1.96%	2	1	93	93	4.643717559554366E-4	1	1	231	311	0	11	+C
barcode01_consensus_vsearch	3684	C	*/+T	546	7	1.25%	2	2	93	93	0.0076646995790388295	1	1	233	313	1	6	+T
barcode01_consensus_vsearch	3685	T	*/+C	541	9	1.6%	2	2	93	93	0.0018897568952923375	1	1	234	307	1	8	+C
barcode01_consensus_vsearch	3685	T	*/-C	541	8	1.42%	2	1	93	93	0.003807227915540985	1	1	234	307	0	8	+C
barcode01_consensus_vsearch	3686	C	*/-TC	539	13	2.33%	2	2	93	93	1.1365123014973769E-4	1	1	235	304	2	11	-TC
barcode01_consensus_vsearch	3689	A	*/-T	545	8	1.42%	2	2	93	93	0.003807939918250496	1	1	220	325	6	2	-T
barcode01_consensus_vsearch	3696	C	*/+G	533	8	1.43%	2	1	93	93	0.003805772517181644	1	1	221	312	0	8	+G
barcode01_consensus_vsearch	3696	C	*/-G	533	14	2.5%	2	1	93	93	5.6105149032658256E-5	1	1	221	312	14	0	-G
barcode01_consensus_vsearch	3697	G	*/-AG	537	7	1.27%	2	1	93	93	0.007662263431712945	1	1	212	325	7	0	-AG
barcode01_consensus_vsearch	3704	T	*/-C	546	7	1.25%	2	1	93	93	0.0076646995790388295	1	1	236	310	0	7	-C
barcode01_consensus_vsearch	3709	A	*/-C	545	9	1.59%	2	2	93	93	0.001890210465296116	1	1	229	316	2	7	-C
barcode01_consensus_vsearch	3711	C	*/-G	522	31	5.5%	2	1	93	93	3.021862694714269E-10	1	1	234	288	0	31	-G
barcode01_consensus_vsearch	3713	G	*/-A	547	14	2.48%	2	1	93	93	5.622464038442748E-5	1	1	222	325	14	0	-A
barcode01_consensus_vsearch	3717	C	*/+A	531	7	1.24%	2	2	93	93	0.007660594223165221	1	1	215	316	6	1	+A
barcode01_consensus_vsearch	3717	C	*/-G	531	13	2.3%	2	1	93	93	1.1353046202906254E-4	1	1	215	316	13	0	-G
barcode01_consensus_vsearch	3724	C	*/-AC	539	18	3.19%	2	1	93	93	3.3178617815960446E-6	1	1	218	321	18	0	-AC
barcode01_consensus_vsearch	3731	A	*/-T	517	19	3.39%	2	2	93	93	1.6215617652422516E-6	1	1	232	285	3	16	-T
barcode01_consensus_vsearch	3731	A	*/-TTA	517	9	1.61%	2	1	93	93	0.0018868919421650878	1	1	232	285	0	9	-T
barcode01_consensus_vsearch	3734	A	*/+G	441	8	1.46%	2	2	93	93	0.0037853352821818676	1	1	226	215	1	7	+G
barcode01_consensus_vsearch	3734	A	*/-G	441	80	14.63%	2	1	93	93	3.091260144691896E-26	1	1	226	215	0	80	-G
barcode01_consensus_vsearch	3738	C	*/-GC	529	11	1.96%	2	1	93	93	4.6380530311171874E-4	1	1	236	293	0	11	-GC
barcode01_consensus_vsearch	3741	C	*/+G	510	11	1.95%	2	1	93	93	4.629274092769525E-4	1	1	235	275	0	11	+G
barcode01_consensus_vsearch	3745	C	*/-G	542	8	1.42%	2	2	93	93	0.003807406881292934	1	1	232	310	2	6	-G
barcode01_consensus_vsearch	3750	G	*/-C	521	8	1.42%	2	1	93	93	0.0038035073991726275	1	1	197	324	8	0	-C
barcode01_consensus_vsearch	3754	C	*/-T	541	13	2.31%	2	2	93	93	1.136808905722468E-4	1	1	230	311	1	12	-T
barcode01_consensus_vsearch	3755	T	*/+C	513	13	2.36%	2	1	93	93	1.132456493646404E-4	1	1	199	314	13	0	+C
barcode01_consensus_vsearch	3755	T	*/-C	513	25	4.54%	2	2	93	93	2.240432168921102E-8	1	1	199	314	24	1	-C
barcode01_consensus_vsearch	3757	C	*/+G	484	10	1.77%	2	1	93	93	9.326679901268426E-4	1	1	217	267	0	10	+G
barcode01_consensus_vsearch	3757	C	*/-G	484	53	9.38%	2	2	93	93	2.879323306614207E-17	1	1	217	267	7	46	-G
barcode01_consensus_vsearch	3757	C	*/-GGA	484	7	1.24%	2	2	93	93	0.007646113201788858	1	1	217	267	6	1	-G
barcode01_consensus_vsearch	3760	A	*/-G	540	7	1.27%	2	1	93	93	0.007663084355008458	1	1	216	324	7	0	-G
barcode01_consensus_vsearch	3761	G	*/-AG	531	14	2.52%	2	2	93	93	5.608759281149405E-5	1	1	209	322	11	3	-AG
barcode01_consensus_vsearch	3763	G	*/+AG	517	7	1.28%	2	2	93	93	0.0076565513232377735	1	1	216	301	4	3	+AG
barcode01_consensus_vsearch	3763	G	*/-T	517	15	2.73%	2	2	93	93	2.761204391196279E-5	1	1	216	301	1	14	-T
barcode01_consensus_vsearch	3766	C	*/-T	519	30	5.31%	2	2	93	93	6.198275489719869E-10	1	1	229	290	6	24	-T
barcode01_consensus_vsearch	3772	A	*/-TA	544	8	1.43%	2	2	93	93	0.0038077628791647437	1	1	228	316	3	5	-TA
barcode01_consensus_vsearch	3779	C	*/-G	541	7	1.26%	2	1	93	93	0.007663356006147005	1	1	238	303	0	7	-G
barcode01_consensus_vsearch	3781	G	*/-C	471	76	13.48%	2	2	93	93	8.0417064833669435E-25	1	1	196	275	28	48	-C
barcode01_consensus_vsearch	3781	G	*/-CC	471	9	1.6%	2	1	93	93	0.001880608069030174	1	1	196	275	9	0	-C
barcode01_consensus_vsearch	3785	C	*/-T	552	8	1.42%	2	2	93	93	0.0038091615924873046	1	1	237	315	1	7	-T
barcode01_consensus_vsearch	3786	T	*/+G	518	30	5.39%	2	1	93	93	6.193543383816422E-10	1	1	235	283	0	30	+G
barcode01_consensus_vsearch	3801	C	*/-AC	536	17	3.04%	2	1	93	93	6.73404392961064E-6	1	1	218	318	17	0	-AC
barcode01_consensus_vsearch	3804	G	*/-T	546	10	1.77%	2	2	93	93	9.375048493952046E-4	1	1	222	324	7	3	-T
barcode01_consensus_vsearch	3814	C	*/+A	550	7	1.24%	2	1	93	93	0.007665757133253386	1	1	235	315	0	7	+A
barcode01_consensus_vsearch	3819	A	*/-C	544	9	1.59%	2	2	93	93	0.0018900976825545202	1	1	234	310	2	7	-C
barcode01_consensus_vsearch	3823	A	*/-CA	533	15	2.67%	2	2	93	93	2.7693911463208213E-5	1	1	228	305	7	8	-CA
barcode01_consensus_vsearch	3827	A	*/-TA	545	13	2.31%	2	2	93	93	1.1373958909834942E-4	1	1	233	312	2	11	-TA
barcode01_consensus_vsearch	3842	T	*/-G	525	26	4.63%	2	2	93	93	1.1017739533227039E-8	1	1	232	293	2	24	-G
barcode01_consensus_vsearch	3846	A	*/-T	548	8	1.42%	2	2	93	93	0.003808467237244324	1	1	232	316	1	7	-T
barcode01_consensus_vsearch	3853	C	*/+G	531	7	1.25%	2	1	93	93	0.007660594223165221	1	1	230	301	0	7	+G
barcode01_consensus_vsearch	3853	C	*/-G	531	7	1.25%	2	2	93	93	0.007660594223165221	1	1	230	301	2	5	+G
barcode01_consensus_vsearch	3863	C	*/-A	534	17	3.02%	2	1	93	93	6.730946741652701E-6	1	1	218	316	17	0	-A
barcode01_consensus_vsearch	3864	A	*/-C	522	8	1.46%	2	2	93	93	0.0038037000521996237	1	1	201	321	6	2	-C
barcode01_consensus_vsearch	3873	G	*/+C	535	8	1.42%	2	1	93	93	0.0038061403627091955	1	1	230	305	0	8	+C
barcode01_consensus_vsearch	3873	G	*/-C	535	14	2.49%	2	2	93	93	5.61225811719022E-5	1	1	230	305	6	8	-C
barcode01_consensus_vsearch	3874	C	*/+T	533	9	1.64%	2	1	93	93	0.0018888298504045951	1	1	230	303	0	9	+T
barcode01_consensus_vsearch	3877	T	*/-C	509	41	7.39%	2	2	93	93	2.0968441711159555E-13	1	1	191	318	40	1	-C
barcode01_consensus_vsearch	3890	C	*/-A	539	19	3.39%	2	2	93	93	1.63214994368726E-6	1	1	219	320	18	1	-A
barcode01_consensus_vsearch	3892	C	*/-T	530	21	3.73%	2	1	93	93	3.926775167322623E-7	1	1	230	300	0	21	-T
barcode01_consensus_vsearch	3893	T	*/+C	520	8	1.49%	2	2	93	93	0.0038033140209771956	1	1	224	296	5	3	+C
barcode01_consensus_vsearch	3896	G	*/-A	550	11	1.95%	2	2	93	93	4.647074958288269E-4	1	1	229	321	8	3	-A
barcode01_consensus_vsearch	3899	C	*/+T	543	7	1.25%	2	2	93	93	0.007663896355890601	1	1	227	316	4	3	+T
barcode01_consensus_vsearch	3902	T	*/+G	544	7	1.24%	2	1	93	93	0.007664165065188001	1	1	220	324	7	0	+G
barcode01_consensus_vsearch	3902	T	*/-A	544	9	1.59%	2	2	93	93	0.0018900976825545202	1	1	220	324	8	1	-A
barcode01_consensus_vsearch	3903	A	*/+G	534	9	1.62%	2	1	93	93	0.0018889472115475113	1	1	219	315	0	9	+G
barcode01_consensus_vsearch	3907	T	*/-A	519	18	3.19%	2	2	93	93	3.30037773845427E-6	1	1	220	299	12	6	-A
barcode01_consensus_vsearch	3907	T	*/-AA	519	17	3.01%	2	1	93	93	6.707017638951936E-6	1	1	220	299	0	17	-A
barcode01_consensus_vsearch	3909	A	*/-G	527	7	1.28%	2	2	93	93	0.007659460657798071	1	1	225	302	4	3	-G
barcode01_consensus_vsearch	3910	G	*/+C	524	11	1.98%	2	2	93	93	4.635802256328469E-4	1	1	215	309	1	10	+C
barcode01_consensus_vsearch	3912	T	*/-C	549	11	1.95%	2	1	93	93	4.646660447990897E-4	1	1	235	314	0	11	-C
barcode01_consensus_vsearch	3916	T	*/-C	530	28	4.96%	2	2	93	93	2.6322553713172326E-9	1	1	213	317	21	7	-C
barcode01_consensus_vsearch	3918	C	*/-A	528	30	5.32%	2	1	93	93	6.240237553892686E-10	1	1	236	292	0	30	-A
barcode01_consensus_vsearch	3920	A	*/-T	550	7	1.24%	2	1	93	93	0.007665757133253386	1	1	235	315	0	7	-T
barcode01_consensus_vsearch	3923	A	*/+G	535	11	1.95%	2	1	93	93	4.640700413183075E-4	1	1	233	302	0	11	+G
barcode01_consensus_vsearch	3923	A	*/-G	535	8	1.42%	2	1	93	93	0.0038061403627091955	1	1	233	302	0	8	+G
barcode01_consensus_vsearch	3936	C	*/+A	548	7	1.25%	2	1	93	93	0.007665230254675653	1	1	237	311	0	7	+A
barcode01_consensus_vsearch	3940	C	*/-GC	541	11	1.95%	2	2	93	93	4.643291149889421E-4	1	1	227	314	6	5	-GC
barcode01_consensus_vsearch	3941	G	*/-C	523	18	3.28%	2	2	93	93	3.303972127514567E-6	1	1	212	311	13	5	-C
barcode01_consensus_vsearch	3952	A	*/+G	548	7	1.24%	2	1	93	93	0.007665230254675653	1	1	232	316	0	7	+G
barcode01_consensus_vsearch	3965	A	*/-C	541	10	1.79%	2	1	93	93	9.371546456216187E-4	1	1	234	307	0	10	-C
barcode01_consensus_vsearch	3967	C	*/-TC	547	7	1.25%	2	2	93	93	0.0076649653940683155	1	1	233	314	1	6	-TC
barcode01_consensus_vsearch	3971	C	*/-ACAC	554	8	1.42%	2	1	93	93	0.0038095050853976346	1	1	228	326	8	0	-ACAC
barcode01_consensus_vsearch	3973	C	*/-AC	451	91	16.4%	2	2	93	93	6.51201972469504E-30	1	1	155	296	72	19	-AC
barcode01_consensus_vsearch	3973	C	*/-ACGT	451	11	1.98%	2	2	93	93	4.597497298035834E-4	1	1	155	296	2	9	-AC
barcode01_consensus_vsearch	3975	C	*/+AC	439	11	2.43%	2	2	93	93	4.5900342337653016E-4	1	1	146	293	7	4	+AC
barcode01_consensus_vsearch	3977	T	*/-GTGT	539	7	1.27%	2	2	93	93	0.007662811712528587	1	1	230	309	2	5	-GTGT
barcode01_consensus_vsearch	3979	T	*/-GT	482	63	11.35%	2	2	93	93	1.6185428098043307E-20	1	1	227	255	5	58	-GT
barcode01_consensus_vsearch	3984	T	*/-GG	529	17	3.02%	2	1	93	93	6.723109338714888E-6	1	1	232	297	0	17	-GG
barcode01_consensus_vsearch	3988	T	*/-A	528	9	1.6%	2	2	93	93	0.0018882365473064763	1	1	230	298	4	5	-A
barcode01_consensus_vsearch	3990	A	*/+T	498	7	1.25%	2	1	93	93	0.007650707432770799	1	1	186	312	0	7	+T
barcode01_consensus_vsearch	3990	A	*/-T	498	53	9.43%	2	2	93	93	2.9849769063328315E-17	1	1	186	312	50	3	-T
barcode01_consensus_vsearch	3997	C	*/-GC	542	18	3.19%	2	2	93	93	3.3203825524341474E-6	1	1	223	319	11	7	-GC
barcode01_consensus_vsearch	3999	C	*/+T	530	10	1.84%	2	1	93	93	9.363616496764544E-4	1	1	222	308	0	10	+T
barcode01_consensus_vsearch	4005	G	*/-C	546	9	1.61%	2	1	93	93	0.001890322845155412	1	1	221	325	9	0	-C
barcode01_consensus_vsearch	4007	C	*/+T	533	17	3.02%	2	2	93	93	6.729390109352399E-6	1	1	229	304	5	12	+T
barcode01_consensus_vsearch	4007	C	*/-T	533	10	1.78%	2	2	93	93	9.365810686774555E-4	1	1	229	304	1	9	+T
barcode01_consensus_vsearch	4009	T	*/+C	524	9	1.6%	2	2	93	93	0.0018877539630633598	1	1	213	311	5	4	+C
barcode01_consensus_vsearch	4009	T	*/-C	524	13	2.31%	2	2	93	93	1.1342191290655594E-4	1	1	213	311	3	10	-C
barcode01_consensus_vsearch	4009	T	*/-CCTT	524	9	1.6%	2	1	93	93	0.0018877539630633598	1	1	213	311	9	0	-C
barcode01_consensus_vsearch	4010	C	*/+G	520	13	2.41%	2	1	93	93	1.1335863736764801E-4	1	1	204	316	13	0	+G
barcode01_consensus_vsearch	4011	C	*/+T	522	8	1.44%	2	1	93	93	0.0038037000521996237	1	1	224	298	0	8	+T
barcode01_consensus_vsearch	4011	C	*/-T	522	16	2.89%	2	2	93	93	1.3626242060282805E-5	1	1	224	298	1	15	-T
barcode01_consensus_vsearch	4013	T	*/-G	518	21	3.79%	2	1	93	93	3.90950556217314E-7	1	1	218	300	0	21	-G
barcode01_consensus_vsearch	4019	T	*/-A	516	33	5.88%	2	1	93	93	7.091949900238436E-11	1	1	195	321	33	0	-A
barcode01_consensus_vsearch	4022	G	*/-A	547	13	2.3%	2	2	93	93	1.1376863153597855E-4	1	1	223	324	12	1	-A
barcode01_consensus_vsearch	4039	C	*/-T	510	46	8.19%	2	2	93	93	5.3830094477712526E-15	1	1	235	275	1	45	-T
barcode01_consensus_vsearch	4044	T	*/-C	525	32	5.7%	2	2	93	93	1.4723767990427373E-10	1	1	204	321	31	1	-C
barcode01_consensus_vsearch	4046	C	*/-G	490	63	11.21%	2	2	93	93	1.6664962377990703E-20	1	1	228	262	4	59	-G
barcode01_consensus_vsearch	4056	C	*/-T	539	21	3.72%	2	2	93	93	3.9392798623314776E-7	1	1	234	305	1	20	-T
barcode01_consensus_vsearch	4057	T	*/+C	525	10	1.84%	2	2	93	93	9.359905507976904E-4	1	1	227	298	8	2	+C
barcode01_consensus_vsearch	4058	C	*/+T	540	8	1.43%	2	1	93	93	0.003807048300577348	1	1	234	306	0	8	+T
barcode01_consensus_vsearch	4059	T	*/-A	517	28	5.03%	2	2	93	93	2.6099744599127038E-9	1	1	229	288	3	25	-A
barcode01_consensus_vsearch	4063	T	*/+C	481	25	4.43%	2	2	93	93	2.199373788260121E-8	1	1	216	265	5	20	+C
barcode01_consensus_vsearch	4063	T	*/-C	481	48	8.51%	2	2	93	93	1.1630216917015365E-15	1	1	216	265	14	34	-C
barcode01_consensus_vsearch	4070	T	*/-A	551	8	1.42%	2	1	93	93	0.0038089889297735855	1	1	228	323	8	0	-A
barcode01_consensus_vsearch	4071	A	*/-C	523	23	4.16%	2	2	93	93	9.409492862523217E-8	1	1	203	320	22	1	-C
barcode01_consensus_vsearch	4091	T	*/-C	539	21	3.74%	2	1	93	93	3.9392798623314776E-7	1	1	216	323	21	0	-C
barcode01_consensus_vsearch	4093	C	*/-A	543	12	2.13%	2	1	93	93	2.2990389605394288E-4	1	1	218	325	12	0	-A
barcode01_consensus_vsearch	4099	A	*/-CA	541	12	2.13%	2	2	93	93	2.2985341710330166E-4	1	1	228	313	1	11	-CA
barcode01_consensus_vsearch	4100	C	*/+A	537	10	1.82%	2	1	93	93	9.368699288806099E-4	1	1	233	304	0	10	+A
barcode01_consensus_vsearch	4111	G	*/-TG	543	14	2.49%	2	2	93	93	5.619109483854551E-5	1	1	232	311	1	13	-TG
barcode01_consensus_vsearch	4116	A	*/-G	535	11	1.95%	2	2	93	93	4.640700413183075E-4	1	1	223	312	1	10	-G
barcode01_consensus_vsearch	4118	G	*/+A	550	7	1.24%	2	1	93	93	0.007665757133253386	1	1	225	325	7	0	+A
barcode01_consensus_vsearch	4126	C	*/-T	533	22	3.91%	2	2	93	93	1.9282739572065165E-7	1	1	234	299	2	20	-T
barcode01_consensus_vsearch	4128	T	*/-G	536	7	1.25%	2	1	93	93	0.007661987782401454	1	1	228	308	0	7	-G
barcode01_consensus_vsearch	4129	G	*/-A	521	30	5.4%	2	2	93	93	6.207697483129786E-10	1	1	233	288	3	27	-A
barcode01_consensus_vsearch	4132	T	*/+G	507	13	2.33%	2	1	93	93	1.1314644468241172E-4	1	1	236	271	0	13	+G
barcode01_consensus_vsearch	4133	G	*/-A	519	19	3.41%	2	2	93	93	1.6225577997907453E-6	1	1	229	290	8	11	-A
barcode01_consensus_vsearch	4148	T	*/+G	495	19	3.41%	2	2	93	93	1.610128365111685E-6	1	1	175	320	18	1	+G
barcode01_consensus_vsearch	4148	T	*/-G	495	22	3.94%	2	1	93	93	1.8977945460865472E-7	1	1	175	320	22	0	-G
barcode01_consensus_vsearch	4149	G	*/-A	492	33	6.2%	2	1	93	93	6.928005878655259E-11	1	1	167	325	33	0	-A
barcode01_consensus_vsearch	4152	G	*/+C	463	73	13.01%	2	2	93	93	7.619216974034906E-24	1	1	139	324	71	2	+C
barcode01_consensus_vsearch	4152	G	*/-C	463	9	1.6%	2	1	93	93	0.0018793914772358292	1	1	139	324	9	0	+C
barcode01_consensus_vsearch	4162	T	*/-C	544	14	2.48%	2	1	93	93	5.619952498505845E-5	1	1	219	325	14	0	-C
barcode01_consensus_vsearch	4179	A	*/-G	548	7	1.25%	2	1	93	93	0.007665230254675653	1	1	227	321	7	0	-G
barcode01_consensus_vsearch	4189	C	*/+T	553	8	1.42%	2	1	93	93	0.00380933364327884	1	1	236	317	0	8	+T
barcode01_consensus_vsearch	4190	C	*/-T	552	8	1.42%	2	2	93	93	0.0038091615924873046	1	1	233	319	4	4	-T
barcode01_consensus_vsearch	4198	A	*/-G	524	16	2.84%	2	2	93	93	1.3632037671173861E-5	1	1	224	300	2	14	-G
barcode01_consensus_vsearch	4203	G	*/+CG	534	9	1.6%	2	1	93	93	0.0018889472115475113	1	1	218	316	0	9	+CG
barcode01_consensus_vsearch	4203	G	*/-A	534	13	2.31%	2	1	93	93	1.1357615375318739E-4	1	1	218	316	13	0	-A
barcode01_consensus_vsearch	4204	A	*/-G	521	19	3.45%	2	2	93	93	1.6235469314922575E-6	1	1	200	321	16	3	-G
barcode01_consensus_vsearch	4206	G	*/+T	544	9	1.6%	2	1	93	93	0.0018900976825545202	1	1	221	323	9	0	+T
barcode01_consensus_vsearch	4209	T	*/-G	505	52	9.2%	2	1	93	93	6.371305416001793E-17	1	1	235	270	0	52	-G
barcode01_consensus_vsearch	4212	A	*/+T	537	10	1.79%	2	1	93	93	9.368699288806099E-4	1	1	235	302	0	10	+T
barcode01_consensus_vsearch	4214	C	*/-T	533	15	2.69%	2	2	93	93	2.7693911463208213E-5	1	1	229	304	3	12	-T
barcode01_consensus_vsearch	4215	T	*/-A	530	7	1.28%	2	2	93	93	0.007660312408999644	1	1	227	303	5	2	-A
barcode01_consensus_vsearch	4222	C	*/-AC	545	11	1.95%	2	1	93	93	4.6449877293201324E-4	1	1	226	319	11	0	-AC
barcode01_consensus_vsearch	4226	T	*/-C	543	12	2.13%	2	1	93	93	2.2990389605394288E-4	1	1	220	323	12	0	-C
barcode01_consensus_vsearch	4231	T	*/-C	536	8	1.42%	2	1	93	93	0.003806323277364471	1	1	234	302	0	8	-C
barcode01_consensus_vsearch	4231	T	*/-CT	536	11	1.96%	2	1	93	93	4.6411360868119984E-4	1	1	234	302	0	11	-CT
barcode01_consensus_vsearch	4232	C	*/-T	510	16	2.94%	2	1	93	93	1.3590583249330675E-5	1	1	233	277	0	16	-T
barcode01_consensus_vsearch	4234	T	*/+G	545	9	1.6%	2	2	93	93	0.001890210465296116	1	1	232	313	1	8	+G
barcode01_consensus_vsearch	4239	T	*/-G	548	7	1.24%	2	2	93	93	0.007665230254675653	1	1	232	316	3	4	-G
barcode01_consensus_vsearch	4249	G	*/-TG	544	11	1.96%	2	2	93	93	4.6445658412336564E-4	1	1	224	320	6	5	-TG
barcode01_consensus_vsearch	4255	G	*/-T	547	8	1.43%	2	1	93	93	0.003808292093894457	1	1	232	315	0	8	-T
barcode01_consensus_vsearch	4263	T	*/+C	509	22	3.98%	2	2	93	93	1.9094844568686073E-7	1	1	218	291	3	19	+C
barcode01_consensus_vsearch	4263	T	*/-C	509	20	3.62%	2	2	93	93	7.942158977765082E-7	1	1	218	291	16	4	+C
barcode01_consensus_vsearch	4277	C	*/-G	541	8	1.43%	2	2	93	93	0.003807227915540985	1	1	229	312	3	5	-G
barcode01_consensus_vsearch	4291	C	*/+A	497	19	3.36%	2	2	93	93	1.6112053361048563E-6	1	1	209	288	5	14	+A
barcode01_consensus_vsearch	4291	C	*/-A	497	47	8.32%	2	2	93	93	2.515792886439792E-15	1	1	209	288	23	24	-A
barcode01_consensus_vsearch	4297	T	*/-C	505	56	9.91%	2	2	93	93	3.2728523008760013E-18	1	1	235	270	2	54	-C
barcode01_consensus_vsearch	4301	C	*/+T	545	10	1.77%	2	1	93	93	9.374353074031662E-4	1	1	238	307	0	10	+T
barcode01_consensus_vsearch	4301	C	*/-T	545	7	1.24%	2	1	93	93	0.007664432804486939	1	1	238	307	0	7	+T
barcode01_consensus_vsearch	4304	T	*/+CT	549	7	1.25%	2	1	93	93	0.007665494166045835	1	1	235	314	0	7	+CT
barcode01_consensus_vsearch	4354	T	*/-A	533	20	3.54%	2	2	93	93	8.006624381481838E-7	1	1	211	322	18	2	-A
barcode01_consensus_vsearch	4361	T	*/+C	529	16	2.84%	2	1	93	93	1.3646348443780324E-5	1	1	216	313	16	0	+C
barcode01_consensus_vsearch	4361	T	*/-C	529	7	1.24%	2	1	93	93	0.007660029547299292	1	1	216	313	0	7	+C
barcode01_consensus_vsearch	4362	C	*/+T	503	32	5.78%	2	1	93	93	1.4440563695621966E-10	1	1	233	270	0	32	+T
barcode01_consensus_vsearch	4362	C	*/-T	503	18	3.25%	2	2	93	93	3.2854806049934338E-6	1	1	233	270	1	17	+T
barcode01_consensus_vsearch	4363	T	*/+G	513	12	2.21%	2	1	93	93	2.2910717513474195E-4	1	1	226	287	0	12	+G
barcode01_consensus_vsearch	4369	C	*/-T	373	7	1.25%	2	1	93	93	0.007597769697997662	1	1	226	147	0	7	-T
barcode01_consensus_vsearch	4369	C	*/-TC	373	179	31.85%	2	2	93	93	3.916505422881116E-62	1	1	226	147	12	167	-TC
barcode01_consensus_vsearch	4382	C	*/-T	549	7	1.24%	2	2	93	93	0.007665494166045835	1	1	235	314	1	6	-T
barcode01_consensus_vsearch	4387	T	*/-C	546	9	1.6%	2	1	93	93	0.001890322845155412	1	1	228	318	9	0	-C
barcode01_consensus_vsearch	4389	C	*/+G	548	7	1.24%	2	1	93	93	0.007665230254675653	1	1	233	315	0	7	+G
barcode01_consensus_vsearch	4392	T	*/-G	553	7	1.24%	2	1	93	93	0.00766654042031271	1	1	237	316	0	7	-G
