Chrom	Position	Ref	Cons	Reads1	Reads2	VarFreq	Strands1	Strands2	Qual1	Qual2	Pvalue	MapQual1	MapQual2	Reads1Plus	Reads1Minus	Reads2Plus	Reads2Minus	VarAllele
barcode32_consensus_vsearch	5	G	*/-T	334	23	6.34%	2	1	93	93	8.267729573786586E-8	1	1	200	134	23	0	-T
barcode32_consensus_vsearch	26	T	*/+C	314	9	1.81%	2	2	93	93	0.0018458842535959892	1	1	201	113	4	5	+C
barcode32_consensus_vsearch	26	T	*/-C	314	160	32.26%	2	2	93	93	6.034373345669113E-56	1	1	201	113	17	143	-C
barcode32_consensus_vsearch	26	T	*/-CC	314	10	2.02%	2	2	93	93	9.101036737212366E-4	1	1	201	113	7	3	-C
barcode32_consensus_vsearch	34	T	*/-C	475	15	3.01%	2	1	93	93	2.7372718800438504E-5	1	1	211	264	15	0	-C
barcode32_consensus_vsearch	74	C	*/+A	484	7	1.4%	2	1	93	93	0.007646113201788858	1	1	218	266	7	0	+A
barcode32_consensus_vsearch	76	G	*/-C	460	21	4.22%	2	1	93	93	3.81499356408219E-7	1	1	193	267	21	0	-C
barcode32_consensus_vsearch	84	C	*/-T	484	7	1.41%	2	2	93	93	0.007646113201788858	1	1	229	255	1	6	-T
barcode32_consensus_vsearch	89	A	*/+T	467	15	3.06%	2	1	93	93	2.7322596448303877E-5	1	1	227	240	0	15	+T
barcode32_consensus_vsearch	90	A	*/-G	449	15	3.04%	2	2	93	93	2.720376910801439E-5	1	1	224	225	3	12	-G
barcode32_consensus_vsearch	90	A	*/-GGG	449	9	1.82%	2	1	93	93	0.001877161257840413	1	1	224	225	0	9	-G
barcode32_consensus_vsearch	96	T	*/+C	483	7	1.41%	2	1	93	93	0.007645775038504135	1	1	221	262	7	0	+C
barcode32_consensus_vsearch	98	A	*/+G	463	14	2.85%	2	1	93	93	5.540609994561752E-5	1	1	225	238	0	14	+G
barcode32_consensus_vsearch	101	A	*/-C	460	21	4.22%	2	2	93	93	3.81499356408219E-7	1	1	211	249	10	11	-C
barcode32_consensus_vsearch	104	C	*/-G	469	22	4.41%	2	2	93	93	1.8744924457634513E-7	1	1	228	241	2	20	-G
barcode32_consensus_vsearch	111	T	*/-G	452	25	5.07%	2	2	93	93	2.1580602526326585E-8	1	1	205	247	12	13	-G
barcode32_consensus_vsearch	113	G	*/+A	475	7	1.41%	2	2	93	93	0.007643019431907797	1	1	225	250	2	5	+A
barcode32_consensus_vsearch	113	G	*/-A	475	11	2.21%	2	2	93	93	4.611337655353414E-4	1	1	225	250	2	9	-A
barcode32_consensus_vsearch	116	G	*/+C	481	8	1.61%	2	2	93	93	0.003795159536553975	1	1	222	259	3	5	+C
barcode32_consensus_vsearch	118	C	*/-TC	472	14	2.81%	2	1	93	93	5.550687631584109E-5	1	1	231	241	0	14	-TC
barcode32_consensus_vsearch	119	T	*/-C	439	22	4.58%	2	2	93	93	1.844686308264858E-7	1	1	209	230	21	1	-C
barcode32_consensus_vsearch	119	T	*/-CC	439	10	2.08%	2	1	93	93	9.283331329900578E-4	1	1	209	230	0	10	-C
barcode32_consensus_vsearch	121	C	*/-G	466	13	2.66%	2	2	93	93	1.1240391866883229E-4	1	1	227	239	2	11	-G
barcode32_consensus_vsearch	126	G	*/+A	466	9	1.82%	2	1	93	93	0.0018798524523993853	1	1	202	264	9	0	+A
barcode32_consensus_vsearch	127	G	*/-T	458	19	3.82%	2	2	93	93	1.5886940404524131E-6	1	1	197	261	17	2	-T
barcode32_consensus_vsearch	130	G	*/+C	389	7	1.43%	2	2	93	93	0.0076064012202881484	1	1	131	258	6	1	+C
barcode32_consensus_vsearch	130	G	*/-C	389	80	16.39%	2	2	93	93	2.073673918938244E-26	1	1	131	258	75	5	-C
barcode32_consensus_vsearch	131	C	*/+T	373	19	4.63%	2	1	93	93	1.5254799460974752E-6	1	1	138	235	0	19	+T
barcode32_consensus_vsearch	133	C	*/-G	455	8	1.61%	2	2	93	93	0.003788965477306861	1	1	214	241	2	6	-G
barcode32_consensus_vsearch	137	T	*/+GA	465	7	1.41%	2	1	93	93	0.007639444132665198	1	1	208	257	7	0	+GA
barcode32_consensus_vsearch	146	C	*/+T	488	8	1.6%	2	1	93	93	0.0037967169586205873	1	1	230	258	0	8	+T
barcode32_consensus_vsearch	147	C	*/-T	489	8	1.6%	2	2	93	93	0.0037969358900811403	1	1	228	261	3	5	-T
barcode32_consensus_vsearch	149	G	*/-C	485	7	1.41%	2	2	93	93	0.007646449996103257	1	1	227	258	1	6	-C
barcode32_consensus_vsearch	150	C	*/-T	469	7	1.43%	2	1	93	93	0.007640892201856266	1	1	228	241	0	7	-T
barcode32_consensus_vsearch	150	C	*/-TC	469	7	1.43%	2	1	93	93	0.007640892201856266	1	1	228	241	0	7	-T
barcode32_consensus_vsearch	151	T	*/+C	401	12	2.48%	2	2	93	93	2.251372974218295E-4	1	1	215	186	6	6	+C
barcode32_consensus_vsearch	151	T	*/-C	401	66	13.64%	2	2	93	93	1.1439096602230793E-21	1	1	215	186	8	58	-C
barcode32_consensus_vsearch	154	C	*/+A	394	8	1.61%	2	1	93	93	0.0037713141940397903	1	1	206	188	8	0	+A
barcode32_consensus_vsearch	154	C	*/-A	394	65	13.05%	2	2	93	93	2.3640404788882874E-21	1	1	206	188	4	61	-A
barcode32_consensus_vsearch	154	C	*/-AA	394	12	2.41%	2	2	93	93	2.2481843544276345E-4	1	1	206	188	1	11	-A
barcode32_consensus_vsearch	156	A	*/-G	408	11	2.26%	2	1	93	93	4.5688172943049915E-4	1	1	215	193	11	0	-G
barcode32_consensus_vsearch	158	C	*/+A	480	12	2.4%	2	1	93	93	2.2812107221508167E-4	1	1	214	266	12	0	+A
barcode32_consensus_vsearch	161	T	*/-C	475	16	3.21%	2	1	93	93	1.3477087849748697E-5	1	1	207	268	16	0	-C
barcode32_consensus_vsearch	163	C	*/-G	482	8	1.6%	2	1	93	93	0.0037953847313509786	1	1	219	263	8	0	-G
barcode32_consensus_vsearch	164	G	*/-C	465	12	2.46%	2	1	93	93	2.2762878163700055E-4	1	1	197	268	12	0	-C
barcode32_consensus_vsearch	167	C	*/+A	458	8	1.6%	2	2	93	93	0.0037897152001668	1	1	199	259	4	4	+A
barcode32_consensus_vsearch	167	C	*/-A	458	18	3.61%	2	2	93	93	3.2385570492970216E-6	1	1	199	259	15	3	-A
barcode32_consensus_vsearch	180	A	*/-C	474	9	1.81%	2	2	93	93	0.0018810540052625968	1	1	216	258	2	7	-C
barcode32_consensus_vsearch	181	C	*/+T	475	10	2.05%	2	1	93	93	9.318644876872256E-4	1	1	225	250	0	10	+T
barcode32_consensus_vsearch	185	A	*/+C	467	10	2%	2	2	93	93	9.311251637351389E-4	1	1	216	251	1	9	+C
barcode32_consensus_vsearch	185	A	*/-C	467	7	1.4%	2	2	93	93	0.007640171209119411	1	1	216	251	1	6	+C
barcode32_consensus_vsearch	188	C	*/-T	470	20	4%	2	2	93	93	7.825008890635863E-7	1	1	224	246	1	19	-T
barcode32_consensus_vsearch	190	T	*/-A	477	7	1.41%	2	2	93	93	0.0076437168376962865	1	1	215	262	6	1	-A
barcode32_consensus_vsearch	198	A	*/-TC	480	7	1.4%	2	1	93	93	0.007644752250974145	1	1	230	250	0	7	-TC
barcode32_consensus_vsearch	199	T	*/+C	461	7	1.44%	2	2	93	93	0.007637971418043615	1	1	214	247	6	1	+C
barcode32_consensus_vsearch	199	T	*/-C	461	13	2.67%	2	2	93	93	1.1230483155649456E-4	1	1	214	247	9	4	-C
barcode32_consensus_vsearch	201	C	*/-T	475	13	2.61%	2	1	93	93	1.1257730181393008E-4	1	1	228	247	0	13	-T
barcode32_consensus_vsearch	205	T	*/-C	473	8	1.61%	2	2	93	93	0.0037933245016082413	1	1	208	265	7	1	-C
barcode32_consensus_vsearch	205	T	*/-CC	473	13	2.62%	2	1	93	93	1.1253931160046193E-4	1	1	208	265	13	0	-CC
barcode32_consensus_vsearch	208	C	*/+G	466	15	3.01%	2	1	93	93	2.7316218709712403E-5	1	1	224	242	0	15	+G
barcode32_consensus_vsearch	223	G	*/-T	468	17	3.41%	2	2	93	93	6.6151932289237184E-6	1	1	212	256	11	6	-T
barcode32_consensus_vsearch	235	T	*/+C	365	19	3.81%	2	2	93	93	1.518220570262078E-6	1	1	199	166	1	18	+C
barcode32_consensus_vsearch	235	T	*/-C	365	103	20.64%	2	2	93	93	1.777867923335843E-34	1	1	199	166	25	78	-C
barcode32_consensus_vsearch	237	C	*/+A	481	9	1.83%	2	1	93	93	0.0018820734984676631	1	1	217	264	9	0	+A
barcode32_consensus_vsearch	238	C	*/+T	462	10	2.02%	2	1	93	93	9.306505389952973E-4	1	1	228	234	0	10	+T
barcode32_consensus_vsearch	238	C	*/-T	462	11	2.22%	2	2	93	93	4.6040119257224194E-4	1	1	228	234	1	10	-T
barcode32_consensus_vsearch	243	C	*/-T	483	12	2.41%	2	2	93	93	2.2821602994011232E-4	1	1	221	262	6	6	-T
barcode32_consensus_vsearch	257	C	*/-A	492	7	1.4%	2	2	93	93	0.007648769914171423	1	1	226	266	5	2	-A
barcode32_consensus_vsearch	261	C	*/+A	488	7	1.4%	2	1	93	93	0.007647452247954883	1	1	223	265	7	0	+A
barcode32_consensus_vsearch	275	C	*/-T	468	15	3.04%	2	2	93	93	2.73289488521999E-5	1	1	218	250	4	11	-T
barcode32_consensus_vsearch	277	T	*/-G	423	57	11.45%	2	2	93	93	1.1847433209211717E-18	1	1	213	210	5	52	-G
barcode32_consensus_vsearch	290	C	*/-G	474	7	1.42%	2	2	93	93	0.00764266856336234	1	1	228	246	1	6	-G
barcode32_consensus_vsearch	311	G	*/-TG	488	7	1.41%	2	1	93	93	0.007647452247954883	1	1	228	260	0	7	-TG
barcode32_consensus_vsearch	312	T	*/+A	471	7	1.42%	2	1	93	93	0.007641607186910932	1	1	220	251	7	0	+A
barcode32_consensus_vsearch	314	A	*/-G	465	20	4.04%	2	1	93	93	7.808737410384608E-7	1	1	201	264	20	0	-G
barcode32_consensus_vsearch	315	G	*/-A	456	9	1.88%	2	1	93	93	0.0018782929787467238	1	1	188	268	9	0	-A
barcode32_consensus_vsearch	315	G	*/-AA	456	10	2.09%	2	1	93	93	9.300677370579054E-4	1	1	188	268	10	0	-AA
barcode32_consensus_vsearch	322	T	*/-C	478	13	2.61%	2	2	93	93	1.1263372295721515E-4	1	1	225	253	2	11	-C
barcode32_consensus_vsearch	326	T	*/+C	404	12	2.43%	2	1	93	93	2.2527075525117761E-4	1	1	167	237	0	12	+C
barcode32_consensus_vsearch	326	T	*/-C	404	75	15.18%	2	2	93	93	1.1403727641291976E-24	1	1	167	237	62	13	-C
barcode32_consensus_vsearch	334	A	*/+T	462	15	3.04%	2	1	93	93	2.7290451356177234E-5	1	1	198	264	15	0	+T
barcode32_consensus_vsearch	334	A	*/-T	462	14	2.83%	2	2	93	93	5.539467548962186E-5	1	1	198	264	12	2	+T
barcode32_consensus_vsearch	339	C	*/-A	480	9	1.81%	2	2	93	93	0.0018819296258635499	1	1	220	260	7	2	-A
barcode32_consensus_vsearch	341	A	*/-G	452	42	8.43%	2	2	93	93	9.152720257482155E-14	1	1	224	228	6	36	-G
barcode32_consensus_vsearch	351	A	*/+G	475	12	2.42%	2	2	93	93	2.2796026847120298E-4	1	1	214	261	9	3	+G
barcode32_consensus_vsearch	352	G	*/+A	403	12	2.43%	2	2	93	93	2.252264779649526E-4	1	1	144	259	11	1	+A
barcode32_consensus_vsearch	352	G	*/-A	403	9	1.82%	2	2	93	93	0.0018687788150290171	1	1	144	259	8	1	+A
barcode32_consensus_vsearch	352	G	*/-AG	403	60	12.15%	2	2	93	93	1.1229710522347233E-19	1	1	144	259	55	5	-AG
barcode32_consensus_vsearch	358	A	*/-C	481	11	2.21%	2	2	93	93	4.61459050447595E-4	1	1	219	262	6	5	-C
barcode32_consensus_vsearch	370	A	*/-GA	474	15	3.04%	2	1	93	93	2.7366539591447386E-5	1	1	207	267	15	0	-GA
barcode32_consensus_vsearch	381	G	*/+C	480	11	2.2%	2	1	93	93	4.6140537857478075E-4	1	1	228	252	0	11	+C
barcode32_consensus_vsearch	384	C	*/+T	464	14	2.83%	2	1	93	93	5.5417478251858426E-5	1	1	229	235	0	14	+T
barcode32_consensus_vsearch	388	C	*/-G	476	8	1.61%	2	2	93	93	0.0037940196998724205	1	1	226	250	1	7	-G
barcode32_consensus_vsearch	395	T	*/-A	486	7	1.4%	2	2	93	93	0.007646785429777685	1	1	225	261	2	5	-A
barcode32_consensus_vsearch	398	A	*/+C	434	12	2.4%	2	2	93	93	2.2650904494607855E-4	1	1	173	261	10	2	+C
barcode32_consensus_vsearch	398	A	*/-C	434	48	9.6%	2	2	93	93	1.0370616087142262E-15	1	1	173	261	44	4	-C
barcode32_consensus_vsearch	401	C	*/-T	481	11	2.2%	2	1	93	93	4.61459050447595E-4	1	1	230	251	0	11	-T
barcode32_consensus_vsearch	405	C	*/-T	479	16	3.21%	2	2	93	93	1.3490833331351945E-5	1	1	227	252	1	15	-T
barcode32_consensus_vsearch	406	T	*/+C	457	9	1.87%	2	2	93	93	0.0018784519065768144	1	1	205	252	7	2	+C
barcode32_consensus_vsearch	406	T	*/-C	457	13	2.7%	2	1	93	93	1.122240880099708E-4	1	1	205	252	13	0	-C
barcode32_consensus_vsearch	408	C	*/-G	483	10	2%	2	1	93	93	9.325801412601721E-4	1	1	228	255	0	10	-G
barcode32_consensus_vsearch	412	C	*/+A	473	14	2.82%	2	2	93	93	5.551785156036872E-5	1	1	228	245	1	13	+A
barcode32_consensus_vsearch	412	C	*/-A	473	7	1.41%	2	1	93	93	0.007642316239083064	1	1	228	245	0	7	+A
barcode32_consensus_vsearch	422	T	*/+C	484	8	1.6%	2	1	93	93	0.0037958323931522003	1	1	220	264	8	0	+C
barcode32_consensus_vsearch	424	A	*/+G	469	10	2.02%	2	2	93	93	9.313122777676234E-4	1	1	215	254	5	5	+G
barcode32_consensus_vsearch	439	T	*/-A	481	11	2.2%	2	2	93	93	4.61459050447595E-4	1	1	217	264	8	3	-A
barcode32_consensus_vsearch	442	G	*/-A	479	10	2.01%	2	1	93	93	9.32225201663148E-4	1	1	213	266	10	0	-A
barcode32_consensus_vsearch	445	G	*/+A	322	57	11.7%	2	2	93	93	7.11452109242659E-19	1	1	120	202	23	34	+A
barcode32_consensus_vsearch	445	G	*/-A	322	84	17.25%	2	2	93	93	4.27299108703011E-28	1	1	120	202	55	29	-A
barcode32_consensus_vsearch	445	G	*/-AAA	322	13	2.67%	2	1	93	93	1.0841418786432788E-4	1	1	120	202	13	0	-A
barcode32_consensus_vsearch	449	A	*/-G	473	15	3.04%	2	1	93	93	2.7360336076732557E-5	1	1	206	267	15	0	-G
barcode32_consensus_vsearch	451	A	*/-GA	469	14	2.85%	2	2	93	93	5.547368722232185E-5	1	1	207	262	12	2	-GA
barcode32_consensus_vsearch	455	C	*/-T	475	16	3.22%	2	1	93	93	1.3477087849748697E-5	1	1	230	245	0	16	-T
barcode32_consensus_vsearch	457	C	*/-T	461	34	6.85%	2	2	93	93	3.237491413805929E-11	1	1	227	234	2	32	-T
barcode32_consensus_vsearch	459	G	*/-C	473	13	2.61%	2	2	93	93	1.1253931160046193E-4	1	1	212	261	8	5	-C
barcode32_consensus_vsearch	462	C	*/+G	459	7	1.4%	2	2	93	93	0.007637225621250393	1	1	223	236	2	5	+G
barcode32_consensus_vsearch	462	C	*/-G	459	16	3.2%	2	2	93	93	1.3419903067028988E-5	1	1	223	236	3	13	-G
barcode32_consensus_vsearch	466	G	*/-C	370	120	24%	2	2	93	93	1.8246087965997886E-40	1	1	172	198	53	67	-C
barcode32_consensus_vsearch	484	G	*/-CG	481	13	2.62%	2	2	93	93	1.1268947774239521E-4	1	1	227	254	1	12	-CG
barcode32_consensus_vsearch	488	T	*/+C	485	7	1.4%	2	1	93	93	0.007646449996103257	1	1	223	262	7	0	+C
barcode32_consensus_vsearch	505	C	*/+A	431	14	2.85%	2	1	93	93	5.501599410545798E-5	1	1	216	215	0	14	+A
barcode32_consensus_vsearch	505	C	*/-A	431	35	7.11%	2	2	93	93	1.499555803358195E-11	1	1	216	215	8	27	-A
barcode32_consensus_vsearch	516	T	*/-C	479	18	3.62%	2	1	93	93	3.2614469292433853E-6	1	1	211	268	18	0	-C
barcode32_consensus_vsearch	523	G	*/-C	489	8	1.6%	2	2	93	93	0.0037969358900811403	1	1	221	268	7	1	-C
barcode32_consensus_vsearch	525	C	*/-G	488	8	1.6%	2	2	93	93	0.0037967169586205873	1	1	226	262	3	5	-G
barcode32_consensus_vsearch	540	C	*/-T	477	15	3.02%	2	2	93	93	2.7385004869631912E-5	1	1	224	253	2	13	-T
barcode32_consensus_vsearch	542	T	*/-C	335	127	25.71%	2	2	93	93	2.4753202692733367E-43	1	1	201	134	19	108	-C
barcode32_consensus_vsearch	542	T	*/-CC	335	12	2.43%	2	1	93	93	2.2163604035931107E-4	1	1	201	134	0	12	-C
barcode32_consensus_vsearch	544	C	*/+T	457	10	2.09%	2	1	93	93	9.301658958586232E-4	1	1	224	233	0	10	+T
barcode32_consensus_vsearch	545	C	*/+T	331	27	5.51%	2	2	93	93	4.477667815426522E-9	1	1	217	114	6	21	+T
barcode32_consensus_vsearch	545	C	*/+TT	331	9	1.84%	2	1	93	93	0.0018511701245308928	1	1	217	114	0	9	+T
barcode32_consensus_vsearch	545	C	*/-T	331	43	8.78%	2	2	93	93	3.1586499822809585E-14	1	1	217	114	4	39	-T
barcode32_consensus_vsearch	545	C	*/-TT	331	40	8.16%	2	2	93	93	2.994608669172783E-13	1	1	217	114	2	38	-T
barcode32_consensus_vsearch	545	C	*/-TTTC	331	12	2.45%	2	1	93	93	2.2138194180680858E-4	1	1	217	114	0	12	-T
barcode32_consensus_vsearch	548	T	*/-C	416	51	10.67%	2	2	93	93	1.0480644003881796E-16	1	1	224	192	3	48	-C
barcode32_consensus_vsearch	549	C	*/-G	376	7	1.62%	2	2	93	93	0.007599442747600996	1	1	220	156	2	5	-G
barcode32_consensus_vsearch	549	C	*/-GCC	376	22	5.09%	2	2	93	93	1.7692620972051166E-7	1	1	220	156	2	20	-GCC
barcode32_consensus_vsearch	550	G	*/-C	436	9	1.96%	2	2	93	93	0.0018749660605302289	1	1	217	219	3	6	-C
barcode32_consensus_vsearch	553	A	*/-TA	467	12	2.46%	2	2	93	93	2.2769616072969756E-4	1	1	225	242	1	11	-TA
barcode32_consensus_vsearch	554	T	*/+A	451	7	1.46%	2	1	93	93	0.007634177589087493	1	1	228	223	0	7	+A
barcode32_consensus_vsearch	556	C	*/+G	411	15	3.04%	2	2	93	93	2.6921453674127367E-5	1	1	216	195	1	14	+G
barcode32_consensus_vsearch	556	C	*/-G	411	28	5.67%	2	2	93	93	2.388398459462071E-9	1	1	216	195	9	19	-G
barcode32_consensus_vsearch	556	C	*/-GG	411	20	4.05%	2	2	93	93	7.611138031103958E-7	1	1	216	195	4	16	-G
barcode32_consensus_vsearch	561	C	*/+A	475	11	2.21%	2	1	93	93	4.611337655353414E-4	1	1	227	248	0	11	+A
barcode32_consensus_vsearch	568	G	*/-C	439	38	7.66%	2	2	93	93	1.6890492495921027E-12	1	1	212	227	5	33	-C
barcode32_consensus_vsearch	568	G	*/-CC	439	13	2.62%	2	2	93	93	1.1184359100871172E-4	1	1	212	227	11	2	-C
barcode32_consensus_vsearch	572	C	*/-T	415	65	13%	2	2	93	93	2.6511243250355647E-21	1	1	219	196	3	62	-T
barcode32_consensus_vsearch	576	G	*/+A	453	9	1.81%	2	1	93	93	0.0018778121106653614	1	1	206	247	0	9	+A
barcode32_consensus_vsearch	576	G	*/-A	453	25	5.04%	2	2	93	93	2.159556775118174E-8	1	1	206	247	13	12	-A
barcode32_consensus_vsearch	580	C	*/+G	443	24	4.87%	2	1	93	93	4.4016730385165736E-8	1	1	208	235	0	24	+G
barcode32_consensus_vsearch	580	C	*/+T	443	8	1.62%	2	2	93	93	0.003785867578538486	1	1	208	235	7	1	+G
barcode32_consensus_vsearch	582	G	*/+A	489	7	1.4%	2	2	93	93	0.007647783648781579	1	1	228	261	1	6	+A
barcode32_consensus_vsearch	587	T	*/-C	395	97	19.4%	2	2	93	93	3.289924608714953E-32	1	1	190	205	39	58	-C
barcode32_consensus_vsearch	590	C	*/-T	486	9	1.8%	2	2	93	93	0.001882784227427251	1	1	228	258	2	7	-T
barcode32_consensus_vsearch	599	A	*/-G	451	19	3.81%	2	1	93	93	1.5842873954953467E-6	1	1	209	242	0	19	-G
barcode32_consensus_vsearch	604	C	*/-G	476	8	1.61%	2	2	93	93	0.0037940196998724205	1	1	214	262	6	2	-G
barcode32_consensus_vsearch	610	A	*/-C	482	9	1.8%	2	2	93	93	0.0018822167908263267	1	1	216	266	6	3	-C
barcode32_consensus_vsearch	617	T	*/-C	474	23	4.6%	2	1	93	93	9.187559655014242E-8	1	1	205	269	23	0	-C
barcode32_consensus_vsearch	631	A	*/-CA	476	17	3.42%	2	2	93	93	6.630785443026535E-6	1	1	214	262	12	5	-CA
barcode32_consensus_vsearch	640	C	*/-T	467	27	5.4%	2	2	93	93	5.171647194563027E-9	1	1	228	239	1	26	-T
barcode32_consensus_vsearch	643	T	*/+C	406	15	3%	2	2	93	93	2.6880690187417594E-5	1	1	202	204	3	12	+C
barcode32_consensus_vsearch	643	T	*/-C	406	70	14%	2	2	93	93	5.472720554847782E-23	1	1	202	204	23	47	-C
barcode32_consensus_vsearch	647	C	*/-AC	489	7	1.4%	2	1	93	93	0.007647783648781579	1	1	222	267	7	0	-AC
barcode32_consensus_vsearch	660	C	*/-A	480	7	1.4%	2	2	93	93	0.007644752250974145	1	1	222	258	4	3	-A
barcode32_consensus_vsearch	677	A	*/-T	485	8	1.6%	2	2	93	93	0.003796054871155719	1	1	223	262	4	4	-T
barcode32_consensus_vsearch	691	C	*/+T	466	10	2.05%	2	1	93	93	9.310310253206723E-4	1	1	217	249	0	10	+T
barcode32_consensus_vsearch	704	T	*/-A	464	16	3.21%	2	2	93	93	1.3438163175026509E-5	1	1	211	253	15	1	-A
barcode32_consensus_vsearch	705	A	*/+G	473	7	1.45%	2	2	93	93	0.007642316239083064	1	1	213	260	1	6	+G
barcode32_consensus_vsearch	706	G	*/-A	482	7	1.41%	2	1	93	93	0.007645435497920978	1	1	217	265	7	0	-A
barcode32_consensus_vsearch	707	A	*/-G	471	15	3.05%	2	1	93	93	2.7347855554444646E-5	1	1	207	264	15	0	-G
barcode32_consensus_vsearch	712	G	*/+C	482	7	1.41%	2	1	93	93	0.007645435497920978	1	1	222	260	0	7	+C
barcode32_consensus_vsearch	712	G	*/+T	482	7	1.41%	2	1	93	93	0.007645435497920978	1	1	222	260	7	0	+C
barcode32_consensus_vsearch	715	C	*/-T	489	9	1.8%	2	2	93	93	0.0018832038811610028	1	1	227	262	3	6	-T
barcode32_consensus_vsearch	716	T	*/+A	447	8	1.64%	2	1	93	93	0.0037869182351470006	1	1	205	242	0	8	+A
barcode32_consensus_vsearch	716	T	*/-AC	447	18	3.68%	2	1	93	93	3.22579636303218E-6	1	1	205	242	18	0	-AC
barcode32_consensus_vsearch	717	A	*/-C	448	13	2.73%	2	2	93	93	1.1203744361480323E-4	1	1	194	254	4	9	-C
barcode32_consensus_vsearch	717	A	*/-CC	448	7	1.47%	2	2	93	93	0.00763300706774014	1	1	194	254	6	1	-C
barcode32_consensus_vsearch	718	C	*/+T	427	23	5%	2	2	93	93	8.934721786040063E-8	1	1	200	227	1	22	+T
barcode32_consensus_vsearch	720	C	*/-G	460	7	1.4%	2	2	93	93	0.007637599314660889	1	1	227	233	2	5	-G
barcode32_consensus_vsearch	720	C	*/-GG	460	13	2.6%	2	1	93	93	1.1228477000319914E-4	1	1	227	233	0	13	-GG
barcode32_consensus_vsearch	726	C	*/-AC	482	8	1.61%	2	1	93	93	0.0037953847313509786	1	1	218	264	8	0	-AC
barcode32_consensus_vsearch	729	G	*/-C	422	65	13.16%	2	2	93	93	2.7478788630167745E-21	1	1	158	264	64	1	-C
barcode32_consensus_vsearch	730	C	*/+T	420	7	1.62%	2	1	93	93	0.007621292853586086	1	1	163	257	0	7	+T
barcode32_consensus_vsearch	732	C	*/-T	480	7	1.4%	2	2	93	93	0.007644752250974145	1	1	218	262	4	3	-T
barcode32_consensus_vsearch	733	T	*/+G	456	13	2.64%	2	1	93	93	1.1220369318586293E-4	1	1	200	256	13	0	+G
barcode32_consensus_vsearch	734	A	*/-G	470	8	1.62%	2	2	93	93	0.0037926206375474623	1	1	214	256	5	3	-G
barcode32_consensus_vsearch	735	G	*/+A	453	7	1.43%	2	1	93	93	0.00763494949227727	1	1	189	264	7	0	+A
barcode32_consensus_vsearch	739	T	*/+C	483	7	1.41%	2	1	93	93	0.007645775038504135	1	1	224	259	0	7	+C
barcode32_consensus_vsearch	740	C	*/+T	487	7	1.41%	2	1	93	93	0.007647119511005615	1	1	228	259	0	7	+T
barcode32_consensus_vsearch	751	T	*/-CCA	476	7	1.42%	2	1	93	93	0.0076433688537074695	1	1	214	262	7	0	-CCA
barcode32_consensus_vsearch	765	C	*/-T	431	28	5.61%	2	1	93	93	2.4365834044236508E-9	1	1	229	202	0	28	-T
barcode32_consensus_vsearch	765	C	*/-TC	431	39	7.82%	2	2	93	93	7.993694385127283E-13	1	1	229	202	1	38	-TC
barcode32_consensus_vsearch	766	T	*/+C	392	22	5.09%	2	2	93	93	1.79033196422273E-7	1	1	220	172	8	14	+C
barcode32_consensus_vsearch	766	T	*/-C	392	12	2.78%	2	1	93	93	2.2472535825225005E-4	1	1	220	172	0	12	+C
barcode32_consensus_vsearch	776	A	*/-T	486	8	1.6%	2	1	93	93	0.0037962764544926452	1	1	227	259	0	8	-T
barcode32_consensus_vsearch	796	G	*/-AG	469	16	3.25%	2	2	93	93	1.3456064691647558E-5	1	1	206	263	14	2	-AG
barcode32_consensus_vsearch	797	A	*/-G	457	13	2.73%	2	2	93	93	1.122240880099708E-4	1	1	200	257	9	4	-G
barcode32_consensus_vsearch	802	T	*/-G	468	9	1.83%	2	2	93	93	0.0018801565806267238	1	1	222	246	3	6	-G
barcode32_consensus_vsearch	808	A	*/-G	466	8	1.63%	2	1	93	93	0.0037916683896426647	1	1	205	261	8	0	-G
barcode32_consensus_vsearch	811	C	*/+A	427	51	10.3%	2	1	93	93	1.0855243109960514E-16	1	1	160	267	51	0	+A
barcode32_consensus_vsearch	811	C	*/+G	427	7	1.41%	2	1	93	93	0.007624362444354587	1	1	160	267	7	0	+A
barcode32_consensus_vsearch	813	C	*/-T	435	29	5.87%	2	2	93	93	1.1859692179355092E-9	1	1	183	252	17	12	-T
barcode32_consensus_vsearch	813	C	*/-TT	435	25	5.06%	2	1	93	93	2.1317669098559165E-8	1	1	183	252	25	0	-T
barcode32_consensus_vsearch	816	G	*/-A	469	21	4.22%	2	1	93	93	3.8309939360375244E-7	1	1	202	267	21	0	-A
barcode32_consensus_vsearch	827	A	*/+T	441	27	5.4%	2	2	93	93	5.064782223535546E-9	1	1	180	261	25	2	+T
barcode32_consensus_vsearch	827	A	*/-T	441	24	4.8%	2	2	93	93	4.395787401826721E-8	1	1	180	261	21	3	+T
barcode32_consensus_vsearch	831	T	*/+C	482	11	2.21%	2	1	93	93	4.615125084318156E-4	1	1	215	267	11	0	+C
barcode32_consensus_vsearch	846	T	*/-C	490	9	1.8%	2	1	93	93	0.0018833426553170954	1	1	230	260	0	9	-C
barcode32_consensus_vsearch	869	T	*/+C	479	8	1.6%	2	2	93	93	0.0037947063913870826	1	1	212	267	7	1	+C
barcode32_consensus_vsearch	869	T	*/-C	479	8	1.6%	2	1	93	93	0.0037947063913870826	1	1	212	267	8	0	+C
barcode32_consensus_vsearch	871	C	*/-T	481	12	2.41%	2	2	93	93	2.2815285032269742E-4	1	1	227	254	1	11	-T
barcode32_consensus_vsearch	881	T	*/-C	488	7	1.4%	2	2	93	93	0.007647452247954883	1	1	226	262	3	4	-C
barcode32_consensus_vsearch	883	C	*/-G	483	7	1.4%	2	2	93	93	0.007645775038504135	1	1	222	261	3	4	-G
barcode32_consensus_vsearch	886	C	*/-T	473	15	3.02%	2	2	93	93	2.7360336076732557E-5	1	1	222	251	2	13	-T
barcode32_consensus_vsearch	888	T	*/-C	475	19	3.83%	2	2	93	93	1.5989128018653312E-6	1	1	222	253	5	14	-C
barcode32_consensus_vsearch	910	C	*/-A	489	9	1.8%	2	2	93	93	0.0018832038811610028	1	1	222	267	8	1	-A
barcode32_consensus_vsearch	926	C	*/+T	399	17	3.4%	2	2	93	93	6.4574101240949084E-6	1	1	212	187	6	11	+T
barcode32_consensus_vsearch	926	C	*/-T	399	57	11.4%	2	2	93	93	1.0727322376474148E-18	1	1	212	187	10	47	-T
barcode32_consensus_vsearch	926	C	*/-TT	399	22	4.4%	2	1	93	93	1.7991060895133482E-7	1	1	212	187	0	22	-T
barcode32_consensus_vsearch	931	G	*/-TG	486	9	1.8%	2	2	93	93	0.001882784227427251	1	1	220	266	8	1	-TG
barcode32_consensus_vsearch	944	A	*/-G	485	9	1.81%	2	2	93	93	0.001882643221311292	1	1	220	265	7	2	-G
barcode32_consensus_vsearch	952	C	*/-T	480	8	1.63%	2	1	93	93	0.0037949334251056385	1	1	225	255	0	8	-T
barcode32_consensus_vsearch	953	T	*/-C	459	16	3.3%	2	1	93	93	1.3419903067028988E-5	1	1	221	238	0	16	-C
barcode32_consensus_vsearch	954	C	*/+T	459	9	1.88%	2	1	93	93	0.0018787677458533404	1	1	225	234	0	9	+T
barcode32_consensus_vsearch	954	C	*/-T	459	7	1.46%	2	2	93	93	0.007637225621250393	1	1	225	234	1	6	+T
barcode32_consensus_vsearch	955	T	*/-G	460	15	3.08%	2	2	93	93	2.7277411668883823E-5	1	1	218	242	2	13	-G
barcode32_consensus_vsearch	961	C	*/+T	468	7	1.42%	2	1	93	93	0.007640532461160509	1	1	217	251	0	7	+T
barcode32_consensus_vsearch	961	C	*/-T	468	12	2.44%	2	2	93	93	2.2772964456396167E-4	1	1	217	251	4	8	-T
barcode32_consensus_vsearch	965	A	*/-C	479	10	2%	2	1	93	93	9.32225201663148E-4	1	1	227	252	0	10	-C
barcode32_consensus_vsearch	978	T	*/+C	483	10	2.01%	2	1	93	93	9.325801412601721E-4	1	1	230	253	0	10	+C
barcode32_consensus_vsearch	979	T	*/-C	486	9	1.81%	2	1	93	93	0.001882784227427251	1	1	230	256	0	9	-C
barcode32_consensus_vsearch	982	T	*/-C	453	33	6.63%	2	2	93	93	6.635712481722751E-11	1	1	194	259	27	6	-C
barcode32_consensus_vsearch	1001	C	*/+T	462	9	1.83%	2	2	93	93	0.0018792365273515336	1	1	217	245	1	8	+T
barcode32_consensus_vsearch	1001	C	*/-T	462	10	2.04%	2	2	93	93	9.306505389952973E-4	1	1	217	245	5	5	-T
barcode32_consensus_vsearch	1003	T	*/-A	482	9	1.81%	2	1	93	93	0.0018822167908263267	1	1	215	267	9	0	-A
barcode32_consensus_vsearch	1006	C	*/+A	418	19	3.8%	2	2	93	93	1.5617633199588545E-6	1	1	199	219	6	13	+A
barcode32_consensus_vsearch	1006	C	*/-A	418	56	11.2%	2	2	93	93	2.4686864577780773E-18	1	1	199	219	23	33	-A
barcode32_consensus_vsearch	1018	A	*/-C	486	8	1.61%	2	1	93	93	0.0037962764544926452	1	1	220	266	8	0	-C
barcode32_consensus_vsearch	1030	A	*/-CAT	480	13	2.6%	2	1	93	93	1.1267096612421377E-4	1	1	229	251	0	13	-CAT
barcode32_consensus_vsearch	1033	T	*/+C	466	18	3.7%	2	1	93	93	3.247496373666324E-6	1	1	231	235	0	18	+C
barcode32_consensus_vsearch	1034	T	*/-C	474	19	3.8%	2	1	93	93	1.5983298244217642E-6	1	1	226	248	0	19	-C
barcode32_consensus_vsearch	1035	C	*/+T	450	13	2.7%	2	1	93	93	1.120795287248837E-4	1	1	220	230	0	13	+T
barcode32_consensus_vsearch	1043	C	*/-AC	480	13	2.6%	2	1	93	93	1.1267096612421377E-4	1	1	213	267	13	0	-AC
barcode32_consensus_vsearch	1060	C	*/+A	476	7	1.41%	2	1	93	93	0.0076433688537074695	1	1	209	267	7	0	+A
barcode32_consensus_vsearch	1060	C	*/-A	476	11	2.21%	2	1	93	93	4.6118852633942285E-4	1	1	209	267	11	0	-A
barcode32_consensus_vsearch	1062	A	*/-G	477	13	2.62%	2	2	93	93	1.1261499053632246E-4	1	1	217	260	9	4	-G
barcode32_consensus_vsearch	1068	T	*/-C	464	9	1.81%	2	2	93	93	0.0018795457786723107	1	1	223	241	1	8	-C
barcode32_consensus_vsearch	1068	T	*/-CT	464	14	2.81%	2	1	93	93	5.5417478251858426E-5	1	1	223	241	0	14	-CT
barcode32_consensus_vsearch	1069	C	*/+T	442	7	1.48%	2	1	93	93	0.007630619313173879	1	1	227	215	0	7	+T
barcode32_consensus_vsearch	1069	C	*/-T	442	16	3.38%	2	1	93	93	1.3354986497750224E-5	1	1	227	215	0	16	-T
barcode32_consensus_vsearch	1079	T	*/-A	472	11	2.2%	2	1	93	93	4.6096814715598024E-4	1	1	208	264	11	0	-A
barcode32_consensus_vsearch	1092	T	*/-G	482	14	2.8%	2	1	93	93	5.5614703562630715E-5	1	1	229	253	0	14	-G
barcode32_consensus_vsearch	1102	C	*/-A	478	7	1.41%	2	1	93	93	0.0076440633927143216	1	1	227	251	0	7	-A
barcode32_consensus_vsearch	1111	G	*/+C	420	16	3.23%	2	2	93	93	1.3263859391341419E-5	1	1	184	236	8	8	+C
barcode32_consensus_vsearch	1111	G	*/-C	420	53	10.71%	2	2	93	93	2.3726520575430323E-17	1	1	184	236	28	25	-C
barcode32_consensus_vsearch	1116	C	*/+G	427	7	1.4%	2	2	93	93	0.007624362444354587	1	1	221	206	2	5	+G
barcode32_consensus_vsearch	1116	C	*/+T	427	18	3.61%	2	1	93	93	3.201090232328667E-6	1	1	221	206	0	18	+T
barcode32_consensus_vsearch	1120	T	*/+C	446	13	2.61%	2	1	93	93	1.1199500266454E-4	1	1	181	265	13	0	+C
barcode32_consensus_vsearch	1120	T	*/-C	446	31	6.22%	2	1	93	93	2.8141990982101394E-10	1	1	181	265	31	0	-C
barcode32_consensus_vsearch	1134	C	*/+T	479	8	1.6%	2	2	93	93	0.0037947063913870826	1	1	218	261	7	1	+T
barcode32_consensus_vsearch	1138	A	*/+C	483	11	2.2%	2	1	93	93	4.6156575380591254E-4	1	1	227	256	0	11	+C
barcode32_consensus_vsearch	1144	T	*/+A	456	8	1.6%	2	2	93	93	0.0037892164544094686	1	1	216	240	4	4	+A
barcode32_consensus_vsearch	1144	T	*/-A	456	21	4.21%	2	2	93	93	3.8077064300609826E-7	1	1	216	240	4	17	-A
barcode32_consensus_vsearch	1150	T	*/+G	457	17	3.43%	2	1	93	93	6.592942957263356E-6	1	1	216	241	0	17	+G
barcode32_consensus_vsearch	1151	G	*/-A	487	7	1.41%	2	2	93	93	0.007647119511005615	1	1	219	268	6	1	-A
barcode32_consensus_vsearch	1153	G	*/+C	488	7	1.4%	2	1	93	93	0.007647452247954883	1	1	230	258	0	7	+C
barcode32_consensus_vsearch	1155	T	*/+C	484	8	1.6%	2	2	93	93	0.0037958323931522003	1	1	222	262	7	1	+C
barcode32_consensus_vsearch	1171	G	*/-AG	482	7	1.4%	2	1	93	93	0.007645435497920978	1	1	214	268	7	0	-AG
barcode32_consensus_vsearch	1172	A	*/+G	349	7	1.44%	2	1	93	93	0.007583376037704121	1	1	98	251	7	0	+G
barcode32_consensus_vsearch	1172	A	*/-G	349	108	22.22%	2	2	93	93	2.3338386402380844E-36	1	1	98	251	94	14	-G
barcode32_consensus_vsearch	1172	A	*/-GGGA	349	10	2.06%	2	1	93	93	9.164636628305845E-4	1	1	98	251	10	0	-G
barcode32_consensus_vsearch	1179	C	*/-T	477	14	2.81%	2	2	93	93	5.5561320509265604E-5	1	1	222	255	3	11	-T
barcode32_consensus_vsearch	1181	T	*/-C	473	18	3.64%	2	2	93	93	3.255094271946507E-6	1	1	219	254	3	15	-C
barcode32_consensus_vsearch	1182	C	*/+T	448	11	2.29%	2	2	93	93	4.59566741968889E-4	1	1	220	228	1	10	+T
barcode32_consensus_vsearch	1182	C	*/-G	448	7	1.46%	2	2	93	93	0.00763300706774014	1	1	220	228	2	5	+T
barcode32_consensus_vsearch	1185	C	*/-G	476	9	1.82%	2	2	93	93	0.001881348261906975	1	1	221	255	6	3	-G
barcode32_consensus_vsearch	1187	G	*/+A	485	9	1.8%	2	1	93	93	0.001882643221311292	1	1	231	254	0	9	+A
barcode32_consensus_vsearch	1200	A	*/+G	483	7	1.42%	2	1	93	93	0.007645775038504135	1	1	226	257	0	7	+G
barcode32_consensus_vsearch	1201	G	*/-A	486	9	1.8%	2	2	93	93	0.001882784227427251	1	1	223	263	6	3	-A
barcode32_consensus_vsearch	1206	T	*/+C	487	8	1.6%	2	1	93	93	0.003796497148536327	1	1	231	256	0	8	+C
barcode32_consensus_vsearch	1207	T	*/-C	484	9	1.8%	2	2	93	93	0.001882501648786426	1	1	224	260	2	7	-C
barcode32_consensus_vsearch	1208	C	*/+G	470	10	2.04%	2	1	93	93	9.314052581613561E-4	1	1	226	244	0	10	+G
barcode32_consensus_vsearch	1216	C	*/-T	463	21	4.23%	2	2	93	93	3.8203870993173336E-7	1	1	226	237	3	18	-T
barcode32_consensus_vsearch	1221	G	*/+C	432	8	1.62%	2	2	93	93	0.0037828805172695963	1	1	211	221	4	4	+C
barcode32_consensus_vsearch	1221	G	*/-C	432	49	9.9%	2	2	93	93	4.89977009222016E-16	1	1	211	221	7	42	-C
barcode32_consensus_vsearch	1230	C	*/-GC	485	9	1.81%	2	2	93	93	0.001882643221311292	1	1	219	266	8	1	-GC
barcode32_consensus_vsearch	1247	A	*/+T	481	7	1.41%	2	1	93	93	0.007645094571574461	1	1	223	258	0	7	+T
barcode32_consensus_vsearch	1250	T	*/+G	485	8	1.6%	2	1	93	93	0.003796054871155719	1	1	228	257	0	8	+G
barcode32_consensus_vsearch	1252	C	*/-AC	484	7	1.41%	2	1	93	93	0.007646113201788858	1	1	221	263	7	0	-AC
barcode32_consensus_vsearch	1256	T	*/+C	484	7	1.41%	2	1	93	93	0.007646113201788858	1	1	219	265	7	0	+C
barcode32_consensus_vsearch	1258	A	*/+G	481	9	1.81%	2	2	93	93	0.0018820734984676631	1	1	224	257	1	8	+G
barcode32_consensus_vsearch	1259	G	*/+A	487	7	1.41%	2	1	93	93	0.007647119511005615	1	1	229	258	0	7	+A
barcode32_consensus_vsearch	1277	A	*/-C	479	11	2.21%	2	2	93	93	4.61351491529115E-4	1	1	216	263	10	1	-C
barcode32_consensus_vsearch	1280	A	*/+G	488	7	1.4%	2	2	93	93	0.007647452247954883	1	1	224	264	4	3	+G
barcode32_consensus_vsearch	1281	G	*/-A	487	9	1.81%	2	1	93	93	0.0018829246705400634	1	1	220	267	9	0	-A
barcode32_consensus_vsearch	1286	T	*/-C	470	14	2.81%	2	2	93	93	5.548479440961097E-5	1	1	222	248	6	8	-C
barcode32_consensus_vsearch	1289	T	*/-CT	480	7	1.42%	2	2	93	93	0.007644752250974145	1	1	225	255	2	5	-CT
barcode32_consensus_vsearch	1298	A	*/+C	469	9	1.8%	2	2	93	93	0.0018803077000523797	1	1	209	260	7	2	+C
barcode32_consensus_vsearch	1298	A	*/-C	469	15	3%	2	2	93	93	2.7335276071797284E-5	1	1	209	260	12	3	-C
barcode32_consensus_vsearch	1303	A	*/+C	480	7	1.4%	2	1	93	93	0.007644752250974145	1	1	216	264	7	0	+C
barcode32_consensus_vsearch	1304	T	*/-A	479	11	2.24%	2	1	93	93	4.61351491529115E-4	1	1	214	265	11	0	-A
barcode32_consensus_vsearch	1306	C	*/-AC	479	13	2.61%	2	1	93	93	1.126523813406278E-4	1	1	212	267	13	0	-AC
barcode32_consensus_vsearch	1320	C	*/-T	474	17	3.4%	2	1	93	93	6.626932431295206E-6	1	1	231	243	0	17	-T
barcode32_consensus_vsearch	1323	C	*/+T	424	7	1.41%	2	1	93	93	0.007623059056742502	1	1	228	196	0	7	+T
barcode32_consensus_vsearch	1323	C	*/-T	424	61	12.27%	2	2	93	93	5.790064757207927E-20	1	1	228	196	1	60	-T
barcode32_consensus_vsearch	1327	C	*/-G	479	10	2.01%	2	2	93	93	9.32225201663148E-4	1	1	221	258	5	5	-G
barcode32_consensus_vsearch	1331	T	*/-C	482	12	2.41%	2	1	93	93	2.2818450264947262E-4	1	1	216	266	12	0	-C
barcode32_consensus_vsearch	1335	A	*/+C	464	8	1.6%	2	2	93	93	0.0037911862558090196	1	1	207	257	5	3	+C
barcode32_consensus_vsearch	1335	A	*/-C	464	14	2.8%	2	2	93	93	5.5417478251858426E-5	1	1	207	257	7	7	-C
barcode32_consensus_vsearch	1338	C	*/-T	488	8	1.6%	2	2	93	93	0.0037967169586205873	1	1	228	260	2	6	-T
barcode32_consensus_vsearch	1341	T	*/-AT	487	9	1.8%	2	2	93	93	0.0018829246705400634	1	1	223	264	5	4	-AT
barcode32_consensus_vsearch	1347	C	*/-T	471	17	3.46%	2	1	93	93	6.621096938006784E-6	1	1	227	244	0	17	-T
barcode32_consensus_vsearch	1351	C	*/-T	463	25	5.08%	2	2	93	93	2.174230562921273E-8	1	1	225	238	1	24	-T
barcode32_consensus_vsearch	1353	C	*/-A	479	7	1.43%	2	1	93	93	0.007644408527576281	1	1	224	255	0	7	-A
barcode32_consensus_vsearch	1356	A	*/-T	488	9	1.8%	2	1	93	93	0.0018830645540022467	1	1	230	258	0	9	-T
barcode32_consensus_vsearch	1373	A	*/-G	459	27	5.45%	2	2	93	93	5.139785322165528E-9	1	1	224	235	1	26	-G
barcode32_consensus_vsearch	1390	C	*/-G	470	7	1.41%	2	2	93	93	0.007641250440637751	1	1	214	256	6	1	-G
barcode32_consensus_vsearch	1390	C	*/-GC	470	9	1.81%	2	2	93	93	0.0018804581949022445	1	1	214	256	2	7	-GC
barcode32_consensus_vsearch	1391	G	*/-C	464	8	1.66%	2	1	93	93	0.0037911862558090196	1	1	206	258	8	0	-C
barcode32_consensus_vsearch	1393	C	*/+A	441	9	1.81%	2	2	93	93	0.0018758252149176666	1	1	190	251	7	2	+A
barcode32_consensus_vsearch	1393	C	*/-G	441	13	2.62%	2	1	93	93	1.1188731357687094E-4	1	1	190	251	13	0	-G
barcode32_consensus_vsearch	1393	C	*/-GA	441	14	2.82%	2	2	93	93	5.514358248895189E-5	1	1	190	251	12	2	-GA
barcode32_consensus_vsearch	1398	C	*/-T	486	9	1.81%	2	1	93	93	0.001882784227427251	1	1	229	257	0	9	-T
barcode32_consensus_vsearch	1400	C	*/-TC	459	32	6.48%	2	2	93	93	1.3815625525148605E-10	1	1	217	242	13	19	-TC
barcode32_consensus_vsearch	1424	G	*/-CG	490	8	1.6%	2	2	93	93	0.0037971539481312534	1	1	230	260	1	7	-CG
barcode32_consensus_vsearch	1427	T	*/-A	486	8	1.6%	2	2	93	93	0.0037962764544926452	1	1	222	264	7	1	-A
barcode32_consensus_vsearch	1428	A	*/+G	362	14	2.85%	2	2	93	93	5.395878332906229E-5	1	1	142	220	12	2	+G
barcode32_consensus_vsearch	1428	A	*/-G	362	96	19.55%	2	2	93	93	4.8085349914165036E-32	1	1	142	220	67	29	-G
barcode32_consensus_vsearch	1428	A	*/-GG	362	10	2.04%	2	2	93	93	9.185266415574814E-4	1	1	142	220	2	8	-G
barcode32_consensus_vsearch	1432	G	*/+T	479	10	2%	2	1	93	93	9.32225201663148E-4	1	1	213	266	10	0	+T
barcode32_consensus_vsearch	1438	C	*/-AC	470	15	3.01%	2	1	93	93	2.734157825647552E-5	1	1	206	264	15	0	-AC
barcode32_consensus_vsearch	1439	A	*/-C	450	16	3.31%	2	2	93	93	1.3386096253716735E-5	1	1	195	255	9	7	-C
barcode32_consensus_vsearch	1453	A	*/-CA	475	13	2.61%	2	2	93	93	1.1257730181393008E-4	1	1	217	258	9	4	-CA
barcode32_consensus_vsearch	1456	T	*/+A	468	8	1.62%	2	1	93	93	0.0037921465001774166	1	1	205	263	8	0	+A
barcode32_consensus_vsearch	1456	T	*/-A	468	13	2.63%	2	1	93	93	1.1244299307545754E-4	1	1	205	263	13	0	-A
barcode32_consensus_vsearch	1465	C	*/-T	480	7	1.4%	2	1	93	93	0.007644752250974145	1	1	231	249	0	7	-T
barcode32_consensus_vsearch	1465	C	*/-TC	480	13	2.6%	2	1	93	93	1.1267096612421377E-4	1	1	231	249	0	13	-TC
barcode32_consensus_vsearch	1466	T	*/+C	445	8	1.67%	2	2	93	93	0.0037863952091791225	1	1	227	218	2	6	+C
barcode32_consensus_vsearch	1466	T	*/-C	445	27	5.62%	2	2	93	93	5.081861232861126E-9	1	1	227	218	2	25	-C
barcode32_consensus_vsearch	1468	C	*/-T	472	17	3.4%	2	1	93	93	6.623049623494056E-6	1	1	231	241	0	17	-T
barcode32_consensus_vsearch	1470	T	*/-G	484	8	1.61%	2	1	93	93	0.0037958323931522003	1	1	229	255	0	8	-G
barcode32_consensus_vsearch	1481	T	*/+C	485	9	1.8%	2	2	93	93	0.001882643221311292	1	1	224	261	5	4	+C
barcode32_consensus_vsearch	1487	C	*/-G	478	15	3.01%	2	2	93	93	2.739111201125375E-5	1	1	228	250	1	14	-G
barcode32_consensus_vsearch	1517	C	*/+T	474	8	1.6%	2	1	93	93	0.0037935571892849574	1	1	228	246	0	8	+T
barcode32_consensus_vsearch	1517	C	*/-T	474	11	2.2%	2	2	93	93	4.610787829701709E-4	1	1	228	246	1	10	-T
barcode32_consensus_vsearch	1520	G	*/+C	487	7	1.41%	2	1	93	93	0.007647119511005615	1	1	223	264	7	0	+C
barcode32_consensus_vsearch	1521	C	*/+G	460	22	4.42%	2	2	93	93	1.8659002790024337E-7	1	1	217	243	11	11	+G
barcode32_consensus_vsearch	1523	G	*/-A	403	83	16.6%	2	1	93	93	2.241923346994036E-27	1	1	137	266	83	0	-A
barcode32_consensus_vsearch	1523	G	*/-AGC	403	7	1.4%	2	1	93	93	0.007613403934674614	1	1	137	266	7	0	-A
barcode32_consensus_vsearch	1527	G	*/-CG	463	20	4.06%	2	2	93	93	7.802142185918749E-7	1	1	209	254	8	12	-CG
barcode32_consensus_vsearch	1528	C	*/+G	446	8	1.68%	2	2	93	93	0.0037866572939678073	1	1	193	253	7	1	+G
barcode32_consensus_vsearch	1531	A	*/+C	469	8	1.61%	2	2	93	93	0.0037923840624007267	1	1	212	257	6	2	+C
barcode32_consensus_vsearch	1533	C	*/-TC	450	39	7.8%	2	1	93	93	8.264160293615328E-13	1	1	230	220	0	39	-TC
barcode32_consensus_vsearch	1534	T	*/+C	437	12	2.61%	2	1	93	93	2.266239976305489E-4	1	1	217	220	12	0	+C
barcode32_consensus_vsearch	1538	C	*/+T	483	7	1.42%	2	1	93	93	0.007645775038504135	1	1	224	259	0	7	+T
barcode32_consensus_vsearch	1546	A	*/+G	466	10	2.02%	2	2	93	93	9.310310253206723E-4	1	1	204	262	8	2	+G
barcode32_consensus_vsearch	1546	A	*/-G	466	11	2.22%	2	2	93	93	4.6063077485828253E-4	1	1	204	262	9	2	-G
barcode32_consensus_vsearch	1554	G	*/-TG	483	12	2.4%	2	2	93	93	2.2821602994011232E-4	1	1	218	265	9	3	-TG
barcode32_consensus_vsearch	1560	C	*/-G	464	28	5.61%	2	2	93	93	2.509038583846264E-9	1	1	221	243	5	23	-G
barcode32_consensus_vsearch	1570	C	*/-A	479	11	2.21%	2	1	93	93	4.61351491529115E-4	1	1	216	263	11	0	-A
barcode32_consensus_vsearch	1572	C	*/-T	476	13	2.61%	2	1	93	93	1.1259618363707113E-4	1	1	229	247	0	13	-T
barcode32_consensus_vsearch	1573	T	*/+C	366	21	4.38%	2	2	93	93	3.60842434638953E-7	1	1	163	203	13	8	+C
barcode32_consensus_vsearch	1573	T	*/-C	366	82	17.08%	2	2	93	93	3.481806014256806E-27	1	1	163	203	51	31	-C
barcode32_consensus_vsearch	1578	G	*/+A	452	28	5.67%	2	2	93	93	2.4836374756567267E-9	1	1	185	267	27	1	+A
barcode32_consensus_vsearch	1580	A	*/-G	474	12	2.45%	2	2	93	93	2.2792771969765323E-4	1	1	207	267	11	1	-G
barcode32_consensus_vsearch	1581	G	*/+A	454	9	1.89%	2	1	93	93	0.0018779730851546438	1	1	189	265	9	0	+A
barcode32_consensus_vsearch	1583	G	*/-A	432	25	5.12%	2	2	93	93	2.1269532754988194E-8	1	1	170	262	24	1	-A
barcode32_consensus_vsearch	1583	G	*/-AG	432	29	5.94%	2	2	93	93	1.1823782153082758E-9	1	1	170	262	24	5	-AG
barcode32_consensus_vsearch	1592	T	*/-C	480	15	3%	2	2	93	93	2.7403255204375622E-5	1	1	224	256	4	11	-C
barcode32_consensus_vsearch	1595	C	*/-GA	453	12	2.4%	2	2	93	93	2.2721262456584418E-4	1	1	216	237	5	7	-GA
barcode32_consensus_vsearch	1596	G	*/-AA	468	12	2.47%	2	2	93	93	2.2772964456396167E-4	1	1	209	259	10	2	-AA
barcode32_consensus_vsearch	1600	C	*/+T	397	28	5.69%	2	2	93	93	2.3525147178522405E-9	1	1	191	206	14	14	+T
barcode32_consensus_vsearch	1600	C	*/-T	397	48	9.76%	2	2	93	93	9.306515603100128E-16	1	1	191	206	22	26	-T
barcode32_consensus_vsearch	1600	C	*/-TT	397	7	1.42%	2	2	93	93	0.00761046189928152	1	1	191	206	2	5	-T
barcode32_consensus_vsearch	1606	T	*/-C	482	9	1.81%	2	2	93	93	0.0018822167908263267	1	1	226	256	3	6	-C
barcode32_consensus_vsearch	1621	T	*/+G	476	14	2.82%	2	1	93	93	5.555051756564947E-5	1	1	231	245	0	14	+G
barcode32_consensus_vsearch	1629	G	*/-C	476	16	3.21%	2	1	93	93	1.3480544192748738E-5	1	1	214	262	16	0	-C
barcode32_consensus_vsearch	1632	T	*/+G	479	7	1.4%	2	1	93	93	0.007644408527576281	1	1	225	254	0	7	+G
barcode32_consensus_vsearch	1635	G	*/-C	464	13	2.64%	2	2	93	93	1.1236452596727411E-4	1	1	213	251	5	8	-C
barcode32_consensus_vsearch	1637	C	*/-G	469	13	2.62%	2	2	93	93	1.1246241212055434E-4	1	1	228	241	3	10	-G
barcode32_consensus_vsearch	1640	C	*/+A	390	16	3.25%	2	2	93	93	1.3124583755675277E-5	1	1	192	198	10	6	+A
barcode32_consensus_vsearch	1640	C	*/-A	390	32	6.5%	2	2	93	93	1.2643104385131093E-10	1	1	192	198	24	8	-A
barcode32_consensus_vsearch	1640	C	*/-AA	390	20	4.07%	2	2	93	93	7.521585947868342E-7	1	1	192	198	1	19	-A
barcode32_consensus_vsearch	1640	C	*/-AAA	390	7	1.42%	2	1	93	93	0.007606917708857565	1	1	192	198	0	7	-A
barcode32_consensus_vsearch	1646	G	*/+C	473	12	2.4%	2	2	93	93	2.2789503975864872E-4	1	1	219	254	6	6	+C
barcode32_consensus_vsearch	1659	G	*/-A	377	16	3.24%	2	1	93	93	1.3058016225586293E-5	1	1	136	241	16	0	-A
barcode32_consensus_vsearch	1659	G	*/-AG	377	100	20.24%	2	2	93	93	2.373982179245878E-33	1	1	136	241	73	27	-AG
barcode32_consensus_vsearch	1663	T	*/-G	479	8	1.62%	2	2	93	93	0.0037947063913870826	1	1	227	252	1	7	-G
barcode32_consensus_vsearch	1673	A	*/-C	481	7	1.42%	2	2	93	93	0.007645094571574461	1	1	219	262	1	6	-C
barcode32_consensus_vsearch	1675	C	*/-G	478	9	1.8%	2	2	93	93	0.0018816401257546191	1	1	222	256	3	6	-G
barcode32_consensus_vsearch	1697	C	*/-G	486	8	1.61%	2	1	93	93	0.0037962764544926452	1	1	221	265	8	0	-G
barcode32_consensus_vsearch	1699	C	*/-T	483	7	1.42%	2	2	93	93	0.007645775038504135	1	1	225	258	1	6	-T
barcode32_consensus_vsearch	1701	T	*/+C	389	16	3.21%	2	2	93	93	1.3119606194743481E-5	1	1	184	205	10	6	+C
barcode32_consensus_vsearch	1701	T	*/-C	389	82	16.47%	2	2	93	93	4.334279098540759E-27	1	1	184	205	36	46	-C
barcode32_consensus_vsearch	1701	T	*/-CC	389	7	1.41%	2	1	93	93	0.0076064012202881484	1	1	184	205	0	7	-C
barcode32_consensus_vsearch	1703	C	*/+T	478	7	1.42%	2	1	93	93	0.0076440633927143216	1	1	226	252	0	7	+T
barcode32_consensus_vsearch	1704	C	*/+T	354	8	1.6%	2	2	93	93	0.003756539874175904	1	1	205	149	4	4	+T
barcode32_consensus_vsearch	1704	C	*/-T	354	120	24%	2	2	93	93	1.3199954915140038E-40	1	1	205	149	18	102	-T
barcode32_consensus_vsearch	1730	A	*/+C	445	16	3.21%	2	2	93	93	1.3366772850841294E-5	1	1	219	226	5	11	+C
barcode32_consensus_vsearch	1730	A	*/-C	445	32	6.43%	2	2	93	93	1.3598405176602766E-10	1	1	219	226	5	27	-C
barcode32_consensus_vsearch	1734	T	*/-C	463	12	2.41%	2	2	93	93	2.2756084834032775E-4	1	1	226	237	2	10	-C
barcode32_consensus_vsearch	1734	T	*/-CT	463	16	3.22%	2	1	93	93	1.3434540182264686E-5	1	1	226	237	0	16	-CT
barcode32_consensus_vsearch	1735	C	*/+T	373	34	7.26%	2	2	93	93	2.8361325807825334E-11	1	1	206	167	12	22	+T
barcode32_consensus_vsearch	1735	C	*/-T	373	55	11.75%	2	2	93	93	4.345892423408969E-18	1	1	206	167	9	46	-T
barcode32_consensus_vsearch	1740	C	*/+A	463	12	2.41%	2	1	93	93	2.2756084834032775E-4	1	1	202	261	12	0	+A
barcode32_consensus_vsearch	1740	C	*/-A	463	15	3.01%	2	2	93	93	2.7296931962725753E-5	1	1	202	261	14	1	-A
barcode32_consensus_vsearch	1747	C	*/+T	453	19	3.82%	2	2	93	93	1.5855587867497238E-6	1	1	210	243	10	9	+T
barcode32_consensus_vsearch	1747	C	*/-T	453	17	3.41%	2	2	93	93	6.584608408490289E-6	1	1	210	243	6	11	+T
barcode32_consensus_vsearch	1755	C	*/-T	461	26	5.23%	2	1	93	93	1.0577738822924852E-8	1	1	226	235	0	26	-T
barcode32_consensus_vsearch	1763	C	*/-A	486	8	1.61%	2	1	93	93	0.0037962764544926452	1	1	220	266	8	0	-A
barcode32_consensus_vsearch	1767	C	*/+T	476	7	1.42%	2	2	93	93	0.0076433688537074695	1	1	227	249	1	6	+T
barcode32_consensus_vsearch	1770	C	*/+T	475	8	1.61%	2	1	93	93	0.0037937889200904415	1	1	227	248	0	8	+T
barcode32_consensus_vsearch	1781	T	*/+C	483	8	1.6%	2	1	93	93	0.0037956090150416287	1	1	220	263	8	0	+C
barcode32_consensus_vsearch	1788	C	*/-T	479	7	1.41%	2	2	93	93	0.007644408527576281	1	1	227	252	1	6	-T
barcode32_consensus_vsearch	1788	C	*/-TG	479	7	1.41%	2	1	93	93	0.007644408527576281	1	1	227	252	0	7	-T
barcode32_consensus_vsearch	1803	C	*/+T	451	19	3.84%	2	2	93	93	1.5842873954953467E-6	1	1	198	253	13	6	+T
barcode32_consensus_vsearch	1803	C	*/-T	451	13	2.63%	2	2	93	93	1.1210043923467175E-4	1	1	198	253	8	5	+T
barcode32_consensus_vsearch	1807	A	*/-GAAGA	473	8	1.62%	2	1	93	93	0.0037933245016082413	1	1	210	263	8	0	-GAAGA
barcode32_consensus_vsearch	1810	A	*/-GA	465	12	2.45%	2	1	93	93	2.2762878163700055E-4	1	1	198	267	12	0	-GA
barcode32_consensus_vsearch	1818	A	*/-C	476	9	1.82%	2	2	93	93	0.001881348261906975	1	1	221	255	1	8	-C
barcode32_consensus_vsearch	1821	T	*/-C	457	27	5.5%	2	2	93	93	5.131682084263172E-9	1	1	209	248	18	9	-C
barcode32_consensus_vsearch	1828	T	*/-A	485	9	1.8%	2	1	93	93	0.001882643221311292	1	1	217	268	9	0	-A
barcode32_consensus_vsearch	1839	T	*/+C	473	7	1.4%	2	1	93	93	0.007642316239083064	1	1	221	252	7	0	+C
barcode32_consensus_vsearch	1839	T	*/-C	473	15	3%	2	1	93	93	2.7360336076732557E-5	1	1	221	252	0	15	-C
barcode32_consensus_vsearch	1842	C	*/+A	453	20	4%	2	1	93	93	7.768399135065772E-7	1	1	230	223	0	20	+A
barcode32_consensus_vsearch	1850	T	*/-C	476	17	3.42%	2	1	93	93	6.630785443026535E-6	1	1	229	247	0	17	-C
barcode32_consensus_vsearch	1860	G	*/-A	480	11	2.2%	2	2	93	93	4.6140537857478075E-4	1	1	219	261	9	2	-A
barcode32_consensus_vsearch	1864	G	*/-A	473	20	4.04%	2	2	93	93	7.834626026644059E-7	1	1	209	264	19	1	-A
barcode32_consensus_vsearch	1866	G	*/-C	482	7	1.4%	2	1	93	93	0.007645435497920978	1	1	226	256	0	7	-C
barcode32_consensus_vsearch	1867	C	*/+T	454	7	1.42%	2	2	93	93	0.007635332943374405	1	1	219	235	3	4	+T
barcode32_consensus_vsearch	1867	C	*/-T	454	11	2.23%	2	1	93	93	4.599304008296962E-4	1	1	219	235	0	11	-T
barcode32_consensus_vsearch	1867	C	*/-TT	454	17	3.45%	2	2	93	93	6.586704563448438E-6	1	1	219	235	9	8	-TT
barcode32_consensus_vsearch	1872	C	*/+A	448	11	2.22%	2	2	93	93	4.59566741968889E-4	1	1	193	255	9	2	+A
barcode32_consensus_vsearch	1872	C	*/-A	448	24	4.85%	2	2	93	93	4.416196873697068E-8	1	1	193	255	22	2	-A
barcode32_consensus_vsearch	1875	A	*/-G	486	7	1.4%	2	2	93	93	0.007646785429777685	1	1	222	264	6	1	-G
barcode32_consensus_vsearch	1880	T	*/-G	460	24	4.85%	2	1	93	93	4.449982856988136E-8	1	1	223	237	0	24	-G
barcode32_consensus_vsearch	1885	T	*/-C	482	10	2%	2	2	93	93	9.324919401133498E-4	1	1	220	262	7	3	-C
barcode32_consensus_vsearch	1895	C	*/-G	418	51	10.34%	2	2	93	93	1.0549146343542517E-16	1	1	214	204	10	41	-G
barcode32_consensus_vsearch	1899	G	*/+C	483	8	1.6%	2	1	93	93	0.0037956090150416287	1	1	226	257	0	8	+C
barcode32_consensus_vsearch	1901	T	*/-C	473	10	2.03%	2	1	93	93	9.31681921100583E-4	1	1	226	247	0	10	-C
barcode32_consensus_vsearch	1902	C	*/-TC	415	64	13.14%	2	2	93	93	5.681403860819531E-21	1	1	224	191	5	59	-TC
barcode32_consensus_vsearch	1903	T	*/-C	413	7	1.62%	2	2	93	93	0.007618121440992818	1	1	217	196	5	2	-C
barcode32_consensus_vsearch	1904	C	*/+A	403	7	1.64%	2	1	93	93	0.007613403934674614	1	1	214	189	0	7	+A
barcode32_consensus_vsearch	1905	A	*/-C	418	59	11.92%	2	2	93	93	2.5635885943008142E-19	1	1	221	197	3	56	-C
barcode32_consensus_vsearch	1906	C	*/+T	408	15	3.45%	2	1	93	93	2.6897105828015778E-5	1	1	227	181	0	15	+T
barcode32_consensus_vsearch	1908	C	*/-T	481	7	1.4%	2	1	93	93	0.007645094571574461	1	1	231	250	0	7	-T
barcode32_consensus_vsearch	1909	T	*/+C	471	8	1.62%	2	1	93	93	0.00379285623175068	1	1	221	250	8	0	+C
barcode32_consensus_vsearch	1909	T	*/-CT	471	7	1.42%	2	2	93	93	0.007641607186910932	1	1	221	250	1	6	+C
barcode32_consensus_vsearch	1911	T	*/-A	473	15	3.05%	2	2	93	93	2.7360336076732557E-5	1	1	217	256	10	5	-A
barcode32_consensus_vsearch	1913	A	*/-G	483	8	1.6%	2	1	93	93	0.0037956090150416287	1	1	215	268	8	0	-G
barcode32_consensus_vsearch	1915	G	*/-CG	492	7	1.4%	2	1	93	93	0.007648769914171423	1	1	230	262	0	7	-CG
barcode32_consensus_vsearch	1918	T	*/-C	450	47	9.4%	2	2	93	93	2.2693734151941476E-15	1	1	185	265	43	4	-C
barcode32_consensus_vsearch	1924	T	*/-C	440	54	10.82%	2	2	93	93	1.1994481788521512E-17	1	1	178	262	52	2	-C
barcode32_consensus_vsearch	1927	A	*/-G	429	49	9.92%	2	2	93	93	4.858184205649552E-16	1	1	179	250	34	15	-G
barcode32_consensus_vsearch	1933	C	*/-T	476	14	2.8%	2	2	93	93	5.555051756564947E-5	1	1	219	257	6	8	-T
barcode32_consensus_vsearch	1935	T	*/-G	441	41	8.28%	2	2	93	93	1.8707901959053047E-13	1	1	216	225	3	38	-G
barcode32_consensus_vsearch	1939	A	*/-G	480	13	2.61%	2	2	93	93	1.1267096612421377E-4	1	1	217	263	12	1	-G
barcode32_consensus_vsearch	1950	C	*/+A	348	19	3.82%	2	2	93	93	1.5018443455160622E-6	1	1	175	173	16	3	+A
barcode32_consensus_vsearch	1950	C	*/-A	348	56	11.24%	2	2	93	93	1.7894701188814517E-18	1	1	175	173	23	33	-A
barcode32_consensus_vsearch	1950	C	*/-AA	348	9	1.81%	2	1	93	93	0.001855959493097644	1	1	175	173	9	0	-A
barcode32_consensus_vsearch	1950	C	*/-AAA	348	57	11.45%	2	2	93	93	8.328003705292934E-19	1	1	175	173	1	56	-AAA
barcode32_consensus_vsearch	1960	C	*/-T	481	7	1.42%	2	1	93	93	0.007645094571574461	1	1	224	257	0	7	-T
barcode32_consensus_vsearch	1965	C	*/-A	457	31	6.25%	2	2	93	93	2.847381742949839E-10	1	1	224	233	3	28	-A
barcode32_consensus_vsearch	1975	C	*/-T	490	7	1.4%	2	1	93	93	0.007648113721449173	1	1	230	260	0	7	-T
barcode32_consensus_vsearch	1976	T	*/-C	469	11	2.24%	2	1	93	93	4.608004961442996E-4	1	1	222	247	0	11	-C
barcode32_consensus_vsearch	1977	C	*/-G	472	7	1.44%	2	2	93	93	0.007641962449987148	1	1	224	248	3	4	-G
barcode32_consensus_vsearch	1984	C	*/-A	469	13	2.64%	2	2	93	93	1.1246241212055434E-4	1	1	212	257	11	2	-A
barcode32_consensus_vsearch	1989	A	*/-C	482	7	1.41%	2	2	93	93	0.007645435497920978	1	1	216	266	6	1	-C
barcode32_consensus_vsearch	1998	C	*/-A	474	8	1.62%	2	2	93	93	0.0037935571892849574	1	1	210	264	6	2	-A
barcode32_consensus_vsearch	1998	C	*/-AA	474	7	1.42%	2	1	93	93	0.00764266856336234	1	1	210	264	7	0	-A
barcode32_consensus_vsearch	2001	A	*/-T	479	13	2.61%	2	1	93	93	1.126523813406278E-4	1	1	214	265	13	0	-T
barcode32_consensus_vsearch	2013	G	*/-C	481	12	2.41%	2	2	93	93	2.2815285032269742E-4	1	1	215	266	11	1	-C
barcode32_consensus_vsearch	2015	C	*/-G	471	13	2.61%	2	1	93	93	1.1250101626549275E-4	1	1	212	259	13	0	-G
barcode32_consensus_vsearch	2020	C	*/-A	479	11	2.22%	2	1	93	93	4.61351491529115E-4	1	1	212	267	11	0	-A
barcode32_consensus_vsearch	2021	A	*/+C	469	8	1.65%	2	1	93	93	0.0037923840624007267	1	1	211	258	0	8	+C
barcode32_consensus_vsearch	2023	T	*/-C	484	7	1.4%	2	1	93	93	0.007646113201788858	1	1	228	256	0	7	-C
barcode32_consensus_vsearch	2033	T	*/+G	474	10	2.02%	2	2	93	93	9.317733904039459E-4	1	1	223	251	1	9	+G
barcode32_consensus_vsearch	2041	T	*/+C	458	8	1.62%	2	2	93	93	0.0037897152001668	1	1	202	256	7	1	+C
barcode32_consensus_vsearch	2041	T	*/-C	458	23	4.66%	2	2	93	93	9.106402662600043E-8	1	1	202	256	18	5	-C
barcode32_consensus_vsearch	2044	C	*/-T	479	13	2.6%	2	2	93	93	1.126523813406278E-4	1	1	227	252	2	11	-T
barcode32_consensus_vsearch	2050	G	*/+T	475	11	2.2%	2	2	93	93	4.611337655353414E-4	1	1	212	263	10	1	+T
barcode32_consensus_vsearch	2050	G	*/-T	475	9	1.8%	2	2	93	93	0.0018812014345212318	1	1	212	263	8	1	+T
barcode32_consensus_vsearch	2054	C	*/+T	438	32	6.5%	2	2	93	93	1.3486135060287485E-10	1	1	215	223	6	26	+T
barcode32_consensus_vsearch	2054	C	*/-T	438	15	3.05%	2	2	93	93	2.712670522265434E-5	1	1	215	223	7	8	+T
barcode32_consensus_vsearch	2058	T	*/-C	483	9	1.8%	2	2	93	93	0.0018823595064416164	1	1	227	256	2	7	-C
barcode32_consensus_vsearch	2088	C	*/-G	463	16	3.22%	2	2	93	93	1.3434540182264686E-5	1	1	220	243	5	11	-G
barcode32_consensus_vsearch	2095	T	*/+C	466	8	1.6%	2	2	93	93	0.0037916683896426647	1	1	213	253	6	2	+C
barcode32_consensus_vsearch	2095	T	*/-C	466	21	4.21%	2	2	93	93	3.8257202218391176E-7	1	1	213	253	12	9	-C
barcode32_consensus_vsearch	2097	C	*/-T	484	7	1.4%	2	1	93	93	0.007646113201788858	1	1	228	256	0	7	-T
barcode32_consensus_vsearch	2105	T	*/-C	476	19	3.81%	2	1	93	93	1.5994935898798693E-6	1	1	209	267	19	0	-C
barcode32_consensus_vsearch	2107	C	*/+G	464	25	5%	2	2	93	93	2.1756694088942403E-8	1	1	226	238	1	24	+G
barcode32_consensus_vsearch	2109	A	*/-G	476	8	1.62%	2	2	93	93	0.0037940196998724205	1	1	211	265	7	1	-G
barcode32_consensus_vsearch	2117	C	*/+T	444	11	2.2%	2	1	93	93	4.5931907660072465E-4	1	1	229	215	0	11	+T
barcode32_consensus_vsearch	2117	C	*/-T	444	43	8.6%	2	2	93	93	4.3107938157220064E-14	1	1	229	215	1	42	-T
barcode32_consensus_vsearch	2120	T	*/-A	483	12	2.4%	2	2	93	93	2.2821602994011232E-4	1	1	228	255	2	10	-A
barcode32_consensus_vsearch	2122	G	*/+A	473	10	2%	2	2	93	93	9.31681921100583E-4	1	1	223	250	2	8	+A
barcode32_consensus_vsearch	2122	G	*/-A	473	11	2.2%	2	2	93	93	4.6102357729833573E-4	1	1	223	250	4	7	-A
barcode32_consensus_vsearch	2128	T	*/+G	372	10	2.01%	2	2	93	93	9.200196787898532E-4	1	1	166	206	7	3	+G
barcode32_consensus_vsearch	2128	T	*/-G	372	108	21.73%	2	2	93	93	3.446573512051487E-36	1	1	166	206	55	53	-G
barcode32_consensus_vsearch	2138	A	*/+T	466	15	3%	2	1	93	93	2.7316218709712403E-5	1	1	224	242	0	15	+T
barcode32_consensus_vsearch	2139	C	*/-G	456	15	3.03%	2	2	93	93	2.7251013932340745E-5	1	1	220	236	6	9	-G
barcode32_consensus_vsearch	2143	T	*/+G	443	12	2.41%	2	2	93	93	2.268494660858375E-4	1	1	213	230	7	5	+G
barcode32_consensus_vsearch	2143	T	*/-A	443	7	1.41%	2	2	93	93	0.00763102167395619	1	1	213	230	3	4	+G
barcode32_consensus_vsearch	2144	A	*/+G	472	7	1.42%	2	2	93	93	0.007641962449987148	1	1	220	252	2	5	+G
barcode32_consensus_vsearch	2145	G	*/-A	484	9	1.81%	2	2	93	93	0.001882501648786426	1	1	219	265	8	1	-A
barcode32_consensus_vsearch	2148	T	*/+C	361	9	1.83%	2	2	93	93	0.0018593289243356043	1	1	167	194	2	7	+C
barcode32_consensus_vsearch	2148	T	*/-C	361	119	24.14%	2	2	93	93	3.4821917286268482E-40	1	1	167	194	61	58	-C
barcode32_consensus_vsearch	2152	T	*/-C	427	63	12.75%	2	1	93	93	1.288102969402948E-20	1	1	163	264	63	0	-C
barcode32_consensus_vsearch	2154	C	*/+G	476	12	2.4%	2	2	93	93	2.279926868673764E-4	1	1	225	251	1	11	+G
barcode32_consensus_vsearch	2158	T	*/-C	466	17	3.41%	2	2	93	93	6.61121893334275E-6	1	1	207	259	12	5	-C
barcode32_consensus_vsearch	2158	T	*/-CC	466	7	1.41%	2	1	93	93	0.007639808436151757	1	1	207	259	7	0	-C
barcode32_consensus_vsearch	2165	G	*/-CG	473	13	2.61%	2	2	93	93	1.1253931160046193E-4	1	1	222	251	2	11	-CG
barcode32_consensus_vsearch	2171	C	*/+A	430	26	5.22%	2	2	93	93	1.0327171591167783E-8	1	1	202	228	4	22	+A
barcode32_consensus_vsearch	2171	C	*/-A	430	35	7.03%	2	2	93	93	1.497335516230111E-11	1	1	202	228	20	15	-A
barcode32_consensus_vsearch	2185	C	*/+A	414	23	4.6%	2	2	93	93	8.856382627956532E-8	1	1	158	256	17	6	+A
barcode32_consensus_vsearch	2185	C	*/-A	414	54	10.8%	2	2	93	93	1.0957893791977707E-17	1	1	158	256	53	1	-A
barcode32_consensus_vsearch	2188	A	*/+G	478	8	1.61%	2	1	93	93	0.0037944784297538666	1	1	225	253	0	8	+G
barcode32_consensus_vsearch	2190	G	*/-AGG	483	9	1.81%	2	1	93	93	0.0018823595064416164	1	1	217	266	9	0	-AGG
barcode32_consensus_vsearch	2193	G	*/+C	479	7	1.43%	2	1	93	93	0.007644408527576281	1	1	219	260	0	7	+C
barcode32_consensus_vsearch	2194	C	*/-T	445	43	8.63%	2	1	93	93	4.319765632064551E-14	1	1	226	219	0	43	-T
barcode32_consensus_vsearch	2195	T	*/-C	418	31	6.83%	2	2	93	93	2.724146041468283E-10	1	1	201	217	25	6	-C
barcode32_consensus_vsearch	2197	C	*/+G	439	9	1.8%	2	2	93	93	0.0018754838294876201	1	1	220	219	5	4	+G
barcode32_consensus_vsearch	2198	G	*/-A	478	12	2.43%	2	2	93	93	2.2805713564733962E-4	1	1	213	265	10	2	-A
barcode32_consensus_vsearch	2200	G	*/-A	485	7	1.41%	2	2	93	93	0.007646449996103257	1	1	222	263	4	3	-A
barcode32_consensus_vsearch	2201	A	*/-G	436	45	9.2%	2	2	93	93	9.657271241911319E-15	1	1	183	253	38	7	-G
barcode32_consensus_vsearch	2212	C	*/-T	475	7	1.41%	2	1	93	93	0.007643019431907797	1	1	228	247	0	7	-T
barcode32_consensus_vsearch	2215	G	*/+T	460	7	1.41%	2	2	93	93	0.007637599314660889	1	1	201	259	6	1	+T
barcode32_consensus_vsearch	2215	G	*/-T	460	22	4.43%	2	2	93	93	1.8659002790024337E-7	1	1	201	259	18	4	-T
barcode32_consensus_vsearch	2219	T	*/+G	404	15	3%	2	2	93	93	2.6864125215700153E-5	1	1	183	221	4	11	+G
barcode32_consensus_vsearch	2219	T	*/-G	404	66	13.2%	2	2	93	93	1.163514574059248E-21	1	1	183	221	33	33	-G
barcode32_consensus_vsearch	2224	G	*/-C	487	8	1.6%	2	1	93	93	0.003796497148536327	1	1	218	269	8	0	-C
barcode32_consensus_vsearch	2238	T	*/+A	469	8	1.61%	2	1	93	93	0.0037923840624007267	1	1	205	264	8	0	+A
barcode32_consensus_vsearch	2238	T	*/-A	469	12	2.42%	2	2	93	93	2.2776299237076134E-4	1	1	205	264	11	1	-A
barcode32_consensus_vsearch	2240	G	*/-A	481	11	2.21%	2	2	93	93	4.61459050447595E-4	1	1	217	264	10	1	-A
barcode32_consensus_vsearch	2242	G	*/+C	470	8	1.62%	2	2	93	93	0.0037926206375474623	1	1	217	253	2	6	+C
barcode32_consensus_vsearch	2243	C	*/+T	452	21	4.31%	2	1	93	93	3.800307568243409E-7	1	1	221	231	0	21	+T
barcode32_consensus_vsearch	2249	C	*/-A	482	14	2.81%	2	1	93	93	5.5614703562630715E-5	1	1	216	266	14	0	-A
barcode32_consensus_vsearch	2252	C	*/-A	461	12	2.42%	2	2	93	93	2.2749235397668887E-4	1	1	199	262	8	4	-A
barcode32_consensus_vsearch	2261	C	*/-T	477	8	1.63%	2	2	93	93	0.003794249534494607	1	1	217	260	2	6	-T
barcode32_consensus_vsearch	2265	A	*/+G	425	18	3.64%	2	2	93	93	3.198505438225124E-6	1	1	175	250	16	2	+G
barcode32_consensus_vsearch	2265	A	*/-G	425	44	8.91%	2	2	93	93	1.973333880627716E-14	1	1	175	250	31	13	-G
barcode32_consensus_vsearch	2279	G	*/-C	479	8	1.61%	2	2	93	93	0.0037947063913870826	1	1	225	254	1	7	-C
barcode32_consensus_vsearch	2283	G	*/-A	477	10	2.03%	2	2	93	93	9.320455752429517E-4	1	1	224	253	2	8	-A
barcode32_consensus_vsearch	2287	A	*/-G	467	13	2.62%	2	2	93	93	1.1242349541751215E-4	1	1	221	246	6	7	-G
barcode32_consensus_vsearch	2310	C	*/-G	489	7	1.4%	2	2	93	93	0.007647783648781579	1	1	227	262	2	5	-G
barcode32_consensus_vsearch	2319	T	*/+A	475	10	2.02%	2	1	93	93	9.318644876872256E-4	1	1	215	260	10	0	+A
barcode32_consensus_vsearch	2320	G	*/-TG	437	33	6.63%	2	2	93	93	6.505426383719161E-11	1	1	194	243	9	24	-TG
barcode32_consensus_vsearch	2327	C	*/+A	465	9	1.81%	2	2	93	93	0.001879699435718404	1	1	200	265	8	1	+A
barcode32_consensus_vsearch	2327	C	*/-A	465	19	3.82%	2	2	93	93	1.5929824317177727E-6	1	1	200	265	18	1	-A
barcode32_consensus_vsearch	2333	T	*/+C	484	13	2.6%	2	1	93	93	1.127445778999349E-4	1	1	230	254	0	13	+C
barcode32_consensus_vsearch	2334	T	*/-C	483	13	2.6%	2	2	93	93	1.1272628320445117E-4	1	1	228	255	1	12	-C
barcode32_consensus_vsearch	2351	T	*/+C	478	15	3%	2	1	93	93	2.739111201125375E-5	1	1	228	250	0	15	+C
barcode32_consensus_vsearch	2355	C	*/-A	468	25	5.02%	2	2	93	93	2.1813742654026008E-8	1	1	222	246	3	22	-A
barcode32_consensus_vsearch	2357	A	*/-T	485	9	1.8%	2	1	93	93	0.001882643221311292	1	1	227	258	0	9	-T
barcode32_consensus_vsearch	2359	T	*/-C	464	17	3.41%	2	2	93	93	6.607213423734967E-6	1	1	223	241	1	16	-C
barcode32_consensus_vsearch	2361	A	*/-CA	472	8	1.62%	2	1	93	93	0.0037930908510905733	1	1	214	258	8	0	-CA
barcode32_consensus_vsearch	2362	C	*/-A	474	7	1.44%	2	2	93	93	0.00764266856336234	1	1	212	262	6	1	-A
barcode32_consensus_vsearch	2378	T	*/+C	485	7	1.4%	2	2	93	93	0.007646449996103257	1	1	224	261	3	4	+C
barcode32_consensus_vsearch	2404	A	*/-C	486	9	1.8%	2	2	93	93	0.001882784227427251	1	1	220	266	8	1	-C
barcode32_consensus_vsearch	2411	G	*/-A	479	8	1.63%	2	1	93	93	0.0037947063913870826	1	1	214	265	8	0	-A
barcode32_consensus_vsearch	2421	T	*/+A	456	10	2.02%	2	2	93	93	9.300677370579054E-4	1	1	203	253	5	5	+A
barcode32_consensus_vsearch	2421	T	*/-A	456	21	4.25%	2	2	93	93	3.8077064300609826E-7	1	1	203	253	17	4	-A
barcode32_consensus_vsearch	2426	G	*/-T	478	12	2.4%	2	2	93	93	2.2805713564733962E-4	1	1	216	262	6	6	-T
barcode32_consensus_vsearch	2447	C	*/-A	486	10	2%	2	2	93	93	9.328426394204927E-4	1	1	220	266	9	1	-A
barcode32_consensus_vsearch	2450	T	*/+C	444	42	8.48%	2	2	93	93	9.010531434345522E-14	1	1	190	254	41	1	+C
barcode32_consensus_vsearch	2472	A	*/+G	477	10	2.02%	2	2	93	93	9.320455752429517E-4	1	1	221	256	6	4	+G
barcode32_consensus_vsearch	2473	G	*/-A	483	8	1.61%	2	2	93	93	0.0037956090150416287	1	1	222	261	6	2	-A
barcode32_consensus_vsearch	2474	A	*/-G	475	7	1.43%	2	2	93	93	0.007643019431907797	1	1	214	261	6	1	-G
barcode32_consensus_vsearch	2478	T	*/-G	442	46	9.22%	2	1	93	93	4.670459980728392E-15	1	1	229	213	0	46	-G
barcode32_consensus_vsearch	2484	T	*/+C	472	13	2.61%	2	1	93	93	1.1252020230221805E-4	1	1	230	242	0	13	+C
barcode32_consensus_vsearch	2484	T	*/-C	472	7	1.41%	2	2	93	93	0.007641962449987148	1	1	230	242	1	6	+C
barcode32_consensus_vsearch	2487	T	*/-C	479	11	2.22%	2	2	93	93	4.61351491529115E-4	1	1	222	257	8	3	-C
barcode32_consensus_vsearch	2489	C	*/-G	467	10	2.01%	2	2	93	93	9.311251637351389E-4	1	1	230	237	1	9	-G
barcode32_consensus_vsearch	2492	C	*/+G	460	11	2.21%	2	2	93	93	4.6028496619962057E-4	1	1	215	245	1	10	+G
barcode32_consensus_vsearch	2496	C	*/-G	424	45	9.11%	2	1	93	93	9.381061513053012E-15	1	1	160	264	45	0	-G
barcode32_consensus_vsearch	2497	G	*/+C	358	17	3.81%	2	2	93	93	6.338109529471755E-6	1	1	110	248	11	6	+C
barcode32_consensus_vsearch	2497	G	*/-C	358	29	6.5%	2	2	93	93	1.0803274785134407E-9	1	1	110	248	22	7	-C
barcode32_consensus_vsearch	2498	C	*/+T	428	13	2.86%	2	1	93	93	1.1159624774972868E-4	1	1	170	258	13	0	+T
barcode32_consensus_vsearch	2499	C	*/+T	399	14	2.86%	2	1	93	93	5.456785241416283E-5	1	1	135	264	14	0	+T
barcode32_consensus_vsearch	2499	C	*/+TT	399	13	2.66%	2	1	93	93	1.1088295133444692E-4	1	1	135	264	13	0	+T
barcode32_consensus_vsearch	2502	G	*/-CG	464	7	1.41%	2	2	93	93	0.007639078288945116	1	1	209	255	5	2	-CG
barcode32_consensus_vsearch	2504	G	*/-TG	466	12	2.43%	2	1	93	93	2.276625400345054E-4	1	1	217	249	0	12	-TG
barcode32_consensus_vsearch	2506	G	*/+A	438	20	4.18%	2	2	93	93	7.715259321483055E-7	1	1	196	242	19	1	+A
barcode32_consensus_vsearch	2506	G	*/-A	438	11	2.3%	2	2	93	93	4.589394655227349E-4	1	1	196	242	8	3	+A
barcode32_consensus_vsearch	2507	A	*/+G	455	16	3.31%	2	2	93	93	1.3405029507162834E-5	1	1	203	252	15	1	+G
barcode32_consensus_vsearch	2507	A	*/-G	455	8	1.65%	2	2	93	93	0.003788965477306861	1	1	203	252	3	5	+G
barcode32_consensus_vsearch	2509	C	*/+G	375	12	2.46%	2	1	93	93	2.2389647410688774E-4	1	1	175	200	0	12	+G
barcode32_consensus_vsearch	2509	C	*/-G	375	59	12.09%	2	2	93	93	2.0916224354477574E-19	1	1	175	200	36	23	-G
barcode32_consensus_vsearch	2509	C	*/-GGG	375	9	1.84%	2	1	93	93	0.001862705653908663	1	1	175	200	0	9	-G
barcode32_consensus_vsearch	2511	G	*/+A	448	7	1.46%	2	1	93	93	0.00763300706774014	1	1	197	251	7	0	+A
barcode32_consensus_vsearch	2513	G	*/-C	431	33	6.61%	2	2	93	93	6.454870972530021E-11	1	1	174	257	26	7	-C
barcode32_consensus_vsearch	2515	C	*/+A	238	13	2.62%	2	1	93	93	1.0408769971274523E-4	1	1	144	94	13	0	+A
barcode32_consensus_vsearch	2515	C	*/-G	238	187	37.7%	2	2	93	93	1.4765914728678806E-68	1	1	144	94	49	138	-G
barcode32_consensus_vsearch	2515	C	*/-GG	238	12	2.42%	2	2	93	93	2.132839981841494E-4	1	1	144	94	5	7	-G
barcode32_consensus_vsearch	2515	C	*/-GGG	238	20	4.03%	2	2	93	93	6.503726365883174E-7	1	1	144	94	1	19	-GGG
barcode32_consensus_vsearch	2518	G	*/+A	431	9	1.88%	2	2	93	93	0.0018740875957096264	1	1	197	234	7	2	+A
barcode32_consensus_vsearch	2519	G	*/+A	383	14	2.81%	2	1	93	93	5.4317819652484023E-5	1	1	149	234	14	0	+A
barcode32_consensus_vsearch	2520	G	*/+C	377	7	1.4%	2	1	93	93	0.007599994652592844	1	1	131	246	7	0	+C
barcode32_consensus_vsearch	2520	G	*/-C	377	53	10.62%	2	2	93	93	2.0126272513274994E-17	1	1	131	246	45	8	-C
barcode32_consensus_vsearch	2520	G	*/-CC	377	28	5.61%	2	1	93	93	2.2978604060871463E-9	1	1	131	246	28	0	-C
barcode32_consensus_vsearch	2521	C	*/+T	372	11	2.67%	2	2	93	93	4.539966388795655E-4	1	1	138	234	1	10	+T
barcode32_consensus_vsearch	2523	C	*/+A	263	10	2.02%	2	2	93	93	8.979886896061976E-4	1	1	128	135	8	2	+A
barcode32_consensus_vsearch	2523	C	*/+G	263	78	15.79%	2	2	93	93	2.271170657680034E-26	1	1	128	135	17	61	+G
barcode32_consensus_vsearch	2523	C	*/+GG	263	10	2.02%	2	1	93	93	8.979886896061976E-4	1	1	128	135	0	10	+G
barcode32_consensus_vsearch	2523	C	*/-G	263	53	10.73%	2	2	93	93	1.0263128108090448E-17	1	1	128	135	20	33	-G
barcode32_consensus_vsearch	2535	G	*/-C	462	9	1.81%	2	2	93	93	0.0018792365273515336	1	1	211	251	8	1	-C
barcode32_consensus_vsearch	2535	G	*/-CCG	462	8	1.61%	2	1	93	93	0.003790700047657303	1	1	211	251	0	8	-C
barcode32_consensus_vsearch	2537	C	*/-G	470	7	1.43%	2	2	93	93	0.007641250440637751	1	1	221	249	5	2	-G
barcode32_consensus_vsearch	2561	C	*/+A	420	9	1.83%	2	1	93	93	0.0018720837112055043	1	1	168	252	9	0	+A
barcode32_consensus_vsearch	2561	C	*/-A	420	54	10.95%	2	2	93	93	1.119931858207531E-17	1	1	168	252	49	5	-A
barcode32_consensus_vsearch	2564	A	*/-G	476	10	2%	2	2	93	93	9.319552152179441E-4	1	1	221	255	5	5	-G
barcode32_consensus_vsearch	2573	G	*/-A	482	7	1.42%	2	1	93	93	0.007645435497920978	1	1	215	267	7	0	-A
barcode32_consensus_vsearch	2576	T	*/-G	480	7	1.41%	2	1	93	93	0.007644752250974145	1	1	231	249	0	7	-G
barcode32_consensus_vsearch	2583	T	*/-C	468	23	4.66%	2	2	93	93	9.157676636073005E-8	1	1	229	239	1	22	-C
barcode32_consensus_vsearch	2584	C	*/+G	451	9	1.89%	2	1	93	93	0.0018774880842022342	1	1	229	222	0	9	+G
barcode32_consensus_vsearch	2587	T	*/-A	464	21	4.28%	2	2	93	93	3.822171469291514E-7	1	1	223	241	4	17	-A
barcode32_consensus_vsearch	2591	G	*/-A	479	9	1.81%	2	1	93	93	0.0018817851694759033	1	1	214	265	9	0	-A
barcode32_consensus_vsearch	2593	T	*/+C	449	23	4.61%	2	2	93	93	9.058613186339343E-8	1	1	208	241	14	9	+C
barcode32_consensus_vsearch	2593	T	*/-C	449	23	4.61%	2	2	93	93	9.058613186339343E-8	1	1	208	241	8	15	+C
barcode32_consensus_vsearch	2597	T	*/+C	476	8	1.61%	2	2	93	93	0.0037940196998724205	1	1	213	263	7	1	+C
barcode32_consensus_vsearch	2597	T	*/-C	476	9	1.81%	2	1	93	93	0.001881348261906975	1	1	213	263	9	0	-C
barcode32_consensus_vsearch	2613	C	*/-G	483	7	1.4%	2	1	93	93	0.007645775038504135	1	1	225	258	0	7	-G
barcode32_consensus_vsearch	2616	A	*/-G	481	8	1.61%	2	1	93	93	0.003795159536553975	1	1	219	262	8	0	-G
barcode32_consensus_vsearch	2620	C	*/-T	476	14	2.8%	2	2	93	93	5.555051756564947E-5	1	1	226	250	2	12	-T
barcode32_consensus_vsearch	2622	T	*/+A	485	8	1.6%	2	2	93	93	0.003796054871155719	1	1	220	265	7	1	+A
barcode32_consensus_vsearch	2625	T	*/-AC	467	21	4.23%	2	1	93	93	3.8274846785425195E-7	1	1	205	262	21	0	-AC
barcode32_consensus_vsearch	2627	C	*/-G	456	7	1.47%	2	2	93	93	0.007636094898325736	1	1	203	253	2	5	-G
barcode32_consensus_vsearch	2630	C	*/+T	427	11	2.21%	2	2	93	93	4.5821703849988575E-4	1	1	183	244	6	5	+T
barcode32_consensus_vsearch	2630	C	*/-T	427	38	7.65%	2	2	93	93	1.654537556830738E-12	1	1	183	244	27	11	-T
barcode32_consensus_vsearch	2636	C	*/-T	474	15	3.01%	2	1	93	93	2.7366539591447386E-5	1	1	228	246	0	15	-T
barcode32_consensus_vsearch	2638	T	*/-C	461	21	4.28%	2	2	93	93	3.816798184601848E-7	1	1	227	234	1	20	-C
barcode32_consensus_vsearch	2640	C	*/-T	483	9	1.82%	2	1	93	93	0.0018823595064416164	1	1	231	252	0	9	-T
barcode32_consensus_vsearch	2641	T	*/+C	468	9	1.84%	2	2	93	93	0.0018801565806267238	1	1	223	245	7	2	+C
barcode32_consensus_vsearch	2642	C	*/+T	475	7	1.43%	2	1	93	93	0.007643019431907797	1	1	230	245	0	7	+T
barcode32_consensus_vsearch	2643	T	*/+A	461	8	1.64%	2	1	93	93	0.003790455399559823	1	1	225	236	0	8	+A
barcode32_consensus_vsearch	2657	T	*/-G	387	106	21.24%	2	1	93	93	2.1845212381896584E-35	1	1	230	157	0	106	-G
barcode32_consensus_vsearch	2669	C	*/-G	483	12	2.4%	2	1	93	93	2.2821602994011232E-4	1	1	231	252	0	12	-G
barcode32_consensus_vsearch	2671	G	*/-C	488	7	1.4%	2	1	93	93	0.007647452247954883	1	1	220	268	7	0	-C
barcode32_consensus_vsearch	2675	T	*/+G	480	8	1.61%	2	1	93	93	0.0037949334251056385	1	1	226	254	0	8	+G
barcode32_consensus_vsearch	2676	G	*/-A	464	22	4.44%	2	2	93	93	1.8697543232849226E-7	1	1	202	262	20	2	-A
barcode32_consensus_vsearch	2678	G	*/-T	479	14	2.81%	2	1	93	93	5.5582799321315175E-5	1	1	228	251	0	14	-T
barcode32_consensus_vsearch	2687	G	*/-C	487	9	1.8%	2	2	93	93	0.0018829246705400634	1	1	220	267	7	2	-C
barcode32_consensus_vsearch	2696	T	*/-CT	442	45	9.05%	2	2	93	93	9.792899959565554E-15	1	1	207	235	21	24	-CT
barcode32_consensus_vsearch	2698	T	*/-G	411	19	4.3%	2	2	93	93	1.556577160279619E-6	1	1	202	209	1	18	-G
barcode32_consensus_vsearch	2706	T	*/-C	483	13	2.6%	2	2	93	93	1.1272628320445117E-4	1	1	218	265	12	1	-C
barcode32_consensus_vsearch	2708	C	*/+A	439	9	1.8%	2	1	93	93	0.0018754838294876201	1	1	196	243	9	0	+A
barcode32_consensus_vsearch	2708	C	*/+G	439	22	4.4%	2	2	93	93	1.844686308264858E-7	1	1	196	243	2	20	+G
barcode32_consensus_vsearch	2708	C	*/-GA	439	7	1.4%	2	1	93	93	0.00762940145447119	1	1	196	243	7	0	+G
barcode32_consensus_vsearch	2708	C	*/-GAA	439	7	1.4%	2	2	93	93	0.00762940145447119	1	1	196	243	6	1	+G
barcode32_consensus_vsearch	2709	G	*/+A	392	58	12.01%	2	2	93	93	4.869724128553423E-19	1	1	128	264	57	1	+A
barcode32_consensus_vsearch	2709	G	*/+AA	392	9	1.86%	2	2	93	93	0.0018664928473143382	1	1	128	264	8	1	+A
barcode32_consensus_vsearch	2709	G	*/-A	392	7	1.45%	2	2	93	93	0.007607942959128091	1	1	128	264	6	1	+A
barcode32_consensus_vsearch	2738	G	*/-TAG	488	9	1.8%	2	1	93	93	0.0018830645540022467	1	1	230	258	0	9	-TAG
barcode32_consensus_vsearch	2745	C	*/-G	480	7	1.41%	2	2	93	93	0.007644752250974145	1	1	225	255	1	6	-G
barcode32_consensus_vsearch	2754	T	*/-GT	463	24	4.84%	2	2	93	93	4.4582014697079395E-8	1	1	221	242	7	17	-GT
barcode32_consensus_vsearch	2758	C	*/-A	405	82	16.43%	2	2	93	93	4.9805132573977926E-27	1	1	147	258	80	2	-A
barcode32_consensus_vsearch	2761	A	*/-G	476	10	2%	2	2	93	93	9.319552152179441E-4	1	1	217	259	5	5	-G
barcode32_consensus_vsearch	2762	G	*/+A	473	8	1.64%	2	1	93	93	0.0037933245016082413	1	1	215	258	8	0	+A
barcode32_consensus_vsearch	2766	A	*/+G	430	9	1.82%	2	1	93	93	0.0018739095280781474	1	1	216	214	0	9	+G
barcode32_consensus_vsearch	2766	A	*/-G	430	43	8.7%	2	2	93	93	4.183078230168467E-14	1	1	216	214	6	37	-G
barcode32_consensus_vsearch	2799	C	*/-T	454	39	7.83%	2	2	93	93	8.319424049908036E-13	1	1	226	228	1	38	-T
barcode32_consensus_vsearch	2804	T	*/+A	457	7	1.43%	2	1	93	93	0.007636473423421301	1	1	196	261	7	0	+A
barcode32_consensus_vsearch	2804	T	*/-A	457	7	1.43%	2	2	93	93	0.007636473423421301	1	1	196	261	6	1	+A
barcode32_consensus_vsearch	2805	A	*/+G	391	13	2.67%	2	2	93	93	1.1066876939038198E-4	1	1	197	194	7	6	+G
barcode32_consensus_vsearch	2805	A	*/-G	391	61	12.53%	2	2	93	93	4.944762853099716E-20	1	1	197	194	15	46	-G
barcode32_consensus_vsearch	2805	A	*/-GG	391	19	3.9%	2	1	93	93	1.5408670957132326E-6	1	1	197	194	0	19	-G
barcode32_consensus_vsearch	2808	G	*/-A	487	7	1.4%	2	1	93	93	0.007647119511005615	1	1	218	269	7	0	-A
barcode32_consensus_vsearch	2811	T	*/+C	465	11	2.2%	2	2	93	93	4.605737343945907E-4	1	1	224	241	1	10	+C
barcode32_consensus_vsearch	2811	T	*/-C	465	18	3.61%	2	2	93	93	3.2463941232164672E-6	1	1	224	241	5	13	-C
barcode32_consensus_vsearch	2813	C	*/-T	484	7	1.41%	2	1	93	93	0.007646113201788858	1	1	231	253	0	7	-T
barcode32_consensus_vsearch	2814	T	*/-C	475	13	2.64%	2	2	93	93	1.1257730181393008E-4	1	1	230	245	1	12	-C
barcode32_consensus_vsearch	2819	G	*/+A	490	8	1.6%	2	2	93	93	0.0037971539481312534	1	1	224	266	7	1	+A
barcode32_consensus_vsearch	2822	G	*/-A	488	7	1.41%	2	1	93	93	0.007647452247954883	1	1	222	266	7	0	-A
barcode32_consensus_vsearch	2825	C	*/-A	481	13	2.61%	2	1	93	93	1.1268947774239521E-4	1	1	231	250	0	13	-A
barcode32_consensus_vsearch	2838	G	*/+T	466	12	2.42%	2	1	93	93	2.276625400345054E-4	1	1	217	249	0	12	+T
barcode32_consensus_vsearch	2839	C	*/-T	462	7	1.42%	2	1	93	93	0.007638341941529366	1	1	224	238	0	7	-T
barcode32_consensus_vsearch	2841	C	*/-T	477	14	2.81%	2	1	93	93	5.5561320509265604E-5	1	1	229	248	0	14	-T
barcode32_consensus_vsearch	2844	T	*/-C	473	11	2.21%	2	2	93	93	4.6102357729833573E-4	1	1	219	254	5	6	-C
barcode32_consensus_vsearch	2866	C	*/+A	475	17	3.41%	2	1	93	93	6.628862640224215E-6	1	1	209	266	17	0	+A
barcode32_consensus_vsearch	2870	A	*/-T	482	7	1.41%	2	2	93	93	0.007645435497920978	1	1	221	261	4	3	-T
barcode32_consensus_vsearch	2872	T	*/+A	463	7	1.4%	2	1	93	93	0.007638710895182459	1	1	222	241	0	7	+A
barcode32_consensus_vsearch	2872	T	*/+G	463	11	2.2%	2	1	93	93	4.6045894472293125E-4	1	1	222	241	0	11	+G
barcode32_consensus_vsearch	2872	T	*/-AC	463	8	1.6%	2	2	93	93	0.003790943664241956	1	1	222	241	6	2	+G
barcode32_consensus_vsearch	2873	A	*/-C	436	12	2.46%	2	2	93	93	2.2658584690234848E-4	1	1	201	235	8	4	-C
barcode32_consensus_vsearch	2873	A	*/-CC	436	9	1.85%	2	1	93	93	0.0018749660605302289	1	1	201	235	9	0	-C
barcode32_consensus_vsearch	2874	C	*/+T	413	14	3%	2	1	93	93	5.4771858527024145E-5	1	1	204	209	0	14	+T
barcode32_consensus_vsearch	2876	C	*/+T	391	8	1.61%	2	1	93	93	0.003770308015149166	1	1	227	164	0	8	+T
barcode32_consensus_vsearch	2876	C	*/-GG	391	18	3.63%	2	1	93	93	3.1509866451656527E-6	1	1	227	164	0	18	-GG
barcode32_consensus_vsearch	2881	C	*/-T	488	8	1.6%	2	2	93	93	0.0037967169586205873	1	1	228	260	2	6	-T
barcode32_consensus_vsearch	2885	C	*/+G	475	7	1.41%	2	1	93	93	0.007643019431907797	1	1	228	247	0	7	+G
barcode32_consensus_vsearch	2885	C	*/-G	475	7	1.41%	2	1	93	93	0.007643019431907797	1	1	228	247	0	7	+G
barcode32_consensus_vsearch	2887	G	*/-C	489	8	1.6%	2	2	93	93	0.0037969358900811403	1	1	222	267	7	1	-C
barcode32_consensus_vsearch	2889	C	*/-A	461	29	5.8%	2	2	93	93	1.2156017482565903E-9	1	1	199	262	25	4	-A
barcode32_consensus_vsearch	2891	A	*/+G	412	12	2.42%	2	2	93	93	2.2561765155391507E-4	1	1	181	231	8	4	+G
barcode32_consensus_vsearch	2891	A	*/-G	412	48	9.7%	2	2	93	93	9.7456521696269E-16	1	1	181	231	20	28	-G
barcode32_consensus_vsearch	2894	G	*/+A	475	13	2.61%	2	1	93	93	1.1257730181393008E-4	1	1	209	266	13	0	+A
barcode32_consensus_vsearch	2898	A	*/+C	480	8	1.61%	2	1	93	93	0.0037949334251056385	1	1	227	253	0	8	+C
barcode32_consensus_vsearch	2900	T	*/-C	455	25	5.08%	2	2	93	93	2.1625336978880357E-8	1	1	223	232	2	23	-C
barcode32_consensus_vsearch	2916	T	*/-GT	479	10	2.01%	2	1	93	93	9.32225201663148E-4	1	1	227	252	0	10	-GT
barcode32_consensus_vsearch	2923	C	*/+TT	482	7	1.41%	2	1	93	93	0.007645435497920978	1	1	216	266	7	0	+TT
barcode32_consensus_vsearch	2924	G	*/-CG	404	86	17.27%	2	2	93	93	2.1584711245327626E-28	1	1	175	229	47	39	-CG
barcode32_consensus_vsearch	2926	G	*/+A	387	11	2.67%	2	1	93	93	4.5526079174589983E-4	1	1	164	223	11	0	+A
barcode32_consensus_vsearch	2934	C	*/+A	486	7	1.4%	2	1	93	93	0.007646785429777685	1	1	222	264	7	0	+A
barcode32_consensus_vsearch	2945	A	*/+G	478	7	1.4%	2	2	93	93	0.0076440633927143216	1	1	224	254	3	4	+G
barcode32_consensus_vsearch	2963	T	*/-A	481	9	1.81%	2	1	93	93	0.0018820734984676631	1	1	214	267	9	0	-A
barcode32_consensus_vsearch	2967	G	*/-C	452	37	7.41%	2	1	93	93	3.585925252694147E-12	1	1	230	222	0	37	-C
barcode32_consensus_vsearch	2969	C	*/+T	481	7	1.4%	2	1	93	93	0.007645094571574461	1	1	229	252	0	7	+T
barcode32_consensus_vsearch	2971	C	*/-A	480	9	1.8%	2	2	93	93	0.0018819296258635499	1	1	227	253	2	7	-A
barcode32_consensus_vsearch	2985	C	*/-T	456	18	3.6%	2	2	93	93	3.23627812187009E-6	1	1	191	265	15	3	-T
barcode32_consensus_vsearch	2985	C	*/-TT	456	23	4.6%	2	1	93	93	9.095920246805368E-8	1	1	191	265	23	0	-TT
barcode32_consensus_vsearch	2988	G	*/-A	481	18	3.6%	2	1	93	93	3.2635326193915317E-6	1	1	212	269	18	0	-A
barcode32_consensus_vsearch	2998	T	*/-C	449	34	6.88%	2	2	93	93	3.1889574141081365E-11	1	1	225	224	4	30	-C
barcode32_consensus_vsearch	3002	T	*/+C	471	9	1.81%	2	1	93	93	0.001880608069030174	1	1	218	253	9	0	+C
barcode32_consensus_vsearch	3002	T	*/-C	471	8	1.61%	2	1	93	93	0.00379285623175068	1	1	218	253	0	8	+C
barcode32_consensus_vsearch	3003	C	*/+T	458	14	2.87%	2	1	93	93	5.534851051459439E-5	1	1	222	236	0	14	+T
barcode32_consensus_vsearch	3003	C	*/-T	458	7	1.43%	2	2	93	93	0.0076368503276010025	1	1	222	236	3	4	+T
barcode32_consensus_vsearch	3004	T	*/-A	463	9	1.87%	2	2	93	93	0.0018793914772358292	1	1	214	249	5	4	-A
barcode32_consensus_vsearch	3006	A	*/-G	464	8	1.62%	2	2	93	93	0.0037911862558090196	1	1	211	253	3	5	-G
barcode32_consensus_vsearch	3006	A	*/-GA	464	12	2.43%	2	1	93	93	2.2759488469078704E-4	1	1	211	253	12	0	-GA
barcode32_consensus_vsearch	3009	A	*/-G	474	15	3.04%	2	1	93	93	2.7366539591447386E-5	1	1	213	261	15	0	-G
barcode32_consensus_vsearch	3021	G	*/-C	483	12	2.41%	2	1	93	93	2.2821602994011232E-4	1	1	217	266	12	0	-C
barcode32_consensus_vsearch	3023	C	*/-A	452	22	4.43%	2	2	93	93	1.8580173221678518E-7	1	1	207	245	18	4	-A
barcode32_consensus_vsearch	3023	C	*/-AA	452	13	2.62%	2	2	93	93	1.121212624491629E-4	1	1	207	245	2	11	-A
barcode32_consensus_vsearch	3046	A	*/-G	472	8	1.61%	2	2	93	93	0.0037930908510905733	1	1	210	262	7	1	-G
barcode32_consensus_vsearch	3047	G	*/+A	479	7	1.43%	2	2	93	93	0.007644408527576281	1	1	215	264	6	1	+A
barcode32_consensus_vsearch	3050	T	*/+A	432	31	6.21%	2	2	93	93	2.7702154590407103E-10	1	1	171	261	30	1	+A
barcode32_consensus_vsearch	3050	T	*/-A	432	32	6.41%	2	2	93	93	1.3387880535611644E-10	1	1	171	261	27	5	-A
barcode32_consensus_vsearch	3074	T	*/-A	467	24	4.8%	2	2	93	93	4.4690225919613884E-8	1	1	227	240	2	22	-A
barcode32_consensus_vsearch	3076	A	*/-G	474	20	4.01%	2	1	93	93	7.837807852284418E-7	1	1	228	246	0	20	-G
barcode32_consensus_vsearch	3082	C	*/-A	480	9	1.8%	2	2	93	93	0.0018819296258635499	1	1	216	264	7	2	-A
barcode32_consensus_vsearch	3087	C	*/-A	482	8	1.61%	2	2	93	93	0.0037953847313509786	1	1	218	264	7	1	-A
barcode32_consensus_vsearch	3090	T	*/+C	477	16	3.23%	2	2	93	93	1.3483987169261433E-5	1	1	216	261	14	2	+C
barcode32_consensus_vsearch	3105	C	*/+G	475	8	1.6%	2	1	93	93	0.0037937889200904415	1	1	227	248	0	8	+G
barcode32_consensus_vsearch	3105	C	*/-G	475	9	1.8%	2	2	93	93	0.0018812014345212318	1	1	227	248	1	8	-G
barcode32_consensus_vsearch	3120	A	*/-C	481	12	2.41%	2	2	93	93	2.2815285032269742E-4	1	1	217	264	10	2	-C
barcode32_consensus_vsearch	3125	C	*/-A	484	7	1.4%	2	2	93	93	0.007646113201788858	1	1	223	261	4	3	-A
barcode32_consensus_vsearch	3131	C	*/+A	448	12	2.41%	2	1	93	93	2.2703297154905811E-4	1	1	183	265	12	0	+A
barcode32_consensus_vsearch	3131	C	*/-A	448	26	5.23%	2	2	93	93	1.0476041215272843E-8	1	1	183	265	25	1	-A
barcode32_consensus_vsearch	3131	C	*/-AA	448	9	1.81%	2	1	93	93	0.0018769967833365436	1	1	183	265	9	0	-A
barcode32_consensus_vsearch	3132	A	*/+G	448	9	1.94%	2	1	93	93	0.0018769967833365436	1	1	182	266	9	0	+G
barcode32_consensus_vsearch	3133	A	*/-G	475	11	2.24%	2	1	93	93	4.611337655353414E-4	1	1	210	265	11	0	-G
barcode32_consensus_vsearch	3134	G	*/+A	421	21	4.3%	2	2	93	93	3.7388789115262633E-7	1	1	158	263	18	3	+A
barcode32_consensus_vsearch	3134	G	*/-A	421	41	8.4%	2	2	93	93	1.797002608503621E-13	1	1	158	263	40	1	-A
barcode32_consensus_vsearch	3138	G	*/-A	487	7	1.4%	2	2	93	93	0.007647119511005615	1	1	221	266	6	1	-A
barcode32_consensus_vsearch	3142	T	*/+C	482	8	1.61%	2	2	93	93	0.0037953847313509786	1	1	226	256	2	6	+C
barcode32_consensus_vsearch	3143	C	*/-TC	476	19	3.82%	2	2	93	93	1.5994935898798693E-6	1	1	229	247	1	18	-TC
barcode32_consensus_vsearch	3144	T	*/+C	463	9	1.88%	2	1	93	93	0.0018793914772358292	1	1	218	245	9	0	+C
barcode32_consensus_vsearch	3156	T	*/+C	479	7	1.41%	2	2	93	93	0.007644408527576281	1	1	223	256	4	3	+C
barcode32_consensus_vsearch	3165	T	*/-GT	483	11	2.2%	2	1	93	93	4.6156575380591254E-4	1	1	219	264	11	0	-GT
barcode32_consensus_vsearch	3169	T	*/-G	484	9	1.81%	2	1	93	93	0.001882501648786426	1	1	229	255	0	9	-G
barcode32_consensus_vsearch	3173	C	*/+T	486	7	1.41%	2	1	93	93	0.007646785429777685	1	1	227	259	0	7	+T
barcode32_consensus_vsearch	3175	T	*/-G	471	19	3.82%	2	1	93	93	1.5965676314035944E-6	1	1	226	245	0	19	-G
barcode32_consensus_vsearch	3176	G	*/+A	471	8	1.66%	2	1	93	93	0.00379285623175068	1	1	222	249	8	0	+A
barcode32_consensus_vsearch	3181	G	*/+T	486	7	1.41%	2	2	93	93	0.007646785429777685	1	1	218	268	6	1	+T
barcode32_consensus_vsearch	3184	T	*/+C	372	13	2.6%	2	2	93	93	1.1012568366163888E-4	1	1	203	169	4	9	+C
barcode32_consensus_vsearch	3184	T	*/-C	372	92	18.4%	2	2	93	93	1.3415195997413948E-30	1	1	203	169	22	70	-C
barcode32_consensus_vsearch	3184	T	*/-CC	372	21	4.2%	2	2	93	93	3.6242294260751566E-7	1	1	203	169	2	19	-C
barcode32_consensus_vsearch	3194	G	*/-A	486	7	1.41%	2	2	93	93	0.007646785429777685	1	1	224	262	3	4	-A
barcode32_consensus_vsearch	3198	C	*/-A	454	20	4.02%	2	2	93	93	7.771832178536633E-7	1	1	225	229	3	17	-A
barcode32_consensus_vsearch	3198	C	*/-AA	454	17	3.42%	2	1	93	93	6.586704563448438E-6	1	1	225	229	0	17	-A
barcode32_consensus_vsearch	3201	A	*/-T	470	7	1.41%	2	2	93	93	0.007641250440637751	1	1	226	244	1	6	-T
barcode32_consensus_vsearch	3203	T	*/-A	444	7	1.42%	2	1	93	93	0.007631422258539495	1	1	226	218	0	7	-A
barcode32_consensus_vsearch	3203	T	*/-AA	444	26	5.27%	2	1	93	93	1.0443792076363971E-8	1	1	226	218	0	26	-AA
barcode32_consensus_vsearch	3218	A	*/+C	394	9	1.82%	2	1	93	93	0.0018669176476072253	1	1	194	200	0	9	+C
barcode32_consensus_vsearch	3218	A	*/-C	394	70	14.14%	2	2	93	93	5.0684186540355674E-23	1	1	194	200	20	50	-C
barcode32_consensus_vsearch	3218	A	*/-CC	394	14	2.83%	2	2	93	93	5.4491738001769014E-5	1	1	194	200	10	4	-C
barcode32_consensus_vsearch	3219	C	*/+T	389	10	2.45%	2	1	93	93	9.223889705434762E-4	1	1	192	197	0	10	+T
barcode32_consensus_vsearch	3220	C	*/+T	454	10	2.09%	2	2	93	93	9.298701683765745E-4	1	1	205	249	7	3	+T
barcode32_consensus_vsearch	3222	C	*/-T	478	10	2%	2	2	93	93	9.321355699884069E-4	1	1	219	259	2	8	-T
barcode32_consensus_vsearch	3223	T	*/+A	459	8	1.64%	2	1	93	93	0.0037899629824653274	1	1	209	250	8	0	+A
barcode32_consensus_vsearch	3223	T	*/-GG	459	9	1.84%	2	1	93	93	0.0018787677458533404	1	1	209	250	9	0	-GG
barcode32_consensus_vsearch	3230	G	*/+C	470	12	2.42%	2	2	93	93	2.2779620497645633E-4	1	1	218	252	4	8	+C
barcode32_consensus_vsearch	3234	T	*/+CT	479	12	2.42%	2	1	93	93	2.2808916757551884E-4	1	1	228	251	0	12	+CT
barcode32_consensus_vsearch	3235	T	*/+C	484	7	1.4%	2	1	93	93	0.007646113201788858	1	1	217	267	7	0	+C
barcode32_consensus_vsearch	3240	C	*/-A	491	8	1.6%	2	2	93	93	0.0037973711380205697	1	1	227	264	4	4	-A
barcode32_consensus_vsearch	3246	C	*/+T	470	9	1.83%	2	1	93	93	0.0018804581949022445	1	1	230	240	0	9	+T
barcode32_consensus_vsearch	3260	C	*/-T	483	7	1.4%	2	2	93	93	0.007645775038504135	1	1	225	258	1	6	-T
barcode32_consensus_vsearch	3272	C	*/-TC	480	8	1.61%	2	2	93	93	0.0037949334251056385	1	1	225	255	1	7	-TC
barcode32_consensus_vsearch	3273	T	*/+C	313	33	6.76%	2	2	93	93	5.226013355706942E-11	1	1	184	129	30	3	+C
barcode32_consensus_vsearch	3273	T	*/-C	313	102	20.9%	2	2	93	93	1.6374429001940735E-34	1	1	184	129	10	92	-C
barcode32_consensus_vsearch	3273	T	*/-CC	313	28	5.74%	2	2	93	93	2.090566361182771E-9	1	1	184	129	2	26	-C
barcode32_consensus_vsearch	3279	T	*/-G	450	47	9.42%	2	1	93	93	2.2693734151941476E-15	1	1	229	221	0	47	-G
barcode32_consensus_vsearch	3281	G	*/-A	475	24	4.8%	2	1	93	93	4.490207325334608E-8	1	1	206	269	24	0	-A
barcode32_consensus_vsearch	3283	G	*/-C	481	14	2.81%	2	1	93	93	5.5604110352241374E-5	1	1	214	267	14	0	-C
barcode32_consensus_vsearch	3292	C	*/-T	472	15	3.01%	2	2	93	93	2.7354108112592933E-5	1	1	221	251	1	14	-T
barcode32_consensus_vsearch	3292	C	*/-TT	472	7	1.41%	2	2	93	93	0.007641962449987148	1	1	221	251	6	1	-T
barcode32_consensus_vsearch	3297	A	*/-T	485	14	2.8%	2	2	93	93	5.56462368684008E-5	1	1	230	255	1	13	-T
barcode32_consensus_vsearch	3300	T	*/-C	464	21	4.2%	2	1	93	93	3.822171469291514E-7	1	1	229	235	0	21	-C
barcode32_consensus_vsearch	3300	T	*/-CTC	464	11	2.2%	2	1	93	93	4.605164581707988E-4	1	1	229	235	0	11	-C
barcode32_consensus_vsearch	3301	C	*/-TC	427	27	5.77%	2	1	93	93	5.003047372227946E-9	1	1	230	197	0	27	-TC
barcode32_consensus_vsearch	3305	T	*/-A	450	15	3.07%	2	1	93	93	2.721060177339259E-5	1	1	210	240	15	0	-A
barcode32_consensus_vsearch	3317	C	*/+A	482	10	2%	2	1	93	93	9.324919401133498E-4	1	1	215	267	10	0	+A
barcode32_consensus_vsearch	3318	G	*/-A	490	10	2%	2	2	93	93	9.331878021836545E-4	1	1	222	268	9	1	-A
barcode32_consensus_vsearch	3319	A	*/+G	465	8	1.63%	2	1	93	93	0.0037914278288080057	1	1	203	262	8	0	+G
barcode32_consensus_vsearch	3322	C	*/+A	358	13	2.61%	2	2	93	93	1.0969123745697646E-4	1	1	184	174	4	9	+A
barcode32_consensus_vsearch	3322	C	*/-A	358	84	16.87%	2	2	93	93	6.588406768371314E-28	1	1	184	174	22	62	-A
barcode32_consensus_vsearch	3322	C	*/-AA	358	34	6.83%	2	2	93	93	2.7557294512275087E-11	1	1	184	174	13	21	-A
barcode32_consensus_vsearch	3337	T	*/-C	488	10	2%	2	1	93	93	9.330159046450721E-4	1	1	220	268	10	0	-C
barcode32_consensus_vsearch	3342	T	*/+C	431	7	1.41%	2	2	93	93	0.007626072650234986	1	1	177	254	3	4	+C
barcode32_consensus_vsearch	3342	T	*/-C	431	53	10.66%	2	2	93	93	2.4623890858219188E-17	1	1	177	254	45	8	-C
barcode32_consensus_vsearch	3381	A	*/+T	490	8	1.6%	2	1	93	93	0.0037971539481312534	1	1	231	259	0	8	+T
barcode32_consensus_vsearch	3391	C	*/-T	486	7	1.41%	2	2	93	93	0.007646785429777685	1	1	225	261	2	5	-T
barcode32_consensus_vsearch	3393	T	*/+C	482	8	1.6%	2	1	93	93	0.0037953847313509786	1	1	217	265	8	0	+C
barcode32_consensus_vsearch	3397	T	*/+C	351	27	5.43%	2	2	93	93	4.604503634135495E-9	1	1	119	232	22	5	+C
barcode32_consensus_vsearch	3397	T	*/-C	351	97	19.52%	2	2	93	93	1.8396695441302113E-32	1	1	119	232	77	20	-C
barcode32_consensus_vsearch	3397	T	*/-CC	351	18	3.62%	2	2	93	93	3.0848036546380445E-6	1	1	119	232	10	8	-C
barcode32_consensus_vsearch	3401	C	*/-T	475	16	3.2%	2	2	93	93	1.3477087849748697E-5	1	1	228	247	2	14	-T
barcode32_consensus_vsearch	3405	C	*/+T	451	8	1.62%	2	2	93	93	0.0037879507121486144	1	1	200	251	7	1	+T
barcode32_consensus_vsearch	3405	C	*/-T	451	7	1.42%	2	1	93	93	0.007634177589087493	1	1	200	251	0	7	+T
barcode32_consensus_vsearch	3405	C	*/-TT	451	21	4.25%	2	2	93	93	3.7984400952288665E-7	1	1	200	251	17	4	-TT
barcode32_consensus_vsearch	3412	T	*/-C	471	28	5.6%	2	2	93	93	2.5233889255921095E-9	1	1	204	267	27	1	-C
barcode32_consensus_vsearch	3414	C	*/-T	491	7	1.4%	2	1	93	93	0.007648442473937147	1	1	230	261	0	7	-T
barcode32_consensus_vsearch	3418	T	*/+A	480	11	2.2%	2	1	93	93	4.6140537857478075E-4	1	1	229	251	0	11	+A
barcode32_consensus_vsearch	3423	G	*/-A	469	12	2.43%	2	2	93	93	2.2776299237076134E-4	1	1	219	250	1	11	-A
barcode32_consensus_vsearch	3430	T	*/-C	487	9	1.8%	2	2	93	93	0.0018829246705400634	1	1	224	263	6	3	-C
barcode32_consensus_vsearch	3431	C	*/+T	474	11	2.24%	2	1	93	93	4.610787829701709E-4	1	1	223	251	0	11	+T
barcode32_consensus_vsearch	3432	C	*/-T	454	39	7.8%	2	2	93	93	8.319424049908036E-13	1	1	226	228	3	36	-T
barcode32_consensus_vsearch	3434	T	*/-G	474	7	1.4%	2	2	93	93	0.00764266856336234	1	1	227	247	1	6	-G
barcode32_consensus_vsearch	3437	C	*/-A	456	17	3.41%	2	2	93	93	6.590871787990329E-6	1	1	224	232	2	15	-A
barcode32_consensus_vsearch	3443	C	*/+T	473	7	1.41%	2	2	93	93	0.007642316239083064	1	1	223	250	2	5	+T
barcode32_consensus_vsearch	3446	T	*/-C	484	11	2.2%	2	2	93	93	4.616187878341615E-4	1	1	227	257	2	9	-C
barcode32_consensus_vsearch	3447	C	*/+T	467	8	1.64%	2	1	93	93	0.0037919079446709545	1	1	225	242	0	8	+T
barcode32_consensus_vsearch	3449	C	*/+G	480	8	1.61%	2	1	93	93	0.0037949334251056385	1	1	216	264	8	0	+G
barcode32_consensus_vsearch	3454	G	*/+T	456	32	6.46%	2	1	93	93	1.3769877846836955E-10	1	1	192	264	32	0	+T
barcode32_consensus_vsearch	3456	T	*/+G	484	9	1.8%	2	2	93	93	0.001882501648786426	1	1	220	264	8	1	+G
barcode32_consensus_vsearch	3472	C	*/+A	470	7	1.4%	2	2	93	93	0.007641250440637751	1	1	203	267	6	1	+A
barcode32_consensus_vsearch	3472	C	*/-A	470	21	4.2%	2	2	93	93	3.832738809329882E-7	1	1	203	267	20	1	-A
barcode32_consensus_vsearch	3474	A	*/-G	478	9	1.8%	2	1	93	93	0.0018816401257546191	1	1	211	267	9	0	-G
barcode32_consensus_vsearch	3505	G	*/+C	427	13	2.62%	2	2	93	93	1.1157316780867368E-4	1	1	204	223	9	4	+C
barcode32_consensus_vsearch	3505	G	*/-C	427	48	9.66%	2	2	93	93	1.0174230450459582E-15	1	1	204	223	10	38	-C
barcode32_consensus_vsearch	3510	C	*/+T	409	12	2.4%	2	1	93	93	2.2548906969822708E-4	1	1	221	188	0	12	+T
barcode32_consensus_vsearch	3516	T	*/+C	445	7	1.41%	2	2	93	93	0.007631821078608308	1	1	186	259	6	1	+C
barcode32_consensus_vsearch	3516	T	*/-C	445	29	5.85%	2	2	93	93	1.197675637972052E-9	1	1	186	259	26	3	-C
barcode32_consensus_vsearch	3516	T	*/-CC	445	9	1.81%	2	1	93	93	0.0018764990590094985	1	1	186	259	9	0	-C
barcode32_consensus_vsearch	3521	A	*/-TTA	483	9	1.8%	2	1	93	93	0.0018823595064416164	1	1	221	262	9	0	-TTA
barcode32_consensus_vsearch	3538	T	*/+C	464	7	1.4%	2	1	93	93	0.007639078288945116	1	1	195	269	7	0	+C
barcode32_consensus_vsearch	3538	T	*/-C	464	29	5.8%	2	1	93	93	1.2188578298184865E-9	1	1	195	269	29	0	-C
barcode32_consensus_vsearch	3541	T	*/-A	471	18	3.63%	2	2	93	93	3.252944247950858E-6	1	1	212	259	17	1	-A
barcode32_consensus_vsearch	3543	G	*/+A	474	13	2.61%	2	1	93	93	1.1255834461917994E-4	1	1	227	247	0	13	+A
barcode32_consensus_vsearch	3548	C	*/+A	481	10	2%	2	1	93	93	9.324033845593119E-4	1	1	230	251	0	10	+A
barcode32_consensus_vsearch	3551	C	*/+A	439	18	3.61%	2	2	93	93	3.21615593583041E-6	1	1	196	243	7	11	+A
barcode32_consensus_vsearch	3551	C	*/-A	439	29	5.81%	2	2	93	93	1.1906998815745488E-9	1	1	196	243	25	4	-A
barcode32_consensus_vsearch	3564	C	*/-AC	461	36	7.21%	2	2	93	93	7.54055267074655E-12	1	1	200	261	28	8	-AC
barcode32_consensus_vsearch	3568	T	*/-C	470	22	4.4%	2	1	93	93	1.8754296717078046E-7	1	1	203	267	22	0	-C
barcode32_consensus_vsearch	3574	T	*/+C	492	7	1.4%	2	2	93	93	0.007648769914171423	1	1	229	263	2	5	+C
barcode32_consensus_vsearch	3608	C	*/+T	482	9	1.82%	2	1	93	93	0.0018822167908263267	1	1	224	258	0	9	+T
barcode32_consensus_vsearch	3609	C	*/-T	484	10	2%	2	2	93	93	9.326679901268426E-4	1	1	228	256	1	9	-T
barcode32_consensus_vsearch	3612	C	*/+T	485	9	1.82%	2	1	93	93	0.001882643221311292	1	1	228	257	0	9	+T
barcode32_consensus_vsearch	3614	T	*/-G	462	25	5.03%	2	2	93	93	2.1727866110235284E-8	1	1	224	238	2	23	-G
barcode32_consensus_vsearch	3622	T	*/+C	470	15	3.02%	2	2	93	93	2.734157825647552E-5	1	1	217	253	12	3	+C
barcode32_consensus_vsearch	3623	C	*/-T	478	9	1.82%	2	2	93	93	0.0018816401257546191	1	1	230	248	1	8	-T
barcode32_consensus_vsearch	3626	A	*/+T	373	15	3%	2	2	93	93	2.6586639991105327E-5	1	1	172	201	6	9	+T
barcode32_consensus_vsearch	3626	A	*/-T	373	96	19.2%	2	2	93	93	5.564918166934961E-32	1	1	172	201	44	52	-T
barcode32_consensus_vsearch	3626	A	*/-TT	373	7	1.4%	2	1	93	93	0.007597769697997662	1	1	172	201	7	0	-T
barcode32_consensus_vsearch	3633	C	*/+A	438	13	2.61%	2	2	93	93	1.1182158871350396E-4	1	1	218	220	3	10	+A
barcode32_consensus_vsearch	3633	C	*/-A	438	16	3.21%	2	2	93	93	1.333904137735575E-5	1	1	218	220	8	8	-A
barcode32_consensus_vsearch	3633	C	*/-AA	438	25	5.02%	2	2	93	93	2.1365271227405784E-8	1	1	218	220	2	23	-AA
barcode32_consensus_vsearch	3638	T	*/+A	384	17	3.43%	2	2	93	93	6.4164031706101775E-6	1	1	171	213	9	8	+A
barcode32_consensus_vsearch	3638	T	*/-A	384	76	15.35%	2	2	93	93	4.50935882273989E-25	1	1	171	213	43	33	-A
barcode32_consensus_vsearch	3638	T	*/-AA	384	11	2.22%	2	2	93	93	4.5501547153779163E-4	1	1	171	213	7	4	-A
barcode32_consensus_vsearch	3644	T	*/-C	485	7	1.41%	2	2	93	93	0.007646449996103257	1	1	223	262	6	1	-C
barcode32_consensus_vsearch	3646	C	*/+T	479	17	3.41%	2	1	93	93	6.636509837581552E-6	1	1	231	248	0	17	+T
barcode32_consensus_vsearch	3648	G	*/-T	479	7	1.41%	2	2	93	93	0.007644408527576281	1	1	222	257	4	3	-T
barcode32_consensus_vsearch	3651	T	*/+C	367	29	5.8%	2	2	93	93	1.094297585058097E-9	1	1	206	161	4	25	+C
barcode32_consensus_vsearch	3651	T	*/-C	367	69	13.8%	2	2	93	93	9.106876370429892E-23	1	1	206	161	17	52	-C
barcode32_consensus_vsearch	3651	T	*/-CC	367	8	1.6%	2	2	93	93	0.0037616841729398503	1	1	206	161	1	7	-C
barcode32_consensus_vsearch	3651	T	*/-CCC	367	18	3.6%	2	2	93	93	3.1127943336343686E-6	1	1	206	161	1	17	-CCC
barcode32_consensus_vsearch	3660	C	*/-AC	475	18	3.6%	2	1	93	93	3.2572279369292244E-6	1	1	211	264	18	0	-AC
barcode32_consensus_vsearch	3668	G	*/-A	479	11	2.22%	2	2	93	93	4.61351491529115E-4	1	1	219	260	10	1	-A
barcode32_consensus_vsearch	3670	A	*/-G	478	16	3.21%	2	2	93	93	1.3487416856570409E-5	1	1	217	261	13	3	-G
barcode32_consensus_vsearch	3684	C	*/+A	478	7	1.41%	2	1	93	93	0.0076440633927143216	1	1	227	251	0	7	+A
barcode32_consensus_vsearch	3688	G	*/-AG	466	19	3.82%	2	2	93	93	1.5935856818178344E-6	1	1	221	245	5	14	-AG
barcode32_consensus_vsearch	3689	A	*/+G	332	19	4.03%	2	2	93	93	1.4851278237791481E-6	1	1	132	200	8	11	+G
barcode32_consensus_vsearch	3689	A	*/-G	332	106	22.46%	2	2	93	93	8.794651196091808E-36	1	1	132	200	78	28	-G
barcode32_consensus_vsearch	3689	A	*/-GG	332	8	1.69%	2	2	93	93	0.0037469467580895535	1	1	132	200	3	5	-G
barcode32_consensus_vsearch	3692	G	*/+A	442	7	1.41%	2	2	93	93	0.007630619313173879	1	1	200	242	2	5	+A
barcode32_consensus_vsearch	3692	G	*/-A	442	33	6.63%	2	2	93	93	6.546836910460762E-11	1	1	200	242	22	11	-A
barcode32_consensus_vsearch	3695	A	*/-G	476	9	1.81%	2	2	93	93	0.001881348261906975	1	1	222	254	4	5	-G
barcode32_consensus_vsearch	3696	G	*/+C	478	8	1.63%	2	1	93	93	0.0037944784297538666	1	1	227	251	0	8	+C
barcode32_consensus_vsearch	3697	G	*/+C	481	8	1.6%	2	2	93	93	0.003795159536553975	1	1	219	262	4	4	+C
barcode32_consensus_vsearch	3700	C	*/-G	468	15	3.01%	2	2	93	93	2.73289488521999E-5	1	1	227	241	1	14	-G
barcode32_consensus_vsearch	3702	G	*/-C	478	12	2.41%	2	2	93	93	2.2805713564733962E-4	1	1	224	254	4	8	-C
barcode32_consensus_vsearch	3704	C	*/-G	465	21	4.22%	2	1	93	93	3.8239491644037583E-7	1	1	228	237	0	21	-G
barcode32_consensus_vsearch	3707	A	*/-C	484	9	1.8%	2	2	93	93	0.001882501648786426	1	1	222	262	7	2	-C
barcode32_consensus_vsearch	3723	A	*/-G	467	13	2.64%	2	2	93	93	1.1242349541751215E-4	1	1	207	260	8	5	-G
barcode32_consensus_vsearch	3740	A	*/-G	469	14	2.82%	2	2	93	93	5.547368722232185E-5	1	1	220	249	7	7	-G
barcode32_consensus_vsearch	3742	G	*/-C	473	15	3.01%	2	1	93	93	2.7360336076732557E-5	1	1	208	265	15	0	-C
barcode32_consensus_vsearch	3745	C	*/-A	445	38	7.6%	2	2	93	93	1.7058906962187198E-12	1	1	187	258	36	2	-A
barcode32_consensus_vsearch	3758	C	*/+A	456	16	3.24%	2	1	93	93	1.3408770375979718E-5	1	1	196	260	16	0	+A
barcode32_consensus_vsearch	3758	C	*/-G	456	10	2.02%	2	2	93	93	9.300677370579054E-4	1	1	196	260	8	2	+A
barcode32_consensus_vsearch	3759	G	*/-A	467	17	3.47%	2	1	93	93	6.613209960094712E-6	1	1	202	265	17	0	-A
barcode32_consensus_vsearch	3762	C	*/+T	398	35	7.04%	2	2	93	93	1.422627177942685E-11	1	1	191	207	14	21	+T
barcode32_consensus_vsearch	3762	C	*/-T	398	46	9.26%	2	2	93	93	4.157533854860474E-15	1	1	191	207	19	27	-T
barcode32_consensus_vsearch	3762	C	*/-TT	398	15	3.02%	2	2	93	93	2.6813513686337928E-5	1	1	191	207	5	10	-T
barcode32_consensus_vsearch	3769	A	*/-C	485	7	1.4%	2	2	93	93	0.007646449996103257	1	1	225	260	5	2	-C
barcode32_consensus_vsearch	3779	C	*/+T	484	8	1.61%	2	2	93	93	0.0037958323931522003	1	1	226	258	1	7	+T
barcode32_consensus_vsearch	3795	T	*/-G	467	27	5.4%	2	1	93	93	5.171647194563027E-9	1	1	227	240	0	27	-G
barcode32_consensus_vsearch	3801	T	*/-G	467	18	3.61%	2	2	93	93	3.2485943663543954E-6	1	1	226	241	1	17	-G
barcode32_consensus_vsearch	3812	C	*/-G	474	8	1.6%	2	1	93	93	0.0037935571892849574	1	1	229	245	0	8	-G
barcode32_consensus_vsearch	3822	C	*/-A	481	11	2.21%	2	1	93	93	4.61459050447595E-4	1	1	214	267	11	0	-A
barcode32_consensus_vsearch	3829	C	*/-TT	481	7	1.4%	2	1	93	93	0.007645094571574461	1	1	221	260	7	0	-TT
barcode32_consensus_vsearch	3832	G	*/-C	462	16	3.23%	2	2	93	93	1.3430902761682295E-5	1	1	214	248	11	5	-C
barcode32_consensus_vsearch	3836	T	*/-C	436	54	10.89%	2	1	93	93	1.1836672684981912E-17	1	1	169	267	54	0	-C
barcode32_consensus_vsearch	3852	T	*/+A	469	17	3.42%	2	2	93	93	6.6171687850428155E-6	1	1	205	264	16	1	+A
barcode32_consensus_vsearch	3852	T	*/-A	469	9	1.81%	2	2	93	93	0.0018803077000523797	1	1	205	264	8	1	+A
barcode32_consensus_vsearch	3854	A	*/-G	463	21	4.2%	2	2	93	93	3.8203870993173336E-7	1	1	216	247	12	9	-G
barcode32_consensus_vsearch	3857	G	*/-A	492	7	1.4%	2	1	93	93	0.007648769914171423	1	1	223	269	7	0	-A
barcode32_consensus_vsearch	3861	T	*/+A	486	7	1.4%	2	2	93	93	0.007646785429777685	1	1	221	265	5	2	+A
barcode32_consensus_vsearch	3870	C	*/+T	480	9	1.82%	2	1	93	93	0.0018819296258635499	1	1	226	254	0	9	+T
barcode32_consensus_vsearch	3877	C	*/-A	480	17	3.4%	2	2	93	93	6.638403437232998E-6	1	1	224	256	5	12	-A
barcode32_consensus_vsearch	3887	A	*/-C	483	10	2.01%	2	2	93	93	9.325801412601721E-4	1	1	218	265	8	2	-C
barcode32_consensus_vsearch	3890	C	*/+A	351	37	7.4%	2	2	93	93	2.9553035408132212E-12	1	1	113	238	20	17	+A
barcode32_consensus_vsearch	3890	C	*/+AA	351	7	1.4%	2	2	93	93	0.0075846487975676224	1	1	113	238	6	1	+A
barcode32_consensus_vsearch	3890	C	*/-A	351	80	16%	2	2	93	93	1.4479157383416168E-26	1	1	113	238	73	7	-A
barcode32_consensus_vsearch	3890	C	*/-AA	351	13	2.6%	2	2	93	93	1.0946195562417223E-4	1	1	113	238	11	2	-A
barcode32_consensus_vsearch	3897	G	*/-C	480	9	1.82%	2	2	93	93	0.0018819296258635499	1	1	223	257	6	3	-C
barcode32_consensus_vsearch	3899	C	*/+T	484	8	1.6%	2	1	93	93	0.0037958323931522003	1	1	231	253	0	8	+T
barcode32_consensus_vsearch	3923	A	*/-C	474	9	1.82%	2	1	93	93	0.0018810540052625968	1	1	222	252	0	9	-C
barcode32_consensus_vsearch	3926	T	*/+C	411	12	2.44%	2	2	93	93	2.2557498827275595E-4	1	1	206	205	1	11	+C
barcode32_consensus_vsearch	3926	T	*/-C	411	61	12.4%	2	2	93	93	5.456434135197138E-20	1	1	206	205	19	42	-C
barcode32_consensus_vsearch	3938	G	*/-A	490	10	2%	2	2	93	93	9.331878021836545E-4	1	1	222	268	9	1	-A
barcode32_consensus_vsearch	3941	T	*/-GG	466	9	1.81%	2	1	93	93	0.0018798524523993853	1	1	222	244	0	9	-GG
barcode32_consensus_vsearch	3945	T	*/-A	465	9	1.83%	2	2	93	93	0.001879699435718404	1	1	220	245	6	3	-A
barcode32_consensus_vsearch	3947	A	*/-T	451	42	8.4%	2	2	93	93	9.135089929517853E-14	1	1	195	256	35	7	-T
barcode32_consensus_vsearch	3954	C	*/-GC	478	15	3%	2	2	93	93	2.739111201125375E-5	1	1	222	256	8	7	-GC
barcode32_consensus_vsearch	3962	G	*/+CC	460	9	1.84%	2	1	93	93	0.0018789246658047912	1	1	200	260	9	0	+CC
barcode32_consensus_vsearch	3962	G	*/-C	460	12	2.45%	2	2	93	93	2.2745789421925263E-4	1	1	200	260	9	3	-C
barcode32_consensus_vsearch	3964	C	*/+T	466	19	3.82%	2	2	93	93	1.5935856818178344E-6	1	1	222	244	2	17	+T
barcode32_consensus_vsearch	3966	T	*/-C	474	15	3.01%	2	2	93	93	2.7366539591447386E-5	1	1	219	255	3	12	-C
barcode32_consensus_vsearch	3968	C	*/+T	462	10	2.02%	2	2	93	93	9.306505389952973E-4	1	1	223	239	1	9	+T
barcode32_consensus_vsearch	3968	C	*/-T	462	17	3.43%	2	2	93	93	6.6031763316283235E-6	1	1	223	239	2	15	-T
barcode32_consensus_vsearch	3970	T	*/-G	462	32	6.41%	2	1	93	93	1.3860948087689356E-10	1	1	227	235	0	32	-G
barcode32_consensus_vsearch	3999	T	*/+C	486	7	1.41%	2	2	93	93	0.007646785429777685	1	1	227	259	2	5	+C
barcode32_consensus_vsearch	4001	T	*/-C	473	17	3.46%	2	2	93	93	6.624994773409317E-6	1	1	215	258	15	2	-C
barcode32_consensus_vsearch	4003	C	*/+G	422	25	5.02%	2	1	93	93	2.110510404694971E-8	1	1	196	226	25	0	+G
barcode32_consensus_vsearch	4003	C	*/-G	422	39	7.83%	2	2	93	93	7.860821837207306E-13	1	1	196	226	2	37	-G
barcode32_consensus_vsearch	4003	C	*/-GG	422	7	1.41%	2	2	93	93	0.007622180052576428	1	1	196	226	5	2	-G
barcode32_consensus_vsearch	4009	C	*/+A	475	15	3.02%	2	1	93	93	2.7372718800438504E-5	1	1	210	265	15	0	+A
barcode32_consensus_vsearch	4010	G	*/-A	476	14	2.83%	2	2	93	93	5.555051756564947E-5	1	1	211	265	12	2	-A
barcode32_consensus_vsearch	4012	G	*/+C	421	28	5.71%	2	2	93	93	2.4129244906436424E-9	1	1	167	254	20	8	+C
barcode32_consensus_vsearch	4012	G	*/-C	421	30	6.12%	2	2	93	93	5.656319037844705E-10	1	1	167	254	29	1	-C
barcode32_consensus_vsearch	4015	C	*/-T	486	10	2%	2	1	93	93	9.328426394204927E-4	1	1	230	256	0	10	-T
barcode32_consensus_vsearch	4018	A	*/+C	449	17	3.4%	2	1	93	93	6.576138989271143E-6	1	1	222	227	0	17	+C
barcode32_consensus_vsearch	4018	A	*/-C	449	27	5.4%	2	2	93	93	5.098700964956615E-9	1	1	222	227	2	25	-C
barcode32_consensus_vsearch	4031	C	*/+AA	347	8	1.6%	2	1	93	93	0.003753615277703552	1	1	231	116	0	8	+AA
barcode32_consensus_vsearch	4038	A	*/+T	490	7	1.4%	2	1	93	93	0.007648113721449173	1	1	229	261	0	7	+T
barcode32_consensus_vsearch	4055	C	*/-T	483	9	1.81%	2	1	93	93	0.0018823595064416164	1	1	229	254	0	9	-T
barcode32_consensus_vsearch	4056	T	*/+C	475	9	1.83%	2	2	93	93	0.0018812014345212318	1	1	222	253	8	1	+C
barcode32_consensus_vsearch	4057	C	*/-T	486	7	1.41%	2	1	93	93	0.007646785429777685	1	1	228	258	0	7	-T
barcode32_consensus_vsearch	4065	G	*/-A	470	24	4.82%	2	2	93	93	4.4770374718808064E-8	1	1	206	264	22	2	-A
barcode32_consensus_vsearch	4074	T	*/+A	486	11	2.2%	2	2	93	93	4.617242268643541E-4	1	1	219	267	10	1	+A
barcode32_consensus_vsearch	4075	A	*/-G	438	44	8.82%	2	2	93	93	2.033239879152028E-14	1	1	201	237	21	23	-G
barcode32_consensus_vsearch	4081	G	*/-A	475	19	3.83%	2	2	93	93	1.5989128018653312E-6	1	1	220	255	7	12	-A
barcode32_consensus_vsearch	4084	A	*/-T	484	8	1.6%	2	2	93	93	0.0037958323931522003	1	1	228	256	3	5	-T
barcode32_consensus_vsearch	4088	G	*/-A	476	13	2.62%	2	2	93	93	1.1259618363707113E-4	1	1	227	249	4	9	-A
barcode32_consensus_vsearch	4107	C	*/-A	476	12	2.42%	2	2	93	93	2.279926868673764E-4	1	1	214	262	10	2	-A
barcode32_consensus_vsearch	4116	G	*/-CG	486	7	1.41%	2	1	93	93	0.007646785429777685	1	1	227	259	0	7	-CG
barcode32_consensus_vsearch	4124	A	*/+G	457	10	2.01%	2	1	93	93	9.301658958586232E-4	1	1	193	264	10	0	+G
barcode32_consensus_vsearch	4124	A	*/-GA	457	23	4.63%	2	2	93	93	9.10117112999701E-8	1	1	193	264	20	3	-GA
barcode32_consensus_vsearch	4126	A	*/+G	450	7	1.49%	2	1	93	93	0.0076337891152176976	1	1	192	258	7	0	+G
barcode32_consensus_vsearch	4127	A	*/-G	481	10	2.02%	2	1	93	93	9.324033845593119E-4	1	1	213	268	10	0	-G
barcode32_consensus_vsearch	4131	A	*/-TTA	463	20	4.02%	2	2	93	93	7.802142185918749E-7	1	1	223	240	1	19	-TTA
barcode32_consensus_vsearch	4149	G	*/+C	466	14	2.82%	2	2	93	93	5.544009752911821E-5	1	1	218	248	4	10	+C
barcode32_consensus_vsearch	4149	G	*/-C	466	10	2.01%	2	2	93	93	9.310310253206723E-4	1	1	218	248	4	6	+C
barcode32_consensus_vsearch	4154	G	*/-A	482	10	2.01%	2	1	93	93	9.324919401133498E-4	1	1	217	265	10	0	-A
barcode32_consensus_vsearch	4156	A	*/+G	464	11	2.21%	2	2	93	93	4.605164581707988E-4	1	1	211	253	6	5	+G
barcode32_consensus_vsearch	4156	A	*/-G	464	16	3.21%	2	2	93	93	1.3438163175026509E-5	1	1	211	253	7	9	-G
barcode32_consensus_vsearch	4157	G	*/+A	463	7	1.46%	2	1	93	93	0.007638710895182459	1	1	207	256	7	0	+A
barcode32_consensus_vsearch	4160	C	*/+T	461	8	1.61%	2	1	93	93	0.003790455399559823	1	1	199	262	8	0	+T
barcode32_consensus_vsearch	4161	A	*/+T	441	27	5.44%	2	2	93	93	5.064782223535546E-9	1	1	178	263	25	2	+T
barcode32_consensus_vsearch	4165	G	*/+T	377	38	7.6%	2	2	93	93	1.4978505198144916E-12	1	1	140	237	34	4	+T
barcode32_consensus_vsearch	4165	G	*/+TT	377	7	1.4%	2	1	93	93	0.007599994652592844	1	1	140	237	7	0	+T
barcode32_consensus_vsearch	4165	G	*/-T	377	56	11.2%	2	2	93	93	2.0724697891265145E-18	1	1	140	237	42	14	-T
barcode32_consensus_vsearch	4165	G	*/-TT	377	17	3.4%	2	2	93	93	6.396270971981517E-6	1	1	140	237	5	12	-T
barcode32_consensus_vsearch	4172	A	*/+T	475	8	1.6%	2	1	93	93	0.0037937889200904415	1	1	230	245	0	8	+T
barcode32_consensus_vsearch	4172	A	*/-T	475	10	2%	2	1	93	93	9.318644876872256E-4	1	1	230	245	0	10	-T
barcode32_consensus_vsearch	4174	C	*/-T	486	9	1.8%	2	1	93	93	0.001882784227427251	1	1	231	255	0	9	-T
barcode32_consensus_vsearch	4175	T	*/-A	476	10	2.04%	2	2	93	93	9.319552152179441E-4	1	1	229	247	2	8	-A
barcode32_consensus_vsearch	4186	T	*/+C	459	15	3.01%	2	1	93	93	2.7270852271146047E-5	1	1	209	250	15	0	+C
barcode32_consensus_vsearch	4186	T	*/-C	459	22	4.42%	2	2	93	93	1.8649277784007355E-7	1	1	209	250	6	16	-C
barcode32_consensus_vsearch	4191	T	*/-C	465	27	5.41%	2	2	93	93	5.1637632790293855E-9	1	1	202	263	23	4	-C
barcode32_consensus_vsearch	4198	T	*/+C	484	9	1.8%	2	1	93	93	0.001882501648786426	1	1	218	266	9	0	+C
barcode32_consensus_vsearch	4199	C	*/-G	480	7	1.41%	2	2	93	93	0.007644752250974145	1	1	220	260	2	5	-G
barcode32_consensus_vsearch	4203	A	*/+T	402	8	1.62%	2	2	93	93	0.003773925935642463	1	1	172	230	3	5	+T
barcode32_consensus_vsearch	4203	A	*/-T	402	74	15.01%	2	2	93	93	2.4375565521568565E-24	1	1	172	230	47	27	-T
barcode32_consensus_vsearch	4241	T	*/-C	461	36	7.21%	2	2	93	93	7.54055267074655E-12	1	1	194	267	35	1	-C
barcode32_consensus_vsearch	4250	T	*/-A	459	25	5.04%	2	2	93	93	2.1684238498088094E-8	1	1	194	265	24	1	-A
barcode32_consensus_vsearch	4252	A	*/-G	475	13	2.61%	2	2	93	93	1.1257730181393008E-4	1	1	213	262	9	4	-G
barcode32_consensus_vsearch	4285	G	*/-A	491	8	1.6%	2	2	93	93	0.0037973711380205697	1	1	224	267	7	1	-A
barcode32_consensus_vsearch	4291	T	*/+C	464	25	5.04%	2	1	93	93	2.1756694088942403E-8	1	1	230	234	0	25	+C
barcode32_consensus_vsearch	4292	T	*/-C	462	28	5.6%	2	2	93	93	2.50487632973982E-9	1	1	227	235	1	27	-C
barcode32_consensus_vsearch	4341	C	*/+T	435	13	2.61%	2	1	93	93	1.1175501046296811E-4	1	1	225	210	0	13	+T
barcode32_consensus_vsearch	4341	C	*/-T	435	45	9.02%	2	2	93	93	9.634506915173312E-15	1	1	225	210	3	42	-T
