Chrom	Position	Ref	Cons	Reads1	Reads2	VarFreq	Strands1	Strands2	Qual1	Qual2	Pvalue	MapQual1	MapQual2	Reads1Plus	Reads1Minus	Reads2Plus	Reads2Minus	VarAllele
barcode64_consensus_vsearch	59	A	R	200	7	3.37%	2	1	93	93	0.007420075094973923	1	1	74	126	7	0	G
barcode64_consensus_vsearch	205	T	Y	188	14	6.76%	2	1	93	93	4.834532199564987E-5	1	1	78	110	0	14	C
barcode64_consensus_vsearch	283	T	Y	196	9	4.35%	2	1	93	93	0.001785610469261078	1	1	81	115	0	9	C
barcode64_consensus_vsearch	313	C	Y	194	10	4.81%	2	2	93	93	8.722750499460999E-4	1	1	78	116	3	7	T
barcode64_consensus_vsearch	325	G	R	163	35	17.41%	2	1	93	93	5.598205402920753E-12	1	1	45	118	35	0	A
barcode64_consensus_vsearch	332	G	R	190	7	3.54%	2	1	93	93	0.007400362831181816	1	1	70	120	7	0	A
barcode64_consensus_vsearch	626	C	Y	177	7	3.37%	2	1	93	93	0.007371570136883838	1	1	78	99	0	7	-T
barcode64_consensus_vsearch	635	C	Y	165	41	19.62%	2	1	93	93	4.980352699409301E-14	1	1	82	83	0	41	T
barcode64_consensus_vsearch	649	G	R	188	11	5.53%	2	1	93	93	4.2366328040616125E-4	1	1	70	118	11	0	A
barcode64_consensus_vsearch	659	G	R	190	13	6.31%	2	1	93	93	1.0011736432355593E-4	1	1	67	123	13	0	A
barcode64_consensus_vsearch	661	G	R	199	9	4.33%	2	1	93	93	0.0017879699024036485	1	1	73	126	9	0	A
barcode64_consensus_vsearch	679	C	Y	202	7	3.35%	2	2	93	93	0.007423793454516522	1	1	80	122	2	5	T
barcode64_consensus_vsearch	690	G	R	194	7	3.47%	2	1	93	93	0.007408480654387502	1	1	72	122	7	0	A
barcode64_consensus_vsearch	707	T	Y	146	12	5.77%	2	1	93	93	1.9655548349622453E-4	1	1	78	68	0	12	C
barcode64_consensus_vsearch	727	G	R	186	8	4.08%	2	2	93	93	0.0036291041675517713	1	1	74	112	5	3	A
barcode64_consensus_vsearch	1142	C	Y	191	13	6.28%	2	1	93	93	1.0021782040526559E-4	1	1	82	109	0	13	T
barcode64_consensus_vsearch	1146	C	Y	198	11	5.26%	2	1	93	93	4.2662591196418204E-4	1	1	82	116	0	11	T
barcode64_consensus_vsearch	1329	T	Y	196	10	4.83%	2	2	93	93	8.7325475503958E-4	1	1	80	116	1	9	C
barcode64_consensus_vsearch	1336	A	W	137	62	29.81%	2	2	93	93	7.617419188124373E-22	1	1	53	84	27	35	T
barcode64_consensus_vsearch	1418	G	R	199	7	3.4%	2	2	93	93	0.007418189114685095	1	1	75	124	6	1	A
barcode64_consensus_vsearch	1537	C	Y	183	19	9.27%	2	1	93	93	1.223804948400246E-6	1	1	78	105	0	19	T
barcode64_consensus_vsearch	1565	T	W	197	7	3.41%	2	1	93	93	0.007414362253072604	1	1	81	116	0	7	A
barcode64_consensus_vsearch	1579	C	Y	182	9	4.31%	2	1	93	93	0.001773645426870732	1	1	80	102	0	9	+T
barcode64_consensus_vsearch	1683	A	R	196	11	5.26%	2	2	93	93	4.260552860545617E-4	1	1	72	124	10	1	G
barcode64_consensus_vsearch	1802	T	Y	196	7	3.38%	2	2	93	93	0.007412420836520295	1	1	80	116	1	6	C
barcode64_consensus_vsearch	1870	C	Y	199	7	3.38%	2	1	93	93	0.007418189114685095	1	1	82	117	0	7	T
barcode64_consensus_vsearch	1880	G	R	171	14	7.45%	2	2	93	93	4.728202054249692E-5	1	1	69	102	11	3	A
barcode64_consensus_vsearch	1881	G	R	173	9	4.31%	2	2	93	93	0.001765008337317725	1	1	72	101	3	6	-C
barcode64_consensus_vsearch	1883	C	Y	196	8	3.83%	2	1	93	93	0.0036424672415343016	1	1	78	118	0	8	T
barcode64_consensus_vsearch	2095	T	Y	146	62	29.67%	2	2	93	93	1.0179759032279514E-21	1	1	53	93	28	34	C
barcode64_consensus_vsearch	2156	T	Y	199	9	4.33%	2	1	93	93	0.0017879699024036485	1	1	81	118	0	9	C
barcode64_consensus_vsearch	2228	A	R	197	9	4.33%	2	2	93	93	0.0017864043973660122	1	1	80	117	2	7	G
barcode64_consensus_vsearch	2229	T	Y	198	8	3.85%	2	2	93	93	0.0036449867501809376	1	1	81	117	1	7	C
barcode64_consensus_vsearch	2251	C	Y	200	8	3.85%	2	1	93	93	0.003647458600901869	1	1	82	118	0	8	T
barcode64_consensus_vsearch	2293	C	Y	194	9	4.35%	2	1	93	93	0.0017839997252666491	1	1	82	112	0	9	T
barcode64_consensus_vsearch	2386	A	R	197	8	3.85%	2	2	93	93	0.003643733038795537	1	1	72	125	7	1	G
barcode64_consensus_vsearch	2456	A	R	189	10	4.78%	2	2	93	93	8.697426073947409E-4	1	1	73	116	9	1	G
barcode64_consensus_vsearch	2485	A	R	146	63	30.14%	2	2	93	93	4.333110859064796E-22	1	1	57	89	25	38	G
barcode64_consensus_vsearch	2498	T	Y	199	7	3.38%	2	2	93	93	0.007418189114685095	1	1	75	124	6	1	C
barcode64_consensus_vsearch	2531	G	R	187	14	6.86%	2	2	93	93	4.828732418008738E-5	1	1	66	121	13	1	A
barcode64_consensus_vsearch	2770	C	Y	186	16	7.8%	2	1	93	93	1.1203138488426297E-5	1	1	81	105	0	16	T
barcode64_consensus_vsearch	2774	T	W	158	11	5.34%	2	1	93	93	4.127839426459288E-4	1	1	78	80	0	11	+A
barcode64_consensus_vsearch	2775	G	R	159	27	13.24%	2	1	93	93	2.6949429879321714E-9	1	1	78	81	0	27	A
barcode64_consensus_vsearch	2776	T	Y	130	25	12.25%	2	1	93	93	1.040731081913205E-8	1	1	78	52	0	25	-C
barcode64_consensus_vsearch	2797	C	Y	174	33	15.87%	2	1	93	93	2.9121523783930724E-11	1	1	81	93	0	33	T
barcode64_consensus_vsearch	2855	G	R	140	68	32.69%	2	2	93	93	4.711325647543176E-24	1	1	55	85	27	41	A
barcode64_consensus_vsearch	2880	T	Y	140	63	30.73%	2	2	93	93	3.565237241507167E-22	1	1	56	84	25	38	C
barcode64_consensus_vsearch	2882	G	R	197	7	3.4%	2	1	93	93	0.007414362253072604	1	1	74	123	7	0	A
barcode64_consensus_vsearch	2969	C	Y	201	8	3.83%	2	1	93	93	0.003648677074969142	1	1	82	119	0	8	T
barcode64_consensus_vsearch	3047	C	Y	197	7	3.35%	2	2	93	93	0.007414362253072604	1	1	78	119	1	6	T
barcode64_consensus_vsearch	3147	G	R	188	16	7.84%	2	2	93	93	1.1238487264411091E-5	1	1	64	124	14	2	A
barcode64_consensus_vsearch	3181	T	Y	200	8	3.83%	2	1	93	93	0.003647458600901869	1	1	82	118	0	8	C
barcode64_consensus_vsearch	3227	C	Y	182	9	4.31%	2	1	93	93	0.001773645426870732	1	1	72	110	0	9	T
barcode64_consensus_vsearch	3281	G	R	198	9	4.31%	2	2	93	93	0.0017871908399793336	1	1	80	118	2	7	A
barcode64_consensus_vsearch	3406	T	Y	187	13	6.31%	2	1	93	93	9.981039688765196E-5	1	1	78	109	0	13	C
barcode64_consensus_vsearch	3490	G	S	198	7	3.4%	2	1	93	93	0.007416284922397948	1	1	82	116	0	7	C
barcode64_consensus_vsearch	3605	C	Y	193	12	5.74%	2	2	93	93	2.0687207786004562E-4	1	1	81	112	1	11	T
barcode64_consensus_vsearch	3616	C	Y	197	11	5.26%	2	2	93	93	4.263419112240475E-4	1	1	81	116	1	10	T
barcode64_consensus_vsearch	3630	T	Y	196	7	3.43%	2	1	93	93	0.007412420836520295	1	1	77	119	0	7	C
barcode64_consensus_vsearch	3644	T	Y	188	7	3.5%	2	2	93	93	0.007396180372504935	1	1	76	112	2	5	C
barcode64_consensus_vsearch	3650	G	R	195	10	4.85%	2	1	93	93	8.72767211907752E-4	1	1	71	124	10	0	A
barcode64_consensus_vsearch	3674	C	Y	195	8	3.92%	2	1	93	93	0.003641189182853133	1	1	81	114	0	8	T
barcode64_consensus_vsearch	3698	T	Y	182	20	9.8%	2	2	93	93	5.817046897591735E-7	1	1	75	107	1	19	C
barcode64_consensus_vsearch	3828	C	Y	191	7	3.38%	2	1	93	93	0.007402422710817429	1	1	81	110	0	7	T
barcode64_consensus_vsearch	3876	C	Y	192	17	8.13%	2	1	93	93	5.4367634478171795E-6	1	1	82	110	0	17	T
barcode64_consensus_vsearch	3930	C	Y	190	15	7.18%	2	1	93	93	2.3400493517599244E-5	1	1	82	108	0	15	T
barcode64_consensus_vsearch	3946	A	R	186	7	3.37%	2	2	93	93	0.007391912172859777	1	1	74	112	5	2	-G
barcode64_consensus_vsearch	3994	G	R	197	8	3.86%	2	1	93	93	0.003643733038795537	1	1	81	116	0	8	A
barcode64_consensus_vsearch	4035	G	R	192	10	4.9%	2	1	93	93	8.712766047726398E-4	1	1	69	123	10	0	A
