Chrom	Position	Ref	Cons	Reads1	Reads2	VarFreq	Strands1	Strands2	Qual1	Qual2	Pvalue	MapQual1	MapQual2	Reads1Plus	Reads1Minus	Reads2Plus	Reads2Minus	VarAllele
barcode73_consensus_vsearch	262	T	Y	151	7	4.43%	2	1	93	93	0.0072999599354883	1	1	95	56	0	7	C
barcode73_consensus_vsearch	339	G	R	90	67	42.41%	2	1	93	93	8.0025688898675345E-25	1	1	28	62	67	0	A
barcode73_consensus_vsearch	449	A	R	154	7	4.32%	2	2	93	93	0.007309387540537701	1	1	87	67	6	1	G
barcode73_consensus_vsearch	504	T	Y	91	67	42.14%	2	2	93	93	8.61982616583257E-25	1	1	55	36	36	31	C
barcode73_consensus_vsearch	663	C	Y	151	9	5.52%	2	1	93	93	0.0017399333914630318	1	1	94	57	0	9	T
barcode73_consensus_vsearch	672	G	R	147	12	7.5%	2	1	93	93	1.968338727730909E-4	1	1	81	66	12	0	A
barcode73_consensus_vsearch	955	C	Y	133	9	5.66%	2	2	93	93	0.0017138441890134975	1	1	88	45	1	8	-A
barcode73_consensus_vsearch	987	A	R	157	7	4.27%	2	2	93	93	0.007318474691436204	1	1	89	68	6	1	G
barcode73_consensus_vsearch	1011	G	R	149	12	7.41%	2	2	93	93	1.973810305249449E-4	1	1	82	67	11	1	A
barcode73_consensus_vsearch	1018	T	W	154	9	5.52%	2	1	93	93	0.0017437389109563706	1	1	95	59	0	9	A
barcode73_consensus_vsearch	1027	A	R	152	9	5.59%	2	1	93	93	0.0017412171593368057	1	1	83	69	9	0	G
barcode73_consensus_vsearch	1175	A	R	154	7	4.32%	2	1	93	93	0.007309387540537701	1	1	88	66	7	0	G
barcode73_consensus_vsearch	1237	G	R	151	10	6.13%	2	1	93	93	8.455751061324735E-4	1	1	84	67	10	0	A
barcode73_consensus_vsearch	1400	G	R	149	10	6.21%	2	1	93	93	8.439970829824387E-4	1	1	81	68	10	0	A
barcode73_consensus_vsearch	1405	T	Y	153	7	4.35%	2	2	93	93	0.007306283766632104	1	1	93	60	1	6	C
barcode73_consensus_vsearch	1524	G	R	152	12	7.32%	2	1	93	93	1.9817852873331993E-4	1	1	83	69	12	0	A
barcode73_consensus_vsearch	1734	T	Y	156	7	4.29%	2	2	93	93	0.007315482324450346	1	1	90	66	5	2	C
barcode73_consensus_vsearch	1829	T	Y	84	79	48.17%	2	2	93	93	5.2221561112549925E-30	1	1	52	32	42	37	C
barcode73_consensus_vsearch	2162	G	R	113	8	6.45%	2	1	93	93	0.0034665335534631017	1	1	58	55	8	0	A
barcode73_consensus_vsearch	2165	G	R	149	14	8.59%	2	1	93	93	4.5611517394377126E-5	1	1	81	68	14	0	A
barcode73_consensus_vsearch	2210	C	Y	154	7	4.27%	2	1	93	93	0.007309387540537701	1	1	94	60	0	7	T
barcode73_consensus_vsearch	2276	C	Y	148	10	6.1%	2	1	93	93	8.43193752284248E-4	1	1	94	54	0	10	T
barcode73_consensus_vsearch	2278	G	S	149	9	5.52%	2	1	93	93	0.0017373186708144468	1	1	90	59	0	9	C
barcode73_consensus_vsearch	2357	T	Y	149	8	4.88%	2	2	93	93	0.0035651816371754363	1	1	87	62	2	6	C
barcode73_consensus_vsearch	2457	G	R	138	8	5.16%	2	1	93	93	0.003540077109132777	1	1	76	62	8	0	A
barcode73_consensus_vsearch	2461	T	K	81	53	38.69%	2	2	93	93	1.7386766681937565E-19	1	1	53	28	25	28	G
barcode73_consensus_vsearch	2467	C	S	5	19	11.59%	2	1	93	93	3.6825992147203637E-9	1	1	1	4	19	0	+G
barcode73_consensus_vsearch	2508	T	W	85	77	46.95%	2	2	93	93	3.993413496842995E-29	1	1	45	40	49	28	A
barcode73_consensus_vsearch	2514	A	R	153	9	5.52%	2	1	93	93	0.001742485574678114	1	1	84	69	9	0	G
barcode73_consensus_vsearch	2567	T	Y	143	18	11.11%	2	1	93	93	2.307403514021655E-6	1	1	95	48	0	18	C
barcode73_consensus_vsearch	2585	T	Y	151	11	6.71%	2	1	93	93	4.096981551383751E-4	1	1	95	56	0	11	C
barcode73_consensus_vsearch	2813	G	R	145	16	9.94%	2	1	93	93	1.0313695879487064E-5	1	1	76	69	16	0	A
barcode73_consensus_vsearch	2835	G	R	156	8	4.88%	2	1	93	93	0.0035794408926960136	1	1	95	61	0	8	A
barcode73_consensus_vsearch	2881	T	Y	150	7	4.32%	2	2	93	93	0.007296738417420601	1	1	90	60	3	4	C
barcode73_consensus_vsearch	3316	G	R	151	8	5%	2	1	93	93	0.003569381041008898	1	1	86	65	8	0	A
barcode73_consensus_vsearch	3446	G	R	141	9	5.84%	2	1	93	93	0.0017261861346754147	1	1	82	59	9	0	A
barcode73_consensus_vsearch	3512	G	R	152	9	5.52%	2	2	93	93	0.0017412171593368057	1	1	85	67	8	1	A
barcode73_consensus_vsearch	3524	A	R	151	7	4.29%	2	2	93	93	0.0072999599354883	1	1	86	65	6	1	G
barcode73_consensus_vsearch	3577	T	Y	154	7	4.35%	2	2	93	93	0.007309387540537701	1	1	93	61	1	6	C
barcode73_consensus_vsearch	3725	A	R	143	16	9.82%	2	2	93	93	1.0260370524245005E-5	1	1	79	64	15	1	G
barcode73_consensus_vsearch	3743	A	R	149	15	9.15%	2	2	93	93	2.1829365358467202E-5	1	1	81	68	14	1	G
barcode73_consensus_vsearch	4053	G	R	143	11	7.05%	2	1	93	93	4.058484568807199E-4	1	1	74	69	11	0	A
barcode73_consensus_vsearch	4054	G	S	136	7	4.27%	2	1	93	93	0.007246976545021271	1	1	68	68	7	0	+A
barcode73_consensus_vsearch	4055	A	M	132	14	8.59%	2	1	93	93	4.4016859474274804E-5	1	1	63	69	14	0	C
barcode73_consensus_vsearch	4058	C	M	145	9	5.59%	2	1	93	93	0.0017318922033024672	1	1	77	68	9	0	A
barcode73_consensus_vsearch	4100	G	R	157	7	4.27%	2	1	93	93	0.007318474691436204	1	1	88	69	7	0	A
barcode73_consensus_vsearch	4110	A	R	155	7	4.29%	2	1	93	93	0.00731245349755727	1	1	87	68	7	0	G
barcode73_consensus_vsearch	4304	G	R	147	13	8.12%	2	1	93	93	9.47147318829823E-5	1	1	80	67	13	0	A
barcode73_consensus_vsearch	4359	A	R	157	7	4.27%	2	1	93	93	0.007318474691436204	1	1	88	69	7	0	G
barcode73_consensus_vsearch	4388	T	Y	138	21	12.88%	2	2	93	93	2.3527036656455968E-7	1	1	81	57	11	10	C
