Chrom	Position	Ref	Cons	Reads1	Reads2	VarFreq	Strands1	Strands2	Qual1	Qual2	Pvalue	MapQual1	MapQual2	Reads1Plus	Reads1Minus	Reads2Plus	Reads2Minus	VarAllele
barcode89_consensus_vsearch	1	C	C	117	0	0%	2	0	93	0	1.0	1	0	106	11	0	0	
barcode89_consensus_vsearch	2	T	T	131	0	0%	2	0	93	0	1.0	1	0	108	23	0	0	
barcode89_consensus_vsearch	3	A	A	157	0	0%	2	0	93	0	1.0	1	0	109	48	0	0	
barcode89_consensus_vsearch	4	T	T	172	1	0.58%	2	1	93	93	0.4999999999999138	1	1	108	64	1	0	C
barcode89_consensus_vsearch	5	G	*/-T	178	8	4.21%	2	2	93	93	0.0036173981471315664	1	1	98	80	7	1	-T
barcode89_consensus_vsearch	6	T	T	195	0	0%	2	0	93	0	1.0	1	0	102	93	0	0	
barcode89_consensus_vsearch	7	T	T	225	0	0%	2	0	93	0	1.0	1	0	109	116	0	0	
barcode89_consensus_vsearch	8	T	T	234	0	0%	2	0	93	0	1.0	1	0	109	125	0	0	
barcode89_consensus_vsearch	9	T	T	246	0	0%	2	0	93	0	1.0	1	0	109	137	0	0	
barcode89_consensus_vsearch	10	A	A	254	0	0%	2	0	93	0	1.0	1	0	109	145	0	0	
barcode89_consensus_vsearch	11	A	A	254	1	0.39%	2	1	93	93	0.4999999999999138	1	1	108	146	1	0	+T
barcode89_consensus_vsearch	12	T	T	256	0	0%	2	0	93	0	1.0	1	0	109	147	0	0	
barcode89_consensus_vsearch	13	T	T	251	2	0.78%	2	2	93	93	0.24950495049494414	1	1	105	146	1	1	-A
barcode89_consensus_vsearch	14	A	A	252	1	0.39%	2	1	93	93	0.5000000000003686	1	1	107	145	0	1	+G
barcode89_consensus_vsearch	15	G	G	256	0	0%	2	0	93	0	1.0	1	0	108	148	0	0	
barcode89_consensus_vsearch	16	A	A	256	1	0.39%	2	1	93	93	0.4999999999999138	1	1	108	148	1	0	+C
barcode89_consensus_vsearch	17	C	C	254	2	0.78%	2	1	93	93	0.2495107632092758	1	1	106	148	2	0	+G
barcode89_consensus_vsearch	18	A	A	255	1	0.39%	2	1	93	93	0.4999999999999138	1	1	107	148	1	0	-G
barcode89_consensus_vsearch	19	G	G	253	2	0.78%	2	1	93	93	0.24950884086425928	1	1	108	145	0	2	T
barcode89_consensus_vsearch	20	T	T	255	2	0.77%	2	1	93	93	0.2495126705651419	1	1	106	149	2	0	+C
barcode89_consensus_vsearch	21	C	C	250	4	1.56%	2	1	93	93	0.061761087351402955	1	1	102	148	4	0	+G
barcode89_consensus_vsearch	22	A	A	249	4	1.56%	2	1	93	93	0.06175816388801474	1	1	103	146	4	0	-G
barcode89_consensus_vsearch	23	G	G	251	2	0.79%	2	1	93	93	0.24950495049494414	1	1	103	148	2	0	-A
barcode89_consensus_vsearch	24	A	A	251	3	1.17%	2	1	93	93	0.12426035502961323	1	1	106	145	0	3	G
barcode89_consensus_vsearch	25	T	T	255	2	0.78%	2	1	93	93	0.2495126705651419	1	1	107	148	2	0	G
barcode89_consensus_vsearch	26	T	*/-C	181	67	25.97%	2	2	93	93	3.8573881247783916E-23	1	1	99	82	6	61	-C
barcode89_consensus_vsearch	27	C	C	189	1	0.52%	2	1	93	93	0.5000000000001412	1	1	101	88	0	1	+TC
barcode89_consensus_vsearch	28	C	C	256	2	0.78%	2	2	93	93	0.24951456310670525	1	1	107	149	1	1	T
barcode89_consensus_vsearch	29	C	C	255	2	0.77%	2	2	93	93	0.2495126705651419	1	1	107	148	1	1	+T
barcode89_consensus_vsearch	30	C	C	244	6	2.32%	2	1	93	93	0.015158143859196256	1	1	108	136	0	6	-T
barcode89_consensus_vsearch	31	T	T	250	3	1.19%	2	2	93	93	0.12425742574263329	1	1	108	142	1	2	C
barcode89_consensus_vsearch	32	T	T	255	3	1.16%	2	1	93	93	0.1242718446601877	1	1	108	147	0	3	C
barcode89_consensus_vsearch	33	G	G	256	3	1.16%	2	2	93	93	0.12427466150865948	1	1	108	148	1	2	A
barcode89_consensus_vsearch	34	T	*/-C	247	8	3.09%	2	1	93	93	0.0036945340250354765	1	1	99	148	8	0	-C
barcode89_consensus_vsearch	35	C	C	250	1	0.4%	2	1	93	93	0.4999999999999138	1	1	100	150	1	0	+A
barcode89_consensus_vsearch	36	C	C	257	1	0.39%	2	1	93	93	0.4999999999999138	1	1	108	149	1	0	+A
barcode89_consensus_vsearch	37	G	G	257	1	0.39%	2	1	93	93	0.4999999999999138	1	1	108	149	0	1	A
barcode89_consensus_vsearch	38	T	T	256	2	0.77%	2	1	93	93	0.24951456310670525	1	1	108	148	0	2	C
barcode89_consensus_vsearch	39	A	A	255	1	0.39%	2	1	93	93	0.4999999999999138	1	1	106	149	1	0	+C
barcode89_consensus_vsearch	40	C	C	256	1	0.39%	2	1	93	93	0.4999999999999138	1	1	107	149	1	0	G
barcode89_consensus_vsearch	41	C	C	259	0	0%	2	0	93	0	1.0	1	0	109	150	0	0	
barcode89_consensus_vsearch	42	A	A	255	3	1.16%	2	2	93	93	0.1242718446601877	1	1	107	148	2	1	G
barcode89_consensus_vsearch	43	G	G	258	1	0.39%	2	1	93	93	0.4999999999999138	1	1	108	150	1	0	+T
barcode89_consensus_vsearch	44	T	T	258	1	0.39%	2	1	93	93	0.4999999999999138	1	1	109	149	0	1	C
barcode89_consensus_vsearch	45	T	T	257	1	0.39%	2	1	93	93	0.4999999999999138	1	1	107	150	1	0	+C
barcode89_consensus_vsearch	46	C	C	253	4	1.55%	2	1	93	93	0.0617697211064687	1	1	107	146	0	4	+T
barcode89_consensus_vsearch	47	T	T	254	2	0.78%	2	1	93	93	0.2495107632092758	1	1	106	148	2	0	-A
barcode89_consensus_vsearch	48	A	A	253	1	0.39%	2	1	93	93	0.5000000000003686	1	1	106	147	0	1	G
barcode89_consensus_vsearch	49	A	A	255	1	0.39%	2	1	93	93	0.4999999999999138	1	1	108	147	1	0	C
barcode89_consensus_vsearch	50	G	G	257	2	0.77%	2	2	93	93	0.24951644100587136	1	1	108	149	1	1	-T
barcode89_consensus_vsearch	51	T	T	255	2	0.78%	2	1	93	93	0.2495126705651419	1	1	108	147	0	2	C
barcode89_consensus_vsearch	52	T	T	255	2	0.77%	2	1	93	93	0.2495126705651419	1	1	109	146	0	2	-G
barcode89_consensus_vsearch	53	G	G	254	1	0.39%	2	1	93	93	0.4999999999999138	1	1	109	145	0	1	C
barcode89_consensus_vsearch	54	G	G	257	1	0.39%	2	1	93	93	0.4999999999999138	1	1	109	148	0	1	A
barcode89_consensus_vsearch	55	T	Y	249	9	3.49%	2	1	93	93	0.0018193721277701645	1	1	109	140	0	9	C
barcode89_consensus_vsearch	56	T	T	254	3	1.16%	2	2	93	93	0.12426900584791233	1	1	108	146	1	2	C
barcode89_consensus_vsearch	57	G	G	256	1	0.39%	2	1	93	93	0.4999999999999138	1	1	108	148	0	1	-TT
barcode89_consensus_vsearch	58	T	T	256	1	0.39%	2	1	93	93	0.4999999999999138	1	1	109	147	0	1	C
barcode89_consensus_vsearch	59	T	T	251	4	1.56%	2	1	93	93	0.06176398786346276	1	1	104	147	4	0	-A
barcode89_consensus_vsearch	60	A	A	252	1	0.39%	2	1	93	93	0.5000000000003686	1	1	103	149	0	1	C
barcode89_consensus_vsearch	61	A	A	255	1	0.39%	2	1	93	93	0.4999999999999138	1	1	106	149	0	1	+T
barcode89_consensus_vsearch	62	T	T	252	4	1.55%	2	1	93	93	0.06176686569346045	1	1	104	148	4	0	G
barcode89_consensus_vsearch	63	T	T	257	1	0.39%	2	1	93	93	0.4999999999999138	1	1	108	149	0	1	C
barcode89_consensus_vsearch	64	G	G	258	1	0.39%	2	1	93	93	0.4999999999999138	1	1	108	150	1	0	-TA
barcode89_consensus_vsearch	65	T	T	255	2	0.78%	2	2	93	93	0.2495126705651419	1	1	107	148	1	1	C
barcode89_consensus_vsearch	66	A	A	256	1	0.39%	2	1	93	93	0.4999999999999138	1	1	108	148	0	1	+T
barcode89_consensus_vsearch	67	C	C	256	1	0.39%	2	1	93	93	0.4999999999999138	1	1	107	149	1	0	-G
barcode89_consensus_vsearch	68	G	G	253	2	0.78%	2	1	93	93	0.24950884086425928	1	1	103	150	2	0	-C
barcode89_consensus_vsearch	69	C	C	254	1	0.39%	2	1	93	93	0.4999999999999138	1	1	105	149	0	1	+T
barcode89_consensus_vsearch	70	C	C	252	5	1.93%	2	2	93	93	0.030642626352771006	1	1	107	145	2	3	T
barcode89_consensus_vsearch	71	G	G	254	2	0.78%	2	2	93	93	0.2495107632092758	1	1	108	146	1	1	A
barcode89_consensus_vsearch	72	G	G	259	0	0%	2	0	93	0	1.0	1	0	109	150	0	0	
barcode89_consensus_vsearch	73	A	A	258	1	0.39%	2	1	93	93	0.4999999999999138	1	1	109	149	0	1	+T
barcode89_consensus_vsearch	74	C	*/-G	248	7	2.7%	2	1	93	93	0.007493349252391194	1	1	109	139	0	7	-G
barcode89_consensus_vsearch	75	G	R	238	10	4%	2	2	93	93	8.902795873314557E-4	1	1	99	139	9	1	A
barcode89_consensus_vsearch	76	G	G	253	2	0.78%	2	1	93	93	0.24950884086425928	1	1	107	146	2	0	+A
barcode89_consensus_vsearch	77	G	G	254	3	1.16%	2	2	93	93	0.12426900584791233	1	1	108	146	1	2	A
barcode89_consensus_vsearch	78	C	C	249	2	0.78%	2	1	93	93	0.24950099800389156	1	1	105	144	2	0	+A
barcode89_consensus_vsearch	79	G	G	252	3	1.16%	2	2	93	93	0.12426326129665838	1	1	106	146	2	1	-A
barcode89_consensus_vsearch	80	A	A	256	0	0%	2	0	93	0	1.0	1	0	107	149	0	0	
barcode89_consensus_vsearch	81	A	*/-C	244	9	3.47%	2	2	93	93	0.001816779465609443	1	1	100	144	7	2	-C
barcode89_consensus_vsearch	82	C	C	241	6	2.4%	2	1	93	93	0.01515249705946412	1	1	101	140	0	6	+T
barcode89_consensus_vsearch	83	C	C	250	4	1.54%	2	1	93	93	0.061761087351402955	1	1	108	142	0	4	T
barcode89_consensus_vsearch	84	C	C	252	4	1.54%	2	1	93	93	0.06176686569346045	1	1	108	144	0	4	-T
barcode89_consensus_vsearch	85	T	Y	240	10	3.92%	2	2	93	93	8.909515133367017E-4	1	1	107	133	1	9	C
barcode89_consensus_vsearch	86	G	*/-C	245	10	3.86%	2	2	93	93	8.925864463478502E-4	1	1	96	149	9	1	-C
barcode89_consensus_vsearch	87	C	C	247	1	0.4%	2	1	93	93	0.4999999999999138	1	1	98	149	1	0	+G
barcode89_consensus_vsearch	88	C	C	253	2	0.77%	2	2	93	93	0.24950884086425928	1	1	105	148	1	1	+A
barcode89_consensus_vsearch	89	A	A	255	1	0.39%	2	1	93	93	0.4999999999999138	1	1	106	149	1	0	G
barcode89_consensus_vsearch	90	A	A	252	3	1.16%	2	2	93	93	0.12426326129665838	1	1	107	145	1	2	G
barcode89_consensus_vsearch	91	G	G	255	1	0.39%	2	1	93	93	0.4999999999999138	1	1	107	148	1	0	+A
barcode89_consensus_vsearch	92	G	G	259	0	0%	2	0	93	0	1.0	1	0	109	150	0	0	
barcode89_consensus_vsearch	93	C	C	257	1	0.39%	2	1	93	93	0.4999999999999138	1	1	108	149	0	1	+T
barcode89_consensus_vsearch	94	C	C	257	2	0.77%	2	2	93	93	0.24951644100587136	1	1	108	149	1	1	T
barcode89_consensus_vsearch	95	A	A	258	1	0.39%	2	1	93	93	0.4999999999999138	1	1	108	150	1	0	G
barcode89_consensus_vsearch	96	T	T	255	3	1.16%	2	1	93	93	0.1242718446601877	1	1	105	150	3	0	+C
barcode89_consensus_vsearch	97	C	C	255	1	0.39%	2	1	93	93	0.4999999999999138	1	1	105	150	1	0	+AA
barcode89_consensus_vsearch	98	A	R	248	7	2.72%	2	1	93	93	0.007493349252391194	1	1	99	149	7	0	G
barcode89_consensus_vsearch	99	G	G	256	1	0.39%	2	1	93	93	0.4999999999999138	1	1	108	148	0	1	+CAAG
barcode89_consensus_vsearch	100	T	T	255	3	1.16%	2	2	93	93	0.1242718446601877	1	1	107	148	1	2	C
barcode89_consensus_vsearch	101	A	*/-C	249	7	2.7%	2	2	93	93	0.007494585982750822	1	1	106	143	2	5	-C
barcode89_consensus_vsearch	102	C	C	251	1	0.4%	2	1	93	93	0.5000000000003686	1	1	107	144	0	1	+T
barcode89_consensus_vsearch	103	C	C	259	0	0%	2	0	93	0	1.0	1	0	109	150	0	0	
barcode89_consensus_vsearch	104	C	C	254	3	1.16%	2	2	93	93	0.12426900584791233	1	1	108	146	1	2	T
barcode89_consensus_vsearch	105	C	Y	226	14	5.41%	2	2	93	93	5.0216988599021617E-5	1	1	108	118	1	13	T
barcode89_consensus_vsearch	106	G	G	257	1	0.39%	2	1	93	93	0.4999999999999138	1	1	107	150	1	0	-A
barcode89_consensus_vsearch	107	A	A	257	1	0.39%	2	1	93	93	0.4999999999999138	1	1	107	150	1	0	G
barcode89_consensus_vsearch	108	T	T	257	1	0.39%	2	1	93	93	0.4999999999999138	1	1	109	148	0	1	+A
barcode89_consensus_vsearch	109	G	G	257	1	0.39%	2	1	93	93	0.4999999999999138	1	1	108	149	0	1	-C
barcode89_consensus_vsearch	110	C	C	256	1	0.39%	2	1	93	93	0.4999999999999138	1	1	108	148	0	1	+T
barcode89_consensus_vsearch	111	T	T	252	4	1.54%	2	2	93	93	0.06176686569346045	1	1	108	144	1	3	-G
barcode89_consensus_vsearch	112	G	G	250	2	0.78%	2	1	93	93	0.2495029821073759	1	1	108	142	0	2	A
barcode89_consensus_vsearch	113	G	*/-A	249	7	2.7%	2	1	93	93	0.007494585982750822	1	1	101	148	7	0	-A
barcode89_consensus_vsearch	114	A	A	248	1	0.4%	2	1	93	93	0.4999999999999138	1	1	102	146	0	1	C
barcode89_consensus_vsearch	115	A	A	253	2	0.78%	2	2	93	93	0.24950884086425928	1	1	107	146	1	1	-GG
barcode89_consensus_vsearch	116	G	G	251	1	0.39%	2	1	93	93	0.5000000000003686	1	1	107	144	0	1	+CG
barcode89_consensus_vsearch	117	G	G	253	2	0.78%	2	1	93	93	0.24950884086425928	1	1	108	145	0	2	T
barcode89_consensus_vsearch	118	C	C	253	3	1.16%	2	1	93	93	0.124266144814075	1	1	107	146	0	3	T
barcode89_consensus_vsearch	119	G	G	256	2	0.78%	2	1	93	93	0.24951456310670525	1	1	107	149	2	0	-C
barcode89_consensus_vsearch	120	C	C	252	4	1.56%	2	1	93	93	0.06176686569346045	1	1	106	146	0	4	T
barcode89_consensus_vsearch	121	C	C	252	4	1.54%	2	1	93	93	0.06176686569346045	1	1	109	143	0	4	-G
barcode89_consensus_vsearch	122	G	G	250	3	1.18%	2	2	93	93	0.12425742574263329	1	1	108	142	1	2	A
barcode89_consensus_vsearch	123	G	G	253	2	0.78%	2	2	93	93	0.24950884086425928	1	1	108	145	1	1	A
barcode89_consensus_vsearch	124	C	C	255	1	0.39%	2	1	93	93	0.4999999999999138	1	1	109	146	0	1	A
barcode89_consensus_vsearch	125	C	C	257	1	0.39%	2	1	93	93	0.4999999999999138	1	1	109	148	0	1	+A
barcode89_consensus_vsearch	126	G	*/-TG	246	7	2.71%	2	2	93	93	0.007490846702557751	1	1	107	139	1	6	-TG
barcode89_consensus_vsearch	127	T	T	245	2	0.81%	2	2	93	93	0.24949290060873971	1	1	106	139	1	1	C
barcode89_consensus_vsearch	128	G	G	245	2	0.8%	2	1	93	93	0.24949290060873971	1	1	105	140	2	0	+A
barcode89_consensus_vsearch	129	A	A	252	1	0.39%	2	1	93	93	0.5000000000003686	1	1	105	147	1	0	+G
barcode89_consensus_vsearch	130	G	G	253	1	0.39%	2	1	93	93	0.5000000000003686	1	1	106	147	0	1	+C
barcode89_consensus_vsearch	131	G	G	252	2	0.78%	2	1	93	93	0.2495069033532105	1	1	103	149	2	0	A
barcode89_consensus_vsearch	132	C	C	256	1	0.39%	2	1	93	93	0.4999999999999138	1	1	106	150	1	0	+T
barcode89_consensus_vsearch	133	T	T	253	3	1.16%	2	2	93	93	0.124266144814075	1	1	106	147	1	2	C
barcode89_consensus_vsearch	134	A	R	248	7	2.71%	2	2	93	93	0.007493349252391194	1	1	102	146	6	1	G
barcode89_consensus_vsearch	135	G	G	251	3	1.17%	2	2	93	93	0.12426035502961323	1	1	105	146	1	2	A
barcode89_consensus_vsearch	136	T	T	254	2	0.78%	2	1	93	93	0.2495107632092758	1	1	109	145	0	2	A
barcode89_consensus_vsearch	137	G	G	254	3	1.16%	2	2	93	93	0.12426900584791233	1	1	107	147	2	1	A
barcode89_consensus_vsearch	138	C	C	255	2	0.78%	2	1	93	93	0.2495126705651419	1	1	108	147	0	2	T
barcode89_consensus_vsearch	139	C	Y	248	7	2.7%	2	1	93	93	0.007493349252391194	1	1	107	141	0	7	T
barcode89_consensus_vsearch	140	G	G	257	1	0.39%	2	1	93	93	0.4999999999999138	1	1	107	150	1	0	A
barcode89_consensus_vsearch	141	A	A	257	1	0.39%	2	1	93	93	0.4999999999999138	1	1	107	150	1	0	+T
barcode89_consensus_vsearch	142	C	C	258	1	0.39%	2	1	93	93	0.4999999999999138	1	1	108	150	1	0	T
barcode89_consensus_vsearch	143	C	C	258	1	0.39%	2	1	93	93	0.4999999999999138	1	1	109	149	0	1	+T
barcode89_consensus_vsearch	144	T	T	254	3	1.16%	2	1	93	93	0.12426900584791233	1	1	109	145	0	3	C
barcode89_consensus_vsearch	145	G	G	258	1	0.39%	2	1	93	93	0.4999999999999138	1	1	109	149	0	1	A
barcode89_consensus_vsearch	146	C	C	253	4	1.54%	2	1	93	93	0.0617697211064687	1	1	109	144	0	4	-T
barcode89_consensus_vsearch	147	T	*/-C	239	15	5.88%	2	1	93	93	2.466799176058401E-5	1	1	94	145	15	0	-C
barcode89_consensus_vsearch	148	C	C	244	0	0%	2	0	93	0	1.0	1	0	94	150	0	0	
barcode89_consensus_vsearch	149	C	C	252	2	0.77%	2	1	93	93	0.2495069033532105	1	1	102	150	2	0	+A
barcode89_consensus_vsearch	150	A	*/-G	246	8	3.11%	2	1	93	93	0.003693711391797067	1	1	96	150	8	0	-G
barcode89_consensus_vsearch	151	G	G	242	5	1.99%	2	1	93	93	0.030618062239993613	1	1	92	150	5	0	+A
barcode89_consensus_vsearch	152	A	*/-G	243	10	3.88%	2	1	93	93	8.91940019333984E-4	1	1	96	147	10	0	-G
barcode89_consensus_vsearch	153	G	G	246	0	0%	2	0	93	0	1.0	1	0	99	147	0	0	
barcode89_consensus_vsearch	154	A	A	254	1	0.39%	2	1	93	93	0.4999999999999138	1	1	109	145	0	1	+T
barcode89_consensus_vsearch	155	C	C	255	1	0.39%	2	1	93	93	0.4999999999999138	1	1	107	148	1	0	+A
barcode89_consensus_vsearch	156	G	G	248	2	0.78%	2	1	93	93	0.24949899799584363	1	1	103	145	2	0	+A
barcode89_consensus_vsearch	157	T	T	247	5	1.95%	2	1	93	93	0.030630587731099716	1	1	102	145	5	0	+C
barcode89_consensus_vsearch	158	C	C	255	3	1.16%	2	2	93	93	0.1242718446601877	1	1	107	148	1	2	-T
barcode89_consensus_vsearch	159	T	Y	247	7	2.73%	2	2	93	93	0.00749210286352295	1	1	105	142	1	6	C
barcode89_consensus_vsearch	160	A	A	256	1	0.39%	2	1	93	93	0.4999999999999138	1	1	106	150	1	0	G
barcode89_consensus_vsearch	161	A	A	254	2	0.77%	2	1	93	93	0.2495107632092758	1	1	105	149	2	0	-C
barcode89_consensus_vsearch	162	C	C	253	2	0.78%	2	1	93	93	0.24950884086425928	1	1	105	148	2	0	G
barcode89_consensus_vsearch	163	C	C	251	3	1.16%	2	1	93	93	0.12426035502961323	1	1	103	148	3	0	-A
barcode89_consensus_vsearch	164	A	A	254	2	0.78%	2	1	93	93	0.2495107632092758	1	1	104	150	2	0	+G
barcode89_consensus_vsearch	165	A	A	254	3	1.16%	2	2	93	93	0.12426900584791233	1	1	107	147	1	2	-G
barcode89_consensus_vsearch	166	G	G	255	1	0.39%	2	1	93	93	0.4999999999999138	1	1	108	147	0	1	A
barcode89_consensus_vsearch	167	G	G	258	1	0.39%	2	1	93	93	0.4999999999999138	1	1	108	150	1	0	-CC
barcode89_consensus_vsearch	168	C	C	256	1	0.39%	2	1	93	93	0.4999999999999138	1	1	108	148	0	1	+T
barcode89_consensus_vsearch	169	C	C	257	1	0.39%	2	1	93	93	0.4999999999999138	1	1	108	149	0	1	T
barcode89_consensus_vsearch	170	C	C	257	1	0.39%	2	1	93	93	0.4999999999999138	1	1	108	149	0	1	-AA
barcode89_consensus_vsearch	171	A	A	257	1	0.39%	2	1	93	93	0.4999999999999138	1	1	108	149	1	0	G
barcode89_consensus_vsearch	172	A	A	255	3	1.16%	2	1	93	93	0.1242718446601877	1	1	106	149	3	0	G
barcode89_consensus_vsearch	173	C	C	250	3	1.16%	2	1	93	93	0.12425742574263329	1	1	103	147	3	0	+A
barcode89_consensus_vsearch	174	G	G	251	2	0.78%	2	1	93	93	0.24950495049494414	1	1	103	148	2	0	T
barcode89_consensus_vsearch	175	T	T	256	0	0%	2	0	93	0	1.0	1	0	107	149	0	0	
barcode89_consensus_vsearch	176	A	A	247	5	1.94%	2	2	93	93	0.030630587731099716	1	1	103	144	1	4	-C
barcode89_consensus_vsearch	177	C	C	248	3	1.18%	2	1	93	93	0.12425149700602607	1	1	107	141	0	3	+T
barcode89_consensus_vsearch	178	C	C	257	2	0.77%	2	1	93	93	0.24951644100587136	1	1	109	148	0	2	T
barcode89_consensus_vsearch	179	C	C	253	5	1.93%	2	1	93	93	0.030644978141142375	1	1	108	145	0	5	T
barcode89_consensus_vsearch	180	A	A	256	2	0.78%	2	1	93	93	0.24951456310670525	1	1	106	150	2	0	G
barcode89_consensus_vsearch	181	A	*/+C	236	9	3.47%	2	2	93	93	0.0018124155419458562	1	1	94	142	5	4	+C
barcode89_consensus_vsearch	182	C	C	249	1	0.4%	2	1	93	93	0.5000000000003686	1	1	104	145	0	1	A
barcode89_consensus_vsearch	183	C	C	258	0	0%	2	0	93	0	1.0	1	0	108	150	0	0	
barcode89_consensus_vsearch	184	C	*/-T	249	10	3.86%	2	1	93	93	8.93850136274439E-4	1	1	109	140	0	10	-T
barcode89_consensus_vsearch	185	T	T	243	3	1.2%	2	1	93	93	0.12423625254575449	1	1	106	137	3	0	A
barcode89_consensus_vsearch	186	T	T	253	3	1.16%	2	2	93	93	0.124266144814075	1	1	105	148	2	1	-A
barcode89_consensus_vsearch	187	A	A	254	2	0.78%	2	1	93	93	0.2495107632092758	1	1	107	147	0	2	+G
barcode89_consensus_vsearch	188	G	G	257	1	0.39%	2	1	93	93	0.4999999999999138	1	1	107	150	1	0	-A
barcode89_consensus_vsearch	189	A	A	256	1	0.39%	2	1	93	93	0.4999999999999138	1	1	107	149	1	0	+G
barcode89_consensus_vsearch	190	G	G	254	2	0.77%	2	1	93	93	0.2495107632092758	1	1	105	149	2	0	-C
barcode89_consensus_vsearch	191	C	C	253	3	1.17%	2	1	93	93	0.124266144814075	1	1	104	149	3	0	G
barcode89_consensus_vsearch	192	C	C	256	2	0.77%	2	1	93	93	0.24951456310670525	1	1	108	148	0	2	T
barcode89_consensus_vsearch	193	A	A	257	2	0.77%	2	1	93	93	0.24951644100587136	1	1	109	148	0	2	G
barcode89_consensus_vsearch	194	A	A	247	5	1.93%	2	1	93	93	0.030630587731099716	1	1	108	139	0	5	+C
barcode89_consensus_vsearch	195	T	T	240	5	1.98%	2	1	93	93	0.030612909050433162	1	1	108	132	0	5	-C
barcode89_consensus_vsearch	196	C	C	249	1	0.4%	2	1	93	93	0.5000000000003686	1	1	108	141	1	0	+G
barcode89_consensus_vsearch	197	C	*/-T	228	23	8.88%	2	2	93	93	7.03198840955012E-8	1	1	100	128	7	16	-T
barcode89_consensus_vsearch	198	T	T	235	0	0%	2	0	93	0	1.0	1	0	102	133	0	0	
barcode89_consensus_vsearch	199	T	T	255	2	0.78%	2	1	93	93	0.2495126705651419	1	1	109	146	0	2	C
barcode89_consensus_vsearch	200	T	T	254	3	1.16%	2	1	93	93	0.12426900584791233	1	1	109	145	0	3	+C
barcode89_consensus_vsearch	201	T	*/-C	232	13	5.02%	2	2	93	93	1.0367157527188826E-4	1	1	100	132	5	8	-C
barcode89_consensus_vsearch	202	C	C	243	2	0.81%	2	1	93	93	0.24948875255617758	1	1	101	142	2	0	T
barcode89_consensus_vsearch	203	C	C	259	0	0%	2	0	93	0	1.0	1	0	109	150	0	0	
barcode89_consensus_vsearch	204	C	*/+T	239	7	2.7%	2	1	93	93	0.0074817700326852326	1	1	104	135	0	7	+T
barcode89_consensus_vsearch	205	G	G	250	4	1.56%	2	2	93	93	0.061761087351402955	1	1	103	147	2	2	-A
barcode89_consensus_vsearch	206	A	A	251	1	0.4%	2	1	93	93	0.5000000000003686	1	1	104	147	1	0	+GA
barcode89_consensus_vsearch	207	A	A	256	2	0.78%	2	1	93	93	0.24951456310670525	1	1	108	148	0	2	G
barcode89_consensus_vsearch	208	G	G	255	1	0.39%	2	1	93	93	0.4999999999999138	1	1	105	150	1	0	+T
barcode89_consensus_vsearch	209	T	T	254	2	0.78%	2	1	93	93	0.2495107632092758	1	1	106	148	0	2	C
barcode89_consensus_vsearch	210	T	T	257	1	0.39%	2	1	93	93	0.4999999999999138	1	1	107	150	1	0	C
barcode89_consensus_vsearch	211	A	A	258	1	0.39%	2	1	93	93	0.4999999999999138	1	1	109	149	0	1	G
barcode89_consensus_vsearch	212	C	C	252	4	1.54%	2	1	93	93	0.06176686569346045	1	1	109	143	0	4	-G
barcode89_consensus_vsearch	213	G	G	252	0	0%	2	0	93	0	1.0	1	0	109	143	0	0	
barcode89_consensus_vsearch	214	G	G	254	1	0.39%	2	1	93	93	0.4999999999999138	1	1	108	146	0	1	-A
barcode89_consensus_vsearch	215	A	A	252	2	0.78%	2	1	93	93	0.2495069033532105	1	1	108	144	0	2	+T
barcode89_consensus_vsearch	216	T	T	255	1	0.39%	2	1	93	93	0.4999999999999138	1	1	108	147	0	1	-C
barcode89_consensus_vsearch	217	C	C	252	4	1.56%	2	1	93	93	0.06176686569346045	1	1	108	144	0	4	-T
barcode89_consensus_vsearch	218	T	T	249	3	1.18%	2	1	93	93	0.12425447316115633	1	1	107	142	0	3	C
barcode89_consensus_vsearch	219	A	A	245	6	2.33%	2	2	93	93	0.015159996253657923	1	1	103	142	2	4	-T
barcode89_consensus_vsearch	220	T	T	248	2	0.8%	2	1	93	93	0.24949899799584363	1	1	105	143	0	2	C
barcode89_consensus_vsearch	221	T	T	257	1	0.39%	2	1	93	93	0.4999999999999138	1	1	107	150	1	0	G
barcode89_consensus_vsearch	222	T	T	258	1	0.39%	2	1	93	93	0.4999999999999138	1	1	108	150	1	0	C
barcode89_consensus_vsearch	223	T	T	256	1	0.39%	2	1	93	93	0.4999999999999138	1	1	107	149	0	1	-G
barcode89_consensus_vsearch	224	G	G	257	0	0%	2	0	93	0	1.0	1	0	108	149	0	0	
barcode89_consensus_vsearch	225	C	C	254	1	0.39%	2	1	93	93	0.4999999999999138	1	1	107	147	0	1	+T
barcode89_consensus_vsearch	226	C	C	250	3	1.16%	2	2	93	93	0.12425742574263329	1	1	105	145	2	1	A
barcode89_consensus_vsearch	227	G	G	253	2	0.78%	2	1	93	93	0.24950884086425928	1	1	106	147	2	0	A
barcode89_consensus_vsearch	228	A	A	253	4	1.54%	2	1	93	93	0.0617697211064687	1	1	103	150	4	0	G
barcode89_consensus_vsearch	229	C	C	255	2	0.78%	2	2	93	93	0.2495126705651419	1	1	107	148	1	1	-T
barcode89_consensus_vsearch	230	T	T	254	2	0.78%	2	1	93	93	0.2495107632092758	1	1	107	147	0	2	+C
barcode89_consensus_vsearch	231	T	*/-C	192	49	18.92%	2	2	93	93	1.1719431569560823E-16	1	1	94	98	11	38	-C
barcode89_consensus_vsearch	232	C	C	204	2	0.97%	2	2	93	93	0.2493917274938698	1	1	97	107	1	1	T
barcode89_consensus_vsearch	233	C	C	248	6	2.35%	2	1	93	93	0.015165466280175907	1	1	102	146	6	0	+A
barcode89_consensus_vsearch	234	C	Y	241	7	2.72%	2	1	93	93	0.007484415214222657	1	1	108	133	0	7	T
barcode89_consensus_vsearch	235	T	T	244	6	2.38%	2	1	93	93	0.015158143859196256	1	1	102	142	6	0	A
barcode89_consensus_vsearch	236	T	T	256	1	0.39%	2	1	93	93	0.4999999999999138	1	1	108	148	1	0	+G
barcode89_consensus_vsearch	237	A	A	256	2	0.77%	2	1	93	93	0.24951456310670525	1	1	107	149	2	0	C
barcode89_consensus_vsearch	238	T	T	257	2	0.77%	2	2	93	93	0.24951644100587136	1	1	108	149	1	1	C
barcode89_consensus_vsearch	239	C	C	254	4	1.54%	2	2	93	93	0.06177255436325217	1	1	105	149	3	1	-T
barcode89_consensus_vsearch	240	T	T	252	1	0.39%	2	1	93	93	0.5000000000003686	1	1	104	148	1	0	+CT
barcode89_consensus_vsearch	241	A	A	255	2	0.78%	2	2	93	93	0.2495126705651419	1	1	106	149	1	1	+C
barcode89_consensus_vsearch	242	C	C	257	0	0%	2	0	93	0	1.0	1	0	107	150	0	0	
barcode89_consensus_vsearch	243	A	A	256	2	0.77%	2	1	93	93	0.24951456310670525	1	1	106	150	2	0	+T
barcode89_consensus_vsearch	244	T	T	257	1	0.39%	2	1	93	93	0.4999999999999138	1	1	109	148	0	1	+AT
barcode89_consensus_vsearch	245	T	T	258	1	0.39%	2	1	93	93	0.4999999999999138	1	1	108	150	1	0	+G
barcode89_consensus_vsearch	246	G	G	259	0	0%	2	0	93	0	1.0	1	0	109	150	0	0	
barcode89_consensus_vsearch	247	T	T	258	1	0.39%	2	1	93	93	0.4999999999999138	1	1	109	149	0	1	+C
barcode89_consensus_vsearch	248	T	T	254	2	0.77%	2	2	93	93	0.2495107632092758	1	1	108	146	1	1	+C
barcode89_consensus_vsearch	249	C	C	255	2	0.77%	2	1	93	93	0.2495126705651419	1	1	106	149	2	0	+A
barcode89_consensus_vsearch	250	T	T	252	4	1.55%	2	2	93	93	0.06176686569346045	1	1	107	145	1	3	C
barcode89_consensus_vsearch	251	A	A	259	0	0%	2	0	93	0	1.0	1	0	109	150	0	0	
barcode89_consensus_vsearch	252	T	T	257	1	0.39%	2	1	93	93	0.4999999999999138	1	1	107	150	1	0	+C
barcode89_consensus_vsearch	253	C	C	257	1	0.39%	2	1	93	93	0.4999999999999138	1	1	108	149	0	1	-A
barcode89_consensus_vsearch	254	A	A	258	0	0%	2	0	93	0	1.0	1	0	109	149	0	0	
barcode89_consensus_vsearch	255	A	A	257	1	0.39%	2	1	93	93	0.4999999999999138	1	1	108	149	1	0	+GCC
barcode89_consensus_vsearch	256	C	C	256	1	0.39%	2	1	93	93	0.4999999999999138	1	1	108	148	1	0	+T
barcode89_consensus_vsearch	257	T	T	246	5	1.94%	2	2	93	93	0.03062812251247695	1	1	101	145	4	1	-A
barcode89_consensus_vsearch	258	A	A	250	2	0.79%	2	1	93	93	0.2495029821073759	1	1	104	146	0	2	+G
barcode89_consensus_vsearch	259	G	G	256	1	0.39%	2	1	93	93	0.4999999999999138	1	1	106	150	1	0	+A
barcode89_consensus_vsearch	260	A	A	257	0	0%	2	0	93	0	1.0	1	0	107	150	0	0	
barcode89_consensus_vsearch	261	G	G	258	1	0.39%	2	1	93	93	0.4999999999999138	1	1	109	149	0	1	A
barcode89_consensus_vsearch	262	G	G	257	1	0.39%	2	1	93	93	0.4999999999999138	1	1	108	149	1	0	-C
barcode89_consensus_vsearch	263	C	C	256	1	0.39%	2	1	93	93	0.4999999999999138	1	1	108	148	0	1	T
barcode89_consensus_vsearch	264	T	T	254	3	1.16%	2	2	93	93	0.12426900584791233	1	1	107	147	2	1	C
barcode89_consensus_vsearch	265	G	G	258	0	0%	2	0	93	0	1.0	1	0	109	149	0	0	
barcode89_consensus_vsearch	266	T	T	253	4	1.54%	2	1	93	93	0.0617697211064687	1	1	108	145	0	4	+C
barcode89_consensus_vsearch	267	T	T	255	4	1.54%	2	1	93	93	0.06177536572082746	1	1	109	146	0	4	-C
barcode89_consensus_vsearch	268	C	C	252	2	0.78%	2	1	93	93	0.2495069033532105	1	1	107	145	2	0	-ACC
barcode89_consensus_vsearch	269	A	A	255	2	0.78%	2	2	93	93	0.2495126705651419	1	1	106	149	1	1	-C
barcode89_consensus_vsearch	270	C	C	253	2	0.78%	2	1	93	93	0.24950884086425928	1	1	106	147	0	2	T
barcode89_consensus_vsearch	271	C	C	247	4	1.56%	2	1	93	93	0.061752247008950906	1	1	106	141	0	4	+T
barcode89_consensus_vsearch	272	T	T	252	2	0.78%	2	1	93	93	0.2495069033532105	1	1	105	147	2	0	+G
barcode89_consensus_vsearch	273	T	*/-G	230	26	10.08%	2	2	93	93	7.637701777030875E-9	1	1	106	124	2	24	-G
barcode89_consensus_vsearch	274	G	G	227	4	1.72%	2	1	93	93	0.061687437086248645	1	1	107	120	0	4	T
barcode89_consensus_vsearch	275	G	G	256	2	0.78%	2	1	93	93	0.24951456310670525	1	1	107	149	2	0	-A
barcode89_consensus_vsearch	276	A	A	249	3	1.17%	2	1	93	93	0.12425447316115633	1	1	101	148	3	0	-G
barcode89_consensus_vsearch	277	G	G	251	2	0.78%	2	2	93	93	0.24950495049494414	1	1	103	148	1	1	+A
barcode89_consensus_vsearch	278	A	A	253	4	1.55%	2	2	93	93	0.0617697211064687	1	1	105	148	3	1	G
barcode89_consensus_vsearch	279	C	C	255	1	0.39%	2	1	93	93	0.4999999999999138	1	1	108	147	1	0	+G
barcode89_consensus_vsearch	280	C	C	253	2	0.77%	2	1	93	93	0.24950884086425928	1	1	108	145	0	2	+T
barcode89_consensus_vsearch	281	T	T	251	3	1.17%	2	1	93	93	0.12426035502961323	1	1	108	143	0	3	C
barcode89_consensus_vsearch	282	G	G	256	1	0.39%	2	1	93	93	0.4999999999999138	1	1	107	149	0	1	+T
barcode89_consensus_vsearch	283	C	C	254	3	1.16%	2	1	93	93	0.12426900584791233	1	1	108	146	0	3	T
barcode89_consensus_vsearch	284	T	T	256	1	0.39%	2	1	93	93	0.4999999999999138	1	1	107	149	1	0	C
barcode89_consensus_vsearch	285	G	G	255	2	0.78%	2	1	93	93	0.2495126705651419	1	1	108	147	0	2	-C
barcode89_consensus_vsearch	286	C	C	249	3	1.18%	2	2	93	93	0.12425447316115633	1	1	107	142	1	2	T
barcode89_consensus_vsearch	287	G	G	249	4	1.56%	2	2	93	93	0.06175816388801474	1	1	108	141	1	3	A
barcode89_consensus_vsearch	288	G	G	254	1	0.39%	2	1	93	93	0.4999999999999138	1	1	109	145	0	1	+T
barcode89_consensus_vsearch	289	T	T	254	2	0.78%	2	1	93	93	0.2495107632092758	1	1	109	145	0	2	C
barcode89_consensus_vsearch	290	T	T	257	1	0.39%	2	1	93	93	0.4999999999999138	1	1	109	148	0	1	+A
barcode89_consensus_vsearch	291	A	A	255	2	0.77%	2	1	93	93	0.2495126705651419	1	1	109	146	0	2	+G
barcode89_consensus_vsearch	292	T	T	253	3	1.16%	2	1	93	93	0.124266144814075	1	1	108	145	0	3	C
barcode89_consensus_vsearch	293	G	G	255	3	1.16%	2	1	93	93	0.1242718446601877	1	1	105	150	3	0	-A
barcode89_consensus_vsearch	294	A	A	256	0	0%	2	0	93	0	1.0	1	0	106	150	0	0	
barcode89_consensus_vsearch	295	G	G	257	1	0.39%	2	1	93	93	0.4999999999999138	1	1	108	149	1	0	-TA
barcode89_consensus_vsearch	296	T	T	255	1	0.39%	2	1	93	93	0.4999999999999138	1	1	108	147	0	1	+A
barcode89_consensus_vsearch	297	A	A	257	0	0%	2	0	93	0	1.0	1	0	108	149	0	0	
barcode89_consensus_vsearch	298	C	C	253	3	1.16%	2	2	93	93	0.124266144814075	1	1	107	146	1	2	T
barcode89_consensus_vsearch	299	G	G	258	1	0.39%	2	1	93	93	0.4999999999999138	1	1	108	150	1	0	-A
barcode89_consensus_vsearch	300	A	A	256	1	0.39%	2	1	93	93	0.4999999999999138	1	1	108	148	0	1	+C
barcode89_consensus_vsearch	301	C	C	254	2	0.78%	2	2	93	93	0.2495107632092758	1	1	108	146	1	1	-T
barcode89_consensus_vsearch	302	T	T	251	3	1.17%	2	1	93	93	0.12426035502961323	1	1	107	144	0	3	+C
barcode89_consensus_vsearch	303	T	T	254	2	0.77%	2	1	93	93	0.2495107632092758	1	1	108	146	0	2	-G
barcode89_consensus_vsearch	304	G	G	252	1	0.39%	2	1	93	93	0.5000000000003686	1	1	108	144	0	1	+A
barcode89_consensus_vsearch	305	G	G	252	4	1.56%	2	1	93	93	0.06176686569346045	1	1	108	144	0	4	A
barcode89_consensus_vsearch	306	C	C	250	4	1.56%	2	1	93	93	0.061761087351402955	1	1	108	142	0	4	T
barcode89_consensus_vsearch	307	G	G	251	5	1.94%	2	1	93	93	0.03064025621010106	1	1	108	143	0	5	-TG
barcode89_consensus_vsearch	308	T	T	235	6	2.38%	2	1	93	93	0.015140783526168764	1	1	96	139	6	0	+A
barcode89_consensus_vsearch	309	G	G	241	2	0.81%	2	1	93	93	0.2494845360824727	1	1	102	139	2	0	-A
barcode89_consensus_vsearch	310	A	A	247	3	1.2%	2	2	93	93	0.12424849699405838	1	1	101	146	2	1	+G
barcode89_consensus_vsearch	311	A	A	254	1	0.39%	2	1	93	93	0.4999999999999138	1	1	108	146	0	1	G
barcode89_consensus_vsearch	312	A	A	255	2	0.77%	2	2	93	93	0.2495126705651419	1	1	107	148	1	1	G
barcode89_consensus_vsearch	313	G	G	255	2	0.78%	2	1	93	93	0.2495126705651419	1	1	106	149	2	0	A
barcode89_consensus_vsearch	314	C	C	249	6	2.33%	2	1	93	93	0.015167261137354384	1	1	108	141	0	6	+T
barcode89_consensus_vsearch	315	T	T	254	2	0.77%	2	1	93	93	0.2495107632092758	1	1	109	145	0	2	+G
barcode89_consensus_vsearch	316	A	A	254	3	1.16%	2	2	93	93	0.12426900584791233	1	1	107	147	1	2	G
barcode89_consensus_vsearch	317	T	T	255	1	0.39%	2	1	93	93	0.4999999999999138	1	1	109	146	0	1	+C
barcode89_consensus_vsearch	318	T	T	249	5	1.93%	2	2	93	93	0.03063545999571253	1	1	105	144	1	4	-C
barcode89_consensus_vsearch	319	C	C	251	1	0.39%	2	1	93	93	0.5000000000003686	1	1	106	145	1	0	+AA
barcode89_consensus_vsearch	320	C	C	256	1	0.39%	2	1	93	93	0.4999999999999138	1	1	107	149	1	0	+T
barcode89_consensus_vsearch	321	T	T	257	1	0.39%	2	1	93	93	0.4999999999999138	1	1	108	149	0	1	C
barcode89_consensus_vsearch	322	T	T	251	4	1.54%	2	2	93	93	0.06176398786346276	1	1	105	146	1	3	+C
barcode89_consensus_vsearch	323	C	C	255	0	0%	2	0	93	0	1.0	1	0	106	149	0	0	
barcode89_consensus_vsearch	324	C	C	253	3	1.16%	2	1	93	93	0.124266144814075	1	1	109	144	0	3	+T
barcode89_consensus_vsearch	325	T	T	251	5	1.95%	2	2	93	93	0.03064025621010106	1	1	108	143	1	4	C
barcode89_consensus_vsearch	326	G	G	258	1	0.39%	2	1	93	93	0.4999999999999138	1	1	108	150	1	0	+CC
barcode89_consensus_vsearch	327	C	C	254	2	0.77%	2	1	93	93	0.2495107632092758	1	1	109	145	0	2	-G
barcode89_consensus_vsearch	328	G	G	254	1	0.39%	2	1	93	93	0.4999999999999138	1	1	107	147	1	0	+A
barcode89_consensus_vsearch	329	G	G	257	2	0.77%	2	1	93	93	0.24951644100587136	1	1	107	150	2	0	-A
barcode89_consensus_vsearch	330	A	*/+T	241	12	4.67%	2	1	93	93	2.1363402075967646E-4	1	1	92	149	12	0	+T
barcode89_consensus_vsearch	331	T	T	254	1	0.39%	2	1	93	93	0.4999999999999138	1	1	106	148	0	1	C
barcode89_consensus_vsearch	332	T	T	258	1	0.39%	2	1	93	93	0.4999999999999138	1	1	109	149	0	1	C
barcode89_consensus_vsearch	333	T	T	259	0	0%	2	0	93	0	1.0	1	0	109	150	0	0	
barcode89_consensus_vsearch	334	T	T	254	3	1.16%	2	1	93	93	0.12426900584791233	1	1	106	148	3	0	+C
barcode89_consensus_vsearch	335	C	C	254	3	1.16%	2	1	93	93	0.12426900584791233	1	1	105	149	3	0	-A
barcode89_consensus_vsearch	336	A	A	253	2	0.78%	2	1	93	93	0.24950884086425928	1	1	104	149	2	0	G
barcode89_consensus_vsearch	337	A	*/-G	239	18	6.95%	2	2	93	93	2.8028611534991314E-6	1	1	107	132	2	16	-G
barcode89_consensus_vsearch	338	G	G	240	1	0.41%	2	1	93	93	0.4999999999999138	1	1	107	133	0	1	+CG
barcode89_consensus_vsearch	339	G	G	257	1	0.39%	2	1	93	93	0.4999999999999138	1	1	108	149	1	0	+AG
barcode89_consensus_vsearch	340	G	G	258	1	0.39%	2	1	93	93	0.4999999999999138	1	1	109	149	0	1	-ACG
barcode89_consensus_vsearch	341	A	A	252	4	1.55%	2	2	93	93	0.06176686569346045	1	1	107	145	1	3	G
barcode89_consensus_vsearch	342	C	C	258	0	0%	2	0	93	0	1.0	1	0	109	149	0	0	
barcode89_consensus_vsearch	343	G	G	255	2	0.78%	2	1	93	93	0.2495126705651419	1	1	107	148	2	0	A
barcode89_consensus_vsearch	344	T	T	256	1	0.39%	2	1	93	93	0.4999999999999138	1	1	109	147	0	1	-CGAG
barcode89_consensus_vsearch	345	C	C	255	2	0.78%	2	1	93	93	0.2495126705651419	1	1	107	148	2	0	+G
barcode89_consensus_vsearch	346	G	G	255	1	0.39%	2	1	93	93	0.4999999999999138	1	1	107	148	1	0	+A
barcode89_consensus_vsearch	347	A	A	253	2	0.78%	2	1	93	93	0.24950884086425928	1	1	108	145	0	2	+G
barcode89_consensus_vsearch	348	G	*/-AG	214	34	13.23%	2	2	93	93	1.7287484494063694E-11	1	1	74	140	31	3	-AG
barcode89_consensus_vsearch	349	A	A	216	2	0.91%	2	1	93	93	0.249425287356441	1	1	74	142	0	2	T
barcode89_consensus_vsearch	350	G	G	215	4	1.79%	2	1	93	93	0.06164286277914926	1	1	74	141	0	4	-C
barcode89_consensus_vsearch	351	C	C	250	2	0.79%	2	1	93	93	0.2495029821073759	1	1	107	143	2	0	+TT
barcode89_consensus_vsearch	352	G	G	256	1	0.39%	2	1	93	93	0.4999999999999138	1	1	107	149	0	1	-C
barcode89_consensus_vsearch	353	C	C	254	3	1.16%	2	2	93	93	0.12426900584791233	1	1	107	147	1	2	T
barcode89_consensus_vsearch	354	A	A	253	4	1.55%	2	2	93	93	0.0617697211064687	1	1	105	148	2	2	-C
barcode89_consensus_vsearch	355	C	C	252	1	0.39%	2	1	93	93	0.5000000000003686	1	1	105	147	1	0	+AC
barcode89_consensus_vsearch	356	C	C	252	5	1.94%	2	1	93	93	0.030642626352771006	1	1	108	144	0	5	T
barcode89_consensus_vsearch	357	G	G	255	2	0.77%	2	1	93	93	0.2495126705651419	1	1	107	148	0	2	T
barcode89_consensus_vsearch	358	G	G	259	0	0%	2	0	93	0	1.0	1	0	109	150	0	0	
barcode89_consensus_vsearch	359	A	A	254	3	1.16%	2	2	93	93	0.12426900584791233	1	1	106	148	1	2	+C
barcode89_consensus_vsearch	360	C	C	258	0	0%	2	0	93	0	1.0	1	0	108	150	0	0	
barcode89_consensus_vsearch	361	C	C	256	1	0.39%	2	1	93	93	0.4999999999999138	1	1	108	148	1	0	+A
barcode89_consensus_vsearch	362	C	C	252	5	1.93%	2	2	93	93	0.030642626352771006	1	1	107	145	1	4	+G
barcode89_consensus_vsearch	363	G	G	259	0	0%	2	0	93	0	1.0	1	0	109	150	0	0	
barcode89_consensus_vsearch	364	A	A	258	1	0.39%	2	1	93	93	0.4999999999999138	1	1	108	150	1	0	C
barcode89_consensus_vsearch	365	C	*/-A	225	21	8.11%	2	2	93	93	3.0540786279774035E-7	1	1	92	133	11	10	-A
barcode89_consensus_vsearch	366	A	A	236	1	0.42%	2	1	93	93	0.4999999999999138	1	1	97	139	0	1	+CA
barcode89_consensus_vsearch	367	A	A	257	1	0.39%	2	1	93	93	0.4999999999999138	1	1	107	150	1	0	+GG
barcode89_consensus_vsearch	368	A	A	255	2	0.77%	2	1	93	93	0.2495126705651419	1	1	105	150	2	0	G
barcode89_consensus_vsearch	369	A	A	256	1	0.39%	2	1	93	93	0.4999999999999138	1	1	106	150	1	0	-G
barcode89_consensus_vsearch	370	G	G	256	1	0.39%	2	1	93	93	0.4999999999999138	1	1	107	149	0	1	+C
barcode89_consensus_vsearch	371	T	T	256	2	0.77%	2	1	93	93	0.24951456310670525	1	1	109	147	0	2	C
barcode89_consensus_vsearch	372	G	G	256	1	0.39%	2	1	93	93	0.4999999999999138	1	1	107	149	0	1	+C
barcode89_consensus_vsearch	373	T	T	254	2	0.78%	2	1	93	93	0.2495107632092758	1	1	107	147	0	2	C
barcode89_consensus_vsearch	374	C	C	250	4	1.55%	2	1	93	93	0.061761087351402955	1	1	100	150	4	0	+A
barcode89_consensus_vsearch	375	G	G	248	6	2.33%	2	1	93	93	0.015165466280175907	1	1	101	147	6	0	-A
barcode89_consensus_vsearch	376	A	A	248	2	0.79%	2	1	93	93	0.24949899799584363	1	1	99	149	2	0	-G
barcode89_consensus_vsearch	377	G	G	248	3	1.17%	2	1	93	93	0.12425149700602607	1	1	104	144	0	3	+C
barcode89_consensus_vsearch	378	C	C	251	4	1.56%	2	1	93	93	0.06176398786346276	1	1	108	143	0	4	-T
barcode89_consensus_vsearch	379	T	T	252	2	0.78%	2	1	93	93	0.2495069033532105	1	1	108	144	0	2	C
barcode89_consensus_vsearch	380	C	*/-T	239	18	6.95%	2	2	93	93	2.8028611534991314E-6	1	1	108	131	1	17	-T
barcode89_consensus_vsearch	381	T	T	235	3	1.24%	2	1	93	93	0.1242105263157532	1	1	106	129	0	3	C
barcode89_consensus_vsearch	382	A	A	254	2	0.78%	2	2	93	93	0.2495107632092758	1	1	106	148	1	1	-C
barcode89_consensus_vsearch	383	C	C	247	6	2.34%	2	1	93	93	0.015163657292611031	1	1	106	141	0	6	+T
barcode89_consensus_vsearch	384	C	C	254	3	1.16%	2	1	93	93	0.12426900584791233	1	1	108	146	0	3	T
barcode89_consensus_vsearch	385	A	A	256	2	0.77%	2	1	93	93	0.24951456310670525	1	1	106	150	2	0	G
barcode89_consensus_vsearch	386	A	A	255	3	1.16%	2	2	93	93	0.1242718446601877	1	1	106	149	2	1	G
barcode89_consensus_vsearch	387	C	C	258	0	0%	2	0	93	0	1.0	1	0	108	150	0	0	
barcode89_consensus_vsearch	388	C	C	256	1	0.39%	2	1	93	93	0.4999999999999138	1	1	108	148	0	1	+AA
barcode89_consensus_vsearch	389	G	G	259	0	0%	2	0	93	0	1.0	1	0	109	150	0	0	
barcode89_consensus_vsearch	390	T	T	259	0	0%	2	0	93	0	1.0	1	0	109	150	0	0	
barcode89_consensus_vsearch	391	T	T	255	1	0.39%	2	1	93	93	0.4999999999999138	1	1	107	148	0	1	+A
barcode89_consensus_vsearch	392	A	A	255	2	0.78%	2	1	93	93	0.2495126705651419	1	1	106	149	2	0	G
barcode89_consensus_vsearch	393	A	A	254	3	1.16%	2	2	93	93	0.12426900584791233	1	1	106	148	2	1	G
barcode89_consensus_vsearch	394	A	*/-C	232	17	6.56%	2	2	93	93	5.751742563661843E-6	1	1	89	143	12	5	-C
barcode89_consensus_vsearch	395	C	C	237	1	0.42%	2	1	93	93	0.5000000000003686	1	1	93	144	1	0	A
barcode89_consensus_vsearch	396	C	C	251	3	1.17%	2	1	93	93	0.12426035502961323	1	1	106	145	0	3	T
barcode89_consensus_vsearch	397	C	C	250	4	1.55%	2	2	93	93	0.061761087351402955	1	1	106	144	3	1	-T
barcode89_consensus_vsearch	398	T	T	251	2	0.78%	2	1	93	93	0.24950495049494414	1	1	104	147	0	2	C
barcode89_consensus_vsearch	399	A	A	253	4	1.54%	2	2	93	93	0.0617697211064687	1	1	105	148	3	1	G
barcode89_consensus_vsearch	400	G	G	258	1	0.39%	2	1	93	93	0.4999999999999138	1	1	108	150	1	0	A
barcode89_consensus_vsearch	401	C	*/-T	238	20	7.72%	2	1	93	93	6.503726365883174E-7	1	1	108	130	0	20	-T
barcode89_consensus_vsearch	402	T	T	233	4	1.67%	2	1	93	93	0.06170802978681481	1	1	103	130	4	0	-C
barcode89_consensus_vsearch	403	C	C	255	0	0%	2	0	93	0	1.0	1	0	105	150	0	0	
barcode89_consensus_vsearch	404	C	*/-G	244	10	3.86%	2	1	93	93	8.922644712756052E-4	1	1	109	135	0	10	-G
barcode89_consensus_vsearch	405	G	G	247	1	0.4%	2	1	93	93	0.4999999999999138	1	1	107	140	1	0	+AG
barcode89_consensus_vsearch	406	G	G	256	2	0.77%	2	2	93	93	0.24951456310670525	1	1	107	149	1	1	A
barcode89_consensus_vsearch	407	A	A	256	1	0.39%	2	1	93	93	0.4999999999999138	1	1	108	148	0	1	+TG
barcode89_consensus_vsearch	408	C	*/+A	239	12	4.65%	2	2	93	93	2.1340156008037268E-4	1	1	107	132	1	11	+A
barcode89_consensus_vsearch	409	A	A	252	1	0.4%	2	1	93	93	0.5000000000003686	1	1	109	143	0	1	G
barcode89_consensus_vsearch	410	A	A	258	1	0.39%	2	1	93	93	0.4999999999999138	1	1	109	149	0	1	T
barcode89_consensus_vsearch	411	A	A	254	2	0.77%	2	2	93	93	0.2495107632092758	1	1	107	147	1	1	G
barcode89_consensus_vsearch	412	C	C	257	1	0.39%	2	1	93	93	0.4999999999999138	1	1	109	148	0	1	+T
barcode89_consensus_vsearch	413	C	Y	246	7	2.7%	2	1	93	93	0.007490846702557751	1	1	109	137	0	7	T
barcode89_consensus_vsearch	414	G	G	259	0	0%	2	0	93	0	1.0	1	0	109	150	0	0	
barcode89_consensus_vsearch	415	A	A	257	1	0.39%	2	1	93	93	0.4999999999999138	1	1	109	148	0	1	-T
barcode89_consensus_vsearch	416	T	T	257	1	0.39%	2	1	93	93	0.4999999999999138	1	1	109	148	0	1	C
barcode89_consensus_vsearch	417	T	T	259	0	0%	2	0	93	0	1.0	1	0	109	150	0	0	
barcode89_consensus_vsearch	418	T	T	256	2	0.77%	2	1	93	93	0.24951456310670525	1	1	108	148	0	2	+G
barcode89_consensus_vsearch	419	C	C	252	4	1.54%	2	1	93	93	0.06176686569346045	1	1	108	144	0	4	T
barcode89_consensus_vsearch	420	A	A	246	6	2.32%	2	2	93	93	0.01516183400716267	1	1	103	143	3	3	+G
barcode89_consensus_vsearch	421	G	G	255	1	0.39%	2	1	93	93	0.4999999999999138	1	1	107	148	1	0	+AG
barcode89_consensus_vsearch	422	G	G	255	2	0.78%	2	1	93	93	0.2495126705651419	1	1	106	149	2	0	+A
barcode89_consensus_vsearch	423	G	G	258	1	0.39%	2	1	93	93	0.4999999999999138	1	1	108	150	1	0	A
barcode89_consensus_vsearch	424	T	T	256	3	1.16%	2	2	93	93	0.12427466150865948	1	1	108	148	1	2	C
barcode89_consensus_vsearch	425	G	G	259	0	0%	2	0	93	0	1.0	1	0	109	150	0	0	
barcode89_consensus_vsearch	426	A	A	259	0	0%	2	0	93	0	1.0	1	0	109	150	0	0	
barcode89_consensus_vsearch	427	T	T	255	2	0.77%	2	1	93	93	0.2495126705651419	1	1	107	148	2	0	+G
barcode89_consensus_vsearch	428	A	A	249	4	1.54%	2	2	93	93	0.06175816388801474	1	1	104	145	2	2	-G
barcode89_consensus_vsearch	429	G	G	255	0	0%	2	0	93	0	1.0	1	0	107	148	0	0	
barcode89_consensus_vsearch	430	G	G	257	1	0.39%	2	1	93	93	0.4999999999999138	1	1	107	150	1	0	+C
barcode89_consensus_vsearch	431	C	C	258	1	0.39%	2	1	93	93	0.4999999999999138	1	1	109	149	0	1	T
barcode89_consensus_vsearch	432	T	T	255	4	1.54%	2	1	93	93	0.06177536572082746	1	1	109	146	0	4	C
barcode89_consensus_vsearch	433	G	G	259	0	0%	2	0	93	0	1.0	1	0	109	150	0	0	
barcode89_consensus_vsearch	434	T	T	254	3	1.16%	2	2	93	93	0.12426900584791233	1	1	107	147	1	2	C
barcode89_consensus_vsearch	435	T	T	251	3	1.16%	2	1	93	93	0.12426035502961323	1	1	106	145	0	3	C
barcode89_consensus_vsearch	436	A	A	254	2	0.78%	2	2	93	93	0.2495107632092758	1	1	106	148	1	1	T
barcode89_consensus_vsearch	437	A	A	252	3	1.16%	2	1	93	93	0.12426326129665838	1	1	105	147	3	0	+G
barcode89_consensus_vsearch	438	G	G	257	1	0.39%	2	1	93	93	0.4999999999999138	1	1	108	149	1	0	-A
barcode89_consensus_vsearch	439	A	A	256	1	0.39%	2	1	93	93	0.4999999999999138	1	1	108	148	0	1	G
barcode89_consensus_vsearch	440	A	A	252	3	1.16%	2	2	93	93	0.12426326129665838	1	1	104	148	1	2	-GAA
barcode89_consensus_vsearch	441	G	*/-A	177	40	15.87%	2	2	93	93	1.2551052481842306E-13	1	1	59	118	26	14	-A
barcode89_consensus_vsearch	442	A	A	203	1	0.49%	2	1	93	93	0.4999999999999138	1	1	70	133	1	0	+G
barcode89_consensus_vsearch	443	A	A	238	4	1.64%	2	2	93	93	0.061724409550499286	1	1	93	145	2	2	G
barcode89_consensus_vsearch	444	A	A	248	3	1.2%	2	2	93	93	0.12425149700602607	1	1	100	148	1	2	G
barcode89_consensus_vsearch	445	A	A	248	6	2.34%	2	1	93	93	0.015165466280175907	1	1	100	148	6	0	-G
barcode89_consensus_vsearch	446	G	G	248	2	0.8%	2	1	93	93	0.24949899799584363	1	1	98	150	2	0	-A
barcode89_consensus_vsearch	447	A	*/-GA	244	8	3.14%	2	1	93	93	0.0036920468013430033	1	1	96	148	8	0	-GA
barcode89_consensus_vsearch	448	G	G	246	1	0.4%	2	1	93	93	0.5000000000003686	1	1	97	149	1	0	-A
barcode89_consensus_vsearch	449	A	A	245	2	0.8%	2	2	93	93	0.24949290060873971	1	1	97	148	1	1	G
barcode89_consensus_vsearch	450	A	A	252	2	0.78%	2	1	93	93	0.2495069033532105	1	1	105	147	2	0	-C
barcode89_consensus_vsearch	451	C	C	251	3	1.17%	2	1	93	93	0.12426035502961323	1	1	107	144	0	3	+T
barcode89_consensus_vsearch	452	T	T	245	5	1.95%	2	1	93	93	0.03062563759307	1	1	106	139	0	5	-C
barcode89_consensus_vsearch	453	C	C	250	2	0.79%	2	1	93	93	0.2495029821073759	1	1	108	142	0	2	-T
barcode89_consensus_vsearch	454	T	T	253	2	0.78%	2	1	93	93	0.24950884086425928	1	1	108	145	0	2	+CT
barcode89_consensus_vsearch	455	T	*/-C	237	12	4.63%	2	2	93	93	2.131655349948094E-4	1	1	95	142	5	7	-C
barcode89_consensus_vsearch	456	C	C	243	0	0%	2	0	93	0	1.0	1	0	100	143	0	0	
barcode89_consensus_vsearch	457	C	C	253	2	0.78%	2	1	93	93	0.24950884086425928	1	1	105	148	0	2	+T
barcode89_consensus_vsearch	458	C	C	253	2	0.77%	2	1	93	93	0.24950884086425928	1	1	106	147	0	2	T
barcode89_consensus_vsearch	459	A	*/-G	233	13	5.04%	2	2	93	93	1.0374225858311641E-4	1	1	103	130	1	12	-G
barcode89_consensus_vsearch	460	G	G	244	1	0.41%	2	1	93	93	0.4999999999999138	1	1	106	138	1	0	+A
barcode89_consensus_vsearch	461	G	G	257	1	0.39%	2	1	93	93	0.4999999999999138	1	1	108	149	0	1	A
barcode89_consensus_vsearch	462	G	*/-C	224	29	11.2%	2	2	93	93	7.955125641077885E-10	1	1	100	124	8	21	-C
barcode89_consensus_vsearch	463	C	C	224	3	1.3%	2	1	93	93	0.12417218543044797	1	1	99	125	0	3	G
barcode89_consensus_vsearch	464	C	Y	248	10	3.86%	2	1	93	93	8.935377905624525E-4	1	1	109	139	0	10	T
barcode89_consensus_vsearch	465	C	C	259	0	0%	2	0	93	0	1.0	1	0	109	150	0	0	
barcode89_consensus_vsearch	466	C	C	258	1	0.39%	2	1	93	93	0.4999999999999138	1	1	109	149	0	1	T
barcode89_consensus_vsearch	467	C	C	251	6	2.32%	2	1	93	93	0.015170809117680038	1	1	108	143	0	6	T
barcode89_consensus_vsearch	468	G	G	255	2	0.78%	2	1	93	93	0.2495126705651419	1	1	108	147	0	2	A
barcode89_consensus_vsearch	469	C	C	258	0	0%	2	0	93	0	1.0	1	0	108	150	0	0	
barcode89_consensus_vsearch	470	C	C	257	1	0.39%	2	1	93	93	0.4999999999999138	1	1	109	148	0	1	-G
barcode89_consensus_vsearch	471	G	G	258	0	0%	2	0	93	0	1.0	1	0	109	149	0	0	
barcode89_consensus_vsearch	472	T	T	254	3	1.16%	2	2	93	93	0.12426900584791233	1	1	107	147	1	2	C
barcode89_consensus_vsearch	473	C	C	256	1	0.39%	2	1	93	93	0.4999999999999138	1	1	107	149	0	1	-GTC
barcode89_consensus_vsearch	474	G	G	256	1	0.39%	2	1	93	93	0.4999999999999138	1	1	108	148	0	1	A
barcode89_consensus_vsearch	475	T	T	255	2	0.78%	2	2	93	93	0.2495126705651419	1	1	108	147	1	1	C
barcode89_consensus_vsearch	476	C	C	256	1	0.39%	2	1	93	93	0.4999999999999138	1	1	108	148	1	0	-T
barcode89_consensus_vsearch	477	T	T	254	4	1.55%	2	1	93	93	0.06177255436325217	1	1	104	150	4	0	+C
barcode89_consensus_vsearch	478	C	C	259	0	0%	2	0	93	0	1.0	1	0	109	150	0	0	
barcode89_consensus_vsearch	479	C	C	253	3	1.16%	2	1	93	93	0.124266144814075	1	1	109	144	0	3	-GC
barcode89_consensus_vsearch	480	G	G	256	0	0%	2	0	93	0	1.0	1	0	109	147	0	0	
barcode89_consensus_vsearch	481	C	C	255	1	0.39%	2	1	93	93	0.4999999999999138	1	1	109	146	0	1	T
barcode89_consensus_vsearch	482	A	A	258	1	0.39%	2	1	93	93	0.4999999999999138	1	1	109	149	0	1	-T
barcode89_consensus_vsearch	483	T	T	258	0	0%	2	0	93	0	1.0	1	0	109	149	0	0	
barcode89_consensus_vsearch	484	T	T	258	1	0.39%	2	1	93	93	0.4999999999999138	1	1	108	150	1	0	+C
barcode89_consensus_vsearch	485	C	C	258	1	0.39%	2	1	93	93	0.4999999999999138	1	1	109	149	0	1	-A
barcode89_consensus_vsearch	486	A	A	255	2	0.78%	2	1	93	93	0.2495126705651419	1	1	106	149	2	0	G
barcode89_consensus_vsearch	487	G	G	259	0	0%	2	0	93	0	1.0	1	0	109	150	0	0	
barcode89_consensus_vsearch	488	T	T	257	2	0.77%	2	1	93	93	0.24951644100587136	1	1	107	150	2	0	C
barcode89_consensus_vsearch	489	T	T	259	0	0%	2	0	93	0	1.0	1	0	109	150	0	0	
barcode89_consensus_vsearch	490	A	A	258	1	0.39%	2	1	93	93	0.4999999999999138	1	1	108	150	1	0	G
barcode89_consensus_vsearch	491	C	C	254	1	0.39%	2	1	93	93	0.4999999999999138	1	1	107	147	1	0	+AC
barcode89_consensus_vsearch	492	G	G	255	1	0.39%	2	1	93	93	0.4999999999999138	1	1	108	147	0	1	+CG
barcode89_consensus_vsearch	493	T	Y	247	10	3.88%	2	2	93	93	8.932230783903669E-4	1	1	107	140	2	8	C
barcode89_consensus_vsearch	494	T	T	254	3	1.16%	2	1	93	93	0.12426900584791233	1	1	108	146	0	3	C
barcode89_consensus_vsearch	495	G	G	252	3	1.16%	2	2	93	93	0.12426326129665838	1	1	104	148	1	2	-C
barcode89_consensus_vsearch	496	C	C	256	0	0%	2	0	93	0	1.0	1	0	108	148	0	0	
barcode89_consensus_vsearch	497	C	C	257	1	0.39%	2	1	93	93	0.4999999999999138	1	1	108	149	0	1	-G
barcode89_consensus_vsearch	498	G	G	251	3	1.16%	2	1	93	93	0.12426035502961323	1	1	107	144	0	3	-TG
barcode89_consensus_vsearch	499	T	T	249	3	1.18%	2	2	93	93	0.12425447316115633	1	1	107	142	1	2	+G
barcode89_consensus_vsearch	500	G	G	253	1	0.39%	2	1	93	93	0.5000000000003686	1	1	108	145	1	0	T
barcode89_consensus_vsearch	501	G	G	253	3	1.17%	2	2	93	93	0.124266144814075	1	1	106	147	2	1	-A
barcode89_consensus_vsearch	502	A	A	254	1	0.39%	2	1	93	93	0.4999999999999138	1	1	105	149	1	0	-GA
barcode89_consensus_vsearch	503	G	G	256	1	0.39%	2	1	93	93	0.4999999999999138	1	1	107	149	1	0	-A
barcode89_consensus_vsearch	504	A	A	256	1	0.39%	2	1	93	93	0.4999999999999138	1	1	107	149	0	1	G
barcode89_consensus_vsearch	505	A	A	255	2	0.77%	2	1	93	93	0.2495126705651419	1	1	109	146	0	2	-T
barcode89_consensus_vsearch	506	T	T	254	2	0.78%	2	1	93	93	0.2495107632092758	1	1	108	146	0	2	-C
barcode89_consensus_vsearch	507	C	C	255	1	0.39%	2	1	93	93	0.4999999999999138	1	1	109	146	0	1	+TG
barcode89_consensus_vsearch	508	C	C	252	6	2.32%	2	1	93	93	0.015172562563020547	1	1	109	143	0	6	T
barcode89_consensus_vsearch	509	A	A	251	5	1.93%	2	2	93	93	0.03064025621010106	1	1	107	144	2	3	-CA
barcode89_consensus_vsearch	510	C	C	250	2	0.79%	2	1	93	93	0.2495029821073759	1	1	107	143	0	2	A
barcode89_consensus_vsearch	511	A	A	252	1	0.39%	2	1	93	93	0.5000000000003686	1	1	107	145	0	1	+CA
barcode89_consensus_vsearch	512	T	T	254	5	1.93%	2	1	93	93	0.030647311787538743	1	1	104	150	5	0	-C
barcode89_consensus_vsearch	513	C	C	253	1	0.39%	2	1	93	93	0.5000000000003686	1	1	104	149	0	1	T
barcode89_consensus_vsearch	514	C	C	251	5	1.93%	2	1	93	93	0.03064025621010106	1	1	106	145	0	5	-AA
barcode89_consensus_vsearch	515	A	A	244	6	2.38%	2	2	93	93	0.015158143859196256	1	1	105	139	1	5	G
barcode89_consensus_vsearch	516	A	A	249	3	1.18%	2	1	93	93	0.12425447316115633	1	1	108	141	0	3	G
barcode89_consensus_vsearch	517	G	G	258	1	0.39%	2	1	93	93	0.4999999999999138	1	1	108	150	1	0	+AAG
barcode89_consensus_vsearch	518	T	Y	249	8	3.09%	2	1	93	93	0.0036961603384701837	1	1	108	141	0	8	C
barcode89_consensus_vsearch	519	G	G	253	2	0.78%	2	1	93	93	0.24950884086425928	1	1	105	148	2	0	-C
barcode89_consensus_vsearch	520	C	C	254	1	0.39%	2	1	93	93	0.4999999999999138	1	1	106	148	0	1	T
barcode89_consensus_vsearch	521	C	C	252	3	1.16%	2	2	93	93	0.12426326129665838	1	1	103	149	2	1	-G
barcode89_consensus_vsearch	522	G	G	255	0	0%	2	0	93	0	1.0	1	0	106	149	0	0	
barcode89_consensus_vsearch	523	G	G	259	0	0%	2	0	93	0	1.0	1	0	109	150	0	0	
barcode89_consensus_vsearch	524	A	A	258	1	0.39%	2	1	93	93	0.4999999999999138	1	1	109	149	0	1	+C
barcode89_consensus_vsearch	525	A	A	258	1	0.39%	2	1	93	93	0.4999999999999138	1	1	109	149	0	1	-T
barcode89_consensus_vsearch	526	T	T	257	1	0.39%	2	1	93	93	0.4999999999999138	1	1	108	149	1	0	+G
barcode89_consensus_vsearch	527	A	A	255	2	0.77%	2	2	93	93	0.2495126705651419	1	1	106	149	1	1	-T
barcode89_consensus_vsearch	528	T	T	253	3	1.17%	2	2	93	93	0.124266144814075	1	1	106	147	1	2	C
barcode89_consensus_vsearch	529	T	T	257	1	0.39%	2	1	93	93	0.4999999999999138	1	1	108	149	0	1	+A
barcode89_consensus_vsearch	530	A	A	258	0	0%	2	0	93	0	1.0	1	0	108	150	0	0	
barcode89_consensus_vsearch	531	A	A	257	1	0.39%	2	1	93	93	0.4999999999999138	1	1	109	148	0	1	+T
barcode89_consensus_vsearch	532	C	C	259	0	0%	2	0	93	0	1.0	1	0	109	150	0	0	
barcode89_consensus_vsearch	533	C	C	251	6	2.32%	2	2	93	93	0.015170809117680038	1	1	107	144	1	5	-G
barcode89_consensus_vsearch	534	G	G	252	1	0.4%	2	1	93	93	0.5000000000003686	1	1	107	145	1	0	A
barcode89_consensus_vsearch	535	G	G	257	1	0.39%	2	1	93	93	0.4999999999999138	1	1	107	150	1	0	-C
barcode89_consensus_vsearch	536	C	C	253	3	1.16%	2	1	93	93	0.124266144814075	1	1	107	146	0	3	-T
barcode89_consensus_vsearch	537	T	T	252	1	0.39%	2	1	93	93	0.5000000000003686	1	1	106	146	1	0	A
barcode89_consensus_vsearch	538	T	*/-C	177	63	24.51%	2	2	93	93	9.905923342206708E-22	1	1	94	83	10	53	-C
barcode89_consensus_vsearch	539	C	C	189	0	0%	2	0	93	0	1.0	1	0	97	92	0	0	
barcode89_consensus_vsearch	540	C	C	253	1	0.39%	2	1	93	93	0.5000000000003686	1	1	107	146	1	0	+G
barcode89_consensus_vsearch	541	C	*/-TT	220	19	7.36%	2	2	93	93	1.3145184545692624E-6	1	1	107	113	1	18	-TT
barcode89_consensus_vsearch	542	T	T	229	1	0.43%	2	1	93	93	0.4999999999999138	1	1	108	121	0	1	C
barcode89_consensus_vsearch	543	T	T	235	2	0.84%	2	1	93	93	0.24947145877361238	1	1	108	127	0	2	C
barcode89_consensus_vsearch	544	T	T	246	6	2.34%	2	1	93	93	0.01516183400716267	1	1	107	139	0	6	-C
barcode89_consensus_vsearch	545	C	*/-G	201	21	8.37%	2	2	93	93	2.903578867014327E-7	1	1	107	94	1	20	-G
barcode89_consensus_vsearch	546	G	*/+C	199	13	5.65%	2	1	93	93	1.0098964132434686E-4	1	1	88	111	13	0	+C
barcode89_consensus_vsearch	547	C	Y	177	31	12.76%	2	2	93	93	1.3920861453897108E-10	1	1	102	75	2	29	T
barcode89_consensus_vsearch	548	G	R	213	24	9.64%	2	2	93	93	3.2291486714684166E-8	1	1	90	123	17	7	A
barcode89_consensus_vsearch	549	G	G	258	0	0%	2	0	93	0	1.0	1	0	109	149	0	0	
barcode89_consensus_vsearch	550	G	G	257	1	0.39%	2	1	93	93	0.4999999999999138	1	1	109	148	0	1	+A
barcode89_consensus_vsearch	551	A	A	249	6	2.32%	2	1	93	93	0.015167261137354384	1	1	109	140	0	6	+T
barcode89_consensus_vsearch	552	C	C	248	4	1.55%	2	1	93	93	0.061755217199896344	1	1	109	139	0	4	T
barcode89_consensus_vsearch	553	G	*/+TG	211	29	11.37%	2	1	93	93	7.57430096392508E-10	1	1	107	104	0	29	+TG
barcode89_consensus_vsearch	554	G	G	255	2	0.78%	2	1	93	93	0.2495126705651419	1	1	109	146	0	2	A
barcode89_consensus_vsearch	555	C	Y	248	9	3.49%	2	1	93	93	0.0018188615104327871	1	1	108	140	0	9	T
barcode89_consensus_vsearch	556	G	G	253	3	1.17%	2	2	93	93	0.124266144814075	1	1	107	146	1	2	A
barcode89_consensus_vsearch	557	C	C	252	3	1.17%	2	1	93	93	0.12426326129665838	1	1	108	144	0	3	T
barcode89_consensus_vsearch	558	A	A	253	4	1.54%	2	2	93	93	0.0617697211064687	1	1	106	147	2	2	G
barcode89_consensus_vsearch	559	C	C	249	5	1.94%	2	2	93	93	0.03063545999571253	1	1	105	144	2	3	-A
barcode89_consensus_vsearch	560	A	A	245	2	0.8%	2	1	93	93	0.24949290060873971	1	1	102	143	2	0	+G
barcode89_consensus_vsearch	561	A	A	255	1	0.39%	2	1	93	93	0.4999999999999138	1	1	109	146	0	1	+CAA
barcode89_consensus_vsearch	562	G	G	248	2	0.78%	2	1	93	93	0.24949899799584363	1	1	105	143	0	2	-TG
barcode89_consensus_vsearch	563	T	T	248	4	1.57%	2	2	93	93	0.061755217199896344	1	1	108	140	1	3	C
barcode89_consensus_vsearch	564	G	G	251	2	0.78%	2	1	93	93	0.24950495049494414	1	1	106	145	0	2	-C
barcode89_consensus_vsearch	565	C	*/-GC	237	13	5.08%	2	2	93	93	1.0401965485220523E-4	1	1	97	140	9	4	-GC
barcode89_consensus_vsearch	566	G	G	241	1	0.41%	2	1	93	93	0.4999999999999138	1	1	97	144	0	1	+TG
barcode89_consensus_vsearch	567	C	C	240	2	0.81%	2	1	93	93	0.24948240165631827	1	1	97	143	0	2	T
barcode89_consensus_vsearch	568	A	A	252	2	0.78%	2	2	93	93	0.2495069033532105	1	1	104	148	1	1	G
barcode89_consensus_vsearch	569	C	C	244	5	1.95%	2	2	93	93	0.030623132735815337	1	1	104	140	1	4	+T
barcode89_consensus_vsearch	570	T	T	252	1	0.39%	2	1	93	93	0.5000000000003686	1	1	107	145	0	1	+CT
barcode89_consensus_vsearch	571	T	T	252	1	0.39%	2	1	93	93	0.5000000000003686	1	1	106	146	0	1	+A
barcode89_consensus_vsearch	572	T	*/-A	234	12	4.63%	2	1	93	93	2.1280463299094273E-4	1	1	108	126	0	12	-A
barcode89_consensus_vsearch	573	A	A	243	3	1.22%	2	1	93	93	0.12423625254575449	1	1	106	137	3	0	G
barcode89_consensus_vsearch	574	A	A	254	2	0.78%	2	1	93	93	0.2495107632092758	1	1	108	146	0	2	G
barcode89_consensus_vsearch	575	A	A	254	2	0.78%	2	1	93	93	0.2495107632092758	1	1	107	147	2	0	+G
barcode89_consensus_vsearch	576	A	R	246	10	3.86%	2	2	93	93	8.92905972782949E-4	1	1	99	147	7	3	G
barcode89_consensus_vsearch	577	C	C	247	5	1.93%	2	1	93	93	0.030630587731099716	1	1	104	143	0	5	+G
barcode89_consensus_vsearch	578	G	R	244	11	4.28%	2	1	93	93	4.373673587096424E-4	1	1	94	150	11	0	A
barcode89_consensus_vsearch	579	G	*/-A	238	19	7.39%	2	1	93	93	1.3505722090443434E-6	1	1	88	150	19	0	-A
barcode89_consensus_vsearch	580	A	A	239	1	0.42%	2	1	93	93	0.4999999999999138	1	1	90	149	0	1	-GTTTCCCTATCG
barcode89_consensus_vsearch	581	G	G	251	5	1.94%	2	2	93	93	0.03064025621010106	1	1	104	147	3	2	-T
barcode89_consensus_vsearch	582	T	T	250	2	0.79%	2	1	93	93	0.2495029821073759	1	1	103	147	2	0	G
barcode89_consensus_vsearch	583	T	T	258	0	0%	2	0	93	0	1.0	1	0	109	149	0	0	
barcode89_consensus_vsearch	584	T	*/-C	196	50	19.38%	2	2	93	93	5.542398448978772E-17	1	1	92	104	16	34	-C
barcode89_consensus_vsearch	585	C	C	198	2	1%	2	1	93	93	0.24937343358388336	1	1	90	108	2	0	T
barcode89_consensus_vsearch	586	C	C	248	2	0.8%	2	1	93	93	0.24949899799584363	1	1	108	140	0	2	T
barcode89_consensus_vsearch	587	C	*/-T	247	7	2.71%	2	1	93	93	0.00749210286352295	1	1	109	138	0	7	-T
barcode89_consensus_vsearch	588	T	T	250	1	0.4%	2	1	93	93	0.4999999999999138	1	1	109	141	0	1	+A
barcode89_consensus_vsearch	589	A	A	256	1	0.39%	2	1	93	93	0.4999999999999138	1	1	109	147	0	1	+T
barcode89_consensus_vsearch	590	T	T	256	2	0.78%	2	1	93	93	0.24951456310670525	1	1	109	147	0	2	-C
barcode89_consensus_vsearch	591	C	C	253	3	1.17%	2	1	93	93	0.124266144814075	1	1	106	147	3	0	-GC
barcode89_consensus_vsearch	592	G	G	255	0	0%	2	0	93	0	1.0	1	0	106	149	0	0	
barcode89_consensus_vsearch	593	C	C	252	2	0.78%	2	1	93	93	0.2495069033532105	1	1	105	147	0	2	+T
barcode89_consensus_vsearch	594	T	T	252	3	1.17%	2	1	93	93	0.12426326129665838	1	1	104	148	3	0	A
barcode89_consensus_vsearch	595	T	T	254	2	0.77%	2	1	93	93	0.2495107632092758	1	1	108	146	0	2	+C
barcode89_consensus_vsearch	596	A	*/-G	239	8	3.1%	2	1	93	93	0.0036877690019176544	1	1	104	135	0	8	-G
barcode89_consensus_vsearch	597	G	G	250	1	0.4%	2	1	93	93	0.4999999999999138	1	1	108	142	1	0	+A
barcode89_consensus_vsearch	598	G	G	258	1	0.39%	2	1	93	93	0.4999999999999138	1	1	108	150	1	0	A
barcode89_consensus_vsearch	599	A	A	256	2	0.77%	2	1	93	93	0.24951456310670525	1	1	109	147	0	2	+T
barcode89_consensus_vsearch	600	T	T	257	1	0.39%	2	1	93	93	0.4999999999999138	1	1	107	150	1	0	+CC
barcode89_consensus_vsearch	601	C	C	256	1	0.39%	2	1	93	93	0.4999999999999138	1	1	106	150	1	0	+A
barcode89_consensus_vsearch	602	G	G	257	1	0.39%	2	1	93	93	0.4999999999999138	1	1	108	149	0	1	+T
barcode89_consensus_vsearch	603	A	A	254	1	0.39%	2	1	93	93	0.4999999999999138	1	1	106	148	1	0	-C
barcode89_consensus_vsearch	604	C	C	256	2	0.78%	2	2	93	93	0.24951456310670525	1	1	107	149	1	1	-T
barcode89_consensus_vsearch	605	T	T	254	2	0.78%	2	2	93	93	0.2495107632092758	1	1	107	147	1	1	C
barcode89_consensus_vsearch	606	A	A	258	1	0.39%	2	1	93	93	0.4999999999999138	1	1	108	150	1	0	T
barcode89_consensus_vsearch	607	A	A	252	4	1.54%	2	2	93	93	0.06176686569346045	1	1	103	149	3	1	-C
barcode89_consensus_vsearch	608	C	C	250	4	1.57%	2	2	93	93	0.061761087351402955	1	1	104	146	1	3	+T
barcode89_consensus_vsearch	609	C	C	257	1	0.39%	2	1	93	93	0.4999999999999138	1	1	107	150	1	0	T
barcode89_consensus_vsearch	610	C	C	259	0	0%	2	0	93	0	1.0	1	0	109	150	0	0	
barcode89_consensus_vsearch	611	A	A	256	2	0.77%	2	2	93	93	0.24951456310670525	1	1	107	149	1	1	G
barcode89_consensus_vsearch	612	T	T	258	1	0.39%	2	1	93	93	0.4999999999999138	1	1	108	150	1	0	C
barcode89_consensus_vsearch	613	G	G	259	0	0%	2	0	93	0	1.0	1	0	109	150	0	0	
barcode89_consensus_vsearch	614	T	T	255	3	1.16%	2	1	93	93	0.1242718446601877	1	1	106	149	3	0	-C
barcode89_consensus_vsearch	615	C	C	256	0	0%	2	0	93	0	1.0	1	0	106	150	0	0	
barcode89_consensus_vsearch	616	C	C	258	1	0.39%	2	1	93	93	0.4999999999999138	1	1	109	149	0	1	+GC
barcode89_consensus_vsearch	617	A	A	258	1	0.39%	2	1	93	93	0.4999999999999138	1	1	108	150	1	0	G
barcode89_consensus_vsearch	618	A	A	256	2	0.77%	2	2	93	93	0.24951456310670525	1	1	108	148	1	1	G
barcode89_consensus_vsearch	619	C	C	256	1	0.39%	2	1	93	93	0.4999999999999138	1	1	109	147	0	1	-T
barcode89_consensus_vsearch	620	T	T	256	1	0.39%	2	1	93	93	0.4999999999999138	1	1	109	147	0	1	-G
barcode89_consensus_vsearch	621	G	G	258	0	0%	2	0	93	0	1.0	1	0	109	149	0	0	
barcode89_consensus_vsearch	622	C	C	259	0	0%	2	0	93	0	1.0	1	0	109	150	0	0	
barcode89_consensus_vsearch	623	T	T	254	5	1.93%	2	2	93	93	0.030647311787538743	1	1	108	146	1	4	C
barcode89_consensus_vsearch	624	G	G	257	2	0.77%	2	1	93	93	0.24951644100587136	1	1	107	150	2	0	A
barcode89_consensus_vsearch	625	T	T	258	1	0.39%	2	1	93	93	0.4999999999999138	1	1	109	149	0	1	+C
barcode89_consensus_vsearch	626	T	T	255	1	0.39%	2	1	93	93	0.4999999999999138	1	1	108	147	0	1	+C
barcode89_consensus_vsearch	627	C	C	252	3	1.16%	2	1	93	93	0.12426326129665838	1	1	106	146	0	3	+T
barcode89_consensus_vsearch	628	A	*/-CA	237	15	5.86%	2	2	93	93	2.4625121800809766E-5	1	1	90	147	14	1	-CA
barcode89_consensus_vsearch	629	C	C	239	1	0.41%	2	1	93	93	0.4999999999999138	1	1	93	146	0	1	+G
barcode89_consensus_vsearch	630	A	A	242	1	0.41%	2	1	93	93	0.4999999999999138	1	1	93	149	1	0	G
barcode89_consensus_vsearch	631	T	T	256	2	0.77%	2	1	93	93	0.24951456310670525	1	1	109	147	0	2	-G
barcode89_consensus_vsearch	632	G	G	256	1	0.39%	2	1	93	93	0.4999999999999138	1	1	108	148	1	0	+TG
barcode89_consensus_vsearch	633	G	G	256	1	0.39%	2	1	93	93	0.4999999999999138	1	1	109	147	0	1	+A
barcode89_consensus_vsearch	634	A	A	256	1	0.39%	2	1	93	93	0.4999999999999138	1	1	109	147	0	1	+CA
barcode89_consensus_vsearch	635	A	A	255	1	0.39%	2	1	93	93	0.4999999999999138	1	1	107	148	0	1	+C
barcode89_consensus_vsearch	636	C	C	255	3	1.16%	2	2	93	93	0.1242718446601877	1	1	107	148	1	2	T
barcode89_consensus_vsearch	637	C	*/-T	243	10	3.86%	2	2	93	93	8.91940019333984E-4	1	1	106	137	1	9	-T
barcode89_consensus_vsearch	638	T	T	248	1	0.4%	2	1	93	93	0.4999999999999138	1	1	107	141	1	0	C
barcode89_consensus_vsearch	639	T	T	257	1	0.39%	2	1	93	93	0.4999999999999138	1	1	109	148	0	1	+C
barcode89_consensus_vsearch	640	T	*/-C	213	33	12.74%	2	2	93	93	3.6860137745867677E-11	1	1	97	116	9	24	-C
barcode89_consensus_vsearch	641	C	C	220	1	0.45%	2	1	93	93	0.4999999999999138	1	1	100	120	0	1	T
barcode89_consensus_vsearch	642	C	C	253	1	0.39%	2	1	93	93	0.5000000000003686	1	1	109	144	0	1	A
barcode89_consensus_vsearch	643	C	C	254	3	1.16%	2	2	93	93	0.12426900584791233	1	1	108	146	1	2	+T
barcode89_consensus_vsearch	644	C	C	251	5	1.93%	2	2	93	93	0.03064025621010106	1	1	105	146	1	4	T
barcode89_consensus_vsearch	645	A	A	253	2	0.78%	2	1	93	93	0.24950884086425928	1	1	105	148	0	2	G
barcode89_consensus_vsearch	646	C	C	255	1	0.39%	2	1	93	93	0.4999999999999138	1	1	105	150	1	0	+T
barcode89_consensus_vsearch	647	T	T	256	1	0.39%	2	1	93	93	0.4999999999999138	1	1	106	150	1	0	G
barcode89_consensus_vsearch	648	T	T	247	6	2.33%	2	2	93	93	0.015163657292611031	1	1	102	145	5	1	+C
barcode89_consensus_vsearch	649	C	C	258	1	0.39%	2	1	93	93	0.4999999999999138	1	1	108	150	1	0	A
barcode89_consensus_vsearch	650	A	A	253	3	1.16%	2	2	93	93	0.124266144814075	1	1	107	146	2	1	G
barcode89_consensus_vsearch	651	G	G	259	0	0%	2	0	93	0	1.0	1	0	109	150	0	0	
barcode89_consensus_vsearch	652	T	T	253	6	2.32%	2	2	93	93	0.01517430252249324	1	1	108	145	1	5	+C
barcode89_consensus_vsearch	653	C	C	258	1	0.39%	2	1	93	93	0.4999999999999138	1	1	108	150	1	0	+T
barcode89_consensus_vsearch	654	C	C	257	1	0.39%	2	1	93	93	0.4999999999999138	1	1	108	149	0	1	-T
barcode89_consensus_vsearch	655	T	T	255	2	0.78%	2	2	93	93	0.2495126705651419	1	1	107	148	1	1	C
barcode89_consensus_vsearch	656	C	C	246	5	1.93%	2	1	93	93	0.03062812251247695	1	1	101	145	5	0	+A
barcode89_consensus_vsearch	657	A	A	249	3	1.19%	2	1	93	93	0.12425447316115633	1	1	103	146	3	0	G
barcode89_consensus_vsearch	658	A	A	255	1	0.39%	2	1	93	93	0.4999999999999138	1	1	108	147	0	1	G
barcode89_consensus_vsearch	659	A	A	257	1	0.39%	2	1	93	93	0.4999999999999138	1	1	109	148	0	1	-G
barcode89_consensus_vsearch	660	G	G	257	1	0.39%	2	1	93	93	0.4999999999999138	1	1	108	149	1	0	+AAG
barcode89_consensus_vsearch	661	T	T	255	3	1.16%	2	1	93	93	0.1242718446601877	1	1	109	146	0	3	C
barcode89_consensus_vsearch	662	T	T	255	2	0.77%	2	1	93	93	0.2495126705651419	1	1	108	147	0	2	+C
barcode89_consensus_vsearch	663	C	C	256	1	0.39%	2	1	93	93	0.4999999999999138	1	1	109	147	0	1	+T
barcode89_consensus_vsearch	664	T	T	255	1	0.39%	2	1	93	93	0.4999999999999138	1	1	108	147	1	0	+C
barcode89_consensus_vsearch	665	C	C	257	1	0.39%	2	1	93	93	0.4999999999999138	1	1	109	148	0	1	T
barcode89_consensus_vsearch	666	A	A	255	3	1.16%	2	1	93	93	0.1242718446601877	1	1	106	149	3	0	-T
barcode89_consensus_vsearch	667	T	T	253	3	1.17%	2	1	93	93	0.124266144814075	1	1	106	147	0	3	C
barcode89_consensus_vsearch	668	T	T	257	2	0.77%	2	2	93	93	0.24951644100587136	1	1	108	149	1	1	C
barcode89_consensus_vsearch	669	T	T	258	1	0.39%	2	1	93	93	0.4999999999999138	1	1	108	150	1	0	-G
barcode89_consensus_vsearch	670	G	G	254	4	1.55%	2	1	93	93	0.06177255436325217	1	1	104	150	4	0	-A
barcode89_consensus_vsearch	671	A	A	250	3	1.18%	2	1	93	93	0.12425742574263329	1	1	100	150	3	0	-G
barcode89_consensus_vsearch	672	G	G	254	1	0.39%	2	1	93	93	0.4999999999999138	1	1	105	149	0	1	-T
barcode89_consensus_vsearch	673	T	T	254	2	0.78%	2	1	93	93	0.2495107632092758	1	1	106	148	2	0	-A
barcode89_consensus_vsearch	674	A	A	253	3	1.17%	2	2	93	93	0.124266144814075	1	1	105	148	2	1	-T
barcode89_consensus_vsearch	675	T	T	253	2	0.78%	2	1	93	93	0.24950884086425928	1	1	105	148	2	0	G
barcode89_consensus_vsearch	676	T	T	258	1	0.39%	2	1	93	93	0.4999999999999138	1	1	109	149	0	1	G
barcode89_consensus_vsearch	677	T	T	255	2	0.77%	2	2	93	93	0.2495126705651419	1	1	107	148	1	1	C
barcode89_consensus_vsearch	678	G	G	255	1	0.39%	2	1	93	93	0.4999999999999138	1	1	106	149	0	1	+C
barcode89_consensus_vsearch	679	C	C	250	4	1.56%	2	1	93	93	0.061761087351402955	1	1	104	146	0	4	T
barcode89_consensus_vsearch	680	T	T	253	1	0.39%	2	1	93	93	0.5000000000003686	1	1	105	148	0	1	+GCT
barcode89_consensus_vsearch	681	A	A	254	2	0.78%	2	1	93	93	0.2495107632092758	1	1	104	150	2	0	C
barcode89_consensus_vsearch	682	C	C	256	1	0.39%	2	1	93	93	0.4999999999999138	1	1	107	149	1	0	+AC
barcode89_consensus_vsearch	683	T	T	253	3	1.17%	2	2	93	93	0.124266144814075	1	1	105	148	2	1	C
barcode89_consensus_vsearch	684	A	A	257	0	0%	2	0	93	0	1.0	1	0	107	150	0	0	
barcode89_consensus_vsearch	685	C	C	255	1	0.39%	2	1	93	93	0.4999999999999138	1	1	108	147	0	1	+T
barcode89_consensus_vsearch	686	C	C	251	4	1.54%	2	2	93	93	0.06176398786346276	1	1	104	147	1	3	T
barcode89_consensus_vsearch	687	A	A	249	4	1.57%	2	1	93	93	0.06175816388801474	1	1	99	150	4	0	-CCA
barcode89_consensus_vsearch	688	C	C	247	3	1.19%	2	1	93	93	0.12424849699405838	1	1	99	148	3	0	G
barcode89_consensus_vsearch	689	C	C	247	4	1.57%	2	2	93	93	0.061752247008950906	1	1	102	145	1	3	T
barcode89_consensus_vsearch	690	A	A	251	1	0.4%	2	1	93	93	0.5000000000003686	1	1	103	148	0	1	G
barcode89_consensus_vsearch	691	A	A	257	1	0.39%	2	1	93	93	0.4999999999999138	1	1	109	148	0	1	G
barcode89_consensus_vsearch	692	G	G	257	1	0.39%	2	1	93	93	0.4999999999999138	1	1	109	148	0	1	+C
barcode89_consensus_vsearch	693	A	A	253	4	1.55%	2	2	93	93	0.0617697211064687	1	1	107	146	2	2	G
barcode89_consensus_vsearch	694	T	T	256	2	0.77%	2	1	93	93	0.24951456310670525	1	1	108	148	0	2	-C
barcode89_consensus_vsearch	695	C	C	253	1	0.39%	2	1	93	93	0.5000000000003686	1	1	107	146	1	0	+G
barcode89_consensus_vsearch	696	T	T	253	2	0.78%	2	1	93	93	0.24950884086425928	1	1	108	145	0	2	-G
barcode89_consensus_vsearch	697	G	G	255	1	0.39%	2	1	93	93	0.4999999999999138	1	1	109	146	0	1	A
barcode89_consensus_vsearch	698	C	C	253	3	1.16%	2	1	93	93	0.124266144814075	1	1	107	146	0	3	T
barcode89_consensus_vsearch	699	A	A	251	3	1.17%	2	1	93	93	0.12426035502961323	1	1	103	148	3	0	G
barcode89_consensus_vsearch	700	C	C	252	2	0.79%	2	2	93	93	0.2495069033532105	1	1	105	147	1	1	-T
barcode89_consensus_vsearch	701	T	T	248	4	1.57%	2	2	93	93	0.061755217199896344	1	1	104	144	1	3	+C
barcode89_consensus_vsearch	702	A	A	249	2	0.79%	2	2	93	93	0.24950099800389156	1	1	104	145	1	1	+G
barcode89_consensus_vsearch	703	G	G	251	3	1.17%	2	1	93	93	0.12426035502961323	1	1	104	147	3	0	-A
barcode89_consensus_vsearch	704	A	A	243	6	2.35%	2	2	93	93	0.015156276648152922	1	1	99	144	3	3	G
barcode89_consensus_vsearch	705	G	G	253	0	0%	2	0	93	0	1.0	1	0	106	147	0	0	
barcode89_consensus_vsearch	706	G	G	254	1	0.39%	2	1	93	93	0.4999999999999138	1	1	107	147	1	0	+C
barcode89_consensus_vsearch	707	C	C	254	2	0.78%	2	1	93	93	0.2495107632092758	1	1	108	146	0	2	T
barcode89_consensus_vsearch	708	T	T	253	3	1.16%	2	2	93	93	0.124266144814075	1	1	106	147	1	2	C
barcode89_consensus_vsearch	709	G	G	254	2	0.77%	2	1	93	93	0.2495107632092758	1	1	105	149	2	0	T
barcode89_consensus_vsearch	710	T	T	256	1	0.39%	2	1	93	93	0.4999999999999138	1	1	108	148	0	1	+C
barcode89_consensus_vsearch	711	T	T	254	3	1.16%	2	2	93	93	0.12426900584791233	1	1	105	149	2	1	C
barcode89_consensus_vsearch	712	C	C	254	3	1.16%	2	2	93	93	0.12426900584791233	1	1	106	148	1	2	-T
barcode89_consensus_vsearch	713	T	T	247	6	2.34%	2	1	93	93	0.015163657292611031	1	1	100	147	6	0	-AC
barcode89_consensus_vsearch	714	A	*/-C	227	19	7.54%	2	2	93	93	1.329073677768642E-6	1	1	95	132	3	16	-C
barcode89_consensus_vsearch	715	C	C	226	3	1.29%	2	1	93	93	0.12417943107231426	1	1	97	129	0	3	+T
barcode89_consensus_vsearch	716	C	S	246	7	2.72%	2	1	93	93	0.007490846702557751	1	1	99	147	7	0	G
barcode89_consensus_vsearch	717	C	*/-GG	216	21	8.11%	2	1	93	93	3.000511080365251E-7	1	1	108	108	0	21	-GG
barcode89_consensus_vsearch	718	G	R	210	13	5.75%	2	1	93	93	1.0196623731956113E-4	1	1	95	115	13	0	A
barcode89_consensus_vsearch	719	G	K	228	10	4.2%	2	1	93	93	8.867554066061573E-4	1	1	109	119	0	10	T
barcode89_consensus_vsearch	720	G	G	259	0	0%	2	0	93	0	1.0	1	0	109	150	0	0	
barcode89_consensus_vsearch	721	A	A	256	2	0.77%	2	1	93	93	0.24951456310670525	1	1	109	147	0	2	-T
barcode89_consensus_vsearch	722	T	T	254	1	0.39%	2	1	93	93	0.4999999999999138	1	1	108	146	1	0	-C
barcode89_consensus_vsearch	723	C	*/-A	235	18	7.03%	2	2	93	93	2.788743065390371E-6	1	1	90	145	17	1	-A
barcode89_consensus_vsearch	724	A	A	237	2	0.84%	2	2	93	93	0.24947589098518488	1	1	91	146	1	1	G
barcode89_consensus_vsearch	725	C	*/-T	232	21	8.17%	2	1	93	93	3.0935923960555286E-7	1	1	109	123	0	21	-T
barcode89_consensus_vsearch	726	T	*/-C	217	10	4.26%	2	2	93	93	8.825309402840407E-4	1	1	98	119	8	2	-C
barcode89_consensus_vsearch	727	C	C	244	1	0.41%	2	1	93	93	0.4999999999999138	1	1	100	144	0	1	T
barcode89_consensus_vsearch	728	C	C	257	0	0%	2	0	93	0	1.0	1	0	108	149	0	0	
barcode89_consensus_vsearch	729	C	C	247	5	1.93%	2	1	93	93	0.030630587731099716	1	1	105	142	0	5	T
barcode89_consensus_vsearch	730	A	A	244	3	1.19%	2	2	93	93	0.1242393509128018	1	1	101	143	2	1	G
barcode89_consensus_vsearch	731	A	A	248	4	1.56%	2	2	93	93	0.061755217199896344	1	1	105	143	2	2	-G
barcode89_consensus_vsearch	732	G	G	247	2	0.78%	2	1	93	93	0.24949698189118988	1	1	103	144	2	0	+A
barcode89_consensus_vsearch	733	G	G	256	2	0.77%	2	1	93	93	0.24951456310670525	1	1	107	149	2	0	A
barcode89_consensus_vsearch	734	C	C	253	2	0.77%	2	2	93	93	0.24950884086425928	1	1	107	146	1	1	-TT
barcode89_consensus_vsearch	735	T	T	253	2	0.78%	2	2	93	93	0.24950884086425928	1	1	106	147	1	1	C
barcode89_consensus_vsearch	736	T	T	252	2	0.78%	2	2	93	93	0.2495069033532105	1	1	106	146	1	1	+C
barcode89_consensus_vsearch	737	C	C	252	2	0.78%	2	2	93	93	0.2495069033532105	1	1	107	145	1	1	+A
barcode89_consensus_vsearch	738	G	G	257	2	0.77%	2	1	93	93	0.24951644100587136	1	1	107	150	2	0	A
barcode89_consensus_vsearch	739	T	T	256	3	1.16%	2	1	93	93	0.12427466150865948	1	1	109	147	0	3	C
barcode89_consensus_vsearch	740	C	C	254	2	0.77%	2	1	93	93	0.2495107632092758	1	1	105	149	2	0	-ACA
barcode89_consensus_vsearch	741	A	A	254	1	0.39%	2	1	93	93	0.4999999999999138	1	1	106	148	0	1	-CA
barcode89_consensus_vsearch	742	C	C	249	4	1.56%	2	2	93	93	0.06175816388801474	1	1	104	145	1	3	-A
barcode89_consensus_vsearch	743	A	A	252	0	0%	2	0	93	0	1.0	1	0	106	146	0	0	
barcode89_consensus_vsearch	744	A	A	256	3	1.16%	2	2	93	93	0.12427466150865948	1	1	107	149	2	1	G
barcode89_consensus_vsearch	745	A	A	247	5	1.93%	2	2	93	93	0.030630587731099716	1	1	105	142	4	1	G
barcode89_consensus_vsearch	746	C	C	256	1	0.39%	2	1	93	93	0.4999999999999138	1	1	109	147	0	1	T
barcode89_consensus_vsearch	747	C	C	253	6	2.32%	2	1	93	93	0.01517430252249324	1	1	109	144	0	6	-TC
barcode89_consensus_vsearch	748	T	T	245	4	1.58%	2	2	93	93	0.061746234985649476	1	1	103	142	2	2	-C
barcode89_consensus_vsearch	749	C	C	245	1	0.41%	2	1	93	93	0.4999999999999138	1	1	103	142	1	0	T
barcode89_consensus_vsearch	750	C	C	250	2	0.78%	2	1	93	93	0.2495029821073759	1	1	103	147	2	0	-AC
barcode89_consensus_vsearch	751	A	A	248	2	0.79%	2	1	93	93	0.24949899799584363	1	1	101	147	2	0	G
barcode89_consensus_vsearch	752	C	C	253	1	0.39%	2	1	93	93	0.5000000000003686	1	1	106	147	0	1	+A
barcode89_consensus_vsearch	753	G	G	246	4	1.54%	2	1	93	93	0.061749253033287245	1	1	106	140	0	4	+T
barcode89_consensus_vsearch	754	C	Y	227	18	7.06%	2	2	93	93	2.7593030688563796E-6	1	1	107	120	1	17	T
barcode89_consensus_vsearch	755	C	*/-T	233	14	5.41%	2	1	93	93	5.050333075042182E-5	1	1	109	124	0	14	-T
barcode89_consensus_vsearch	756	T	T	228	5	2.04%	2	1	93	93	0.030580134234414084	1	1	109	119	0	5	C
barcode89_consensus_vsearch	757	G	G	250	3	1.17%	2	1	93	93	0.12425742574263329	1	1	108	142	0	3	+TG
barcode89_consensus_vsearch	758	C	C	253	1	0.39%	2	1	93	93	0.5000000000003686	1	1	109	144	0	1	+A
barcode89_consensus_vsearch	759	C	C	251	1	0.39%	2	1	93	93	0.5000000000003686	1	1	107	144	0	1	+AC
barcode89_consensus_vsearch	760	T	T	252	2	0.78%	2	1	93	93	0.2495069033532105	1	1	106	146	2	0	-A
barcode89_consensus_vsearch	761	A	A	250	2	0.78%	2	1	93	93	0.2495029821073759	1	1	103	147	2	0	G
barcode89_consensus_vsearch	762	C	C	251	5	1.95%	2	2	93	93	0.03064025621010106	1	1	106	145	1	4	-T
barcode89_consensus_vsearch	763	T	T	247	6	2.37%	2	1	93	93	0.015163657292611031	1	1	108	139	0	6	-C
barcode89_consensus_vsearch	764	C	C	242	4	1.59%	2	1	93	93	0.061737033473691375	1	1	104	138	0	4	+TC
barcode89_consensus_vsearch	765	G	G	247	3	1.17%	2	2	93	93	0.12424849699405838	1	1	104	143	2	1	A
barcode89_consensus_vsearch	766	C	C	250	3	1.17%	2	1	93	93	0.12425742574263329	1	1	105	145	3	0	A
barcode89_consensus_vsearch	767	T	T	257	1	0.39%	2	1	93	93	0.4999999999999138	1	1	108	149	1	0	+C
barcode89_consensus_vsearch	768	C	C	256	1	0.39%	2	1	93	93	0.4999999999999138	1	1	108	148	0	1	+G
barcode89_consensus_vsearch	769	G	G	257	1	0.39%	2	1	93	93	0.4999999999999138	1	1	108	149	1	0	-A
barcode89_consensus_vsearch	770	A	A	253	2	0.78%	2	2	93	93	0.24950884086425928	1	1	104	149	1	1	G
barcode89_consensus_vsearch	771	G	G	257	1	0.39%	2	1	93	93	0.4999999999999138	1	1	107	150	1	0	+A
barcode89_consensus_vsearch	772	C	C	258	1	0.39%	2	1	93	93	0.4999999999999138	1	1	109	149	0	1	T
barcode89_consensus_vsearch	773	A	*/-T	250	8	3.09%	2	1	93	93	0.0036969641636293116	1	1	108	142	0	8	-T
barcode89_consensus_vsearch	774	T	T	248	3	1.2%	2	1	93	93	0.12425149700602607	1	1	109	139	0	3	C
barcode89_consensus_vsearch	775	C	C	258	1	0.39%	2	1	93	93	0.4999999999999138	1	1	108	150	1	0	+A
barcode89_consensus_vsearch	776	G	R	244	8	3.09%	2	1	93	93	0.0036920468013430033	1	1	97	147	8	0	A
barcode89_consensus_vsearch	777	T	T	254	5	1.93%	2	2	93	93	0.030647311787538743	1	1	107	147	2	3	C
barcode89_consensus_vsearch	778	T	T	258	1	0.39%	2	1	93	93	0.4999999999999138	1	1	109	149	0	1	+C
barcode89_consensus_vsearch	779	T	T	250	6	2.32%	2	2	93	93	0.015169042029074849	1	1	106	144	3	3	-C
barcode89_consensus_vsearch	780	C	C	249	2	0.79%	2	1	93	93	0.24950099800389156	1	1	105	144	0	2	-T
barcode89_consensus_vsearch	781	T	T	245	6	2.34%	2	1	93	93	0.015159996253657923	1	1	99	146	6	0	-ACT
barcode89_consensus_vsearch	782	A	A	248	1	0.4%	2	1	93	93	0.4999999999999138	1	1	99	149	0	1	+C
barcode89_consensus_vsearch	783	C	C	247	4	1.59%	2	1	93	93	0.061752247008950906	1	1	101	146	0	4	-T
barcode89_consensus_vsearch	784	T	*/-C	202	43	17.34%	2	1	93	93	1.5067333673858777E-14	1	1	99	103	0	43	-C
barcode89_consensus_vsearch	785	C	C	207	3	1.4%	2	1	93	93	0.12410501193315207	1	1	108	99	0	3	+TC
barcode89_consensus_vsearch	786	G	G	256	1	0.39%	2	1	93	93	0.4999999999999138	1	1	107	149	1	0	+AAG
barcode89_consensus_vsearch	787	A	A	253	3	1.16%	2	2	93	93	0.124266144814075	1	1	106	147	2	1	-G
barcode89_consensus_vsearch	788	G	G	256	0	0%	2	0	93	0	1.0	1	0	107	149	0	0	
barcode89_consensus_vsearch	789	C	C	254	3	1.16%	2	1	93	93	0.12426900584791233	1	1	109	145	0	3	T
barcode89_consensus_vsearch	790	G	G	255	2	0.77%	2	1	93	93	0.2495126705651419	1	1	108	147	0	2	T
barcode89_consensus_vsearch	791	G	G	258	1	0.39%	2	1	93	93	0.4999999999999138	1	1	108	150	1	0	T
barcode89_consensus_vsearch	792	T	T	253	4	1.54%	2	2	93	93	0.0617697211064687	1	1	107	146	1	3	C
barcode89_consensus_vsearch	793	G	G	258	1	0.39%	2	1	93	93	0.4999999999999138	1	1	108	150	1	0	A
barcode89_consensus_vsearch	794	G	*/-A	250	8	3.09%	2	1	93	93	0.0036969641636293116	1	1	100	150	8	0	-A
barcode89_consensus_vsearch	795	A	A	248	2	0.8%	2	2	93	93	0.24949899799584363	1	1	99	149	1	1	G
barcode89_consensus_vsearch	796	G	G	254	3	1.16%	2	1	93	93	0.12426900584791233	1	1	107	147	0	3	-T
barcode89_consensus_vsearch	797	T	T	247	3	1.17%	2	1	93	93	0.12424849699405838	1	1	106	141	0	3	C
barcode89_consensus_vsearch	798	A	A	248	4	1.54%	2	1	93	93	0.061755217199896344	1	1	107	141	0	4	-TG
barcode89_consensus_vsearch	799	T	T	242	4	1.58%	2	1	93	93	0.061737033473691375	1	1	104	138	0	4	A
barcode89_consensus_vsearch	800	G	R	237	12	4.76%	2	2	93	93	2.131655349948094E-4	1	1	95	142	11	1	A
barcode89_consensus_vsearch	801	G	G	250	4	1.55%	2	1	93	93	0.061761087351402955	1	1	102	148	4	0	+A
barcode89_consensus_vsearch	802	G	G	259	0	0%	2	0	93	0	1.0	1	0	109	150	0	0	
barcode89_consensus_vsearch	803	T	T	254	4	1.54%	2	2	93	93	0.06177255436325217	1	1	108	146	1	3	C
barcode89_consensus_vsearch	804	A	A	253	3	1.16%	2	2	93	93	0.124266144814075	1	1	107	146	2	1	G
barcode89_consensus_vsearch	805	C	C	251	3	1.16%	2	2	93	93	0.12426035502961323	1	1	108	143	1	2	-T
barcode89_consensus_vsearch	806	T	T	252	1	0.39%	2	1	93	93	0.5000000000003686	1	1	108	144	0	1	+AAT
barcode89_consensus_vsearch	807	A	A	256	1	0.39%	2	1	93	93	0.4999999999999138	1	1	108	148	1	0	-C
barcode89_consensus_vsearch	808	C	C	248	4	1.56%	2	1	93	93	0.061755217199896344	1	1	101	147	4	0	-G
barcode89_consensus_vsearch	809	G	G	251	3	1.18%	2	1	93	93	0.12426035502961323	1	1	102	149	3	0	A
barcode89_consensus_vsearch	810	C	C	246	6	2.33%	2	2	93	93	0.01516183400716267	1	1	102	144	2	4	-T
barcode89_consensus_vsearch	811	T	T	245	2	0.81%	2	1	93	93	0.24949290060873971	1	1	100	145	2	0	C
barcode89_consensus_vsearch	812	T	T	241	5	1.97%	2	2	93	93	0.030615496107849846	1	1	99	142	2	3	-A
barcode89_consensus_vsearch	813	A	A	244	1	0.41%	2	1	93	93	0.4999999999999138	1	1	101	143	1	0	C
barcode89_consensus_vsearch	814	A	A	253	1	0.39%	2	1	93	93	0.5000000000003686	1	1	108	145	0	1	-G
barcode89_consensus_vsearch	815	G	G	255	1	0.39%	2	1	93	93	0.4999999999999138	1	1	108	147	0	1	+C
barcode89_consensus_vsearch	816	C	C	255	2	0.78%	2	1	93	93	0.2495126705651419	1	1	109	146	0	2	+T
barcode89_consensus_vsearch	817	G	G	255	1	0.39%	2	1	93	93	0.4999999999999138	1	1	108	147	0	1	+C
barcode89_consensus_vsearch	818	C	C	254	2	0.78%	2	2	93	93	0.2495107632092758	1	1	107	147	1	1	T
barcode89_consensus_vsearch	819	C	C	257	1	0.39%	2	1	93	93	0.4999999999999138	1	1	109	148	0	1	T
barcode89_consensus_vsearch	820	A	A	256	1	0.39%	2	1	93	93	0.4999999999999138	1	1	108	148	0	1	+TTA
barcode89_consensus_vsearch	821	T	T	254	4	1.54%	2	1	93	93	0.06177255436325217	1	1	104	150	4	0	-C
barcode89_consensus_vsearch	822	C	C	254	1	0.39%	2	1	93	93	0.4999999999999138	1	1	104	150	1	0	T
barcode89_consensus_vsearch	823	C	C	258	1	0.39%	2	1	93	93	0.4999999999999138	1	1	109	149	0	1	+G
barcode89_consensus_vsearch	824	A	*/-T	214	34	13.13%	2	2	93	93	1.7287484494063694E-11	1	1	69	145	31	3	-T
barcode89_consensus_vsearch	825	T	T	222	2	0.89%	2	1	93	93	0.24944071588395061	1	1	78	144	0	2	C
barcode89_consensus_vsearch	826	T	T	257	1	0.39%	2	1	93	93	0.4999999999999138	1	1	109	148	0	1	C
barcode89_consensus_vsearch	827	T	T	254	3	1.16%	2	1	93	93	0.12426900584791233	1	1	109	145	0	3	C
barcode89_consensus_vsearch	828	T	T	258	1	0.39%	2	1	93	93	0.4999999999999138	1	1	108	150	1	0	C
barcode89_consensus_vsearch	829	C	C	256	1	0.39%	2	1	93	93	0.4999999999999138	1	1	108	148	0	1	+TTC
barcode89_consensus_vsearch	830	A	A	242	6	2.33%	2	2	93	93	0.015154394442017034	1	1	103	139	1	5	+G
barcode89_consensus_vsearch	831	G	G	253	1	0.39%	2	1	93	93	0.5000000000003686	1	1	108	145	0	1	A
barcode89_consensus_vsearch	832	G	G	258	1	0.39%	2	1	93	93	0.4999999999999138	1	1	108	150	1	0	A
barcode89_consensus_vsearch	833	G	G	256	1	0.39%	2	1	93	93	0.4999999999999138	1	1	107	149	1	0	+C
barcode89_consensus_vsearch	834	C	C	256	2	0.77%	2	2	93	93	0.24951456310670525	1	1	107	149	1	1	T
barcode89_consensus_vsearch	835	T	T	253	2	0.78%	2	1	93	93	0.24950884086425928	1	1	106	147	2	0	C
barcode89_consensus_vsearch	836	A	A	256	1	0.39%	2	1	93	93	0.4999999999999138	1	1	108	148	0	1	-G
barcode89_consensus_vsearch	837	G	G	255	2	0.78%	2	1	93	93	0.2495126705651419	1	1	109	146	0	2	A
barcode89_consensus_vsearch	838	T	T	253	4	1.55%	2	1	93	93	0.0617697211064687	1	1	109	144	0	4	+C
barcode89_consensus_vsearch	839	T	T	251	6	2.32%	2	1	93	93	0.015170809117680038	1	1	108	143	0	6	-C
barcode89_consensus_vsearch	840	C	C	252	1	0.4%	2	1	93	93	0.5000000000003686	1	1	109	143	0	1	+T
barcode89_consensus_vsearch	841	A	A	259	0	0%	2	0	93	0	1.0	1	0	109	150	0	0	
barcode89_consensus_vsearch	842	T	T	255	4	1.54%	2	1	93	93	0.06177536572082746	1	1	109	146	0	4	+C
barcode89_consensus_vsearch	843	T	T	250	5	1.93%	2	1	93	93	0.030637867497453432	1	1	109	141	0	5	-C
barcode89_consensus_vsearch	844	C	C	254	0	0%	2	0	93	0	1.0	1	0	109	145	0	0	
barcode89_consensus_vsearch	845	G	G	258	1	0.39%	2	1	93	93	0.4999999999999138	1	1	109	149	0	1	T
barcode89_consensus_vsearch	846	G	G	259	0	0%	2	0	93	0	1.0	1	0	109	150	0	0	
barcode89_consensus_vsearch	847	C	C	256	2	0.77%	2	1	93	93	0.24951456310670525	1	1	106	150	2	0	+G
barcode89_consensus_vsearch	848	A	A	255	2	0.77%	2	1	93	93	0.2495126705651419	1	1	107	148	2	0	G
barcode89_consensus_vsearch	849	G	G	256	2	0.78%	2	1	93	93	0.24951456310670525	1	1	107	149	2	0	A
barcode89_consensus_vsearch	850	G	G	256	2	0.78%	2	1	93	93	0.24951456310670525	1	1	107	149	2	0	T
barcode89_consensus_vsearch	851	T	T	257	1	0.39%	2	1	93	93	0.4999999999999138	1	1	109	148	0	1	C
barcode89_consensus_vsearch	852	G	G	257	1	0.39%	2	1	93	93	0.4999999999999138	1	1	107	150	1	0	+A
barcode89_consensus_vsearch	853	A	A	255	3	1.16%	2	1	93	93	0.1242718446601877	1	1	106	149	3	0	+G
barcode89_consensus_vsearch	854	G	G	251	2	0.78%	2	2	93	93	0.24950495049494414	1	1	104	147	1	1	+T
barcode89_consensus_vsearch	855	T	T	256	1	0.39%	2	1	93	93	0.4999999999999138	1	1	108	148	1	0	C
barcode89_consensus_vsearch	856	T	T	257	2	0.77%	2	1	93	93	0.24951644100587136	1	1	109	148	0	2	C
barcode89_consensus_vsearch	857	G	G	258	1	0.39%	2	1	93	93	0.4999999999999138	1	1	108	150	1	0	+T
barcode89_consensus_vsearch	858	T	T	253	3	1.16%	2	1	93	93	0.124266144814075	1	1	107	146	0	3	C
barcode89_consensus_vsearch	859	T	T	255	2	0.77%	2	2	93	93	0.2495126705651419	1	1	107	148	1	1	C
barcode89_consensus_vsearch	860	A	A	252	5	1.94%	2	2	93	93	0.030642626352771006	1	1	107	145	1	4	G
barcode89_consensus_vsearch	861	C	C	256	1	0.39%	2	1	93	93	0.4999999999999138	1	1	108	148	0	1	T
barcode89_consensus_vsearch	862	A	*/-CA	230	23	8.91%	2	2	93	93	7.062784514333123E-8	1	1	86	144	20	3	-CA
barcode89_consensus_vsearch	863	C	C	231	2	0.85%	2	2	93	93	0.24946236559140877	1	1	88	143	1	1	-AT
barcode89_consensus_vsearch	864	A	A	227	3	1.28%	2	2	93	93	0.12418300653593844	1	1	84	143	1	2	-T
barcode89_consensus_vsearch	865	T	T	254	0	0%	2	0	93	0	1.0	1	0	107	147	0	0	
barcode89_consensus_vsearch	866	T	*/-C	248	7	2.7%	2	2	93	93	0.007493349252391194	1	1	103	145	4	3	-C
barcode89_consensus_vsearch	867	C	C	249	1	0.4%	2	1	93	93	0.5000000000003686	1	1	103	146	1	0	+A
barcode89_consensus_vsearch	868	C	C	249	4	1.54%	2	2	93	93	0.06175816388801474	1	1	107	142	1	3	-T
barcode89_consensus_vsearch	869	T	T	249	2	0.79%	2	1	93	93	0.24950099800389156	1	1	105	144	2	0	A
barcode89_consensus_vsearch	870	T	T	252	4	1.55%	2	2	93	93	0.06176686569346045	1	1	107	145	1	3	C
barcode89_consensus_vsearch	871	A	A	256	2	0.77%	2	2	93	93	0.24951456310670525	1	1	108	148	1	1	G
barcode89_consensus_vsearch	872	G	G	256	1	0.39%	2	1	93	93	0.4999999999999138	1	1	108	148	0	1	-CGG
barcode89_consensus_vsearch	873	C	C	250	5	1.94%	2	1	93	93	0.030637867497453432	1	1	109	141	0	5	-G
barcode89_consensus_vsearch	874	G	G	253	0	0%	2	0	93	0	1.0	1	0	109	144	0	0	
barcode89_consensus_vsearch	875	G	G	258	0	0%	2	0	93	0	1.0	1	0	109	149	0	0	
barcode89_consensus_vsearch	876	A	A	253	3	1.16%	2	1	93	93	0.124266144814075	1	1	108	145	0	3	G
barcode89_consensus_vsearch	877	T	T	254	2	0.78%	2	1	93	93	0.2495107632092758	1	1	109	145	0	2	+C
barcode89_consensus_vsearch	878	T	T	250	3	1.17%	2	1	93	93	0.12425742574263329	1	1	106	144	0	3	-C
barcode89_consensus_vsearch	879	C	C	255	1	0.39%	2	1	93	93	0.4999999999999138	1	1	108	147	1	0	+A
barcode89_consensus_vsearch	880	C	C	248	4	1.54%	2	2	93	93	0.061755217199896344	1	1	106	142	2	2	T
barcode89_consensus_vsearch	881	G	G	257	2	0.77%	2	1	93	93	0.24951644100587136	1	1	107	150	2	0	A
barcode89_consensus_vsearch	882	A	A	256	1	0.39%	2	1	93	93	0.4999999999999138	1	1	107	149	1	0	+G
barcode89_consensus_vsearch	883	C	*/-T	248	9	3.47%	2	2	93	93	0.0018188615104327871	1	1	106	142	2	7	-T
barcode89_consensus_vsearch	884	T	T	241	4	1.61%	2	2	93	93	0.06173391617646867	1	1	103	138	2	2	C
barcode89_consensus_vsearch	885	T	*/-C	246	7	2.71%	2	2	93	93	0.007490846702557751	1	1	103	143	2	5	-C
barcode89_consensus_vsearch	886	C	C	245	2	0.8%	2	2	93	93	0.24949290060873971	1	1	104	141	1	1	G
barcode89_consensus_vsearch	887	C	C	253	2	0.78%	2	2	93	93	0.24950884086425928	1	1	105	148	1	1	-AT
barcode89_consensus_vsearch	888	A	A	254	2	0.78%	2	1	93	93	0.2495107632092758	1	1	105	149	2	0	T
barcode89_consensus_vsearch	889	T	T	255	1	0.39%	2	1	93	93	0.4999999999999138	1	1	106	149	1	0	+C
barcode89_consensus_vsearch	890	G	G	254	5	1.93%	2	1	93	93	0.030647311787538743	1	1	104	150	5	0	A
barcode89_consensus_vsearch	891	G	G	258	1	0.39%	2	1	93	93	0.4999999999999138	1	1	108	150	1	0	C
barcode89_consensus_vsearch	892	C	C	258	1	0.39%	2	1	93	93	0.4999999999999138	1	1	108	150	1	0	+T
barcode89_consensus_vsearch	893	C	C	255	2	0.77%	2	1	93	93	0.2495126705651419	1	1	106	149	2	0	T
barcode89_consensus_vsearch	894	A	A	254	2	0.78%	2	1	93	93	0.2495107632092758	1	1	107	147	0	2	G
barcode89_consensus_vsearch	895	C	C	257	1	0.39%	2	1	93	93	0.4999999999999138	1	1	108	149	0	1	A
barcode89_consensus_vsearch	896	C	C	252	4	1.54%	2	2	93	93	0.06176686569346045	1	1	106	146	1	3	T
barcode89_consensus_vsearch	897	G	G	256	2	0.77%	2	1	93	93	0.24951456310670525	1	1	106	150	2	0	A
barcode89_consensus_vsearch	898	T	T	249	5	1.94%	2	1	93	93	0.03063545999571253	1	1	99	150	5	0	+C
barcode89_consensus_vsearch	899	C	C	254	1	0.39%	2	1	93	93	0.4999999999999138	1	1	104	150	1	0	T
barcode89_consensus_vsearch	900	C	C	255	2	0.77%	2	1	93	93	0.2495126705651419	1	1	108	147	0	2	+T
barcode89_consensus_vsearch	901	T	Y	244	12	4.65%	2	1	93	93	2.1397620289108517E-4	1	1	108	136	0	12	C
barcode89_consensus_vsearch	902	G	G	255	2	0.78%	2	2	93	93	0.2495126705651419	1	1	107	148	1	1	-CTG
barcode89_consensus_vsearch	903	C	Y	230	25	9.73%	2	1	93	93	1.606117534181233E-8	1	1	107	123	0	25	T
barcode89_consensus_vsearch	904	T	T	253	2	0.78%	2	2	93	93	0.24950884086425928	1	1	106	147	1	1	A
barcode89_consensus_vsearch	905	G	*/+T	247	7	2.72%	2	1	93	93	0.00749210286352295	1	1	107	140	0	7	+T
barcode89_consensus_vsearch	906	T	T	258	0	0%	2	0	93	0	1.0	1	0	109	149	0	0	
barcode89_consensus_vsearch	907	C	C	252	6	2.32%	2	1	93	93	0.015172562563020547	1	1	108	144	0	6	-T
barcode89_consensus_vsearch	908	T	T	249	3	1.19%	2	2	93	93	0.12425447316115633	1	1	107	142	1	2	C
barcode89_consensus_vsearch	909	A	A	255	1	0.39%	2	1	93	93	0.4999999999999138	1	1	108	147	0	1	+CA
barcode89_consensus_vsearch	910	G	G	258	0	0%	2	0	93	0	1.0	1	0	109	149	0	0	
barcode89_consensus_vsearch	911	A	A	258	0	0%	2	0	93	0	1.0	1	0	109	149	0	0	
barcode89_consensus_vsearch	912	T	T	255	2	0.78%	2	1	93	93	0.2495126705651419	1	1	108	147	0	2	C
barcode89_consensus_vsearch	913	G	G	255	1	0.39%	2	1	93	93	0.4999999999999138	1	1	108	147	0	1	+CCAG
barcode89_consensus_vsearch	914	A	A	253	5	1.94%	2	2	93	93	0.030644978141142375	1	1	105	148	3	2	G
barcode89_consensus_vsearch	915	A	A	256	2	0.77%	2	2	93	93	0.24951456310670525	1	1	107	149	1	1	G
barcode89_consensus_vsearch	916	C	C	259	0	0%	2	0	93	0	1.0	1	0	109	150	0	0	
barcode89_consensus_vsearch	917	T	T	250	3	1.16%	2	2	93	93	0.12425742574263329	1	1	107	143	1	2	C
barcode89_consensus_vsearch	918	A	A	257	0	0%	2	0	93	0	1.0	1	0	108	149	0	0	
barcode89_consensus_vsearch	919	A	A	258	1	0.39%	2	1	93	93	0.4999999999999138	1	1	109	149	0	1	C
barcode89_consensus_vsearch	920	C	C	255	2	0.77%	2	1	93	93	0.2495126705651419	1	1	108	147	0	2	+A
barcode89_consensus_vsearch	921	A	A	256	1	0.39%	2	1	93	93	0.4999999999999138	1	1	108	148	0	1	+C
barcode89_consensus_vsearch	922	C	C	258	1	0.39%	2	1	93	93	0.4999999999999138	1	1	109	149	0	1	T
barcode89_consensus_vsearch	923	C	*/-T	198	36	13.9%	2	2	93	93	3.3852827773277148E-12	1	1	102	96	6	30	-T
barcode89_consensus_vsearch	924	T	T	213	0	0%	2	0	93	0	1.0	1	0	103	110	0	0	
barcode89_consensus_vsearch	925	T	T	248	1	0.4%	2	1	93	93	0.4999999999999138	1	1	109	139	0	1	C
barcode89_consensus_vsearch	926	T	T	255	3	1.16%	2	2	93	93	0.1242718446601877	1	1	107	148	2	1	C
barcode89_consensus_vsearch	927	T	T	256	2	0.77%	2	1	93	93	0.24951456310670525	1	1	108	148	0	2	C
barcode89_consensus_vsearch	928	G	G	258	1	0.39%	2	1	93	93	0.4999999999999138	1	1	108	150	1	0	-TG
barcode89_consensus_vsearch	929	T	T	255	2	0.78%	2	2	93	93	0.2495126705651419	1	1	107	148	1	1	C
barcode89_consensus_vsearch	930	G	G	255	2	0.78%	2	2	93	93	0.2495126705651419	1	1	106	149	1	1	A
barcode89_consensus_vsearch	931	G	G	257	1	0.39%	2	1	93	93	0.4999999999999138	1	1	108	149	0	1	C
barcode89_consensus_vsearch	932	T	T	257	1	0.39%	2	1	93	93	0.4999999999999138	1	1	108	149	0	1	-GT
barcode89_consensus_vsearch	933	G	G	255	2	0.78%	2	1	93	93	0.2495126705651419	1	1	109	146	0	2	+C
barcode89_consensus_vsearch	934	T	T	256	1	0.39%	2	1	93	93	0.4999999999999138	1	1	107	149	1	0	+C
barcode89_consensus_vsearch	935	C	C	259	0	0%	2	0	93	0	1.0	1	0	109	150	0	0	
barcode89_consensus_vsearch	936	T	T	248	5	1.93%	2	1	93	93	0.030633033482245435	1	1	107	141	0	5	+G
barcode89_consensus_vsearch	937	G	G	257	1	0.39%	2	1	93	93	0.4999999999999138	1	1	108	149	1	0	C
barcode89_consensus_vsearch	938	A	A	257	1	0.39%	2	1	93	93	0.4999999999999138	1	1	107	150	1	0	+C
barcode89_consensus_vsearch	939	T	T	255	1	0.39%	2	1	93	93	0.4999999999999138	1	1	107	148	1	0	+A
barcode89_consensus_vsearch	940	G	G	257	1	0.39%	2	1	93	93	0.4999999999999138	1	1	107	150	1	0	-A
barcode89_consensus_vsearch	941	A	A	252	5	1.94%	2	2	93	93	0.030642626352771006	1	1	104	148	4	1	-G
barcode89_consensus_vsearch	942	G	G	252	1	0.39%	2	1	93	93	0.5000000000003686	1	1	104	148	0	1	+T
barcode89_consensus_vsearch	943	C	C	252	3	1.16%	2	2	93	93	0.12426326129665838	1	1	105	147	1	2	T
barcode89_consensus_vsearch	944	G	G	252	3	1.16%	2	1	93	93	0.12426326129665838	1	1	106	146	0	3	-TAG
barcode89_consensus_vsearch	945	T	T	251	2	0.78%	2	1	93	93	0.24950495049494414	1	1	106	145	0	2	+GT
barcode89_consensus_vsearch	946	A	A	252	2	0.78%	2	1	93	93	0.2495069033532105	1	1	106	146	2	0	-G
barcode89_consensus_vsearch	947	G	G	253	1	0.39%	2	1	93	93	0.5000000000003686	1	1	106	147	1	0	+C
barcode89_consensus_vsearch	948	A	A	252	4	1.54%	2	2	93	93	0.06176686569346045	1	1	106	146	3	1	G
barcode89_consensus_vsearch	949	T	T	256	1	0.39%	2	1	93	93	0.4999999999999138	1	1	108	148	0	1	+C
barcode89_consensus_vsearch	950	T	T	254	3	1.16%	2	1	93	93	0.12426900584791233	1	1	106	148	3	0	-C
barcode89_consensus_vsearch	951	C	C	256	0	0%	2	0	93	0	1.0	1	0	106	150	0	0	
barcode89_consensus_vsearch	952	C	*/-G	241	12	4.63%	2	1	93	93	2.1363402075967646E-4	1	1	108	133	0	12	-G
barcode89_consensus_vsearch	953	G	G	243	1	0.41%	2	1	93	93	0.4999999999999138	1	1	107	136	0	1	+A
barcode89_consensus_vsearch	954	G	G	257	1	0.39%	2	1	93	93	0.4999999999999138	1	1	109	148	0	1	-C
barcode89_consensus_vsearch	955	C	C	255	1	0.39%	2	1	93	93	0.4999999999999138	1	1	109	146	0	1	+A
barcode89_consensus_vsearch	956	A	A	254	2	0.78%	2	2	93	93	0.2495107632092758	1	1	107	147	1	1	+C
barcode89_consensus_vsearch	957	C	C	257	1	0.39%	2	1	93	93	0.4999999999999138	1	1	108	149	0	1	T
barcode89_consensus_vsearch	958	C	*/-T	238	11	4.26%	2	2	93	93	4.3618325858222517E-4	1	1	107	131	1	10	-T
barcode89_consensus_vsearch	959	T	T	246	1	0.4%	2	1	93	93	0.5000000000003686	1	1	106	140	1	0	A
barcode89_consensus_vsearch	960	T	T	256	3	1.16%	2	2	93	93	0.12427466150865948	1	1	107	149	2	1	C
barcode89_consensus_vsearch	961	A	A	258	1	0.39%	2	1	93	93	0.4999999999999138	1	1	109	149	0	1	+CA
barcode89_consensus_vsearch	962	A	A	255	4	1.54%	2	1	93	93	0.06177536572082746	1	1	109	146	0	4	+C
barcode89_consensus_vsearch	963	C	*/-T	246	12	4.63%	2	1	93	93	2.1420009743898608E-4	1	1	109	137	0	12	-T
barcode89_consensus_vsearch	964	T	T	244	2	0.81%	2	1	93	93	0.24949083503056865	1	1	109	135	0	2	-C
barcode89_consensus_vsearch	965	C	C	254	2	0.78%	2	1	93	93	0.2495107632092758	1	1	109	145	0	2	T
barcode89_consensus_vsearch	966	C	C	250	3	1.16%	2	2	93	93	0.12425742574263329	1	1	103	147	2	1	-A
barcode89_consensus_vsearch	967	A	A	249	3	1.19%	2	2	93	93	0.12425447316115633	1	1	102	147	2	1	G
barcode89_consensus_vsearch	968	C	C	253	2	0.78%	2	1	93	93	0.24950884086425928	1	1	106	147	0	2	T
barcode89_consensus_vsearch	969	G	G	256	1	0.39%	2	1	93	93	0.4999999999999138	1	1	108	148	0	1	+T
barcode89_consensus_vsearch	970	T	T	255	3	1.16%	2	2	93	93	0.1242718446601877	1	1	108	147	1	2	C
barcode89_consensus_vsearch	971	T	T	254	5	1.93%	2	1	93	93	0.030647311787538743	1	1	104	150	5	0	+C
barcode89_consensus_vsearch	972	C	C	256	1	0.39%	2	1	93	93	0.4999999999999138	1	1	108	148	0	1	+G
barcode89_consensus_vsearch	973	G	G	256	1	0.39%	2	1	93	93	0.4999999999999138	1	1	108	148	1	0	A
barcode89_consensus_vsearch	974	G	G	258	1	0.39%	2	1	93	93	0.4999999999999138	1	1	109	149	0	1	+T
barcode89_consensus_vsearch	975	T	T	253	3	1.16%	2	2	93	93	0.124266144814075	1	1	108	145	1	2	C
barcode89_consensus_vsearch	976	T	T	254	2	0.77%	2	1	93	93	0.2495107632092758	1	1	108	146	0	2	-C
barcode89_consensus_vsearch	977	C	C	257	0	0%	2	0	93	0	1.0	1	0	109	148	0	0	
barcode89_consensus_vsearch	978	A	A	259	0	0%	2	0	93	0	1.0	1	0	109	150	0	0	
barcode89_consensus_vsearch	979	T	*/-C	237	14	5.41%	2	2	93	93	5.066027102584289E-5	1	1	91	146	12	2	-C
barcode89_consensus_vsearch	980	C	C	241	1	0.41%	2	1	93	93	0.4999999999999138	1	1	94	147	0	1	A
barcode89_consensus_vsearch	981	C	C	254	1	0.39%	2	1	93	93	0.4999999999999138	1	1	105	149	0	1	+T
barcode89_consensus_vsearch	982	C	Y	234	17	6.56%	2	1	93	93	5.765150746373648E-6	1	1	106	128	0	17	T
barcode89_consensus_vsearch	983	G	G	252	1	0.4%	2	1	93	93	0.5000000000003686	1	1	106	146	0	1	+C
barcode89_consensus_vsearch	984	C	C	253	0	0%	2	0	93	0	1.0	1	0	106	147	0	0	
barcode89_consensus_vsearch	985	A	A	256	2	0.77%	2	1	93	93	0.24951456310670525	1	1	109	147	0	2	-T
barcode89_consensus_vsearch	986	T	T	256	1	0.39%	2	1	93	93	0.4999999999999138	1	1	109	147	0	1	C
barcode89_consensus_vsearch	987	C	C	257	2	0.77%	2	1	93	93	0.24951644100587136	1	1	107	150	2	0	-G
barcode89_consensus_vsearch	988	G	G	253	2	0.78%	2	2	93	93	0.24950884086425928	1	1	105	148	1	1	-C
barcode89_consensus_vsearch	989	C	C	253	2	0.78%	2	1	93	93	0.24950884086425928	1	1	104	149	2	0	A
barcode89_consensus_vsearch	990	C	C	255	1	0.39%	2	1	93	93	0.4999999999999138	1	1	106	149	0	1	+AA
barcode89_consensus_vsearch	991	A	A	253	1	0.39%	2	1	93	93	0.5000000000003686	1	1	106	147	0	1	+CA
barcode89_consensus_vsearch	992	G	G	256	1	0.39%	2	1	93	93	0.4999999999999138	1	1	107	149	0	1	-T
barcode89_consensus_vsearch	993	T	T	256	1	0.39%	2	1	93	93	0.4999999999999138	1	1	109	147	0	1	+AT
barcode89_consensus_vsearch	994	T	T	259	0	0%	2	0	93	0	1.0	1	0	109	150	0	0	
barcode89_consensus_vsearch	995	C	C	256	2	0.77%	2	2	93	93	0.24951456310670525	1	1	107	149	1	1	+T
barcode89_consensus_vsearch	996	T	T	255	2	0.78%	2	1	93	93	0.2495126705651419	1	1	106	149	2	0	+A
barcode89_consensus_vsearch	997	G	G	255	2	0.78%	2	1	93	93	0.2495126705651419	1	1	106	149	2	0	A
barcode89_consensus_vsearch	998	C	C	250	3	1.17%	2	1	93	93	0.12425742574263329	1	1	106	144	0	3	-T
barcode89_consensus_vsearch	999	T	T	253	1	0.39%	2	1	93	93	0.5000000000003686	1	1	106	147	1	0	A
barcode89_consensus_vsearch	1000	T	T	252	4	1.56%	2	1	93	93	0.06176686569346045	1	1	102	150	4	0	-A
barcode89_consensus_vsearch	1001	A	A	253	1	0.39%	2	1	93	93	0.5000000000003686	1	1	103	150	1	0	-C
barcode89_consensus_vsearch	1002	C	C	253	4	1.55%	2	1	93	93	0.0617697211064687	1	1	103	150	4	0	G
barcode89_consensus_vsearch	1003	C	*/-A	227	22	8.49%	2	2	93	93	1.4680115312896036E-7	1	1	94	133	10	12	-A
barcode89_consensus_vsearch	1004	A	A	234	1	0.42%	2	1	93	93	0.5000000000003686	1	1	96	138	1	0	+G
barcode89_consensus_vsearch	1005	A	A	258	1	0.39%	2	1	93	93	0.4999999999999138	1	1	108	150	1	0	+G
barcode89_consensus_vsearch	1006	A	A	259	0	0%	2	0	93	0	1.0	1	0	109	150	0	0	
barcode89_consensus_vsearch	1007	A	A	258	1	0.39%	2	1	93	93	0.4999999999999138	1	1	108	150	1	0	G
barcode89_consensus_vsearch	1008	A	A	259	0	0%	2	0	93	0	1.0	1	0	109	150	0	0	
barcode89_consensus_vsearch	1009	T	T	256	2	0.77%	2	1	93	93	0.24951456310670525	1	1	108	148	0	2	-G
barcode89_consensus_vsearch	1010	G	G	257	0	0%	2	0	93	0	1.0	1	0	109	148	0	0	
barcode89_consensus_vsearch	1011	G	G	256	2	0.77%	2	1	93	93	0.24951456310670525	1	1	107	149	2	0	-C
barcode89_consensus_vsearch	1012	C	C	256	0	0%	2	0	93	0	1.0	1	0	107	149	0	0	
barcode89_consensus_vsearch	1013	C	C	258	0	0%	2	0	93	0	1.0	1	0	109	149	0	0	
barcode89_consensus_vsearch	1014	C	C	256	1	0.39%	2	1	93	93	0.4999999999999138	1	1	108	148	0	1	+A
barcode89_consensus_vsearch	1015	A	A	255	2	0.78%	2	1	93	93	0.2495126705651419	1	1	105	150	2	0	-C
barcode89_consensus_vsearch	1016	C	C	252	3	1.17%	2	1	93	93	0.12426326129665838	1	1	106	146	0	3	T
barcode89_consensus_vsearch	1017	T	T	257	1	0.39%	2	1	93	93	0.4999999999999138	1	1	108	149	1	0	+G
barcode89_consensus_vsearch	1018	A	A	257	1	0.39%	2	1	93	93	0.4999999999999138	1	1	109	148	0	1	-G
barcode89_consensus_vsearch	1019	G	G	258	0	0%	2	0	93	0	1.0	1	0	109	149	0	0	
barcode89_consensus_vsearch	1020	T	T	258	1	0.39%	2	1	93	93	0.4999999999999138	1	1	109	149	0	1	-GT
barcode89_consensus_vsearch	1021	G	G	257	1	0.39%	2	1	93	93	0.4999999999999138	1	1	109	148	0	1	-TTGGTG
barcode89_consensus_vsearch	1022	T	T	254	3	1.17%	2	1	93	93	0.12426900584791233	1	1	109	145	0	3	C
barcode89_consensus_vsearch	1023	T	T	252	4	1.55%	2	1	93	93	0.06176686569346045	1	1	108	144	0	4	-G
barcode89_consensus_vsearch	1024	G	G	251	1	0.4%	2	1	93	93	0.5000000000003686	1	1	107	144	0	1	+A
barcode89_consensus_vsearch	1025	G	*/-TG	248	7	2.72%	2	1	93	93	0.007493349252391194	1	1	108	140	0	7	-TG
barcode89_consensus_vsearch	1026	T	T	242	4	1.6%	2	2	93	93	0.061737033473691375	1	1	107	135	1	3	C
barcode89_consensus_vsearch	1027	G	G	248	0	0%	2	0	93	0	1.0	1	0	109	139	0	0	
barcode89_consensus_vsearch	1028	C	C	253	2	0.78%	2	2	93	93	0.24950884086425928	1	1	108	145	1	1	+A
barcode89_consensus_vsearch	1029	A	A	258	1	0.39%	2	1	93	93	0.4999999999999138	1	1	108	150	1	0	-T
barcode89_consensus_vsearch	1030	T	*/+C	248	7	2.71%	2	1	93	93	0.007493349252391194	1	1	106	142	0	7	+C
barcode89_consensus_vsearch	1031	T	*/-C	249	9	3.47%	2	1	93	93	0.0018193721277701645	1	1	108	141	0	9	-C
barcode89_consensus_vsearch	1032	C	C	243	4	1.6%	2	1	93	93	0.061740125504571274	1	1	104	139	4	0	+A
barcode89_consensus_vsearch	1033	G	G	255	3	1.16%	2	1	93	93	0.1242718446601877	1	1	106	149	3	0	-A
barcode89_consensus_vsearch	1034	A	A	253	2	0.78%	2	1	93	93	0.24950884086425928	1	1	103	150	2	0	G
barcode89_consensus_vsearch	1035	A	A	257	1	0.39%	2	1	93	93	0.4999999999999138	1	1	108	149	1	0	-T
barcode89_consensus_vsearch	1036	T	T	257	1	0.39%	2	1	93	93	0.4999999999999138	1	1	108	149	0	1	C
barcode89_consensus_vsearch	1037	G	G	253	4	1.54%	2	1	93	93	0.0617697211064687	1	1	104	149	4	0	A
barcode89_consensus_vsearch	1038	T	T	252	2	0.78%	2	1	93	93	0.2495069033532105	1	1	104	148	2	0	+C
barcode89_consensus_vsearch	1039	C	C	255	1	0.39%	2	1	93	93	0.4999999999999138	1	1	106	149	1	0	+T
barcode89_consensus_vsearch	1040	C	C	256	1	0.39%	2	1	93	93	0.4999999999999138	1	1	107	149	0	1	+A
barcode89_consensus_vsearch	1041	A	A	253	2	0.78%	2	2	93	93	0.24950884086425928	1	1	106	147	1	1	-CG
barcode89_consensus_vsearch	1042	C	C	250	4	1.56%	2	2	93	93	0.061761087351402955	1	1	104	146	1	3	T
barcode89_consensus_vsearch	1043	G	G	253	2	0.78%	2	1	93	93	0.24950884086425928	1	1	105	148	2	0	A
barcode89_consensus_vsearch	1044	T	T	257	1	0.39%	2	1	93	93	0.4999999999999138	1	1	108	149	0	1	+C
barcode89_consensus_vsearch	1045	T	T	251	4	1.55%	2	2	93	93	0.06176398786346276	1	1	105	146	1	3	C
barcode89_consensus_vsearch	1046	C	C	255	1	0.39%	2	1	93	93	0.4999999999999138	1	1	107	148	1	0	+G
barcode89_consensus_vsearch	1047	A	A	256	1	0.39%	2	1	93	93	0.4999999999999138	1	1	108	148	0	1	G
barcode89_consensus_vsearch	1048	A	A	256	2	0.78%	2	1	93	93	0.24951456310670525	1	1	108	148	0	2	-T
barcode89_consensus_vsearch	1049	T	T	254	2	0.78%	2	2	93	93	0.2495107632092758	1	1	107	147	1	1	C
barcode89_consensus_vsearch	1050	T	*/-A	247	7	2.71%	2	2	93	93	0.00749210286352295	1	1	106	141	1	6	-A
barcode89_consensus_vsearch	1051	A	A	250	1	0.4%	2	1	93	93	0.4999999999999138	1	1	107	143	0	1	G
barcode89_consensus_vsearch	1052	A	A	253	6	2.32%	2	1	93	93	0.01517430252249324	1	1	109	144	0	6	-G
barcode89_consensus_vsearch	1053	G	G	253	0	0%	2	0	93	0	1.0	1	0	109	144	0	0	
barcode89_consensus_vsearch	1054	C	C	258	1	0.39%	2	1	93	93	0.4999999999999138	1	1	108	150	1	0	+GA
barcode89_consensus_vsearch	1055	A	A	258	1	0.39%	2	1	93	93	0.4999999999999138	1	1	108	150	1	0	G
barcode89_consensus_vsearch	1056	A	A	256	1	0.39%	2	1	93	93	0.4999999999999138	1	1	106	150	1	0	+G
barcode89_consensus_vsearch	1057	C	C	253	4	1.54%	2	1	93	93	0.0617697211064687	1	1	103	150	4	0	-A
barcode89_consensus_vsearch	1058	A	A	252	1	0.39%	2	1	93	93	0.5000000000003686	1	1	103	149	1	0	+G
barcode89_consensus_vsearch	1059	A	A	256	1	0.39%	2	1	93	93	0.4999999999999138	1	1	107	149	0	1	+G
barcode89_consensus_vsearch	1060	G	G	258	0	0%	2	0	93	0	1.0	1	0	108	150	0	0	
barcode89_consensus_vsearch	1061	G	G	258	1	0.39%	2	1	93	93	0.4999999999999138	1	1	108	150	1	0	-A
barcode89_consensus_vsearch	1062	A	A	253	3	1.16%	2	2	93	93	0.124266144814075	1	1	105	148	2	1	G
barcode89_consensus_vsearch	1063	C	C	256	1	0.39%	2	1	93	93	0.4999999999999138	1	1	108	148	1	0	+T
barcode89_consensus_vsearch	1064	T	T	257	1	0.39%	2	1	93	93	0.4999999999999138	1	1	109	148	0	1	C
barcode89_consensus_vsearch	1065	T	T	250	4	1.54%	2	2	93	93	0.061761087351402955	1	1	107	143	1	3	-C
barcode89_consensus_vsearch	1066	C	*/-T	240	9	3.56%	2	1	93	93	0.0018146318577743554	1	1	107	133	0	9	-T
barcode89_consensus_vsearch	1067	T	T	243	2	0.81%	2	2	93	93	0.24948875255617758	1	1	106	137	1	1	C
barcode89_consensus_vsearch	1068	T	T	255	2	0.78%	2	2	93	93	0.2495126705651419	1	1	107	148	1	1	C
barcode89_consensus_vsearch	1069	A	A	253	2	0.77%	2	1	93	93	0.24950884086425928	1	1	104	149	2	0	-CA
barcode89_consensus_vsearch	1070	C	C	254	1	0.39%	2	1	93	93	0.4999999999999138	1	1	107	147	0	1	-A
barcode89_consensus_vsearch	1071	A	A	255	1	0.39%	2	1	93	93	0.4999999999999138	1	1	107	148	0	1	+GGC
barcode89_consensus_vsearch	1072	T	T	256	1	0.39%	2	1	93	93	0.4999999999999138	1	1	108	148	1	0	+G
barcode89_consensus_vsearch	1073	A	A	255	2	0.78%	2	1	93	93	0.2495126705651419	1	1	106	149	2	0	+T
barcode89_consensus_vsearch	1074	T	T	255	2	0.78%	2	1	93	93	0.2495126705651419	1	1	108	147	0	2	C
barcode89_consensus_vsearch	1075	T	T	258	1	0.39%	2	1	93	93	0.4999999999999138	1	1	108	150	1	0	C
barcode89_consensus_vsearch	1076	T	T	252	3	1.16%	2	2	93	93	0.12426326129665838	1	1	106	146	1	2	+A
barcode89_consensus_vsearch	1077	A	A	257	0	0%	2	0	93	0	1.0	1	0	108	149	0	0	
barcode89_consensus_vsearch	1078	A	A	256	1	0.39%	2	1	93	93	0.4999999999999138	1	1	108	148	1	0	C
barcode89_consensus_vsearch	1079	A	A	258	0	0%	2	0	93	0	1.0	1	0	109	149	0	0	
barcode89_consensus_vsearch	1080	G	G	253	3	1.16%	2	1	93	93	0.124266144814075	1	1	104	149	3	0	-T
barcode89_consensus_vsearch	1081	T	T	254	0	0%	2	0	93	0	1.0	1	0	105	149	0	0	
barcode89_consensus_vsearch	1082	T	T	254	1	0.39%	2	1	93	93	0.4999999999999138	1	1	107	147	0	1	+C
barcode89_consensus_vsearch	1083	T	T	252	3	1.16%	2	1	93	93	0.12426326129665838	1	1	108	144	0	3	+G
barcode89_consensus_vsearch	1084	G	G	255	1	0.39%	2	1	93	93	0.4999999999999138	1	1	107	148	1	0	+A
barcode89_consensus_vsearch	1085	A	A	257	1	0.39%	2	1	93	93	0.4999999999999138	1	1	108	149	1	0	+G
barcode89_consensus_vsearch	1086	G	G	259	0	0%	2	0	93	0	1.0	1	0	109	150	0	0	
barcode89_consensus_vsearch	1087	A	A	255	4	1.54%	2	2	93	93	0.06177536572082746	1	1	107	148	2	2	G
barcode89_consensus_vsearch	1088	A	A	255	2	0.77%	2	2	93	93	0.2495126705651419	1	1	107	148	1	1	G
barcode89_consensus_vsearch	1089	T	T	255	1	0.39%	2	1	93	93	0.4999999999999138	1	1	108	147	1	0	+A
barcode89_consensus_vsearch	1090	A	A	253	2	0.78%	2	1	93	93	0.24950884086425928	1	1	109	144	0	2	+G
barcode89_consensus_vsearch	1091	G	G	254	1	0.39%	2	1	93	93	0.4999999999999138	1	1	107	147	1	0	+A
barcode89_consensus_vsearch	1092	G	G	257	1	0.39%	2	1	93	93	0.4999999999999138	1	1	108	149	0	1	-TT
barcode89_consensus_vsearch	1093	T	T	256	1	0.39%	2	1	93	93	0.4999999999999138	1	1	108	148	1	0	+G
barcode89_consensus_vsearch	1094	T	T	240	6	2.33%	2	2	93	93	0.01515058431619443	1	1	95	145	5	1	+A
barcode89_consensus_vsearch	1095	A	A	249	1	0.4%	2	1	93	93	0.5000000000003686	1	1	102	147	1	0	C
barcode89_consensus_vsearch	1096	A	A	255	2	0.78%	2	1	93	93	0.2495126705651419	1	1	109	146	0	2	-G
barcode89_consensus_vsearch	1097	G	G	254	1	0.39%	2	1	93	93	0.4999999999999138	1	1	109	145	0	1	A
barcode89_consensus_vsearch	1098	G	G	255	2	0.78%	2	1	93	93	0.2495126705651419	1	1	106	149	2	0	+T
barcode89_consensus_vsearch	1099	T	Y	247	10	3.89%	2	2	93	93	8.932230783903669E-4	1	1	107	140	1	9	C
barcode89_consensus_vsearch	1100	T	T	255	1	0.39%	2	1	93	93	0.4999999999999138	1	1	109	146	0	1	-GT
barcode89_consensus_vsearch	1101	G	G	254	3	1.16%	2	1	93	93	0.12426900584791233	1	1	105	149	3	0	+T
barcode89_consensus_vsearch	1102	T	T	254	3	1.17%	2	2	93	93	0.12426900584791233	1	1	106	148	2	1	C
barcode89_consensus_vsearch	1103	T	T	258	1	0.39%	2	1	93	93	0.4999999999999138	1	1	109	149	0	1	C
barcode89_consensus_vsearch	1104	T	T	255	2	0.77%	2	2	93	93	0.2495126705651419	1	1	107	148	1	1	C
barcode89_consensus_vsearch	1105	C	C	257	1	0.39%	2	1	93	93	0.4999999999999138	1	1	107	150	1	0	-A
barcode89_consensus_vsearch	1106	A	A	255	1	0.39%	2	1	93	93	0.4999999999999138	1	1	106	149	0	1	+GA
barcode89_consensus_vsearch	1107	A	*/-C	238	10	3.88%	2	2	93	93	8.902795873314557E-4	1	1	98	140	4	6	-C
barcode89_consensus_vsearch	1108	C	C	244	2	0.81%	2	1	93	93	0.24949083503056865	1	1	103	141	0	2	+T
barcode89_consensus_vsearch	1109	C	C	255	2	0.78%	2	1	93	93	0.2495126705651419	1	1	106	149	2	0	T
barcode89_consensus_vsearch	1110	C	Y	248	9	3.47%	2	2	93	93	0.0018188615104327871	1	1	106	142	3	6	T
barcode89_consensus_vsearch	1111	C	Y	243	12	4.63%	2	2	93	93	2.1386299704443686E-4	1	1	106	137	2	10	T
barcode89_consensus_vsearch	1112	A	A	254	3	1.16%	2	2	93	93	0.12426900584791233	1	1	107	147	1	2	G
barcode89_consensus_vsearch	1113	A	A	256	2	0.77%	2	1	93	93	0.24951456310670525	1	1	109	147	0	2	G
barcode89_consensus_vsearch	1114	G	G	257	1	0.39%	2	1	93	93	0.4999999999999138	1	1	109	148	0	1	+CG
barcode89_consensus_vsearch	1115	G	G	253	2	0.77%	2	1	93	93	0.24950884086425928	1	1	105	148	0	2	-C
barcode89_consensus_vsearch	1116	C	C	255	1	0.39%	2	1	93	93	0.4999999999999138	1	1	108	147	1	0	+A
barcode89_consensus_vsearch	1117	C	C	256	3	1.16%	2	1	93	93	0.12427466150865948	1	1	109	147	0	3	-T
barcode89_consensus_vsearch	1118	T	*/+C	245	8	3.12%	2	1	93	93	0.003692882342347513	1	1	99	146	8	0	+C
barcode89_consensus_vsearch	1119	C	C	255	2	0.77%	2	2	93	93	0.2495126705651419	1	1	107	148	1	1	-T
barcode89_consensus_vsearch	1120	T	T	254	2	0.78%	2	2	93	93	0.2495107632092758	1	1	106	148	1	1	C
barcode89_consensus_vsearch	1121	A	A	259	0	0%	2	0	93	0	1.0	1	0	109	150	0	0	
barcode89_consensus_vsearch	1122	A	A	258	1	0.39%	2	1	93	93	0.4999999999999138	1	1	109	149	0	1	-T
barcode89_consensus_vsearch	1123	T	T	256	2	0.78%	2	2	93	93	0.24951456310670525	1	1	108	148	1	1	+C
barcode89_consensus_vsearch	1124	C	C	257	1	0.39%	2	1	93	93	0.4999999999999138	1	1	109	148	0	1	+AATC
barcode89_consensus_vsearch	1125	A	A	256	2	0.78%	2	1	93	93	0.24951456310670525	1	1	109	147	0	2	G
barcode89_consensus_vsearch	1126	T	T	257	1	0.39%	2	1	93	93	0.4999999999999138	1	1	109	148	0	1	C
barcode89_consensus_vsearch	1127	T	T	257	1	0.39%	2	1	93	93	0.4999999999999138	1	1	109	148	0	1	-C
barcode89_consensus_vsearch	1128	C	C	254	2	0.78%	2	1	93	93	0.2495107632092758	1	1	106	148	2	0	-G
barcode89_consensus_vsearch	1129	G	G	256	0	0%	2	0	93	0	1.0	1	0	106	150	0	0	
barcode89_consensus_vsearch	1130	C	C	252	3	1.16%	2	1	93	93	0.12426326129665838	1	1	102	150	3	0	+T
barcode89_consensus_vsearch	1131	T	T	254	3	1.17%	2	2	93	93	0.12426900584791233	1	1	106	148	1	2	C
barcode89_consensus_vsearch	1132	T	T	256	1	0.39%	2	1	93	93	0.4999999999999138	1	1	106	150	1	0	+CC
barcode89_consensus_vsearch	1133	T	T	256	1	0.39%	2	1	93	93	0.4999999999999138	1	1	106	150	1	0	-A
barcode89_consensus_vsearch	1134	A	A	251	4	1.56%	2	1	93	93	0.06176398786346276	1	1	106	145	0	4	+C
barcode89_consensus_vsearch	1135	C	C	255	1	0.39%	2	1	93	93	0.4999999999999138	1	1	108	147	0	1	+T
barcode89_consensus_vsearch	1136	C	C	255	4	1.54%	2	1	93	93	0.06177536572082746	1	1	109	146	0	4	-TC
barcode89_consensus_vsearch	1137	T	T	249	3	1.18%	2	1	93	93	0.12425447316115633	1	1	105	144	3	0	+C
barcode89_consensus_vsearch	1138	C	C	253	1	0.39%	2	1	93	93	0.5000000000003686	1	1	109	144	0	1	+T
barcode89_consensus_vsearch	1139	A	A	251	4	1.54%	2	1	93	93	0.06176398786346276	1	1	103	148	4	0	T
barcode89_consensus_vsearch	1140	T	T	246	5	1.94%	2	2	93	93	0.03062812251247695	1	1	107	139	1	4	C
barcode89_consensus_vsearch	1141	A	A	256	0	0%	2	0	93	0	1.0	1	0	109	147	0	0	
barcode89_consensus_vsearch	1142	A	A	258	1	0.39%	2	1	93	93	0.4999999999999138	1	1	109	149	0	1	G
barcode89_consensus_vsearch	1143	A	A	259	0	0%	2	0	93	0	1.0	1	0	109	150	0	0	
barcode89_consensus_vsearch	1144	A	A	253	2	0.77%	2	1	93	93	0.24950884086425928	1	1	108	145	0	2	C
barcode89_consensus_vsearch	1145	C	C	258	0	0%	2	0	93	0	1.0	1	0	108	150	0	0	
barcode89_consensus_vsearch	1146	T	T	249	3	1.16%	2	1	93	93	0.12425447316115633	1	1	105	144	3	0	+A
barcode89_consensus_vsearch	1147	G	*/+A	243	12	4.63%	2	1	93	93	2.1386299704443686E-4	1	1	109	134	0	12	+A
barcode89_consensus_vsearch	1148	A	A	252	2	0.78%	2	1	93	93	0.2495069033532105	1	1	105	147	2	0	+G
barcode89_consensus_vsearch	1149	A	A	259	0	0%	2	0	93	0	1.0	1	0	109	150	0	0	
barcode89_consensus_vsearch	1150	A	A	255	3	1.16%	2	2	93	93	0.1242718446601877	1	1	106	149	2	1	G
barcode89_consensus_vsearch	1151	A	A	255	4	1.54%	2	2	93	93	0.06177536572082746	1	1	106	149	3	1	G
barcode89_consensus_vsearch	1152	C	C	254	3	1.16%	2	2	93	93	0.12426900584791233	1	1	106	148	1	2	-AAC
barcode89_consensus_vsearch	1153	A	A	255	0	0%	2	0	93	0	1.0	1	0	107	148	0	0	
barcode89_consensus_vsearch	1154	A	A	254	1	0.39%	2	1	93	93	0.4999999999999138	1	1	107	147	0	1	G
barcode89_consensus_vsearch	1155	C	C	254	1	0.39%	2	1	93	93	0.4999999999999138	1	1	106	148	1	0	-A
barcode89_consensus_vsearch	1156	A	A	256	1	0.39%	2	1	93	93	0.4999999999999138	1	1	107	149	1	0	-C
barcode89_consensus_vsearch	1157	C	C	255	1	0.39%	2	1	93	93	0.4999999999999138	1	1	105	150	1	0	+TT
barcode89_consensus_vsearch	1158	T	T	257	1	0.39%	2	1	93	93	0.4999999999999138	1	1	108	149	0	1	+G
barcode89_consensus_vsearch	1159	G	G	255	2	0.78%	2	2	93	93	0.2495126705651419	1	1	106	149	1	1	A
barcode89_consensus_vsearch	1160	C	C	257	1	0.39%	2	1	93	93	0.4999999999999138	1	1	108	149	1	0	+A
barcode89_consensus_vsearch	1161	T	T	256	2	0.78%	2	1	93	93	0.24951456310670525	1	1	109	147	0	2	C
barcode89_consensus_vsearch	1162	A	A	259	0	0%	2	0	93	0	1.0	1	0	109	150	0	0	
barcode89_consensus_vsearch	1163	T	T	252	6	2.32%	2	1	93	93	0.015172562563020547	1	1	102	150	6	0	-C
barcode89_consensus_vsearch	1164	C	C	251	1	0.4%	2	1	93	93	0.5000000000003686	1	1	102	149	1	0	+A
barcode89_consensus_vsearch	1165	C	C	254	2	0.77%	2	1	93	93	0.2495107632092758	1	1	107	147	0	2	+T
barcode89_consensus_vsearch	1166	T	T	248	5	1.95%	2	2	93	93	0.030633033482245435	1	1	104	144	1	4	C
barcode89_consensus_vsearch	1167	G	G	251	4	1.55%	2	1	93	93	0.06176398786346276	1	1	102	149	4	0	-A
barcode89_consensus_vsearch	1168	A	*/-G	181	57	22.53%	2	2	93	93	1.52747826099673E-19	1	1	51	130	42	15	-G
barcode89_consensus_vsearch	1169	G	G	190	1	0.52%	2	1	93	93	0.4999999999999138	1	1	56	134	0	1	+T
barcode89_consensus_vsearch	1170	G	G	249	1	0.4%	2	1	93	93	0.5000000000003686	1	1	100	149	0	1	T
barcode89_consensus_vsearch	1171	G	*/-A	232	9	3.59%	2	1	93	93	0.0018101271688386934	1	1	101	131	0	9	-A
barcode89_consensus_vsearch	1172	A	A	240	2	0.83%	2	2	93	93	0.24948240165631827	1	1	100	140	1	1	G
barcode89_consensus_vsearch	1173	A	A	258	1	0.39%	2	1	93	93	0.4999999999999138	1	1	109	149	0	1	C
barcode89_consensus_vsearch	1174	A	A	250	5	1.93%	2	1	93	93	0.030637867497453432	1	1	109	141	0	5	+T
barcode89_consensus_vsearch	1175	C	*/-T	240	13	5.1%	2	2	93	93	1.0422226518848426E-4	1	1	105	135	2	11	-T
barcode89_consensus_vsearch	1176	T	T	236	4	1.65%	2	2	93	93	0.0617179396278951	1	1	103	133	2	2	C
barcode89_consensus_vsearch	1177	T	*/-C	239	13	5.06%	2	2	93	93	1.041552345920223E-4	1	1	103	136	2	11	-C
barcode89_consensus_vsearch	1178	C	C	238	2	0.82%	2	1	93	93	0.24947807933195232	1	1	104	134	0	2	+A
barcode89_consensus_vsearch	1179	G	G	250	3	1.18%	2	1	93	93	0.12425742574263329	1	1	107	143	0	3	T
barcode89_consensus_vsearch	1180	G	G	258	0	0%	2	0	93	0	1.0	1	0	108	150	0	0	
barcode89_consensus_vsearch	1181	C	C	248	4	1.55%	2	2	93	93	0.061755217199896344	1	1	103	145	2	2	-A
barcode89_consensus_vsearch	1182	A	R	243	8	3.14%	2	1	93	93	0.003691204692263428	1	1	97	146	8	0	G
barcode89_consensus_vsearch	1183	G	G	255	2	0.78%	2	1	93	93	0.2495126705651419	1	1	109	146	0	2	+T
barcode89_consensus_vsearch	1184	G	G	258	1	0.39%	2	1	93	93	0.4999999999999138	1	1	109	149	0	1	+A
barcode89_consensus_vsearch	1185	A	A	259	0	0%	2	0	93	0	1.0	1	0	109	150	0	0	
barcode89_consensus_vsearch	1186	A	A	256	2	0.77%	2	1	93	93	0.24951456310670525	1	1	107	149	2	0	-C
barcode89_consensus_vsearch	1187	C	C	256	1	0.39%	2	1	93	93	0.4999999999999138	1	1	106	150	1	0	+TT
barcode89_consensus_vsearch	1188	C	C	258	1	0.39%	2	1	93	93	0.4999999999999138	1	1	109	149	0	1	T
barcode89_consensus_vsearch	1189	A	A	255	2	0.77%	2	1	93	93	0.2495126705651419	1	1	109	146	0	2	-G
barcode89_consensus_vsearch	1190	G	G	254	1	0.39%	2	1	93	93	0.4999999999999138	1	1	108	146	0	1	-C
barcode89_consensus_vsearch	1191	C	C	255	1	0.39%	2	1	93	93	0.4999999999999138	1	1	109	146	0	1	-T
barcode89_consensus_vsearch	1192	T	T	253	2	0.78%	2	2	93	93	0.24950884086425928	1	1	107	146	1	1	C
barcode89_consensus_vsearch	1193	A	A	252	2	0.78%	2	1	93	93	0.2495069033532105	1	1	104	148	2	0	G
barcode89_consensus_vsearch	1194	C	C	253	2	0.78%	2	1	93	93	0.24950884086425928	1	1	107	146	0	2	-T
barcode89_consensus_vsearch	1195	T	T	252	2	0.78%	2	2	93	93	0.2495069033532105	1	1	105	147	1	1	C
barcode89_consensus_vsearch	1196	A	A	255	2	0.78%	2	1	93	93	0.2495126705651419	1	1	107	148	0	2	+G
barcode89_consensus_vsearch	1197	G	G	259	0	0%	2	0	93	0	1.0	1	0	109	150	0	0	
barcode89_consensus_vsearch	1198	A	A	257	1	0.39%	2	1	93	93	0.4999999999999138	1	1	109	148	0	1	+GA
barcode89_consensus_vsearch	1199	T	T	257	1	0.39%	2	1	93	93	0.4999999999999138	1	1	108	149	1	0	+A
barcode89_consensus_vsearch	1200	G	G	259	0	0%	2	0	93	0	1.0	1	0	109	150	0	0	
barcode89_consensus_vsearch	1201	G	G	256	1	0.39%	2	1	93	93	0.4999999999999138	1	1	106	150	1	0	+T
barcode89_consensus_vsearch	1202	T	T	252	6	2.32%	2	1	93	93	0.015172562563020547	1	1	109	143	0	6	+C
barcode89_consensus_vsearch	1203	T	*/-C	248	7	2.7%	2	1	93	93	0.007493349252391194	1	1	106	142	0	7	-C
barcode89_consensus_vsearch	1204	C	C	248	2	0.79%	2	1	93	93	0.24949899799584363	1	1	108	140	0	2	+G
barcode89_consensus_vsearch	1205	G	G	258	1	0.39%	2	1	93	93	0.4999999999999138	1	1	108	150	1	0	-A
barcode89_consensus_vsearch	1206	A	A	257	1	0.39%	2	1	93	93	0.4999999999999138	1	1	108	149	0	1	G
barcode89_consensus_vsearch	1207	T	T	258	1	0.39%	2	1	93	93	0.4999999999999138	1	1	108	150	1	0	C
barcode89_consensus_vsearch	1208	T	T	251	3	1.16%	2	2	93	93	0.12426035502961323	1	1	107	144	2	1	+G
barcode89_consensus_vsearch	1209	A	R	245	7	2.73%	2	2	93	93	0.007489580654151418	1	1	101	144	6	1	G
barcode89_consensus_vsearch	1210	G	G	253	2	0.78%	2	1	93	93	0.24950884086425928	1	1	107	146	0	2	+C
barcode89_consensus_vsearch	1211	T	T	251	3	1.16%	2	1	93	93	0.12426035502961323	1	1	108	143	0	3	C
barcode89_consensus_vsearch	1212	C	*/-T	227	14	5.49%	2	2	93	93	5.025884107193111E-5	1	1	95	132	5	9	-T
barcode89_consensus_vsearch	1213	T	T	241	1	0.41%	2	1	93	93	0.4999999999999138	1	1	104	137	0	1	+G
barcode89_consensus_vsearch	1214	T	T	251	2	0.78%	2	1	93	93	0.24950495049494414	1	1	106	145	2	0	+ACC
barcode89_consensus_vsearch	1215	T	T	255	2	0.77%	2	2	93	93	0.2495126705651419	1	1	107	148	1	1	-C
barcode89_consensus_vsearch	1216	C	C	249	3	1.17%	2	2	93	93	0.12425447316115633	1	1	103	146	2	1	+TC
barcode89_consensus_vsearch	1217	G	*/-C	226	23	8.88%	2	2	93	93	7.000811294180209E-8	1	1	95	131	10	13	-C
barcode89_consensus_vsearch	1218	C	C	234	1	0.43%	2	1	93	93	0.5000000000003686	1	1	98	136	0	1	T
barcode89_consensus_vsearch	1219	C	C	258	0	0%	2	0	93	0	1.0	1	0	108	150	0	0	
barcode89_consensus_vsearch	1220	C	C	256	2	0.78%	2	1	93	93	0.24951456310670525	1	1	108	148	0	2	T
barcode89_consensus_vsearch	1221	C	C	257	1	0.39%	2	1	93	93	0.4999999999999138	1	1	109	148	0	1	+A
barcode89_consensus_vsearch	1222	T	T	256	1	0.39%	2	1	93	93	0.4999999999999138	1	1	108	148	0	1	+A
barcode89_consensus_vsearch	1223	A	A	257	1	0.39%	2	1	93	93	0.4999999999999138	1	1	108	149	0	1	+G
barcode89_consensus_vsearch	1224	T	T	254	2	0.77%	2	1	93	93	0.2495107632092758	1	1	105	149	2	0	-A
barcode89_consensus_vsearch	1225	A	A	254	1	0.39%	2	1	93	93	0.4999999999999138	1	1	106	148	0	1	-CGCA
barcode89_consensus_vsearch	1226	C	C	254	2	0.78%	2	1	93	93	0.2495107632092758	1	1	107	147	0	2	G
barcode89_consensus_vsearch	1227	G	G	255	3	1.16%	2	2	93	93	0.1242718446601877	1	1	108	147	1	2	A
barcode89_consensus_vsearch	1228	C	C	249	3	1.16%	2	2	93	93	0.12425447316115633	1	1	105	144	1	2	-A
barcode89_consensus_vsearch	1229	A	A	252	1	0.4%	2	1	93	93	0.5000000000003686	1	1	107	145	0	1	+TA
barcode89_consensus_vsearch	1230	A	A	257	0	0%	2	0	93	0	1.0	1	0	108	149	0	0	
barcode89_consensus_vsearch	1231	A	A	256	1	0.39%	2	1	93	93	0.4999999999999138	1	1	108	148	1	0	-T
barcode89_consensus_vsearch	1232	T	T	255	2	0.78%	2	1	93	93	0.2495126705651419	1	1	108	147	0	2	C
barcode89_consensus_vsearch	1233	T	T	253	2	0.78%	2	1	93	93	0.24950884086425928	1	1	108	145	0	2	+C
barcode89_consensus_vsearch	1234	T	T	258	1	0.39%	2	1	93	93	0.4999999999999138	1	1	108	150	1	0	C
barcode89_consensus_vsearch	1235	G	G	259	0	0%	2	0	93	0	1.0	1	0	109	150	0	0	
barcode89_consensus_vsearch	1236	A	A	255	2	0.77%	2	2	93	93	0.2495126705651419	1	1	108	147	1	1	-CGA
barcode89_consensus_vsearch	1237	C	C	252	3	1.17%	2	1	93	93	0.12426326129665838	1	1	106	146	0	3	T
barcode89_consensus_vsearch	1238	G	G	257	0	0%	2	0	93	0	1.0	1	0	108	149	0	0	
barcode89_consensus_vsearch	1239	A	A	257	0	0%	2	0	93	0	1.0	1	0	108	149	0	0	
barcode89_consensus_vsearch	1240	T	T	256	1	0.39%	2	1	93	93	0.4999999999999138	1	1	107	149	1	0	+C
barcode89_consensus_vsearch	1241	C	C	256	1	0.39%	2	1	93	93	0.4999999999999138	1	1	108	148	1	0	+A
barcode89_consensus_vsearch	1242	G	G	256	1	0.39%	2	1	93	93	0.4999999999999138	1	1	106	150	1	0	-A
barcode89_consensus_vsearch	1243	A	A	251	3	1.17%	2	1	93	93	0.12426035502961323	1	1	106	145	0	3	+T
barcode89_consensus_vsearch	1244	T	T	256	1	0.39%	2	1	93	93	0.4999999999999138	1	1	107	149	1	0	G
barcode89_consensus_vsearch	1245	T	T	255	3	1.16%	2	2	93	93	0.1242718446601877	1	1	107	148	1	2	C
barcode89_consensus_vsearch	1246	T	T	254	2	0.77%	2	1	93	93	0.2495107632092758	1	1	109	145	0	2	+G
barcode89_consensus_vsearch	1247	G	G	259	0	0%	2	0	93	0	1.0	1	0	109	150	0	0	
barcode89_consensus_vsearch	1248	C	*/-AC	248	7	2.7%	2	1	93	93	0.007493349252391194	1	1	102	146	7	0	-AC
barcode89_consensus_vsearch	1249	A	A	247	3	1.19%	2	1	93	93	0.12424849699405838	1	1	101	146	0	3	+T
barcode89_consensus_vsearch	1250	C	C	250	2	0.79%	2	1	93	93	0.2495029821073759	1	1	102	148	0	2	T
barcode89_consensus_vsearch	1251	G	G	257	1	0.39%	2	1	93	93	0.4999999999999138	1	1	109	148	0	1	+CG
barcode89_consensus_vsearch	1252	T	T	257	1	0.39%	2	1	93	93	0.4999999999999138	1	1	108	149	1	0	+C
barcode89_consensus_vsearch	1253	C	C	254	4	1.54%	2	1	93	93	0.06177255436325217	1	1	105	149	4	0	+A
barcode89_consensus_vsearch	1254	A	A	252	3	1.16%	2	1	93	93	0.12426326129665838	1	1	108	144	0	3	+G
barcode89_consensus_vsearch	1255	G	G	252	3	1.16%	2	1	93	93	0.12426326129665838	1	1	109	143	0	3	+A
barcode89_consensus_vsearch	1256	A	A	252	4	1.56%	2	2	93	93	0.06176686569346045	1	1	106	146	2	2	G
barcode89_consensus_vsearch	1257	A	A	252	4	1.54%	2	2	93	93	0.06176686569346045	1	1	104	148	3	1	G
barcode89_consensus_vsearch	1258	C	C	249	4	1.55%	2	2	93	93	0.06175816388801474	1	1	106	143	1	3	T
barcode89_consensus_vsearch	1259	C	Y	205	46	17.83%	2	2	93	93	1.46666265804685E-15	1	1	108	97	1	45	T
barcode89_consensus_vsearch	1260	G	G	248	5	1.95%	2	2	93	93	0.030633033482245435	1	1	103	145	4	1	A
barcode89_consensus_vsearch	1261	C	Y	239	11	4.25%	2	2	93	93	4.3638441469499997E-4	1	1	103	136	1	10	T
barcode89_consensus_vsearch	1262	T	T	254	2	0.78%	2	1	93	93	0.2495107632092758	1	1	107	147	0	2	G
barcode89_consensus_vsearch	1263	G	G	255	1	0.39%	2	1	93	93	0.4999999999999138	1	1	107	148	1	0	+TG
barcode89_consensus_vsearch	1264	C	C	249	5	1.95%	2	1	93	93	0.03063545999571253	1	1	107	142	0	5	T
barcode89_consensus_vsearch	1265	G	G	255	1	0.39%	2	1	93	93	0.4999999999999138	1	1	108	147	0	1	-A
barcode89_consensus_vsearch	1266	A	A	257	1	0.39%	2	1	93	93	0.4999999999999138	1	1	109	148	0	1	G
barcode89_consensus_vsearch	1267	G	G	254	2	0.77%	2	2	93	93	0.2495107632092758	1	1	107	147	1	1	-C
barcode89_consensus_vsearch	1268	C	C	253	2	0.78%	2	2	93	93	0.24950884086425928	1	1	106	147	1	1	T
barcode89_consensus_vsearch	1269	C	C	253	4	1.54%	2	1	93	93	0.0617697211064687	1	1	109	144	0	4	-TC
barcode89_consensus_vsearch	1270	T	T	250	2	0.78%	2	1	93	93	0.2495029821073759	1	1	105	145	2	0	-C
barcode89_consensus_vsearch	1271	C	C	253	0	0%	2	0	93	0	1.0	1	0	107	146	0	0	
barcode89_consensus_vsearch	1272	C	C	253	5	1.93%	2	1	93	93	0.030644978141142375	1	1	104	149	5	0	-A
barcode89_consensus_vsearch	1273	A	*/-C	241	10	3.94%	2	1	93	93	8.912835697054955E-4	1	1	91	150	10	0	-C
barcode89_consensus_vsearch	1274	C	C	239	5	2.01%	2	1	93	93	0.030610300810777105	1	1	92	147	5	0	G
barcode89_consensus_vsearch	1275	C	C	252	2	0.77%	2	1	93	93	0.2495069033532105	1	1	104	148	2	0	+A
barcode89_consensus_vsearch	1276	A	A	251	2	0.78%	2	1	93	93	0.24950495049494414	1	1	106	145	0	2	+G
barcode89_consensus_vsearch	1277	G	G	250	6	2.33%	2	1	93	93	0.015169042029074849	1	1	101	149	6	0	-A
barcode89_consensus_vsearch	1278	A	A	250	1	0.4%	2	1	93	93	0.4999999999999138	1	1	101	149	1	0	-G
barcode89_consensus_vsearch	1279	G	G	254	1	0.39%	2	1	93	93	0.4999999999999138	1	1	108	146	0	1	+C
barcode89_consensus_vsearch	1280	T	T	256	1	0.39%	2	1	93	93	0.4999999999999138	1	1	109	147	0	1	C
barcode89_consensus_vsearch	1281	T	T	256	2	0.78%	2	1	93	93	0.24951456310670525	1	1	109	147	0	2	C
barcode89_consensus_vsearch	1282	T	*/-C	236	17	6.59%	2	2	93	93	5.778370165149079E-6	1	1	108	128	1	16	-C
barcode89_consensus_vsearch	1283	C	C	238	0	0%	2	0	93	0	1.0	1	0	108	130	0	0	
barcode89_consensus_vsearch	1284	C	C	252	2	0.78%	2	1	93	93	0.2495069033532105	1	1	109	143	0	2	-TCTG
barcode89_consensus_vsearch	1285	T	T	248	4	1.58%	2	1	93	93	0.061755217199896344	1	1	109	139	0	4	-CT
barcode89_consensus_vsearch	1286	C	C	246	3	1.2%	2	1	93	93	0.1242454728369122	1	1	109	137	0	3	-T
barcode89_consensus_vsearch	1287	T	T	241	5	2.01%	2	2	93	93	0.030615496107849846	1	1	105	136	4	1	-G
barcode89_consensus_vsearch	1288	G	G	251	1	0.4%	2	1	93	93	0.5000000000003686	1	1	105	146	0	1	A
barcode89_consensus_vsearch	1289	G	G	257	1	0.39%	2	1	93	93	0.4999999999999138	1	1	109	148	0	1	-CT
barcode89_consensus_vsearch	1290	C	C	255	2	0.78%	2	1	93	93	0.2495126705651419	1	1	108	147	0	2	T
barcode89_consensus_vsearch	1291	T	T	256	1	0.39%	2	1	93	93	0.4999999999999138	1	1	107	149	1	0	C
barcode89_consensus_vsearch	1292	T	T	258	0	0%	2	0	93	0	1.0	1	0	108	150	0	0	
barcode89_consensus_vsearch	1293	C	C	254	2	0.77%	2	1	93	93	0.2495107632092758	1	1	109	145	0	2	+AA
barcode89_consensus_vsearch	1294	A	*/-C	231	11	4.25%	2	2	93	93	4.3473033454469255E-4	1	1	89	142	7	4	-C
barcode89_consensus_vsearch	1295	C	C	240	2	0.82%	2	2	93	93	0.24948240165631827	1	1	97	143	1	1	+T
barcode89_consensus_vsearch	1296	C	C	248	4	1.57%	2	1	93	93	0.061755217199896344	1	1	105	143	0	4	+T
barcode89_consensus_vsearch	1297	C	C	256	2	0.77%	2	1	93	93	0.24951456310670525	1	1	109	147	0	2	-T
barcode89_consensus_vsearch	1298	T	T	252	3	1.17%	2	2	93	93	0.12426326129665838	1	1	108	144	1	2	C
barcode89_consensus_vsearch	1299	A	A	257	1	0.39%	2	1	93	93	0.4999999999999138	1	1	109	148	0	1	+T
barcode89_consensus_vsearch	1300	T	T	255	1	0.39%	2	1	93	93	0.4999999999999138	1	1	108	147	0	1	+C
barcode89_consensus_vsearch	1301	T	T	255	3	1.16%	2	2	93	93	0.1242718446601877	1	1	106	149	2	1	-C
barcode89_consensus_vsearch	1302	C	C	251	1	0.39%	2	1	93	93	0.5000000000003686	1	1	105	146	0	1	+A
barcode89_consensus_vsearch	1303	A	A	255	1	0.39%	2	1	93	93	0.4999999999999138	1	1	106	149	1	0	+G
barcode89_consensus_vsearch	1304	C	C	253	3	1.17%	2	1	93	93	0.124266144814075	1	1	104	149	3	0	-GC
barcode89_consensus_vsearch	1305	G	G	253	1	0.39%	2	1	93	93	0.5000000000003686	1	1	105	148	0	1	-C
barcode89_consensus_vsearch	1306	C	C	254	1	0.39%	2	1	93	93	0.4999999999999138	1	1	106	148	0	1	T
barcode89_consensus_vsearch	1307	A	A	256	2	0.77%	2	1	93	93	0.24951456310670525	1	1	109	147	0	2	G
barcode89_consensus_vsearch	1308	T	T	257	2	0.77%	2	2	93	93	0.24951644100587136	1	1	108	149	1	1	C
barcode89_consensus_vsearch	1309	A	A	258	1	0.39%	2	1	93	93	0.4999999999999138	1	1	109	149	0	1	-GT
barcode89_consensus_vsearch	1310	G	G	257	1	0.39%	2	1	93	93	0.4999999999999138	1	1	109	148	0	1	A
barcode89_consensus_vsearch	1311	T	T	257	1	0.39%	2	1	93	93	0.4999999999999138	1	1	109	148	0	1	+C
barcode89_consensus_vsearch	1312	T	T	257	1	0.39%	2	1	93	93	0.4999999999999138	1	1	109	148	0	1	-C
barcode89_consensus_vsearch	1313	C	C	258	0	0%	2	0	93	0	1.0	1	0	109	149	0	0	
barcode89_consensus_vsearch	1314	A	A	258	1	0.39%	2	1	93	93	0.4999999999999138	1	1	108	150	1	0	-C
barcode89_consensus_vsearch	1315	C	C	256	1	0.39%	2	1	93	93	0.4999999999999138	1	1	107	149	1	0	+A
barcode89_consensus_vsearch	1316	C	C	257	1	0.39%	2	1	93	93	0.4999999999999138	1	1	108	149	1	0	-A
barcode89_consensus_vsearch	1317	A	A	258	0	0%	2	0	93	0	1.0	1	0	108	150	0	0	
barcode89_consensus_vsearch	1318	T	T	257	1	0.39%	2	1	93	93	0.4999999999999138	1	1	107	150	1	0	+AA
barcode89_consensus_vsearch	1319	C	*/-T	234	21	8.11%	2	1	93	93	3.104555954926836E-7	1	1	107	127	0	21	-T
barcode89_consensus_vsearch	1320	T	T	235	1	0.42%	2	1	93	93	0.4999999999999138	1	1	109	126	0	1	C
barcode89_consensus_vsearch	1321	T	T	257	0	0%	2	0	93	0	1.0	1	0	109	148	0	0	
barcode89_consensus_vsearch	1322	T	T	253	2	0.77%	2	1	93	93	0.24950884086425928	1	1	106	147	2	0	+C
barcode89_consensus_vsearch	1323	C	*/-GG	244	7	2.73%	2	1	93	93	0.00748830460110489	1	1	107	137	0	7	-GG
barcode89_consensus_vsearch	1324	G	R	236	8	3.24%	2	1	93	93	0.0036851193347710583	1	1	97	139	8	0	A
barcode89_consensus_vsearch	1325	G	G	249	3	1.19%	2	1	93	93	0.12425447316115633	1	1	106	143	3	0	A
barcode89_consensus_vsearch	1326	G	G	253	4	1.54%	2	2	93	93	0.0617697211064687	1	1	104	149	3	1	A
barcode89_consensus_vsearch	1327	T	T	252	6	2.33%	2	2	93	93	0.015172562563020547	1	1	105	147	3	3	-C
barcode89_consensus_vsearch	1328	C	C	252	0	0%	2	0	93	0	1.0	1	0	105	147	0	0	
barcode89_consensus_vsearch	1329	C	C	255	3	1.16%	2	1	93	93	0.1242718446601877	1	1	105	150	3	0	T
barcode89_consensus_vsearch	1330	C	C	252	3	1.16%	2	2	93	93	0.12426326129665838	1	1	105	147	2	1	T
barcode89_consensus_vsearch	1331	A	A	256	2	0.78%	2	2	93	93	0.24951456310670525	1	1	107	149	1	1	T
barcode89_consensus_vsearch	1332	A	A	256	3	1.16%	2	2	93	93	0.12427466150865948	1	1	107	149	2	1	G
barcode89_consensus_vsearch	1333	C	C	253	4	1.54%	2	2	93	93	0.0617697211064687	1	1	107	146	2	2	T
barcode89_consensus_vsearch	1334	A	A	253	1	0.39%	2	1	93	93	0.5000000000003686	1	1	107	146	0	1	+G
barcode89_consensus_vsearch	1335	G	G	256	1	0.39%	2	1	93	93	0.4999999999999138	1	1	107	149	1	0	A
barcode89_consensus_vsearch	1336	C	C	254	1	0.39%	2	1	93	93	0.4999999999999138	1	1	107	147	1	0	+GGC
barcode89_consensus_vsearch	1337	T	Y	246	12	4.63%	2	1	93	93	2.1420009743898608E-4	1	1	109	137	0	12	C
barcode89_consensus_vsearch	1338	A	A	259	0	0%	2	0	93	0	1.0	1	0	109	150	0	0	
barcode89_consensus_vsearch	1339	T	T	251	3	1.16%	2	2	93	93	0.12426035502961323	1	1	105	146	1	2	C
barcode89_consensus_vsearch	1340	G	G	249	5	1.95%	2	1	93	93	0.03063545999571253	1	1	104	145	0	5	+C
barcode89_consensus_vsearch	1341	C	C	252	1	0.39%	2	1	93	93	0.5000000000003686	1	1	104	148	1	0	+TT
barcode89_consensus_vsearch	1342	T	T	251	4	1.56%	2	1	93	93	0.06176398786346276	1	1	107	144	0	4	-C
barcode89_consensus_vsearch	1343	C	C	248	5	1.96%	2	2	93	93	0.030633033482245435	1	1	107	141	2	3	-T
barcode89_consensus_vsearch	1344	T	T	252	2	0.79%	2	1	93	93	0.2495069033532105	1	1	107	145	0	2	C
barcode89_consensus_vsearch	1345	T	T	259	0	0%	2	0	93	0	1.0	1	0	109	150	0	0	
barcode89_consensus_vsearch	1346	A	A	249	5	1.93%	2	2	93	93	0.03063545999571253	1	1	101	148	4	1	-C
barcode89_consensus_vsearch	1347	C	*/-T	236	18	7.09%	2	1	93	93	2.7923090541651273E-6	1	1	105	131	0	18	-T
barcode89_consensus_vsearch	1348	T	T	234	4	1.66%	2	1	93	93	0.061711360854634224	1	1	104	130	4	0	-C
barcode89_consensus_vsearch	1349	C	C	248	3	1.18%	2	1	93	93	0.12425149700602607	1	1	100	148	3	0	+A
barcode89_consensus_vsearch	1350	A	A	254	1	0.39%	2	1	93	93	0.4999999999999138	1	1	106	148	1	0	G
barcode89_consensus_vsearch	1351	A	A	256	1	0.39%	2	1	93	93	0.4999999999999138	1	1	107	149	1	0	+GGAA
barcode89_consensus_vsearch	1352	A	A	256	2	0.77%	2	1	93	93	0.24951456310670525	1	1	109	147	0	2	-T
barcode89_consensus_vsearch	1353	T	T	255	1	0.39%	2	1	93	93	0.4999999999999138	1	1	108	147	1	0	-C
barcode89_consensus_vsearch	1354	C	C	258	0	0%	2	0	93	0	1.0	1	0	108	150	0	0	
barcode89_consensus_vsearch	1355	C	C	258	1	0.39%	2	1	93	93	0.4999999999999138	1	1	109	149	0	1	T
barcode89_consensus_vsearch	1356	A	A	258	1	0.39%	2	1	93	93	0.4999999999999138	1	1	108	150	1	0	G
barcode89_consensus_vsearch	1357	T	T	257	1	0.39%	2	1	93	93	0.4999999999999138	1	1	107	150	1	0	+C
barcode89_consensus_vsearch	1358	C	C	258	0	0%	2	0	93	0	1.0	1	0	108	150	0	0	
barcode89_consensus_vsearch	1359	C	C	255	2	0.77%	2	1	93	93	0.2495126705651419	1	1	106	149	2	0	+A
barcode89_consensus_vsearch	1360	G	G	255	3	1.16%	2	1	93	93	0.1242718446601877	1	1	105	150	3	0	+A
barcode89_consensus_vsearch	1361	A	A	254	3	1.16%	2	1	93	93	0.12426900584791233	1	1	107	147	0	3	T
barcode89_consensus_vsearch	1362	A	A	257	1	0.39%	2	1	93	93	0.4999999999999138	1	1	108	149	1	0	-GA
barcode89_consensus_vsearch	1363	G	G	257	1	0.39%	2	1	93	93	0.4999999999999138	1	1	108	149	0	1	+C
barcode89_consensus_vsearch	1364	A	A	254	1	0.39%	2	1	93	93	0.4999999999999138	1	1	106	148	1	0	+C
barcode89_consensus_vsearch	1365	C	C	256	2	0.78%	2	2	93	93	0.24951456310670525	1	1	108	148	1	1	T
barcode89_consensus_vsearch	1366	A	A	256	1	0.39%	2	1	93	93	0.4999999999999138	1	1	108	148	0	1	+CA
barcode89_consensus_vsearch	1367	T	T	254	3	1.16%	2	2	93	93	0.12426900584791233	1	1	106	148	1	2	C
barcode89_consensus_vsearch	1368	C	C	252	2	0.78%	2	1	93	93	0.2495069033532105	1	1	104	148	2	0	-A
barcode89_consensus_vsearch	1369	A	*/-G	238	15	5.88%	2	1	93	93	2.4646634720268753E-5	1	1	104	134	0	15	-G
barcode89_consensus_vsearch	1370	G	G	243	0	0%	2	0	93	0	1.0	1	0	109	134	0	0	
barcode89_consensus_vsearch	1371	G	G	258	1	0.39%	2	1	93	93	0.4999999999999138	1	1	108	150	1	0	A
barcode89_consensus_vsearch	1372	A	A	258	1	0.39%	2	1	93	93	0.4999999999999138	1	1	108	150	1	0	G
barcode89_consensus_vsearch	1373	T	T	252	4	1.54%	2	2	93	93	0.06176686569346045	1	1	104	148	2	2	C
barcode89_consensus_vsearch	1374	C	C	257	1	0.39%	2	1	93	93	0.4999999999999138	1	1	109	148	0	1	+A
barcode89_consensus_vsearch	1375	G	G	253	5	1.94%	2	2	93	93	0.030644978141142375	1	1	105	148	4	1	A
barcode89_consensus_vsearch	1376	G	G	256	2	0.77%	2	2	93	93	0.24951456310670525	1	1	108	148	1	1	A
barcode89_consensus_vsearch	1377	T	T	256	2	0.77%	2	1	93	93	0.24951456310670525	1	1	109	147	0	2	C
barcode89_consensus_vsearch	1378	C	C	254	2	0.78%	2	2	93	93	0.2495107632092758	1	1	107	147	1	1	-G
barcode89_consensus_vsearch	1379	G	G	256	0	0%	2	0	93	0	1.0	1	0	108	148	0	0	
barcode89_consensus_vsearch	1380	A	A	256	1	0.39%	2	1	93	93	0.4999999999999138	1	1	107	149	1	0	C
barcode89_consensus_vsearch	1381	T	T	256	2	0.77%	2	1	93	93	0.24951456310670525	1	1	109	147	0	2	C
barcode89_consensus_vsearch	1382	G	G	255	2	0.78%	2	1	93	93	0.2495126705651419	1	1	109	146	0	2	T
barcode89_consensus_vsearch	1383	A	A	251	5	1.93%	2	2	93	93	0.03064025621010106	1	1	108	143	1	4	G
barcode89_consensus_vsearch	1384	T	T	250	5	1.94%	2	2	93	93	0.030637867497453432	1	1	108	142	1	4	C
barcode89_consensus_vsearch	1385	G	G	248	3	1.17%	2	1	93	93	0.12425149700602607	1	1	107	141	0	3	A
barcode89_consensus_vsearch	1386	C	C	229	6	2.33%	2	1	93	93	0.015128474502523867	1	1	109	120	0	6	-GC
barcode89_consensus_vsearch	1387	G	*/-C	202	15	6.07%	2	2	93	93	2.375885795125084E-5	1	1	94	108	14	1	-C
barcode89_consensus_vsearch	1388	C	Y	204	16	6.75%	2	1	93	93	1.1500698432241858E-5	1	1	90	114	0	16	T
barcode89_consensus_vsearch	1389	C	Y	239	16	6.18%	2	1	93	93	1.1970518595027228E-5	1	1	109	130	0	16	T
barcode89_consensus_vsearch	1390	C	*/-T	244	9	3.47%	2	1	93	93	0.001816779465609443	1	1	109	135	0	9	-T
barcode89_consensus_vsearch	1391	T	T	244	5	2%	2	1	93	93	0.030623132735815337	1	1	109	135	0	5	C
barcode89_consensus_vsearch	1392	A	A	258	1	0.39%	2	1	93	93	0.4999999999999138	1	1	109	149	0	1	G
barcode89_consensus_vsearch	1393	A	A	258	1	0.39%	2	1	93	93	0.4999999999999138	1	1	108	150	1	0	G
barcode89_consensus_vsearch	1394	C	*/-G	237	10	3.86%	2	2	93	93	8.89939656217755E-4	1	1	98	139	5	5	-G
barcode89_consensus_vsearch	1395	G	R	235	7	2.87%	2	1	93	93	0.007476349629382664	1	1	93	142	7	0	A
barcode89_consensus_vsearch	1396	G	G	248	4	1.57%	2	2	93	93	0.061755217199896344	1	1	104	144	3	1	A
barcode89_consensus_vsearch	1397	G	G	252	3	1.17%	2	2	93	93	0.12426326129665838	1	1	106	146	2	1	A
barcode89_consensus_vsearch	1398	G	G	256	1	0.39%	2	1	93	93	0.4999999999999138	1	1	107	149	0	1	+A
barcode89_consensus_vsearch	1399	T	T	253	4	1.55%	2	2	93	93	0.0617697211064687	1	1	107	146	1	3	C
barcode89_consensus_vsearch	1400	C	C	257	1	0.39%	2	1	93	93	0.4999999999999138	1	1	109	148	0	1	+T
barcode89_consensus_vsearch	1401	T	T	257	1	0.39%	2	1	93	93	0.4999999999999138	1	1	108	149	1	0	-C
barcode89_consensus_vsearch	1402	C	C	257	1	0.39%	2	1	93	93	0.4999999999999138	1	1	107	150	1	0	-A
barcode89_consensus_vsearch	1403	A	A	252	3	1.16%	2	1	93	93	0.12426326129665838	1	1	105	147	3	0	G
barcode89_consensus_vsearch	1404	C	C	256	1	0.39%	2	1	93	93	0.4999999999999138	1	1	109	147	0	1	+T
barcode89_consensus_vsearch	1405	C	C	252	4	1.54%	2	1	93	93	0.06176686569346045	1	1	108	144	0	4	-TCC
barcode89_consensus_vsearch	1406	T	T	245	5	1.98%	2	1	93	93	0.03062563759307	1	1	108	137	0	5	-CC
barcode89_consensus_vsearch	1407	C	C	246	1	0.4%	2	1	93	93	0.5000000000003686	1	1	108	138	0	1	T
barcode89_consensus_vsearch	1408	C	C	248	1	0.4%	2	1	93	93	0.4999999999999138	1	1	109	139	0	1	-G
barcode89_consensus_vsearch	1409	G	G	255	2	0.78%	2	2	93	93	0.2495126705651419	1	1	108	147	1	1	A
barcode89_consensus_vsearch	1410	T	T	256	1	0.39%	2	1	93	93	0.4999999999999138	1	1	109	147	0	1	+C
barcode89_consensus_vsearch	1411	T	T	252	3	1.16%	2	1	93	93	0.12426326129665838	1	1	104	148	3	0	+C
barcode89_consensus_vsearch	1412	C	C	254	1	0.39%	2	1	93	93	0.4999999999999138	1	1	106	148	1	0	+T
barcode89_consensus_vsearch	1413	A	A	253	1	0.39%	2	1	93	93	0.5000000000003686	1	1	105	148	0	1	-CTTTC
barcode89_consensus_vsearch	1414	C	C	248	2	0.78%	2	1	93	93	0.24949899799584363	1	1	106	142	0	2	+T
barcode89_consensus_vsearch	1415	T	T	251	0	0%	2	0	93	0	1.0	1	0	107	144	0	0	
barcode89_consensus_vsearch	1416	T	T	250	2	0.79%	2	2	93	93	0.2495029821073759	1	1	107	143	1	1	C
barcode89_consensus_vsearch	1417	T	T	252	2	0.78%	2	1	93	93	0.2495069033532105	1	1	109	143	0	2	-C
barcode89_consensus_vsearch	1418	C	C	242	3	1.18%	2	1	93	93	0.1242331288343819	1	1	105	137	3	0	-A
barcode89_consensus_vsearch	1419	A	A	246	3	1.19%	2	2	93	93	0.1242454728369122	1	1	104	142	1	2	-T
barcode89_consensus_vsearch	1420	T	T	246	3	1.19%	2	1	93	93	0.1242454728369122	1	1	103	143	3	0	G
barcode89_consensus_vsearch	1421	T	T	256	1	0.39%	2	1	93	93	0.4999999999999138	1	1	107	149	1	0	+A
barcode89_consensus_vsearch	1422	A	A	256	1	0.39%	2	1	93	93	0.4999999999999138	1	1	108	148	0	1	+TTA
barcode89_consensus_vsearch	1423	C	C	257	1	0.39%	2	1	93	93	0.4999999999999138	1	1	107	150	1	0	A
barcode89_consensus_vsearch	1424	G	G	255	3	1.16%	2	1	93	93	0.1242718446601877	1	1	109	146	0	3	-CG
barcode89_consensus_vsearch	1425	C	C	254	1	0.39%	2	1	93	93	0.4999999999999138	1	1	109	145	0	1	+AT
barcode89_consensus_vsearch	1426	G	G	256	0	0%	2	0	93	0	1.0	1	0	109	147	0	0	
barcode89_consensus_vsearch	1427	T	T	256	1	0.39%	2	1	93	93	0.4999999999999138	1	1	108	148	0	1	+GT
barcode89_consensus_vsearch	1428	A	A	258	0	0%	2	0	93	0	1.0	1	0	108	150	0	0	
barcode89_consensus_vsearch	1429	T	T	248	4	1.55%	2	1	93	93	0.061755217199896344	1	1	106	142	0	4	A
barcode89_consensus_vsearch	1430	G	G	254	1	0.39%	2	1	93	93	0.4999999999999138	1	1	107	147	0	1	+CT
barcode89_consensus_vsearch	1431	G	G	258	1	0.39%	2	1	93	93	0.4999999999999138	1	1	108	150	1	0	+A
barcode89_consensus_vsearch	1432	G	G	255	3	1.16%	2	2	93	93	0.1242718446601877	1	1	107	148	2	1	-T
barcode89_consensus_vsearch	1433	T	Y	248	8	3.12%	2	2	93	93	0.0036953503162476236	1	1	106	142	1	7	C
barcode89_consensus_vsearch	1434	T	T	258	1	0.39%	2	1	93	93	0.4999999999999138	1	1	109	149	0	1	C
barcode89_consensus_vsearch	1435	T	T	253	2	0.77%	2	1	93	93	0.24950884086425928	1	1	109	144	0	2	+G
barcode89_consensus_vsearch	1436	G	G	255	1	0.39%	2	1	93	93	0.4999999999999138	1	1	109	146	0	1	+C
barcode89_consensus_vsearch	1437	A	A	254	2	0.78%	2	1	93	93	0.2495107632092758	1	1	109	145	0	2	G
barcode89_consensus_vsearch	1438	C	C	255	2	0.77%	2	1	93	93	0.2495126705651419	1	1	109	146	0	2	+A
barcode89_consensus_vsearch	1439	A	A	246	5	1.93%	2	2	93	93	0.03062812251247695	1	1	101	145	3	2	-C
barcode89_consensus_vsearch	1440	C	C	249	2	0.79%	2	1	93	93	0.24950099800389156	1	1	105	144	0	2	+AC
barcode89_consensus_vsearch	1441	C	C	255	1	0.39%	2	1	93	93	0.4999999999999138	1	1	109	146	0	1	+T
barcode89_consensus_vsearch	1442	C	C	251	5	1.93%	2	2	93	93	0.03064025621010106	1	1	108	143	1	4	T
barcode89_consensus_vsearch	1443	A	A	254	3	1.16%	2	1	93	93	0.12426900584791233	1	1	105	149	3	0	+G
barcode89_consensus_vsearch	1444	A	A	258	1	0.39%	2	1	93	93	0.4999999999999138	1	1	108	150	1	0	T
barcode89_consensus_vsearch	1445	A	A	254	2	0.77%	2	1	93	93	0.2495107632092758	1	1	106	148	2	0	+G
barcode89_consensus_vsearch	1446	C	C	254	1	0.39%	2	1	93	93	0.4999999999999138	1	1	104	150	1	0	+GC
barcode89_consensus_vsearch	1447	A	A	252	5	1.94%	2	1	93	93	0.030642626352771006	1	1	108	144	0	5	+C
barcode89_consensus_vsearch	1448	C	C	258	1	0.39%	2	1	93	93	0.4999999999999138	1	1	108	150	1	0	+TTGCC
barcode89_consensus_vsearch	1449	T	T	253	6	2.32%	2	1	93	93	0.01517430252249324	1	1	109	144	0	6	-C
barcode89_consensus_vsearch	1450	C	*/-GC	240	8	3.16%	2	1	93	93	0.003688638173064166	1	1	99	141	8	0	-GC
barcode89_consensus_vsearch	1451	G	G	249	2	0.8%	2	1	93	93	0.24950099800389156	1	1	99	150	2	0	A
barcode89_consensus_vsearch	1452	C	C	247	3	1.2%	2	1	93	93	0.12424849699405838	1	1	98	149	3	0	-A
barcode89_consensus_vsearch	1453	A	A	256	0	0%	2	0	93	0	1.0	1	0	106	150	0	0	
barcode89_consensus_vsearch	1454	T	T	257	1	0.39%	2	1	93	93	0.4999999999999138	1	1	107	150	1	0	-A
barcode89_consensus_vsearch	1455	A	A	253	2	0.78%	2	1	93	93	0.24950884086425928	1	1	107	146	0	2	G
barcode89_consensus_vsearch	1456	G	G	257	0	0%	2	0	93	0	1.0	1	0	108	149	0	0	
barcode89_consensus_vsearch	1457	A	A	257	1	0.39%	2	1	93	93	0.4999999999999138	1	1	109	148	0	1	G
barcode89_consensus_vsearch	1458	T	T	257	2	0.77%	2	1	93	93	0.24951644100587136	1	1	109	148	0	2	C
barcode89_consensus_vsearch	1459	G	G	253	3	1.16%	2	2	93	93	0.124266144814075	1	1	106	147	1	2	-TT
barcode89_consensus_vsearch	1460	T	Y	246	7	2.75%	2	1	93	93	0.007490846702557751	1	1	108	138	0	7	C
barcode89_consensus_vsearch	1461	T	T	243	6	2.35%	2	1	93	93	0.015156276648152922	1	1	100	143	6	0	+G
barcode89_consensus_vsearch	1462	A	*/-G	244	7	2.72%	2	1	93	93	0.00748830460110489	1	1	102	142	7	0	-G
barcode89_consensus_vsearch	1463	G	G	250	1	0.4%	2	1	93	93	0.4999999999999138	1	1	101	149	0	1	+C
barcode89_consensus_vsearch	1464	A	A	250	5	1.94%	2	1	93	93	0.030637867497453432	1	1	106	144	0	5	+C
barcode89_consensus_vsearch	1465	C	C	251	4	1.54%	2	1	93	93	0.06176398786346276	1	1	109	142	0	4	-T
barcode89_consensus_vsearch	1466	T	*/-C	237	12	4.78%	2	2	93	93	2.131655349948094E-4	1	1	106	131	2	10	-C
barcode89_consensus_vsearch	1467	C	C	241	1	0.41%	2	1	93	93	0.4999999999999138	1	1	107	134	0	1	+TC
barcode89_consensus_vsearch	1468	C	*/-T	243	8	3.09%	2	1	93	93	0.003691204692263428	1	1	108	135	0	8	-T
barcode89_consensus_vsearch	1469	T	T	249	1	0.4%	2	1	93	93	0.5000000000003686	1	1	109	140	0	1	+C
barcode89_consensus_vsearch	1470	T	T	251	4	1.55%	2	1	93	93	0.06176398786346276	1	1	106	145	0	4	-G
barcode89_consensus_vsearch	1471	G	G	249	4	1.57%	2	2	93	93	0.06175816388801474	1	1	105	144	3	1	A
barcode89_consensus_vsearch	1472	G	G	256	1	0.39%	2	1	93	93	0.4999999999999138	1	1	109	147	0	1	+AA
barcode89_consensus_vsearch	1473	T	T	254	3	1.16%	2	1	93	93	0.12426900584791233	1	1	105	149	3	0	+C
barcode89_consensus_vsearch	1474	C	C	258	0	0%	2	0	93	0	1.0	1	0	108	150	0	0	
barcode89_consensus_vsearch	1475	C	C	255	2	0.77%	2	1	93	93	0.2495126705651419	1	1	108	147	0	2	T
barcode89_consensus_vsearch	1476	G	G	258	1	0.39%	2	1	93	93	0.4999999999999138	1	1	108	150	1	0	A
barcode89_consensus_vsearch	1477	T	T	258	1	0.39%	2	1	93	93	0.4999999999999138	1	1	108	150	1	0	-GT
barcode89_consensus_vsearch	1478	G	G	254	2	0.78%	2	1	93	93	0.2495107632092758	1	1	106	148	2	0	-T
barcode89_consensus_vsearch	1479	T	T	252	2	0.78%	2	1	93	93	0.2495069033532105	1	1	106	146	0	2	+GT
barcode89_consensus_vsearch	1480	T	T	258	1	0.39%	2	1	93	93	0.4999999999999138	1	1	109	149	0	1	C
barcode89_consensus_vsearch	1481	T	T	255	3	1.16%	2	2	93	93	0.1242718446601877	1	1	107	148	2	1	+C
barcode89_consensus_vsearch	1482	C	C	255	1	0.39%	2	1	93	93	0.4999999999999138	1	1	107	148	0	1	+G
barcode89_consensus_vsearch	1483	A	A	254	3	1.17%	2	2	93	93	0.12426900584791233	1	1	106	148	2	1	C
barcode89_consensus_vsearch	1484	A	A	254	2	0.78%	2	1	93	93	0.2495107632092758	1	1	107	147	2	0	-G
barcode89_consensus_vsearch	1485	G	G	256	1	0.39%	2	1	93	93	0.4999999999999138	1	1	107	149	0	1	A
barcode89_consensus_vsearch	1486	A	A	257	1	0.39%	2	1	93	93	0.4999999999999138	1	1	107	150	1	0	-C
barcode89_consensus_vsearch	1487	C	C	253	4	1.55%	2	1	93	93	0.0617697211064687	1	1	107	146	0	4	-G
barcode89_consensus_vsearch	1488	G	G	250	2	0.78%	2	1	93	93	0.2495029821073759	1	1	105	145	2	0	A
barcode89_consensus_vsearch	1489	G	G	258	1	0.39%	2	1	93	93	0.4999999999999138	1	1	109	149	0	1	A
barcode89_consensus_vsearch	1490	G	G	256	1	0.39%	2	1	93	93	0.4999999999999138	1	1	106	150	1	0	-T
barcode89_consensus_vsearch	1491	T	T	252	3	1.16%	2	2	93	93	0.12426326129665838	1	1	105	147	1	2	C
barcode89_consensus_vsearch	1492	C	C	253	2	0.78%	2	1	93	93	0.24950884086425928	1	1	105	148	2	0	A
barcode89_consensus_vsearch	1493	G	G	255	2	0.78%	2	1	93	93	0.2495126705651419	1	1	107	148	2	0	A
barcode89_consensus_vsearch	1494	C	C	250	4	1.56%	2	1	93	93	0.061761087351402955	1	1	106	144	0	4	T
barcode89_consensus_vsearch	1495	T	T	253	1	0.39%	2	1	93	93	0.5000000000003686	1	1	106	147	0	1	C
barcode89_consensus_vsearch	1496	T	T	253	2	0.78%	2	2	93	93	0.24950884086425928	1	1	105	148	1	1	C
barcode89_consensus_vsearch	1497	A	A	258	1	0.39%	2	1	93	93	0.4999999999999138	1	1	109	149	0	1	+G
barcode89_consensus_vsearch	1498	C	C	257	1	0.39%	2	1	93	93	0.4999999999999138	1	1	108	149	0	1	+A
barcode89_consensus_vsearch	1499	A	A	259	0	0%	2	0	93	0	1.0	1	0	109	150	0	0	
barcode89_consensus_vsearch	1500	A	A	259	0	0%	2	0	93	0	1.0	1	0	109	150	0	0	
barcode89_consensus_vsearch	1501	C	C	257	2	0.77%	2	1	93	93	0.24951644100587136	1	1	109	148	0	2	A
barcode89_consensus_vsearch	1502	C	C	255	2	0.77%	2	1	93	93	0.2495126705651419	1	1	107	148	0	2	-AT
barcode89_consensus_vsearch	1503	A	A	251	3	1.17%	2	2	93	93	0.12426035502961323	1	1	106	145	1	2	-T
barcode89_consensus_vsearch	1504	T	T	253	0	0%	2	0	93	0	1.0	1	0	108	145	0	0	
barcode89_consensus_vsearch	1505	T	T	255	3	1.16%	2	1	93	93	0.1242718446601877	1	1	109	146	0	3	C
barcode89_consensus_vsearch	1506	A	A	256	1	0.39%	2	1	93	93	0.4999999999999138	1	1	107	149	1	0	+C
barcode89_consensus_vsearch	1507	C	C	258	1	0.39%	2	1	93	93	0.4999999999999138	1	1	108	150	1	0	-G
barcode89_consensus_vsearch	1508	G	G	258	0	0%	2	0	93	0	1.0	1	0	108	150	0	0	
barcode89_consensus_vsearch	1509	C	C	257	1	0.39%	2	1	93	93	0.4999999999999138	1	1	108	149	0	1	+GC
barcode89_consensus_vsearch	1510	C	C	255	2	0.77%	2	1	93	93	0.2495126705651419	1	1	106	149	2	0	T
barcode89_consensus_vsearch	1511	A	A	256	1	0.39%	2	1	93	93	0.4999999999999138	1	1	106	150	1	0	+G
barcode89_consensus_vsearch	1512	G	G	257	1	0.39%	2	1	93	93	0.4999999999999138	1	1	107	150	1	0	A
barcode89_consensus_vsearch	1513	C	C	256	2	0.78%	2	1	93	93	0.24951456310670525	1	1	108	148	0	2	T
barcode89_consensus_vsearch	1514	A	A	258	0	0%	2	0	93	0	1.0	1	0	108	150	0	0	
barcode89_consensus_vsearch	1515	T	T	253	3	1.16%	2	1	93	93	0.124266144814075	1	1	104	149	3	0	-C
barcode89_consensus_vsearch	1516	C	C	254	2	0.78%	2	1	93	93	0.2495107632092758	1	1	106	148	0	2	+T
barcode89_consensus_vsearch	1517	C	C	255	3	1.16%	2	1	93	93	0.1242718446601877	1	1	109	146	0	3	-T
barcode89_consensus_vsearch	1518	T	T	250	4	1.57%	2	1	93	93	0.061761087351402955	1	1	108	142	0	4	C
barcode89_consensus_vsearch	1519	A	A	256	1	0.39%	2	1	93	93	0.4999999999999138	1	1	107	149	1	0	G
barcode89_consensus_vsearch	1520	G	G	258	0	0%	2	0	93	0	1.0	1	0	108	150	0	0	
barcode89_consensus_vsearch	1521	C	C	256	1	0.39%	2	1	93	93	0.4999999999999138	1	1	107	149	1	0	+TT
barcode89_consensus_vsearch	1522	C	Y	244	7	2.71%	2	2	93	93	0.00748830460110489	1	1	104	140	3	4	T
barcode89_consensus_vsearch	1523	G	G	251	1	0.39%	2	1	93	93	0.5000000000003686	1	1	106	145	0	1	-A
barcode89_consensus_vsearch	1524	A	A	251	2	0.79%	2	1	93	93	0.24950495049494414	1	1	107	144	0	2	+T
barcode89_consensus_vsearch	1525	A	A	255	1	0.39%	2	1	93	93	0.4999999999999138	1	1	107	148	0	1	+G
barcode89_consensus_vsearch	1526	G	G	254	1	0.39%	2	1	93	93	0.4999999999999138	1	1	108	146	1	0	+A
barcode89_consensus_vsearch	1527	C	C	248	3	1.16%	2	1	93	93	0.12425149700602607	1	1	108	140	0	3	+A
barcode89_consensus_vsearch	1528	G	G	249	6	2.33%	2	2	93	93	0.015167261137354384	1	1	107	142	1	5	-CG
barcode89_consensus_vsearch	1529	C	C	243	4	1.59%	2	2	93	93	0.061740125504571274	1	1	106	137	1	3	T
barcode89_consensus_vsearch	1530	G	G	248	1	0.4%	2	1	93	93	0.4999999999999138	1	1	107	141	0	1	+CG
barcode89_consensus_vsearch	1531	G	G	256	1	0.39%	2	1	93	93	0.4999999999999138	1	1	109	147	0	1	-T
barcode89_consensus_vsearch	1532	T	T	253	3	1.16%	2	1	93	93	0.124266144814075	1	1	108	145	0	3	+C
barcode89_consensus_vsearch	1533	C	C	253	1	0.39%	2	1	93	93	0.5000000000003686	1	1	106	147	1	0	+A
barcode89_consensus_vsearch	1534	C	C	251	3	1.16%	2	1	93	93	0.12426035502961323	1	1	107	144	0	3	-T
barcode89_consensus_vsearch	1535	T	T	248	5	1.96%	2	2	93	93	0.030633033482245435	1	1	106	142	2	3	C
barcode89_consensus_vsearch	1536	C	C	253	2	0.78%	2	1	93	93	0.24950884086425928	1	1	109	144	0	2	-G
barcode89_consensus_vsearch	1537	G	R	248	8	3.11%	2	2	93	93	0.0036953503162476236	1	1	104	144	5	3	A
barcode89_consensus_vsearch	1538	G	G	259	0	0%	2	0	93	0	1.0	1	0	109	150	0	0	
barcode89_consensus_vsearch	1539	T	T	253	4	1.54%	2	2	93	93	0.0617697211064687	1	1	105	148	2	2	-C
barcode89_consensus_vsearch	1540	C	C	255	0	0%	2	0	93	0	1.0	1	0	107	148	0	0	
barcode89_consensus_vsearch	1541	C	C	257	1	0.39%	2	1	93	93	0.4999999999999138	1	1	109	148	0	1	A
barcode89_consensus_vsearch	1542	C	C	256	1	0.39%	2	1	93	93	0.4999999999999138	1	1	109	147	0	1	+T
barcode89_consensus_vsearch	1543	A	A	251	4	1.55%	2	2	93	93	0.06176398786346276	1	1	107	144	2	2	G
barcode89_consensus_vsearch	1544	G	G	253	2	0.78%	2	1	93	93	0.24950884086425928	1	1	108	145	0	2	-TAG
barcode89_consensus_vsearch	1545	T	T	249	3	1.18%	2	2	93	93	0.12425447316115633	1	1	105	144	1	2	C
barcode89_consensus_vsearch	1546	A	A	252	2	0.78%	2	2	93	93	0.2495069033532105	1	1	107	145	1	1	-G
barcode89_consensus_vsearch	1547	G	G	253	0	0%	2	0	93	0	1.0	1	0	108	145	0	0	
barcode89_consensus_vsearch	1548	G	G	256	1	0.39%	2	1	93	93	0.4999999999999138	1	1	108	148	1	0	A
barcode89_consensus_vsearch	1549	C	C	252	2	0.78%	2	1	93	93	0.2495069033532105	1	1	107	145	0	2	-G
barcode89_consensus_vsearch	1550	G	G	252	1	0.4%	2	1	93	93	0.5000000000003686	1	1	107	145	0	1	+T
barcode89_consensus_vsearch	1551	G	G	256	1	0.39%	2	1	93	93	0.4999999999999138	1	1	107	149	0	1	A
barcode89_consensus_vsearch	1552	C	C	256	1	0.39%	2	1	93	93	0.4999999999999138	1	1	107	149	0	1	T
barcode89_consensus_vsearch	1553	A	A	258	1	0.39%	2	1	93	93	0.4999999999999138	1	1	108	150	1	0	G
barcode89_consensus_vsearch	1554	T	T	255	3	1.16%	2	2	93	93	0.1242718446601877	1	1	107	148	2	1	C
barcode89_consensus_vsearch	1555	T	T	257	1	0.39%	2	1	93	93	0.4999999999999138	1	1	109	148	0	1	+GG
barcode89_consensus_vsearch	1556	G	G	254	3	1.16%	2	2	93	93	0.12426900584791233	1	1	106	148	2	1	A
barcode89_consensus_vsearch	1557	C	C	254	2	0.77%	2	1	93	93	0.2495107632092758	1	1	107	147	0	2	+A
barcode89_consensus_vsearch	1558	A	A	252	3	1.17%	2	2	93	93	0.12426326129665838	1	1	104	148	1	2	G
barcode89_consensus_vsearch	1559	C	C	251	3	1.17%	2	1	93	93	0.12426035502961323	1	1	106	145	0	3	T
barcode89_consensus_vsearch	1560	C	C	256	2	0.77%	2	2	93	93	0.24951456310670525	1	1	107	149	1	1	T
barcode89_consensus_vsearch	1561	G	G	255	2	0.77%	2	1	93	93	0.2495126705651419	1	1	107	148	0	2	-TG
barcode89_consensus_vsearch	1562	T	T	253	2	0.78%	2	1	93	93	0.24950884086425928	1	1	106	147	2	0	+A
barcode89_consensus_vsearch	1563	G	G	254	2	0.78%	2	1	93	93	0.2495107632092758	1	1	107	147	2	0	-A
barcode89_consensus_vsearch	1564	A	A	251	4	1.56%	2	2	93	93	0.06176398786346276	1	1	102	149	3	1	-G
barcode89_consensus_vsearch	1565	G	G	252	1	0.39%	2	1	93	93	0.5000000000003686	1	1	105	147	0	1	+T
barcode89_consensus_vsearch	1566	C	C	254	2	0.78%	2	2	93	93	0.2495107632092758	1	1	106	148	1	1	-T
barcode89_consensus_vsearch	1567	T	T	254	2	0.78%	2	1	93	93	0.2495107632092758	1	1	107	147	0	2	C
barcode89_consensus_vsearch	1568	A	A	256	1	0.39%	2	1	93	93	0.4999999999999138	1	1	108	148	0	1	-T
barcode89_consensus_vsearch	1569	T	T	255	1	0.39%	2	1	93	93	0.4999999999999138	1	1	108	147	0	1	-A
barcode89_consensus_vsearch	1570	A	A	255	1	0.39%	2	1	93	93	0.4999999999999138	1	1	108	147	0	1	C
barcode89_consensus_vsearch	1571	A	A	257	1	0.39%	2	1	93	93	0.4999999999999138	1	1	107	150	1	0	G
barcode89_consensus_vsearch	1572	C	C	253	3	1.16%	2	1	93	93	0.124266144814075	1	1	104	149	3	0	-A
barcode89_consensus_vsearch	1573	A	A	247	4	1.56%	2	1	93	93	0.061752247008950906	1	1	105	142	0	4	+C
barcode89_consensus_vsearch	1574	C	*/-T	242	10	3.91%	2	1	93	93	8.916130618494134E-4	1	1	108	134	0	10	-T
barcode89_consensus_vsearch	1575	T	*/-C	216	21	8.47%	2	2	93	93	3.000511080365251E-7	1	1	91	125	16	5	-C
barcode89_consensus_vsearch	1576	C	C	227	2	0.87%	2	1	93	93	0.24945295404843976	1	1	92	135	0	2	T
barcode89_consensus_vsearch	1577	C	Y	230	12	4.78%	2	1	93	93	2.1231016338203528E-4	1	1	106	124	0	12	T
barcode89_consensus_vsearch	1578	G	G	243	5	1.95%	2	1	93	93	0.030620607699729043	1	1	94	149	5	0	+A
barcode89_consensus_vsearch	1579	A	A	248	2	0.8%	2	1	93	93	0.24949899799584363	1	1	98	150	2	0	G
barcode89_consensus_vsearch	1580	A	A	250	3	1.18%	2	1	93	93	0.12425742574263329	1	1	100	150	3	0	G
barcode89_consensus_vsearch	1581	G	G	250	2	0.79%	2	2	93	93	0.2495029821073759	1	1	102	148	1	1	-A
barcode89_consensus_vsearch	1582	A	A	251	2	0.78%	2	1	93	93	0.24950495049494414	1	1	104	147	2	0	-G
barcode89_consensus_vsearch	1583	G	G	250	2	0.79%	2	1	93	93	0.2495029821073759	1	1	104	146	0	2	-C
barcode89_consensus_vsearch	1584	C	C	253	1	0.39%	2	1	93	93	0.5000000000003686	1	1	108	145	1	0	A
barcode89_consensus_vsearch	1585	C	C	252	4	1.55%	2	1	93	93	0.06176686569346045	1	1	109	143	0	4	T
barcode89_consensus_vsearch	1586	A	*/-CA	243	10	3.88%	2	2	93	93	8.91940019333984E-4	1	1	100	143	8	2	-CA
barcode89_consensus_vsearch	1587	C	C	245	1	0.4%	2	1	93	93	0.4999999999999138	1	1	100	145	1	0	+GC
barcode89_consensus_vsearch	1588	A	A	244	2	0.81%	2	1	93	93	0.24949083503056865	1	1	101	143	0	2	G
barcode89_consensus_vsearch	1589	T	T	256	3	1.16%	2	1	93	93	0.12427466150865948	1	1	109	147	0	3	C
barcode89_consensus_vsearch	1590	T	T	253	4	1.54%	2	1	93	93	0.0617697211064687	1	1	109	144	0	4	-C
barcode89_consensus_vsearch	1591	C	C	252	2	0.78%	2	1	93	93	0.2495069033532105	1	1	109	143	0	2	-TC
barcode89_consensus_vsearch	1592	T	T	255	1	0.39%	2	1	93	93	0.4999999999999138	1	1	109	146	0	1	-C
barcode89_consensus_vsearch	1593	C	C	253	1	0.39%	2	1	93	93	0.5000000000003686	1	1	108	145	0	1	+G
barcode89_consensus_vsearch	1594	A	A	246	5	1.95%	2	2	93	93	0.03062812251247695	1	1	102	144	2	3	-CA
barcode89_consensus_vsearch	1595	C	C	252	1	0.4%	2	1	93	93	0.5000000000003686	1	1	105	147	1	0	G
barcode89_consensus_vsearch	1596	A	A	251	2	0.79%	2	2	93	93	0.24950495049494414	1	1	105	146	1	1	G
barcode89_consensus_vsearch	1597	G	G	254	3	1.16%	2	2	93	93	0.12426900584791233	1	1	106	148	1	2	-C
barcode89_consensus_vsearch	1598	C	C	254	2	0.78%	2	1	93	93	0.2495107632092758	1	1	108	146	0	2	+T
barcode89_consensus_vsearch	1599	C	*/-T	249	7	2.7%	2	2	93	93	0.007494585982750822	1	1	107	142	1	6	-T
barcode89_consensus_vsearch	1600	T	T	251	0	0%	2	0	93	0	1.0	1	0	107	144	0	0	
barcode89_consensus_vsearch	1601	T	T	257	1	0.39%	2	1	93	93	0.4999999999999138	1	1	107	150	1	0	A
barcode89_consensus_vsearch	1602	T	T	257	1	0.39%	2	1	93	93	0.4999999999999138	1	1	108	149	0	1	+GT
barcode89_consensus_vsearch	1603	A	A	259	0	0%	2	0	93	0	1.0	1	0	109	150	0	0	
barcode89_consensus_vsearch	1604	T	T	252	6	2.32%	2	1	93	93	0.015172562563020547	1	1	102	150	6	0	-C
barcode89_consensus_vsearch	1605	C	C	253	0	0%	2	0	93	0	1.0	1	0	103	150	0	0	
barcode89_consensus_vsearch	1606	C	C	258	1	0.39%	2	1	93	93	0.4999999999999138	1	1	109	149	0	1	T
barcode89_consensus_vsearch	1607	C	C	257	1	0.39%	2	1	93	93	0.4999999999999138	1	1	108	149	1	0	-AC
barcode89_consensus_vsearch	1608	A	A	256	2	0.78%	2	2	93	93	0.24951456310670525	1	1	107	149	1	1	-C
barcode89_consensus_vsearch	1609	C	C	256	0	0%	2	0	93	0	1.0	1	0	107	149	0	0	
barcode89_consensus_vsearch	1610	C	C	259	0	0%	2	0	93	0	1.0	1	0	109	150	0	0	
barcode89_consensus_vsearch	1611	A	A	257	2	0.77%	2	1	93	93	0.24951644100587136	1	1	109	148	0	2	G
barcode89_consensus_vsearch	1612	C	C	258	1	0.39%	2	1	93	93	0.4999999999999138	1	1	109	149	0	1	T
barcode89_consensus_vsearch	1613	T	T	254	2	0.77%	2	2	93	93	0.2495107632092758	1	1	106	148	1	1	C
barcode89_consensus_vsearch	1614	G	G	253	2	0.78%	2	1	93	93	0.24950884086425928	1	1	106	147	0	2	+A
barcode89_consensus_vsearch	1615	A	A	256	3	1.16%	2	1	93	93	0.12427466150865948	1	1	109	147	0	3	G
barcode89_consensus_vsearch	1616	A	A	257	1	0.39%	2	1	93	93	0.4999999999999138	1	1	108	149	1	0	G
barcode89_consensus_vsearch	1617	A	A	253	5	1.93%	2	2	93	93	0.030644978141142375	1	1	106	147	3	2	G
barcode89_consensus_vsearch	1618	C	C	257	1	0.39%	2	1	93	93	0.4999999999999138	1	1	108	149	0	1	+GC
barcode89_consensus_vsearch	1619	C	C	254	3	1.16%	2	2	93	93	0.12426900584791233	1	1	106	148	1	2	T
barcode89_consensus_vsearch	1620	G	G	255	2	0.78%	2	1	93	93	0.2495126705651419	1	1	107	148	0	2	A
barcode89_consensus_vsearch	1621	A	A	256	2	0.78%	2	1	93	93	0.24951456310670525	1	1	106	150	2	0	G
barcode89_consensus_vsearch	1622	T	T	259	0	0%	2	0	93	0	1.0	1	0	109	150	0	0	
barcode89_consensus_vsearch	1623	G	G	255	2	0.77%	2	2	93	93	0.2495126705651419	1	1	107	148	1	1	A
barcode89_consensus_vsearch	1624	C	C	254	2	0.77%	2	1	93	93	0.2495107632092758	1	1	108	146	0	2	T
barcode89_consensus_vsearch	1625	T	T	251	1	0.39%	2	1	93	93	0.5000000000003686	1	1	108	143	0	1	+G
barcode89_consensus_vsearch	1626	G	G	255	1	0.39%	2	1	93	93	0.4999999999999138	1	1	108	147	0	1	C
barcode89_consensus_vsearch	1627	G	G	251	5	1.95%	2	1	93	93	0.03064025621010106	1	1	103	148	5	0	-C
barcode89_consensus_vsearch	1628	C	C	248	2	0.79%	2	2	93	93	0.24949899799584363	1	1	102	146	1	1	+A
barcode89_consensus_vsearch	1629	C	C	257	1	0.39%	2	1	93	93	0.4999999999999138	1	1	108	149	1	0	+AC
barcode89_consensus_vsearch	1630	T	T	251	3	1.16%	2	1	93	93	0.12426035502961323	1	1	104	147	3	0	A
barcode89_consensus_vsearch	1631	G	G	257	1	0.39%	2	1	93	93	0.4999999999999138	1	1	107	150	1	0	+A
barcode89_consensus_vsearch	1632	A	A	256	1	0.39%	2	1	93	93	0.4999999999999138	1	1	106	150	1	0	+G
barcode89_consensus_vsearch	1633	A	A	255	3	1.16%	2	1	93	93	0.1242718446601877	1	1	105	150	3	0	G
barcode89_consensus_vsearch	1634	G	G	257	1	0.39%	2	1	93	93	0.4999999999999138	1	1	108	149	0	1	+A
barcode89_consensus_vsearch	1635	A	A	255	4	1.54%	2	1	93	93	0.06177536572082746	1	1	105	150	4	0	G
barcode89_consensus_vsearch	1636	C	C	258	1	0.39%	2	1	93	93	0.4999999999999138	1	1	108	150	1	0	+T
barcode89_consensus_vsearch	1637	G	G	259	0	0%	2	0	93	0	1.0	1	0	109	150	0	0	
barcode89_consensus_vsearch	1638	A	A	253	4	1.54%	2	1	93	93	0.0617697211064687	1	1	107	146	0	4	-T
barcode89_consensus_vsearch	1639	T	T	248	3	1.18%	2	1	93	93	0.12425149700602607	1	1	104	144	3	0	+C
barcode89_consensus_vsearch	1640	C	C	246	3	1.16%	2	2	93	93	0.1242454728369122	1	1	102	144	2	1	+A
barcode89_consensus_vsearch	1641	G	G	249	3	1.17%	2	1	93	93	0.12425447316115633	1	1	100	149	3	0	+A
barcode89_consensus_vsearch	1642	A	A	254	1	0.39%	2	1	93	93	0.4999999999999138	1	1	106	148	0	1	G
barcode89_consensus_vsearch	1643	G	G	252	4	1.54%	2	1	93	93	0.06176686569346045	1	1	107	145	0	4	-T
barcode89_consensus_vsearch	1644	T	T	252	1	0.39%	2	1	93	93	0.5000000000003686	1	1	108	144	1	0	A
barcode89_consensus_vsearch	1645	G	G	258	1	0.39%	2	1	93	93	0.4999999999999138	1	1	109	149	0	1	+AG
barcode89_consensus_vsearch	1646	C	C	256	1	0.39%	2	1	93	93	0.4999999999999138	1	1	107	149	1	0	-AC
barcode89_consensus_vsearch	1647	A	A	249	6	2.33%	2	2	93	93	0.015167261137354384	1	1	105	144	1	5	-C
barcode89_consensus_vsearch	1648	C	C	250	1	0.4%	2	1	93	93	0.4999999999999138	1	1	106	144	0	1	A
barcode89_consensus_vsearch	1649	C	*/-G	204	46	17.83%	2	2	93	93	1.4520299623547088E-15	1	1	89	115	16	30	-G
barcode89_consensus_vsearch	1650	G	G	199	5	2.39%	2	1	93	93	0.03048503048502578	1	1	87	112	0	5	T
barcode89_consensus_vsearch	1651	G	G	250	5	1.96%	2	1	93	93	0.030637867497453432	1	1	102	148	5	0	A
barcode89_consensus_vsearch	1652	G	G	255	1	0.39%	2	1	93	93	0.4999999999999138	1	1	108	147	1	0	A
barcode89_consensus_vsearch	1653	G	G	258	1	0.39%	2	1	93	93	0.4999999999999138	1	1	108	150	1	0	A
barcode89_consensus_vsearch	1654	A	A	258	1	0.39%	2	1	93	93	0.4999999999999138	1	1	109	149	0	1	-GAACCCCGGA
barcode89_consensus_vsearch	1655	G	G	256	2	0.78%	2	1	93	93	0.24951456310670525	1	1	107	149	2	0	-AAC
barcode89_consensus_vsearch	1656	A	A	254	2	0.78%	2	2	93	93	0.2495107632092758	1	1	106	148	1	1	G
barcode89_consensus_vsearch	1657	A	*/-C	217	32	12.5%	2	2	93	93	8.033990528976054E-11	1	1	89	128	14	18	-C
barcode89_consensus_vsearch	1658	C	C	217	4	1.81%	2	1	93	93	0.0616506283607095	1	1	91	126	0	4	+T
barcode89_consensus_vsearch	1659	C	C	248	2	0.78%	2	1	93	93	0.24949899799584363	1	1	105	143	0	2	+T
barcode89_consensus_vsearch	1660	C	Y	238	10	3.89%	2	2	93	93	8.902795873314557E-4	1	1	104	134	1	9	T
barcode89_consensus_vsearch	1661	C	*/-G	213	24	9.3%	2	2	93	93	3.2291486714684166E-8	1	1	107	106	1	23	-G
barcode89_consensus_vsearch	1662	G	K	216	14	6.01%	2	1	93	93	4.97799291733799E-5	1	1	106	110	0	14	T
barcode89_consensus_vsearch	1663	G	G	256	1	0.39%	2	1	93	93	0.4999999999999138	1	1	109	147	0	1	A
barcode89_consensus_vsearch	1664	A	A	255	2	0.78%	2	1	93	93	0.2495126705651419	1	1	108	147	0	2	-T
barcode89_consensus_vsearch	1665	T	T	253	2	0.78%	2	1	93	93	0.24950884086425928	1	1	108	145	0	2	C
barcode89_consensus_vsearch	1666	G	G	256	2	0.78%	2	1	93	93	0.24951456310670525	1	1	108	148	0	2	C
barcode89_consensus_vsearch	1667	A	A	258	1	0.39%	2	1	93	93	0.4999999999999138	1	1	108	150	1	0	G
barcode89_consensus_vsearch	1668	T	T	252	4	1.54%	2	1	93	93	0.06176686569346045	1	1	106	146	0	4	C
barcode89_consensus_vsearch	1669	C	C	258	1	0.39%	2	1	93	93	0.4999999999999138	1	1	109	149	0	1	+A
barcode89_consensus_vsearch	1670	A	A	259	0	0%	2	0	93	0	1.0	1	0	109	150	0	0	
barcode89_consensus_vsearch	1671	A	A	255	3	1.16%	2	2	93	93	0.1242718446601877	1	1	107	148	2	1	G
barcode89_consensus_vsearch	1672	C	C	256	1	0.39%	2	1	93	93	0.4999999999999138	1	1	108	148	1	0	+AAC
barcode89_consensus_vsearch	1673	C	C	254	2	0.77%	2	2	93	93	0.2495107632092758	1	1	106	148	1	1	-GCC
barcode89_consensus_vsearch	1674	G	G	251	4	1.56%	2	1	93	93	0.06176398786346276	1	1	103	148	4	0	A
barcode89_consensus_vsearch	1675	C	C	253	1	0.39%	2	1	93	93	0.5000000000003686	1	1	107	146	0	1	+T
barcode89_consensus_vsearch	1676	C	C	255	1	0.39%	2	1	93	93	0.4999999999999138	1	1	107	148	1	0	A
barcode89_consensus_vsearch	1677	T	Y	250	8	3.09%	2	2	93	93	0.0036969641636293116	1	1	108	142	1	7	C
barcode89_consensus_vsearch	1678	G	G	256	1	0.39%	2	1	93	93	0.4999999999999138	1	1	109	147	0	1	-C
barcode89_consensus_vsearch	1679	C	C	253	3	1.16%	2	2	93	93	0.124266144814075	1	1	105	148	2	1	+A
barcode89_consensus_vsearch	1680	A	A	256	1	0.39%	2	1	93	93	0.4999999999999138	1	1	106	150	1	0	+CA
barcode89_consensus_vsearch	1681	A	A	258	1	0.39%	2	1	93	93	0.4999999999999138	1	1	109	149	0	1	T
barcode89_consensus_vsearch	1682	G	G	257	1	0.39%	2	1	93	93	0.4999999999999138	1	1	109	148	0	1	+T
barcode89_consensus_vsearch	1683	T	T	255	2	0.78%	2	1	93	93	0.2495126705651419	1	1	108	147	0	2	C
barcode89_consensus_vsearch	1684	C	C	257	1	0.39%	2	1	93	93	0.4999999999999138	1	1	109	148	0	1	+AT
barcode89_consensus_vsearch	1685	T	T	256	1	0.39%	2	1	93	93	0.4999999999999138	1	1	109	147	0	1	-G
barcode89_consensus_vsearch	1686	G	G	257	1	0.39%	2	1	93	93	0.4999999999999138	1	1	109	148	0	1	C
barcode89_consensus_vsearch	1687	A	A	256	2	0.77%	2	1	93	93	0.24951456310670525	1	1	107	149	2	0	G
barcode89_consensus_vsearch	1688	T	T	256	3	1.16%	2	2	93	93	0.12427466150865948	1	1	108	148	1	2	C
barcode89_consensus_vsearch	1689	T	T	257	1	0.39%	2	1	93	93	0.4999999999999138	1	1	109	148	0	1	+CAG
barcode89_consensus_vsearch	1690	G	G	252	6	2.32%	2	1	93	93	0.015172562563020547	1	1	103	149	6	0	A
barcode89_consensus_vsearch	1691	C	C	254	2	0.77%	2	2	93	93	0.2495107632092758	1	1	107	147	1	1	-A
barcode89_consensus_vsearch	1692	A	A	254	1	0.39%	2	1	93	93	0.4999999999999138	1	1	106	148	1	0	C
barcode89_consensus_vsearch	1693	A	A	257	1	0.39%	2	1	93	93	0.4999999999999138	1	1	109	148	0	1	G
barcode89_consensus_vsearch	1694	G	G	256	2	0.77%	2	1	93	93	0.24951456310670525	1	1	107	149	2	0	A
barcode89_consensus_vsearch	1695	C	C	256	1	0.39%	2	1	93	93	0.4999999999999138	1	1	107	149	1	0	-G
barcode89_consensus_vsearch	1696	G	G	254	3	1.17%	2	2	93	93	0.12426900584791233	1	1	105	149	2	1	A
barcode89_consensus_vsearch	1697	C	C	249	3	1.16%	2	1	93	93	0.12425447316115633	1	1	106	143	0	3	-T
barcode89_consensus_vsearch	1698	T	Y	241	9	3.59%	2	1	93	93	0.0018151750748872056	1	1	108	133	0	9	C
barcode89_consensus_vsearch	1699	T	*/-C	180	43	16.93%	2	2	93	93	1.2077896720994002E-14	1	1	92	88	10	33	-C
barcode89_consensus_vsearch	1700	C	C	204	1	0.49%	2	1	93	93	0.5000000000001412	1	1	98	106	0	1	+TCC
barcode89_consensus_vsearch	1701	C	C	248	2	0.8%	2	1	93	93	0.24949899799584363	1	1	109	139	0	2	+T
barcode89_consensus_vsearch	1702	C	*/-T	235	13	5.02%	2	1	93	93	1.0388201196169096E-4	1	1	105	130	0	13	-T
barcode89_consensus_vsearch	1703	T	T	240	2	0.82%	2	2	93	93	0.24948240165631827	1	1	106	134	1	1	C
barcode89_consensus_vsearch	1704	T	T	253	4	1.56%	2	2	93	93	0.0617697211064687	1	1	105	148	3	1	C
barcode89_consensus_vsearch	1705	T	*/+C	252	7	2.7%	2	1	93	93	0.007498239332403135	1	1	102	150	7	0	+C
barcode89_consensus_vsearch	1706	C	C	255	2	0.77%	2	1	93	93	0.2495126705651419	1	1	109	146	0	2	+A
barcode89_consensus_vsearch	1707	A	A	257	1	0.39%	2	1	93	93	0.4999999999999138	1	1	108	149	1	0	G
barcode89_consensus_vsearch	1708	A	A	256	2	0.77%	2	1	93	93	0.24951456310670525	1	1	107	149	2	0	G
barcode89_consensus_vsearch	1709	C	C	252	3	1.16%	2	1	93	93	0.12426326129665838	1	1	109	143	0	3	T
barcode89_consensus_vsearch	1710	A	A	255	1	0.39%	2	1	93	93	0.4999999999999138	1	1	109	146	0	1	+C
barcode89_consensus_vsearch	1711	A	A	253	3	1.16%	2	2	93	93	0.124266144814075	1	1	107	146	2	1	-T
barcode89_consensus_vsearch	1712	T	T	253	2	0.78%	2	1	93	93	0.24950884086425928	1	1	107	146	0	2	C
barcode89_consensus_vsearch	1713	T	T	255	2	0.78%	2	2	93	93	0.2495126705651419	1	1	108	147	1	1	C
barcode89_consensus_vsearch	1714	T	T	253	4	1.55%	2	2	93	93	0.0617697211064687	1	1	108	145	1	3	C
barcode89_consensus_vsearch	1715	C	C	254	1	0.39%	2	1	93	93	0.4999999999999138	1	1	106	148	0	1	+A
barcode89_consensus_vsearch	1716	A	A	254	2	0.78%	2	1	93	93	0.2495107632092758	1	1	104	150	2	0	G
barcode89_consensus_vsearch	1717	C	C	254	1	0.39%	2	1	93	93	0.4999999999999138	1	1	106	148	1	0	+A
barcode89_consensus_vsearch	1718	G	G	255	2	0.78%	2	1	93	93	0.2495126705651419	1	1	105	150	2	0	A
barcode89_consensus_vsearch	1719	T	T	252	4	1.55%	2	2	93	93	0.06176686569346045	1	1	107	145	1	3	C
barcode89_consensus_vsearch	1720	A	A	257	1	0.39%	2	1	93	93	0.4999999999999138	1	1	107	150	1	0	+TG
barcode89_consensus_vsearch	1721	C	C	258	1	0.39%	2	1	93	93	0.4999999999999138	1	1	109	149	0	1	-TGTTT
barcode89_consensus_vsearch	1722	T	T	256	2	0.78%	2	2	93	93	0.24951456310670525	1	1	108	148	1	1	C
barcode89_consensus_vsearch	1723	G	G	253	3	1.16%	2	2	93	93	0.124266144814075	1	1	105	148	2	1	+T
barcode89_consensus_vsearch	1724	T	T	255	2	0.78%	2	2	93	93	0.2495126705651419	1	1	107	148	1	1	C
barcode89_consensus_vsearch	1725	T	T	256	1	0.39%	2	1	93	93	0.4999999999999138	1	1	107	149	1	0	+ATT
barcode89_consensus_vsearch	1726	T	T	253	2	0.78%	2	1	93	93	0.24950884086425928	1	1	107	146	0	2	-A
barcode89_consensus_vsearch	1727	A	A	256	1	0.39%	2	1	93	93	0.4999999999999138	1	1	109	147	0	1	C
barcode89_consensus_vsearch	1728	A	A	256	2	0.77%	2	1	93	93	0.24951456310670525	1	1	109	147	0	2	+T
barcode89_consensus_vsearch	1729	C	C	250	6	2.33%	2	1	93	93	0.015169042029074849	1	1	109	141	0	6	-T
barcode89_consensus_vsearch	1730	T	T	249	2	0.79%	2	1	93	93	0.24950099800389156	1	1	109	140	0	2	-C
barcode89_consensus_vsearch	1731	C	C	252	2	0.78%	2	1	93	93	0.2495069033532105	1	1	109	143	0	2	-T
barcode89_consensus_vsearch	1732	T	*/-CT	189	34	13.28%	2	1	93	93	1.491728201551484E-11	1	1	108	81	0	34	-CT
barcode89_consensus_vsearch	1733	C	*/-T	161	30	15.38%	2	1	93	93	2.707298723056385E-10	1	1	107	54	0	30	-T
barcode89_consensus_vsearch	1734	T	T	161	2	1.21%	2	1	93	93	0.24923076923086654	1	1	108	53	0	2	+C
barcode89_consensus_vsearch	1735	T	T	228	1	0.44%	2	1	93	93	0.4999999999999138	1	1	109	119	0	1	C
barcode89_consensus_vsearch	1736	T	T	250	6	2.33%	2	2	93	93	0.015169042029074849	1	1	103	147	5	1	-C
barcode89_consensus_vsearch	1737	C	C	250	1	0.4%	2	1	93	93	0.4999999999999138	1	1	102	148	1	0	T
barcode89_consensus_vsearch	1738	C	*/-A	238	8	3.1%	2	1	93	93	0.0036868928614731586	1	1	93	145	8	0	-A
barcode89_consensus_vsearch	1739	A	A	244	1	0.4%	2	1	93	93	0.4999999999999138	1	1	99	145	1	0	+G
barcode89_consensus_vsearch	1740	A	A	254	1	0.39%	2	1	93	93	0.4999999999999138	1	1	109	145	0	1	G
barcode89_consensus_vsearch	1741	A	A	256	1	0.39%	2	1	93	93	0.4999999999999138	1	1	107	149	1	0	+T
barcode89_consensus_vsearch	1742	G	G	255	2	0.78%	2	1	93	93	0.2495126705651419	1	1	106	149	2	0	T
barcode89_consensus_vsearch	1743	T	T	256	2	0.78%	2	2	93	93	0.24951456310670525	1	1	108	148	1	1	C
barcode89_consensus_vsearch	1744	G	G	255	1	0.39%	2	1	93	93	0.4999999999999138	1	1	107	148	0	1	+TG
barcode89_consensus_vsearch	1745	C	*/-T	241	12	4.63%	2	2	93	93	2.1363402075967646E-4	1	1	100	141	6	6	-T
barcode89_consensus_vsearch	1746	T	T	246	1	0.4%	2	1	93	93	0.5000000000003686	1	1	103	143	0	1	C
barcode89_consensus_vsearch	1747	T	T	256	2	0.77%	2	2	93	93	0.24951456310670525	1	1	108	148	1	1	C
barcode89_consensus_vsearch	1748	T	T	255	2	0.77%	2	1	93	93	0.2495126705651419	1	1	109	146	0	2	+CT
barcode89_consensus_vsearch	1749	T	T	256	2	0.77%	2	1	93	93	0.24951456310670525	1	1	109	147	0	2	C
barcode89_consensus_vsearch	1750	C	C	257	1	0.39%	2	1	93	93	0.4999999999999138	1	1	108	149	1	0	T
barcode89_consensus_vsearch	1751	A	A	256	2	0.77%	2	1	93	93	0.24951456310670525	1	1	109	147	0	2	-T
barcode89_consensus_vsearch	1752	T	T	256	1	0.39%	2	1	93	93	0.4999999999999138	1	1	108	148	1	0	+C
barcode89_consensus_vsearch	1753	C	*/-T	249	7	2.7%	2	1	93	93	0.007494585982750822	1	1	109	140	0	7	-T
barcode89_consensus_vsearch	1754	T	T	251	0	0%	2	0	93	0	1.0	1	0	109	142	0	0	
barcode89_consensus_vsearch	1755	T	T	258	0	0%	2	0	93	0	1.0	1	0	109	149	0	0	
barcode89_consensus_vsearch	1756	T	T	255	2	0.77%	2	1	93	93	0.2495126705651419	1	1	107	148	2	0	+C
barcode89_consensus_vsearch	1757	C	C	252	2	0.78%	2	1	93	93	0.2495069033532105	1	1	107	145	0	2	+G
barcode89_consensus_vsearch	1758	G	G	259	0	0%	2	0	93	0	1.0	1	0	109	150	0	0	
barcode89_consensus_vsearch	1759	A	A	258	1	0.39%	2	1	93	93	0.4999999999999138	1	1	109	149	0	1	+C
barcode89_consensus_vsearch	1760	T	T	253	3	1.16%	2	1	93	93	0.124266144814075	1	1	106	147	3	0	+C
barcode89_consensus_vsearch	1761	C	C	254	2	0.78%	2	1	93	93	0.2495107632092758	1	1	106	148	2	0	-A
barcode89_consensus_vsearch	1762	A	A	253	2	0.78%	2	1	93	93	0.24950884086425928	1	1	107	146	0	2	G
barcode89_consensus_vsearch	1763	C	C	255	1	0.39%	2	1	93	93	0.4999999999999138	1	1	109	146	0	1	+T
barcode89_consensus_vsearch	1764	T	T	255	1	0.39%	2	1	93	93	0.4999999999999138	1	1	108	147	0	1	+GG
barcode89_consensus_vsearch	1765	C	C	252	4	1.55%	2	1	93	93	0.06176686569346045	1	1	109	143	0	4	+T
barcode89_consensus_vsearch	1766	T	T	253	2	0.78%	2	2	93	93	0.24950884086425928	1	1	108	145	1	1	C
barcode89_consensus_vsearch	1767	A	A	254	4	1.54%	2	2	93	93	0.06177255436325217	1	1	106	148	3	1	G
barcode89_consensus_vsearch	1768	C	Y	246	7	2.7%	2	1	93	93	0.007490846702557751	1	1	109	137	0	7	T
barcode89_consensus_vsearch	1769	T	T	255	2	0.78%	2	1	93	93	0.2495126705651419	1	1	109	146	0	2	C
barcode89_consensus_vsearch	1770	T	T	257	1	0.39%	2	1	93	93	0.4999999999999138	1	1	108	149	1	0	+A
barcode89_consensus_vsearch	1771	G	G	257	1	0.39%	2	1	93	93	0.4999999999999138	1	1	108	149	0	1	-T
barcode89_consensus_vsearch	1772	T	T	255	1	0.39%	2	1	93	93	0.4999999999999138	1	1	108	147	1	0	+AT
barcode89_consensus_vsearch	1773	G	G	254	3	1.16%	2	2	93	93	0.12426900584791233	1	1	105	149	2	1	A
barcode89_consensus_vsearch	1774	C	C	256	1	0.39%	2	1	93	93	0.4999999999999138	1	1	108	148	0	1	+G
barcode89_consensus_vsearch	1775	G	G	256	1	0.39%	2	1	93	93	0.4999999999999138	1	1	106	150	1	0	+CC
barcode89_consensus_vsearch	1776	C	C	256	1	0.39%	2	1	93	93	0.4999999999999138	1	1	107	149	1	0	+GC
barcode89_consensus_vsearch	1777	T	Y	248	10	3.86%	2	1	93	93	8.935377905624525E-4	1	1	109	139	0	10	C
barcode89_consensus_vsearch	1778	A	A	259	0	0%	2	0	93	0	1.0	1	0	109	150	0	0	
barcode89_consensus_vsearch	1779	T	T	254	3	1.16%	2	1	93	93	0.12426900584791233	1	1	105	149	3	0	+C
barcode89_consensus_vsearch	1780	C	C	256	1	0.39%	2	1	93	93	0.4999999999999138	1	1	108	148	0	1	A
barcode89_consensus_vsearch	1781	G	G	259	0	0%	2	0	93	0	1.0	1	0	109	150	0	0	
barcode89_consensus_vsearch	1782	G	G	254	2	0.77%	2	1	93	93	0.2495107632092758	1	1	108	146	0	2	-T
barcode89_consensus_vsearch	1783	T	T	255	1	0.39%	2	1	93	93	0.4999999999999138	1	1	109	146	0	1	-C
barcode89_consensus_vsearch	1784	C	C	256	1	0.39%	2	1	93	93	0.4999999999999138	1	1	108	148	0	1	+AA
barcode89_consensus_vsearch	1785	T	T	249	3	1.16%	2	1	93	93	0.12425447316115633	1	1	104	145	3	0	+C
barcode89_consensus_vsearch	1786	C	C	247	5	1.95%	2	2	93	93	0.030630587731099716	1	1	108	139	1	4	-T
barcode89_consensus_vsearch	1787	T	T	238	5	1.98%	2	1	93	93	0.030607671127594244	1	1	107	131	0	5	G
barcode89_consensus_vsearch	1788	G	G	251	2	0.79%	2	2	93	93	0.24950495049494414	1	1	107	144	1	1	A
barcode89_consensus_vsearch	1789	G	G	250	2	0.78%	2	1	93	93	0.2495029821073759	1	1	105	145	2	0	+C
barcode89_consensus_vsearch	1790	C	C	248	4	1.56%	2	1	93	93	0.061755217199896344	1	1	108	140	0	4	A
barcode89_consensus_vsearch	1791	C	C	252	3	1.16%	2	1	93	93	0.12426326129665838	1	1	109	143	0	3	T
barcode89_consensus_vsearch	1792	A	A	254	2	0.78%	2	1	93	93	0.2495107632092758	1	1	109	145	0	2	G
barcode89_consensus_vsearch	1793	A	A	259	0	0%	2	0	93	0	1.0	1	0	109	150	0	0	
barcode89_consensus_vsearch	1794	T	T	257	1	0.39%	2	1	93	93	0.4999999999999138	1	1	108	149	1	0	-A
barcode89_consensus_vsearch	1795	A	A	256	1	0.39%	2	1	93	93	0.4999999999999138	1	1	106	150	1	0	+T
barcode89_consensus_vsearch	1796	T	T	254	3	1.16%	2	2	93	93	0.12426900584791233	1	1	106	148	1	2	C
barcode89_consensus_vsearch	1797	T	T	257	2	0.77%	2	1	93	93	0.24951644100587136	1	1	109	148	0	2	C
barcode89_consensus_vsearch	1798	T	T	255	2	0.77%	2	2	93	93	0.2495126705651419	1	1	107	148	1	1	-A
barcode89_consensus_vsearch	1799	A	A	252	3	1.17%	2	1	93	93	0.12426326129665838	1	1	105	147	3	0	G
barcode89_consensus_vsearch	1800	G	G	252	2	0.78%	2	1	93	93	0.2495069033532105	1	1	107	145	0	2	-C
barcode89_consensus_vsearch	1801	C	C	240	5	1.96%	2	2	93	93	0.030612909050433162	1	1	102	138	2	3	-T
barcode89_consensus_vsearch	1802	T	T	248	2	0.8%	2	1	93	93	0.24949899799584363	1	1	104	144	0	2	C
barcode89_consensus_vsearch	1803	T	T	252	2	0.78%	2	1	93	93	0.2495069033532105	1	1	105	147	0	2	+CTT
barcode89_consensus_vsearch	1804	T	T	256	1	0.39%	2	1	93	93	0.4999999999999138	1	1	106	150	1	0	C
barcode89_consensus_vsearch	1805	A	A	256	2	0.77%	2	1	93	93	0.24951456310670525	1	1	109	147	0	2	+G
barcode89_consensus_vsearch	1806	G	G	259	0	0%	2	0	93	0	1.0	1	0	109	150	0	0	
barcode89_consensus_vsearch	1807	A	A	257	2	0.77%	2	1	93	93	0.24951644100587136	1	1	107	150	2	0	G
barcode89_consensus_vsearch	1808	T	T	254	2	0.77%	2	1	93	93	0.2495107632092758	1	1	104	150	2	0	+A
barcode89_consensus_vsearch	1809	G	G	251	4	1.56%	2	1	93	93	0.06176398786346276	1	1	101	150	4	0	-AA
barcode89_consensus_vsearch	1810	A	A	253	1	0.39%	2	1	93	93	0.5000000000003686	1	1	104	149	0	1	G
barcode89_consensus_vsearch	1811	A	A	255	0	0%	2	0	93	0	1.0	1	0	105	150	0	0	
barcode89_consensus_vsearch	1812	A	A	257	2	0.77%	2	2	93	93	0.24951644100587136	1	1	108	149	1	1	-T
barcode89_consensus_vsearch	1813	T	T	253	3	1.17%	2	1	93	93	0.124266144814075	1	1	105	148	3	0	G
barcode89_consensus_vsearch	1814	T	T	250	6	2.32%	2	1	93	93	0.015169042029074849	1	1	107	143	0	6	+C
barcode89_consensus_vsearch	1815	T	T	258	1	0.39%	2	1	93	93	0.4999999999999138	1	1	108	150	1	0	C
barcode89_consensus_vsearch	1816	A	A	254	4	1.54%	2	1	93	93	0.06177255436325217	1	1	105	149	4	0	-C
barcode89_consensus_vsearch	1817	C	C	253	1	0.39%	2	1	93	93	0.5000000000003686	1	1	104	149	1	0	+AC
barcode89_consensus_vsearch	1818	C	C	253	4	1.54%	2	1	93	93	0.0617697211064687	1	1	105	148	4	0	-ACC
barcode89_consensus_vsearch	1819	A	A	255	0	0%	2	0	93	0	1.0	1	0	105	150	0	0	
barcode89_consensus_vsearch	1820	C	C	255	0	0%	2	0	93	0	1.0	1	0	105	150	0	0	
barcode89_consensus_vsearch	1821	C	C	254	1	0.39%	2	1	93	93	0.4999999999999138	1	1	104	150	1	0	+A
barcode89_consensus_vsearch	1822	C	C	256	2	0.77%	2	1	93	93	0.24951456310670525	1	1	107	149	2	0	G
barcode89_consensus_vsearch	1823	A	*/-T	222	19	7.34%	2	2	93	93	1.3187503319271603E-6	1	1	75	147	18	1	-T
barcode89_consensus_vsearch	1824	T	T	237	1	0.42%	2	1	93	93	0.5000000000003686	1	1	88	149	1	0	+A
barcode89_consensus_vsearch	1825	T	T	256	2	0.78%	2	2	93	93	0.24951456310670525	1	1	107	149	1	1	C
barcode89_consensus_vsearch	1826	T	T	255	2	0.77%	2	1	93	93	0.2495126705651419	1	1	105	150	2	0	C
barcode89_consensus_vsearch	1827	T	T	253	2	0.77%	2	2	93	93	0.24950884086425928	1	1	105	148	1	1	C
barcode89_consensus_vsearch	1828	G	G	255	2	0.78%	2	2	93	93	0.2495126705651419	1	1	107	148	1	1	-A
barcode89_consensus_vsearch	1829	A	A	255	2	0.78%	2	1	93	93	0.2495126705651419	1	1	106	149	2	0	G
barcode89_consensus_vsearch	1830	G	G	258	1	0.39%	2	1	93	93	0.4999999999999138	1	1	108	150	1	0	-C
barcode89_consensus_vsearch	1831	C	C	254	2	0.78%	2	1	93	93	0.2495107632092758	1	1	107	147	0	2	T
barcode89_consensus_vsearch	1832	T	T	255	3	1.16%	2	2	93	93	0.1242718446601877	1	1	108	147	1	2	C
barcode89_consensus_vsearch	1833	G	G	257	1	0.39%	2	1	93	93	0.4999999999999138	1	1	109	148	0	1	+TG
barcode89_consensus_vsearch	1834	C	C	255	2	0.78%	2	1	93	93	0.2495126705651419	1	1	108	147	0	2	T
barcode89_consensus_vsearch	1835	A	A	258	1	0.39%	2	1	93	93	0.4999999999999138	1	1	108	150	1	0	G
barcode89_consensus_vsearch	1836	T	T	256	3	1.16%	2	2	93	93	0.12427466150865948	1	1	108	148	1	2	C
barcode89_consensus_vsearch	1837	T	T	253	5	1.93%	2	2	93	93	0.030644978141142375	1	1	105	148	4	1	+C
barcode89_consensus_vsearch	1838	C	C	257	1	0.39%	2	1	93	93	0.4999999999999138	1	1	109	148	0	1	+T
barcode89_consensus_vsearch	1839	C	C	254	3	1.16%	2	1	93	93	0.12426900584791233	1	1	109	145	0	3	T
barcode89_consensus_vsearch	1840	C	C	248	3	1.16%	2	1	93	93	0.12425149700602607	1	1	107	141	0	3	-A
barcode89_consensus_vsearch	1841	A	A	255	1	0.39%	2	1	93	93	0.4999999999999138	1	1	108	147	1	0	+G
barcode89_consensus_vsearch	1842	A	A	258	1	0.39%	2	1	93	93	0.4999999999999138	1	1	109	149	0	1	+CA
barcode89_consensus_vsearch	1843	A	A	257	2	0.77%	2	1	93	93	0.24951644100587136	1	1	107	150	2	0	G
barcode89_consensus_vsearch	1844	C	C	257	2	0.77%	2	2	93	93	0.24951644100587136	1	1	108	149	1	1	T
barcode89_consensus_vsearch	1845	A	A	259	0	0%	2	0	93	0	1.0	1	0	109	150	0	0	
barcode89_consensus_vsearch	1846	A	A	252	3	1.16%	2	1	93	93	0.12426326129665838	1	1	106	146	3	0	G
barcode89_consensus_vsearch	1847	C	C	252	3	1.16%	2	1	93	93	0.12426326129665838	1	1	109	143	0	3	-T
barcode89_consensus_vsearch	1848	T	T	247	3	1.17%	2	1	93	93	0.12424849699405838	1	1	106	141	0	3	-C
barcode89_consensus_vsearch	1849	C	C	254	1	0.39%	2	1	93	93	0.4999999999999138	1	1	108	146	0	1	-GA
barcode89_consensus_vsearch	1850	G	G	255	1	0.39%	2	1	93	93	0.4999999999999138	1	1	108	147	1	0	-A
barcode89_consensus_vsearch	1851	A	A	253	3	1.17%	2	1	93	93	0.124266144814075	1	1	108	145	0	3	+C
barcode89_consensus_vsearch	1852	C	C	257	2	0.77%	2	1	93	93	0.24951644100587136	1	1	109	148	0	2	+TT
barcode89_consensus_vsearch	1853	T	T	258	1	0.39%	2	1	93	93	0.4999999999999138	1	1	109	149	0	1	-C
barcode89_consensus_vsearch	1854	C	C	256	1	0.39%	2	1	93	93	0.4999999999999138	1	1	108	148	1	0	+AC
barcode89_consensus_vsearch	1855	G	G	258	1	0.39%	2	1	93	93	0.4999999999999138	1	1	109	149	0	1	A
barcode89_consensus_vsearch	1856	T	T	256	2	0.77%	2	2	93	93	0.24951456310670525	1	1	108	148	1	1	C
barcode89_consensus_vsearch	1857	C	C	255	1	0.39%	2	1	93	93	0.4999999999999138	1	1	106	149	1	0	+A
barcode89_consensus_vsearch	1858	G	*/-A	235	11	4.26%	2	1	93	93	4.3557033390967853E-4	1	1	88	147	11	0	-A
barcode89_consensus_vsearch	1859	A	A	246	1	0.4%	2	1	93	93	0.5000000000003686	1	1	98	148	0	1	G
barcode89_consensus_vsearch	1860	A	A	257	1	0.39%	2	1	93	93	0.4999999999999138	1	1	108	149	1	0	G
barcode89_consensus_vsearch	1861	A	A	255	1	0.39%	2	1	93	93	0.4999999999999138	1	1	107	148	1	0	+G
barcode89_consensus_vsearch	1862	G	G	248	5	1.95%	2	1	93	93	0.030633033482245435	1	1	100	148	5	0	-A
barcode89_consensus_vsearch	1863	A	A	248	2	0.79%	2	1	93	93	0.24949899799584363	1	1	100	148	2	0	+G
barcode89_consensus_vsearch	1864	G	G	243	5	1.95%	2	1	93	93	0.030620607699729043	1	1	106	137	0	5	+T
barcode89_consensus_vsearch	1865	C	*/-T	204	20	7.97%	2	2	93	93	6.120185088270156E-7	1	1	103	101	1	19	-T
barcode89_consensus_vsearch	1866	T	T	226	1	0.44%	2	1	93	93	0.4999999999999138	1	1	102	124	1	0	A
barcode89_consensus_vsearch	1867	T	T	243	2	0.8%	2	2	93	93	0.24948875255617758	1	1	103	140	1	1	A
barcode89_consensus_vsearch	1868	T	T	253	2	0.77%	2	1	93	93	0.24950884086425928	1	1	106	147	2	0	C
barcode89_consensus_vsearch	1869	A	A	254	1	0.39%	2	1	93	93	0.4999999999999138	1	1	106	148	1	0	+C
barcode89_consensus_vsearch	1870	C	*/-AC	237	18	6.95%	2	2	93	93	2.7958505667288594E-6	1	1	89	148	17	1	-AC
barcode89_consensus_vsearch	1871	A	A	239	1	0.42%	2	1	93	93	0.4999999999999138	1	1	91	148	1	0	-CG
barcode89_consensus_vsearch	1872	C	*/-G	232	7	2.92%	2	1	93	93	0.007472166294706969	1	1	91	141	0	7	-G
barcode89_consensus_vsearch	1873	G	R	237	11	4.38%	2	1	93	93	4.359805386517798E-4	1	1	95	142	11	0	A
barcode89_consensus_vsearch	1874	G	G	254	2	0.77%	2	1	93	93	0.2495107632092758	1	1	104	150	2	0	A
barcode89_consensus_vsearch	1875	G	G	254	4	1.54%	2	1	93	93	0.06177255436325217	1	1	104	150	4	0	T
barcode89_consensus_vsearch	1876	T	T	257	2	0.77%	2	1	93	93	0.24951644100587136	1	1	107	150	2	0	C
barcode89_consensus_vsearch	1877	G	G	259	0	0%	2	0	93	0	1.0	1	0	109	150	0	0	
barcode89_consensus_vsearch	1878	A	A	257	1	0.39%	2	1	93	93	0.4999999999999138	1	1	108	149	0	1	-C
barcode89_consensus_vsearch	1879	C	C	256	2	0.78%	2	1	93	93	0.24951456310670525	1	1	109	147	0	2	-G
barcode89_consensus_vsearch	1880	G	G	254	2	0.78%	2	1	93	93	0.2495107632092758	1	1	107	147	2	0	A
barcode89_consensus_vsearch	1881	G	G	258	1	0.39%	2	1	93	93	0.4999999999999138	1	1	109	149	0	1	T
barcode89_consensus_vsearch	1882	C	C	250	4	1.54%	2	1	93	93	0.061761087351402955	1	1	107	143	0	4	T
barcode89_consensus_vsearch	1883	A	A	249	2	0.78%	2	1	93	93	0.24950099800389156	1	1	106	143	0	2	+C
barcode89_consensus_vsearch	1884	C	C	250	2	0.78%	2	1	93	93	0.2495029821073759	1	1	106	144	0	2	+T
barcode89_consensus_vsearch	1885	C	C	253	2	0.77%	2	1	93	93	0.24950884086425928	1	1	109	144	0	2	+A
barcode89_consensus_vsearch	1886	A	A	256	2	0.78%	2	2	93	93	0.24951456310670525	1	1	108	148	1	1	G
barcode89_consensus_vsearch	1887	A	A	256	2	0.77%	2	1	93	93	0.24951456310670525	1	1	107	149	2	0	G
barcode89_consensus_vsearch	1888	T	T	257	1	0.39%	2	1	93	93	0.4999999999999138	1	1	109	148	0	1	C
barcode89_consensus_vsearch	1889	C	C	258	1	0.39%	2	1	93	93	0.4999999999999138	1	1	109	149	0	1	-A
barcode89_consensus_vsearch	1890	A	A	252	2	0.78%	2	1	93	93	0.2495069033532105	1	1	104	148	2	0	-CA
barcode89_consensus_vsearch	1891	C	C	254	1	0.39%	2	1	93	93	0.4999999999999138	1	1	105	149	1	0	+GC
barcode89_consensus_vsearch	1892	A	A	250	3	1.17%	2	2	93	93	0.12425742574263329	1	1	104	146	1	2	-TA
barcode89_consensus_vsearch	1893	T	T	249	3	1.17%	2	1	93	93	0.12425447316115633	1	1	103	146	3	0	-AC
barcode89_consensus_vsearch	1894	A	A	250	2	0.79%	2	1	93	93	0.2495029821073759	1	1	102	148	2	0	G
barcode89_consensus_vsearch	1895	C	*/-G	244	8	3.12%	2	2	93	93	0.0036920468013430033	1	1	102	142	3	5	-G
barcode89_consensus_vsearch	1896	G	G	244	6	2.4%	2	1	93	93	0.015158143859196256	1	1	99	145	6	0	A
barcode89_consensus_vsearch	1897	G	G	257	1	0.39%	2	1	93	93	0.4999999999999138	1	1	107	150	1	0	A
barcode89_consensus_vsearch	1898	G	G	257	1	0.39%	2	1	93	93	0.4999999999999138	1	1	108	149	1	0	-A
barcode89_consensus_vsearch	1899	A	A	254	1	0.39%	2	1	93	93	0.4999999999999138	1	1	107	147	0	1	+C
barcode89_consensus_vsearch	1900	T	T	254	3	1.17%	2	2	93	93	0.12426900584791233	1	1	108	146	1	2	C
barcode89_consensus_vsearch	1901	T	*/-C	243	9	3.49%	2	1	93	93	0.001816248829692974	1	1	107	136	0	9	-C
barcode89_consensus_vsearch	1902	C	C	242	3	1.2%	2	1	93	93	0.1242331288343819	1	1	109	133	0	3	-TC
barcode89_consensus_vsearch	1903	T	T	253	1	0.39%	2	1	93	93	0.5000000000003686	1	1	108	145	1	0	C
barcode89_consensus_vsearch	1904	C	*/+A	245	8	3.14%	2	1	93	93	0.003692882342347513	1	1	108	137	0	8	+A
barcode89_consensus_vsearch	1905	A	*/-C	220	26	10.08%	2	2	93	93	7.421753399767936E-9	1	1	106	114	2	24	-C
barcode89_consensus_vsearch	1906	C	Y	208	8	3.54%	2	1	93	93	0.0036568954742723925	1	1	106	102	0	8	T
barcode89_consensus_vsearch	1907	C	C	239	6	2.37%	2	1	93	93	0.015148656024950557	1	1	109	130	0	6	T
barcode89_consensus_vsearch	1908	C	M	246	8	3.09%	2	1	93	93	0.003693711391797067	1	1	108	138	0	8	A
barcode89_consensus_vsearch	1909	T	T	247	6	2.33%	2	1	93	93	0.015163657292611031	1	1	109	138	0	6	-C
barcode89_consensus_vsearch	1910	C	Y	234	8	3.23%	2	1	93	93	0.00368331690336814	1	1	108	126	0	8	T
barcode89_consensus_vsearch	1911	T	T	247	2	0.8%	2	1	93	93	0.24949698189118988	1	1	109	138	0	2	C
barcode89_consensus_vsearch	1912	A	A	255	2	0.78%	2	1	93	93	0.2495126705651419	1	1	106	149	2	0	-T
barcode89_consensus_vsearch	1913	T	T	252	2	0.78%	2	1	93	93	0.2495069033532105	1	1	104	148	2	0	C
barcode89_consensus_vsearch	1914	G	G	257	1	0.39%	2	1	93	93	0.4999999999999138	1	1	109	148	0	1	+CG
barcode89_consensus_vsearch	1915	A	A	255	1	0.39%	2	1	93	93	0.4999999999999138	1	1	106	149	1	0	+G
barcode89_consensus_vsearch	1916	C	C	258	0	0%	2	0	93	0	1.0	1	0	108	150	0	0	
barcode89_consensus_vsearch	1917	G	G	258	0	0%	2	0	93	0	1.0	1	0	108	150	0	0	
barcode89_consensus_vsearch	1918	T	T	245	6	2.32%	2	2	93	93	0.015159996253657923	1	1	98	147	4	2	+C
barcode89_consensus_vsearch	1919	C	C	252	1	0.39%	2	1	93	93	0.5000000000003686	1	1	103	149	1	0	A
barcode89_consensus_vsearch	1920	C	C	259	0	0%	2	0	93	0	1.0	1	0	109	150	0	0	
barcode89_consensus_vsearch	1921	T	T	254	2	0.77%	2	1	93	93	0.2495107632092758	1	1	106	148	2	0	+A
barcode89_consensus_vsearch	1922	G	G	255	2	0.78%	2	2	93	93	0.2495126705651419	1	1	106	149	1	1	A
barcode89_consensus_vsearch	1923	T	T	257	1	0.39%	2	1	93	93	0.4999999999999138	1	1	107	150	1	0	A
barcode89_consensus_vsearch	1924	T	*/-C	227	32	12.36%	2	2	93	93	8.393744355259536E-11	1	1	78	149	31	1	-C
barcode89_consensus_vsearch	1925	C	C	226	1	0.44%	2	1	93	93	0.4999999999999138	1	1	77	149	1	0	A
barcode89_consensus_vsearch	1926	C	C	251	6	2.32%	2	2	93	93	0.015170809117680038	1	1	104	147	4	2	-A
barcode89_consensus_vsearch	1927	A	A	250	1	0.4%	2	1	93	93	0.4999999999999138	1	1	103	147	1	0	+GG
barcode89_consensus_vsearch	1928	A	A	253	3	1.16%	2	2	93	93	0.124266144814075	1	1	105	148	2	1	-G
barcode89_consensus_vsearch	1929	G	G	250	3	1.18%	2	1	93	93	0.12425742574263329	1	1	103	147	3	0	A
barcode89_consensus_vsearch	1930	G	G	254	4	1.54%	2	1	93	93	0.06177255436325217	1	1	105	149	4	0	-A
barcode89_consensus_vsearch	1931	A	A	253	2	0.78%	2	1	93	93	0.24950884086425928	1	1	105	148	0	2	G
barcode89_consensus_vsearch	1932	A	A	253	2	0.77%	2	2	93	93	0.24950884086425928	1	1	108	145	1	1	-CT
barcode89_consensus_vsearch	1933	C	C	255	1	0.39%	2	1	93	93	0.4999999999999138	1	1	108	147	0	1	-T
barcode89_consensus_vsearch	1934	T	T	253	3	1.17%	2	2	93	93	0.124266144814075	1	1	106	147	2	1	C
barcode89_consensus_vsearch	1935	T	T	248	2	0.77%	2	1	93	93	0.24949899799584363	1	1	106	142	0	2	+C
barcode89_consensus_vsearch	1936	A	A	250	3	1.17%	2	2	93	93	0.12425742574263329	1	1	107	143	1	2	+G
barcode89_consensus_vsearch	1937	G	G	257	1	0.39%	2	1	93	93	0.4999999999999138	1	1	109	148	0	1	+TG
barcode89_consensus_vsearch	1938	A	A	251	3	1.16%	2	1	93	93	0.12426035502961323	1	1	106	145	0	3	G
barcode89_consensus_vsearch	1939	C	C	255	2	0.77%	2	2	93	93	0.2495126705651419	1	1	108	147	1	1	-T
barcode89_consensus_vsearch	1940	T	Y	246	7	2.73%	2	2	93	93	0.007490846702557751	1	1	104	142	4	3	C
barcode89_consensus_vsearch	1941	G	G	253	2	0.78%	2	1	93	93	0.24950884086425928	1	1	107	146	2	0	+A
barcode89_consensus_vsearch	1942	G	G	254	4	1.54%	2	2	93	93	0.06177255436325217	1	1	106	148	3	1	A
barcode89_consensus_vsearch	1943	G	G	259	0	0%	2	0	93	0	1.0	1	0	109	150	0	0	
barcode89_consensus_vsearch	1944	C	C	259	0	0%	2	0	93	0	1.0	1	0	109	150	0	0	
barcode89_consensus_vsearch	1945	C	C	256	1	0.39%	2	1	93	93	0.4999999999999138	1	1	109	147	0	1	+G
barcode89_consensus_vsearch	1946	G	G	258	0	0%	2	0	93	0	1.0	1	0	109	149	0	0	
barcode89_consensus_vsearch	1947	A	A	257	1	0.39%	2	1	93	93	0.4999999999999138	1	1	108	149	1	0	G
barcode89_consensus_vsearch	1948	C	C	257	1	0.39%	2	1	93	93	0.4999999999999138	1	1	109	148	0	1	-A
barcode89_consensus_vsearch	1949	A	*/-C	238	18	7%	2	2	93	93	2.799367851477141E-6	1	1	96	142	12	6	-C
barcode89_consensus_vsearch	1950	C	C	239	1	0.42%	2	1	93	93	0.4999999999999138	1	1	97	142	0	1	T
barcode89_consensus_vsearch	1951	C	C	254	1	0.39%	2	1	93	93	0.4999999999999138	1	1	109	145	0	1	+AC
barcode89_consensus_vsearch	1952	C	*/-AA	217	11	4.26%	2	1	93	93	4.3156732794080477E-4	1	1	101	116	0	11	-AA
barcode89_consensus_vsearch	1953	A	A	233	3	1.27%	2	2	93	93	0.12420382165607027	1	1	102	131	1	2	G
barcode89_consensus_vsearch	1954	A	A	246	0	0%	2	0	93	0	1.0	1	0	107	139	0	0	
barcode89_consensus_vsearch	1955	A	A	254	2	0.78%	2	1	93	93	0.2495107632092758	1	1	106	148	0	2	G
barcode89_consensus_vsearch	1956	G	G	253	1	0.39%	2	1	93	93	0.5000000000003686	1	1	105	148	0	1	+C
barcode89_consensus_vsearch	1957	C	C	254	2	0.78%	2	1	93	93	0.2495107632092758	1	1	107	147	0	2	T
barcode89_consensus_vsearch	1958	A	A	257	1	0.39%	2	1	93	93	0.4999999999999138	1	1	108	149	0	1	-T
barcode89_consensus_vsearch	1959	T	T	254	2	0.78%	2	2	93	93	0.2495107632092758	1	1	106	148	1	1	-C
barcode89_consensus_vsearch	1960	C	C	251	5	1.95%	2	1	93	93	0.03064025621010106	1	1	107	144	0	5	-T
barcode89_consensus_vsearch	1961	T	T	252	1	0.39%	2	1	93	93	0.5000000000003686	1	1	109	143	0	1	+C
barcode89_consensus_vsearch	1962	T	T	257	1	0.39%	2	1	93	93	0.4999999999999138	1	1	109	148	0	1	-C
barcode89_consensus_vsearch	1963	C	*/+T	239	9	3.49%	2	1	93	93	0.001814084347407265	1	1	108	131	0	9	+T
barcode89_consensus_vsearch	1964	T	T	251	1	0.4%	2	1	93	93	0.5000000000003686	1	1	108	143	0	1	-A
barcode89_consensus_vsearch	1965	A	A	250	2	0.78%	2	1	93	93	0.2495029821073759	1	1	104	146	2	0	+CCA
barcode89_consensus_vsearch	1966	C	C	247	4	1.55%	2	1	93	93	0.061752247008950906	1	1	107	140	0	4	T
barcode89_consensus_vsearch	1967	A	A	247	3	1.19%	2	1	93	93	0.12424849699405838	1	1	106	141	3	0	G
barcode89_consensus_vsearch	1968	A	A	254	2	0.78%	2	1	93	93	0.2495107632092758	1	1	109	145	0	2	G
barcode89_consensus_vsearch	1969	A	A	256	1	0.39%	2	1	93	93	0.4999999999999138	1	1	108	148	0	1	-T
barcode89_consensus_vsearch	1970	T	T	254	4	1.55%	2	2	93	93	0.06177255436325217	1	1	108	146	1	3	C
barcode89_consensus_vsearch	1971	T	T	256	3	1.16%	2	2	93	93	0.12427466150865948	1	1	108	148	1	2	C
barcode89_consensus_vsearch	1972	A	A	255	2	0.77%	2	2	93	93	0.2495126705651419	1	1	108	147	1	1	-CA
barcode89_consensus_vsearch	1973	C	C	254	1	0.39%	2	1	93	93	0.4999999999999138	1	1	106	148	0	1	+A
barcode89_consensus_vsearch	1974	A	A	254	1	0.39%	2	1	93	93	0.4999999999999138	1	1	105	149	1	0	C
barcode89_consensus_vsearch	1975	A	A	256	1	0.39%	2	1	93	93	0.4999999999999138	1	1	107	149	0	1	C
barcode89_consensus_vsearch	1976	C	C	256	1	0.39%	2	1	93	93	0.4999999999999138	1	1	108	148	0	1	+GG
barcode89_consensus_vsearch	1977	G	G	253	3	1.16%	2	1	93	93	0.124266144814075	1	1	104	149	3	0	A
barcode89_consensus_vsearch	1978	C	C	252	3	1.17%	2	2	93	93	0.12426326129665838	1	1	105	147	2	1	T
barcode89_consensus_vsearch	1979	G	G	252	2	0.78%	2	2	93	93	0.2495069033532105	1	1	106	146	1	1	A
barcode89_consensus_vsearch	1980	G	G	257	2	0.77%	2	1	93	93	0.24951644100587136	1	1	107	150	2	0	A
barcode89_consensus_vsearch	1981	C	C	256	3	1.16%	2	1	93	93	0.12427466150865948	1	1	109	147	0	3	+T
barcode89_consensus_vsearch	1982	C	C	256	3	1.16%	2	1	93	93	0.12427466150865948	1	1	109	147	0	3	-T
barcode89_consensus_vsearch	1983	T	T	254	2	0.78%	2	1	93	93	0.2495107632092758	1	1	109	145	0	2	C
barcode89_consensus_vsearch	1984	G	G	258	1	0.39%	2	1	93	93	0.4999999999999138	1	1	108	150	1	0	-T
barcode89_consensus_vsearch	1985	T	T	255	2	0.78%	2	1	93	93	0.2495126705651419	1	1	107	148	0	2	C
barcode89_consensus_vsearch	1986	T	T	251	3	1.16%	2	1	93	93	0.12426035502961323	1	1	107	144	0	3	-G
barcode89_consensus_vsearch	1987	G	G	254	2	0.78%	2	1	93	93	0.2495107632092758	1	1	107	147	2	0	A
barcode89_consensus_vsearch	1988	G	G	257	2	0.77%	2	1	93	93	0.24951644100587136	1	1	109	148	0	2	A
barcode89_consensus_vsearch	1989	C	C	257	1	0.39%	2	1	93	93	0.4999999999999138	1	1	109	148	0	1	-A
barcode89_consensus_vsearch	1990	A	R	244	13	5.04%	2	2	93	93	1.0448545579776443E-4	1	1	98	146	10	3	G
barcode89_consensus_vsearch	1991	G	G	254	2	0.78%	2	1	93	93	0.2495107632092758	1	1	106	148	0	2	-CTT
barcode89_consensus_vsearch	1992	C	C	247	2	0.78%	2	1	93	93	0.24949698189118988	1	1	104	143	2	0	+T
barcode89_consensus_vsearch	1993	T	T	249	2	0.79%	2	1	93	93	0.24950099800389156	1	1	107	142	0	2	C
barcode89_consensus_vsearch	1994	T	T	249	2	0.79%	2	1	93	93	0.24950099800389156	1	1	107	142	0	2	+C
barcode89_consensus_vsearch	1995	T	T	256	1	0.39%	2	1	93	93	0.4999999999999138	1	1	108	148	0	1	-C
barcode89_consensus_vsearch	1996	C	C	247	4	1.56%	2	2	93	93	0.061752247008950906	1	1	104	143	2	2	+A
barcode89_consensus_vsearch	1997	A	A	252	3	1.17%	2	2	93	93	0.12426326129665838	1	1	103	149	2	1	C
barcode89_consensus_vsearch	1998	A	A	257	1	0.39%	2	1	93	93	0.4999999999999138	1	1	108	149	0	1	+CA
barcode89_consensus_vsearch	1999	A	A	252	4	1.54%	2	2	93	93	0.06176686569346045	1	1	104	148	2	2	+T
barcode89_consensus_vsearch	2000	T	T	254	1	0.39%	2	1	93	93	0.4999999999999138	1	1	106	148	0	1	+C
barcode89_consensus_vsearch	2001	T	T	256	2	0.77%	2	1	93	93	0.24951456310670525	1	1	108	148	0	2	+C
barcode89_consensus_vsearch	2002	T	T	253	2	0.77%	2	1	93	93	0.24950884086425928	1	1	105	148	0	2	+G
barcode89_consensus_vsearch	2003	G	G	256	1	0.39%	2	1	93	93	0.4999999999999138	1	1	107	149	0	1	+AA
barcode89_consensus_vsearch	2004	A	A	255	2	0.78%	2	1	93	93	0.2495126705651419	1	1	106	149	2	0	T
barcode89_consensus_vsearch	2005	G	G	255	2	0.77%	2	1	93	93	0.2495126705651419	1	1	106	149	2	0	-C
barcode89_consensus_vsearch	2006	C	C	255	1	0.39%	2	1	93	93	0.4999999999999138	1	1	106	149	1	0	+TTC
barcode89_consensus_vsearch	2007	A	A	255	3	1.16%	2	2	93	93	0.1242718446601877	1	1	106	149	2	1	G
barcode89_consensus_vsearch	2008	G	G	254	1	0.39%	2	1	93	93	0.4999999999999138	1	1	107	147	0	1	+C
barcode89_consensus_vsearch	2009	T	T	256	1	0.39%	2	1	93	93	0.4999999999999138	1	1	109	147	0	1	C
barcode89_consensus_vsearch	2010	T	T	257	1	0.39%	2	1	93	93	0.4999999999999138	1	1	109	148	0	1	-AC
barcode89_consensus_vsearch	2011	A	A	250	3	1.17%	2	2	93	93	0.12425742574263329	1	1	105	145	1	2	+C
barcode89_consensus_vsearch	2012	C	C	256	0	0%	2	0	93	0	1.0	1	0	108	148	0	0	
barcode89_consensus_vsearch	2013	C	C	250	2	0.78%	2	1	93	93	0.2495029821073759	1	1	104	146	2	0	-G
barcode89_consensus_vsearch	2014	G	G	249	3	1.18%	2	1	93	93	0.12425447316115633	1	1	102	147	3	0	A
barcode89_consensus_vsearch	2015	C	C	252	2	0.78%	2	1	93	93	0.2495069033532105	1	1	106	146	0	2	-T
barcode89_consensus_vsearch	2016	T	T	249	4	1.58%	2	2	93	93	0.06175816388801474	1	1	105	144	2	2	C
barcode89_consensus_vsearch	2017	T	T	256	2	0.78%	2	1	93	93	0.24951456310670525	1	1	108	148	0	2	C
barcode89_consensus_vsearch	2018	C	C	254	3	1.16%	2	1	93	93	0.12426900584791233	1	1	106	148	3	0	-A
barcode89_consensus_vsearch	2019	A	A	250	4	1.56%	2	1	93	93	0.061761087351402955	1	1	106	144	0	4	+C
barcode89_consensus_vsearch	2020	C	C	253	3	1.16%	2	1	93	93	0.124266144814075	1	1	109	144	0	3	T
barcode89_consensus_vsearch	2021	T	T	247	4	1.55%	2	1	93	93	0.061752247008950906	1	1	109	138	0	4	+C
barcode89_consensus_vsearch	2022	C	C	253	1	0.39%	2	1	93	93	0.5000000000003686	1	1	107	146	1	0	+AC
barcode89_consensus_vsearch	2023	G	G	257	2	0.77%	2	2	93	93	0.24951644100587136	1	1	108	149	1	1	A
barcode89_consensus_vsearch	2024	C	C	258	1	0.39%	2	1	93	93	0.4999999999999138	1	1	109	149	0	1	T
barcode89_consensus_vsearch	2025	C	C	255	3	1.16%	2	1	93	93	0.1242718446601877	1	1	109	146	0	3	T
barcode89_consensus_vsearch	2026	G	G	258	0	0%	2	0	93	0	1.0	1	0	109	149	0	0	
barcode89_consensus_vsearch	2027	T	T	257	1	0.39%	2	1	93	93	0.4999999999999138	1	1	109	148	0	1	C
barcode89_consensus_vsearch	2028	T	T	258	0	0%	2	0	93	0	1.0	1	0	109	149	0	0	
barcode89_consensus_vsearch	2029	A	A	257	2	0.77%	2	1	93	93	0.24951644100587136	1	1	107	150	2	0	-C
barcode89_consensus_vsearch	2030	C	C	257	0	0%	2	0	93	0	1.0	1	0	107	150	0	0	
barcode89_consensus_vsearch	2031	T	T	249	4	1.54%	2	1	93	93	0.06175816388801474	1	1	101	148	4	0	-A
barcode89_consensus_vsearch	2032	A	A	253	2	0.78%	2	2	93	93	0.24950884086425928	1	1	104	149	1	1	G
barcode89_consensus_vsearch	2033	A	A	257	1	0.39%	2	1	93	93	0.4999999999999138	1	1	108	149	0	1	-G
barcode89_consensus_vsearch	2034	G	G	257	1	0.39%	2	1	93	93	0.4999999999999138	1	1	108	149	1	0	T
barcode89_consensus_vsearch	2035	G	G	257	1	0.39%	2	1	93	93	0.4999999999999138	1	1	108	149	0	1	+CGG
barcode89_consensus_vsearch	2036	T	T	257	1	0.39%	2	1	93	93	0.4999999999999138	1	1	109	148	0	1	+GT
barcode89_consensus_vsearch	2037	A	A	258	1	0.39%	2	1	93	93	0.4999999999999138	1	1	108	150	1	0	G
barcode89_consensus_vsearch	2038	A	A	255	2	0.77%	2	1	93	93	0.2495126705651419	1	1	108	147	0	2	-TC
barcode89_consensus_vsearch	2039	T	*/-C	238	13	5.08%	2	2	93	93	1.0408769971274523E-4	1	1	99	139	7	6	-C
barcode89_consensus_vsearch	2040	C	C	242	1	0.41%	2	1	93	93	0.4999999999999138	1	1	100	142	1	0	+AATC
barcode89_consensus_vsearch	2041	C	C	256	1	0.39%	2	1	93	93	0.4999999999999138	1	1	108	148	0	1	+T
barcode89_consensus_vsearch	2042	C	C	254	3	1.16%	2	1	93	93	0.12426900584791233	1	1	109	145	0	3	-T
barcode89_consensus_vsearch	2043	T	T	252	2	0.78%	2	1	93	93	0.2495069033532105	1	1	109	143	0	2	+C
barcode89_consensus_vsearch	2044	G	G	257	1	0.39%	2	1	93	93	0.4999999999999138	1	1	108	149	0	1	-TTG
barcode89_consensus_vsearch	2045	T	T	252	6	2.33%	2	1	93	93	0.015172562563020547	1	1	109	143	0	6	C
barcode89_consensus_vsearch	2046	T	T	253	3	1.16%	2	1	93	93	0.124266144814075	1	1	108	145	0	3	-G
barcode89_consensus_vsearch	2047	G	G	255	0	0%	2	0	93	0	1.0	1	0	109	146	0	0	
barcode89_consensus_vsearch	2048	G	G	243	4	1.54%	2	2	93	93	0.061740125504571274	1	1	103	140	2	2	A
barcode89_consensus_vsearch	2049	T	T	247	5	1.98%	2	1	93	93	0.030630587731099716	1	1	107	140	0	5	C
barcode89_consensus_vsearch	2050	T	T	255	0	0%	2	0	93	0	1.0	1	0	109	146	0	0	
barcode89_consensus_vsearch	2051	T	T	248	4	1.56%	2	2	93	93	0.061755217199896344	1	1	106	142	2	2	C
barcode89_consensus_vsearch	2052	C	*/+T	234	15	5.86%	2	1	93	93	2.4559630594525426E-5	1	1	108	126	0	15	+T
barcode89_consensus_vsearch	2053	T	T	250	1	0.4%	2	1	93	93	0.4999999999999138	1	1	108	142	0	1	C
barcode89_consensus_vsearch	2054	T	T	255	1	0.39%	2	1	93	93	0.4999999999999138	1	1	107	148	1	0	C
barcode89_consensus_vsearch	2055	T	T	257	1	0.39%	2	1	93	93	0.4999999999999138	1	1	108	149	0	1	C
barcode89_consensus_vsearch	2056	T	T	252	3	1.16%	2	1	93	93	0.12426326129665838	1	1	109	143	0	3	+C
barcode89_consensus_vsearch	2057	C	C	251	4	1.56%	2	2	93	93	0.06176398786346276	1	1	106	145	2	2	T
barcode89_consensus_vsearch	2058	C	C	255	3	1.16%	2	2	93	93	0.1242718446601877	1	1	108	147	1	2	-T
barcode89_consensus_vsearch	2059	T	T	254	1	0.39%	2	1	93	93	0.4999999999999138	1	1	106	148	1	0	-C
barcode89_consensus_vsearch	2060	C	C	257	1	0.39%	2	1	93	93	0.4999999999999138	1	1	107	150	1	0	T
barcode89_consensus_vsearch	2061	C	C	256	2	0.77%	2	1	93	93	0.24951456310670525	1	1	109	147	0	2	+T
barcode89_consensus_vsearch	2062	G	G	259	0	0%	2	0	93	0	1.0	1	0	109	150	0	0	
barcode89_consensus_vsearch	2063	C	C	258	1	0.39%	2	1	93	93	0.4999999999999138	1	1	109	149	0	1	T
barcode89_consensus_vsearch	2064	T	T	259	0	0%	2	0	93	0	1.0	1	0	109	150	0	0	
barcode89_consensus_vsearch	2065	T	T	259	0	0%	2	0	93	0	1.0	1	0	109	150	0	0	
barcode89_consensus_vsearch	2066	A	A	256	2	0.77%	2	1	93	93	0.24951456310670525	1	1	109	147	0	2	G
barcode89_consensus_vsearch	2067	T	T	255	1	0.39%	2	1	93	93	0.4999999999999138	1	1	109	146	0	1	+C
barcode89_consensus_vsearch	2068	T	T	253	3	1.16%	2	2	93	93	0.124266144814075	1	1	108	145	1	2	C
barcode89_consensus_vsearch	2069	G	G	257	1	0.39%	2	1	93	93	0.4999999999999138	1	1	109	148	0	1	A
barcode89_consensus_vsearch	2070	A	A	258	1	0.39%	2	1	93	93	0.4999999999999138	1	1	109	149	0	1	+T
barcode89_consensus_vsearch	2071	T	T	257	1	0.39%	2	1	93	93	0.4999999999999138	1	1	108	149	1	0	C
barcode89_consensus_vsearch	2072	A	A	254	4	1.54%	2	2	93	93	0.06177255436325217	1	1	108	146	1	3	G
barcode89_consensus_vsearch	2073	T	T	254	1	0.39%	2	1	93	93	0.4999999999999138	1	1	108	146	0	1	+AT
barcode89_consensus_vsearch	2074	G	G	254	2	0.78%	2	2	93	93	0.2495107632092758	1	1	108	146	1	1	-C
barcode89_consensus_vsearch	2075	C	C	254	2	0.78%	2	1	93	93	0.2495107632092758	1	1	108	146	0	2	A
barcode89_consensus_vsearch	2076	T	T	256	1	0.39%	2	1	93	93	0.4999999999999138	1	1	108	148	0	1	A
barcode89_consensus_vsearch	2077	T	T	256	2	0.77%	2	1	93	93	0.24951456310670525	1	1	108	148	0	2	-A
barcode89_consensus_vsearch	2078	A	A	254	1	0.39%	2	1	93	93	0.4999999999999138	1	1	108	146	1	0	+GA
barcode89_consensus_vsearch	2079	A	A	257	1	0.39%	2	1	93	93	0.4999999999999138	1	1	109	148	0	1	G
barcode89_consensus_vsearch	2080	G	G	257	1	0.39%	2	1	93	93	0.4999999999999138	1	1	108	149	0	1	-T
barcode89_consensus_vsearch	2081	T	T	255	2	0.78%	2	1	93	93	0.2495126705651419	1	1	109	146	0	2	C
barcode89_consensus_vsearch	2082	T	T	259	0	0%	2	0	93	0	1.0	1	0	109	150	0	0	
barcode89_consensus_vsearch	2083	C	C	259	0	0%	2	0	93	0	1.0	1	0	109	150	0	0	
barcode89_consensus_vsearch	2084	A	A	255	2	0.77%	2	1	93	93	0.2495126705651419	1	1	107	148	2	0	G
barcode89_consensus_vsearch	2085	G	G	255	1	0.39%	2	1	93	93	0.4999999999999138	1	1	108	147	1	0	+CC
barcode89_consensus_vsearch	2086	C	*/-G	244	9	3.5%	2	2	93	93	0.001816779465609443	1	1	106	138	3	6	-G
barcode89_consensus_vsearch	2087	G	G	245	2	0.81%	2	2	93	93	0.24949290060873971	1	1	104	141	1	1	A
barcode89_consensus_vsearch	2088	G	G	256	1	0.39%	2	1	93	93	0.4999999999999138	1	1	108	148	1	0	C
barcode89_consensus_vsearch	2089	G	G	258	1	0.39%	2	1	93	93	0.4999999999999138	1	1	108	150	1	0	T
barcode89_consensus_vsearch	2090	T	T	255	2	0.77%	2	1	93	93	0.2495126705651419	1	1	109	146	0	2	C
barcode89_consensus_vsearch	2091	A	A	259	0	0%	2	0	93	0	1.0	1	0	109	150	0	0	
barcode89_consensus_vsearch	2092	T	*/-C	242	12	4.63%	2	2	93	93	2.1374893954455973E-4	1	1	95	147	10	2	-C
barcode89_consensus_vsearch	2093	C	C	247	0	0%	2	0	93	0	1.0	1	0	99	148	0	0	
barcode89_consensus_vsearch	2094	C	C	258	1	0.39%	2	1	93	93	0.4999999999999138	1	1	109	149	0	1	+T
barcode89_consensus_vsearch	2095	C	C	255	1	0.39%	2	1	93	93	0.4999999999999138	1	1	109	146	0	1	+TT
barcode89_consensus_vsearch	2096	T	T	257	1	0.39%	2	1	93	93	0.4999999999999138	1	1	108	149	1	0	C
barcode89_consensus_vsearch	2097	A	A	254	2	0.77%	2	1	93	93	0.2495107632092758	1	1	104	150	2	0	G
barcode89_consensus_vsearch	2098	C	C	250	3	1.17%	2	2	93	93	0.12425742574263329	1	1	103	147	2	1	-T
barcode89_consensus_vsearch	2099	T	T	249	3	1.18%	2	1	93	93	0.12425447316115633	1	1	103	146	0	3	C
barcode89_consensus_vsearch	2100	T	T	257	1	0.39%	2	1	93	93	0.4999999999999138	1	1	108	149	0	1	+CT
barcode89_consensus_vsearch	2101	G	G	256	1	0.39%	2	1	93	93	0.4999999999999138	1	1	108	148	1	0	+CC
barcode89_consensus_vsearch	2102	A	A	252	3	1.16%	2	1	93	93	0.12426326129665838	1	1	108	144	0	3	G
barcode89_consensus_vsearch	2103	T	T	251	6	2.33%	2	2	93	93	0.015170809117680038	1	1	104	147	5	1	-C
barcode89_consensus_vsearch	2104	C	C	252	1	0.4%	2	1	93	93	0.5000000000003686	1	1	104	148	0	1	+T
barcode89_consensus_vsearch	2105	C	*/+G	241	13	5.02%	2	1	93	93	1.0428879711659624E-4	1	1	108	133	0	13	+G
barcode89_consensus_vsearch	2106	G	G	250	4	1.55%	2	1	93	93	0.061761087351402955	1	1	100	150	4	0	-A
barcode89_consensus_vsearch	2107	A	A	250	2	0.79%	2	2	93	93	0.2495029821073759	1	1	101	149	1	1	+G
barcode89_consensus_vsearch	2108	G	G	254	2	0.78%	2	2	93	93	0.2495107632092758	1	1	105	149	1	1	+A
barcode89_consensus_vsearch	2109	G	G	257	1	0.39%	2	1	93	93	0.4999999999999138	1	1	107	150	1	0	-TC
barcode89_consensus_vsearch	2110	T	T	253	3	1.16%	2	1	93	93	0.124266144814075	1	1	105	148	3	0	+C
barcode89_consensus_vsearch	2111	C	C	258	0	0%	2	0	93	0	1.0	1	0	108	150	0	0	
barcode89_consensus_vsearch	2112	A	A	258	1	0.39%	2	1	93	93	0.4999999999999138	1	1	108	150	1	0	G
barcode89_consensus_vsearch	2113	A	A	253	4	1.54%	2	2	93	93	0.0617697211064687	1	1	105	148	3	1	G
barcode89_consensus_vsearch	2114	C	C	255	3	1.16%	2	1	93	93	0.1242718446601877	1	1	108	147	0	3	+T
barcode89_consensus_vsearch	2115	C	*/+T	234	12	4.63%	2	1	93	93	2.1280463299094273E-4	1	1	109	125	0	12	+T
barcode89_consensus_vsearch	2116	T	T	243	4	1.62%	2	1	93	93	0.061740125504571274	1	1	109	134	0	4	C
barcode89_consensus_vsearch	2117	T	T	258	0	0%	2	0	93	0	1.0	1	0	109	149	0	0	
barcode89_consensus_vsearch	2118	T	*/-A	214	29	11.2%	2	2	93	93	7.664332129830562E-10	1	1	93	121	12	17	-A
barcode89_consensus_vsearch	2119	A	A	225	3	1.3%	2	1	93	93	0.12417582417582212	1	1	96	129	0	3	T
barcode89_consensus_vsearch	2120	A	A	257	1	0.39%	2	1	93	93	0.4999999999999138	1	1	108	149	1	0	G
barcode89_consensus_vsearch	2121	A	A	259	0	0%	2	0	93	0	1.0	1	0	109	150	0	0	
barcode89_consensus_vsearch	2122	A	A	258	1	0.39%	2	1	93	93	0.4999999999999138	1	1	109	149	0	1	C
barcode89_consensus_vsearch	2123	A	R	248	8	3.09%	2	1	93	93	0.0036953503162476236	1	1	101	147	8	0	G
barcode89_consensus_vsearch	2124	T	T	258	1	0.39%	2	1	93	93	0.4999999999999138	1	1	108	150	1	0	G
barcode89_consensus_vsearch	2125	T	*/+G	75	166	64.09%	2	2	93	93	1.8640740566778656E-70	1	1	43	32	56	110	+G
barcode89_consensus_vsearch	2126	G	G	253	2	0.78%	2	1	93	93	0.24950884086425928	1	1	104	149	2	0	+A
barcode89_consensus_vsearch	2127	G	G	256	2	0.77%	2	2	93	93	0.24951456310670525	1	1	107	149	1	1	A
barcode89_consensus_vsearch	2128	G	G	258	1	0.39%	2	1	93	93	0.4999999999999138	1	1	109	149	0	1	A
barcode89_consensus_vsearch	2129	G	*/+T	249	7	2.7%	2	2	93	93	0.007494585982750822	1	1	102	147	6	1	+T
barcode89_consensus_vsearch	2130	T	T	255	3	1.16%	2	1	93	93	0.1242718446601877	1	1	109	146	0	3	C
barcode89_consensus_vsearch	2131	T	T	257	2	0.77%	2	2	93	93	0.24951644100587136	1	1	108	149	1	1	C
barcode89_consensus_vsearch	2132	T	T	256	1	0.39%	2	1	93	93	0.4999999999999138	1	1	109	147	0	1	-A
barcode89_consensus_vsearch	2133	A	A	257	1	0.39%	2	1	93	93	0.4999999999999138	1	1	109	148	0	1	G
barcode89_consensus_vsearch	2134	A	A	256	1	0.39%	2	1	93	93	0.4999999999999138	1	1	109	147	0	1	+T
barcode89_consensus_vsearch	2135	T	T	257	1	0.39%	2	1	93	93	0.4999999999999138	1	1	109	148	0	1	+AA
barcode89_consensus_vsearch	2136	A	A	251	4	1.54%	2	2	93	93	0.06176398786346276	1	1	106	145	3	1	G
barcode89_consensus_vsearch	2137	G	G	255	1	0.39%	2	1	93	93	0.4999999999999138	1	1	108	147	1	0	A
barcode89_consensus_vsearch	2138	C	C	253	3	1.16%	2	2	93	93	0.124266144814075	1	1	107	146	1	2	T
barcode89_consensus_vsearch	2139	A	A	250	3	1.16%	2	1	93	93	0.12425742574263329	1	1	106	144	0	3	+G
barcode89_consensus_vsearch	2140	G	G	255	1	0.39%	2	1	93	93	0.4999999999999138	1	1	108	147	0	1	+T
barcode89_consensus_vsearch	2141	G	G	257	1	0.39%	2	1	93	93	0.4999999999999138	1	1	108	149	0	1	A
barcode89_consensus_vsearch	2142	A	A	254	2	0.78%	2	2	93	93	0.2495107632092758	1	1	106	148	1	1	G
barcode89_consensus_vsearch	2143	C	C	253	3	1.16%	2	1	93	93	0.124266144814075	1	1	104	149	3	0	-AC
barcode89_consensus_vsearch	2144	A	A	251	4	1.57%	2	2	93	93	0.06176398786346276	1	1	103	148	2	2	G
barcode89_consensus_vsearch	2145	C	C	254	1	0.39%	2	1	93	93	0.4999999999999138	1	1	105	149	1	0	+AC
barcode89_consensus_vsearch	2146	G	G	255	2	0.77%	2	1	93	93	0.2495126705651419	1	1	107	148	2	0	A
barcode89_consensus_vsearch	2147	C	C	255	1	0.39%	2	1	93	93	0.4999999999999138	1	1	107	148	1	0	G
barcode89_consensus_vsearch	2148	A	A	256	1	0.39%	2	1	93	93	0.4999999999999138	1	1	108	148	1	0	+CCA
barcode89_consensus_vsearch	2149	G	G	257	1	0.39%	2	1	93	93	0.4999999999999138	1	1	108	149	1	0	-A
barcode89_consensus_vsearch	2150	A	A	252	3	1.16%	2	1	93	93	0.12426326129665838	1	1	105	147	3	0	G
barcode89_consensus_vsearch	2151	C	C	254	3	1.16%	2	2	93	93	0.12426900584791233	1	1	108	146	1	2	-T
barcode89_consensus_vsearch	2152	T	T	254	1	0.39%	2	1	93	93	0.4999999999999138	1	1	106	148	1	0	A
barcode89_consensus_vsearch	2153	T	T	255	2	0.77%	2	1	93	93	0.2495126705651419	1	1	105	150	2	0	-A
barcode89_consensus_vsearch	2154	A	A	253	3	1.17%	2	2	93	93	0.124266144814075	1	1	104	149	2	1	G
barcode89_consensus_vsearch	2155	A	A	252	4	1.54%	2	1	93	93	0.06176686569346045	1	1	103	149	4	0	G
barcode89_consensus_vsearch	2156	C	C	258	0	0%	2	0	93	0	1.0	1	0	108	150	0	0	
barcode89_consensus_vsearch	2157	T	*/-G	237	19	7.36%	2	1	93	93	1.3486832968659411E-6	1	1	107	130	0	19	-G
barcode89_consensus_vsearch	2158	G	G	237	1	0.42%	2	1	93	93	0.5000000000003686	1	1	107	130	1	0	A
barcode89_consensus_vsearch	2159	G	G	250	5	1.93%	2	1	93	93	0.030637867497453432	1	1	101	149	5	0	-AT
barcode89_consensus_vsearch	2160	A	A	243	4	1.6%	2	1	93	93	0.061740125504571274	1	1	101	142	0	4	+T
barcode89_consensus_vsearch	2161	T	T	252	1	0.39%	2	1	93	93	0.5000000000003686	1	1	104	148	0	1	+AC
barcode89_consensus_vsearch	2162	T	T	257	2	0.77%	2	1	93	93	0.24951644100587136	1	1	107	150	2	0	C
barcode89_consensus_vsearch	2163	T	T	256	1	0.39%	2	1	93	93	0.4999999999999138	1	1	108	148	1	0	+C
barcode89_consensus_vsearch	2164	A	A	256	2	0.78%	2	1	93	93	0.24951456310670525	1	1	107	149	2	0	G
barcode89_consensus_vsearch	2165	C	*/-AC	246	9	3.47%	2	1	93	93	0.0018178284943888832	1	1	100	146	9	0	-AC
barcode89_consensus_vsearch	2166	A	A	246	2	0.8%	2	2	93	93	0.24949494949494755	1	1	99	147	1	1	G
barcode89_consensus_vsearch	2167	C	C	246	1	0.4%	2	1	93	93	0.5000000000003686	1	1	99	147	1	0	+AC
barcode89_consensus_vsearch	2168	T	T	252	3	1.16%	2	2	93	93	0.12426326129665838	1	1	108	144	1	2	C
barcode89_consensus_vsearch	2169	A	A	256	2	0.77%	2	1	93	93	0.24951456310670525	1	1	108	148	0	2	G
barcode89_consensus_vsearch	2170	T	T	257	1	0.39%	2	1	93	93	0.4999999999999138	1	1	107	150	1	0	-C
barcode89_consensus_vsearch	2171	C	C	258	0	0%	2	0	93	0	1.0	1	0	108	150	0	0	
barcode89_consensus_vsearch	2172	C	C	258	1	0.39%	2	1	93	93	0.4999999999999138	1	1	109	149	0	1	T
barcode89_consensus_vsearch	2173	A	A	258	1	0.39%	2	1	93	93	0.4999999999999138	1	1	108	150	1	0	T
barcode89_consensus_vsearch	2174	C	C	258	1	0.39%	2	1	93	93	0.4999999999999138	1	1	108	150	1	0	G
barcode89_consensus_vsearch	2175	C	C	255	3	1.16%	2	1	93	93	0.1242718446601877	1	1	109	146	0	3	-G
barcode89_consensus_vsearch	2176	G	G	255	1	0.39%	2	1	93	93	0.4999999999999138	1	1	109	146	0	1	A
barcode89_consensus_vsearch	2177	G	G	259	0	0%	2	0	93	0	1.0	1	0	109	150	0	0	
barcode89_consensus_vsearch	2178	C	C	252	4	1.54%	2	1	93	93	0.06176686569346045	1	1	105	147	4	0	+G
barcode89_consensus_vsearch	2179	A	A	247	5	1.93%	2	1	93	93	0.030630587731099716	1	1	100	147	5	0	-G
barcode89_consensus_vsearch	2180	G	G	251	1	0.4%	2	1	93	93	0.5000000000003686	1	1	104	147	0	1	+A
barcode89_consensus_vsearch	2181	G	G	252	3	1.16%	2	2	93	93	0.12426326129665838	1	1	108	144	1	2	A
barcode89_consensus_vsearch	2182	C	C	254	2	0.78%	2	1	93	93	0.2495107632092758	1	1	108	146	0	2	T
barcode89_consensus_vsearch	2183	T	T	253	2	0.78%	2	1	93	93	0.24950884086425928	1	1	108	145	0	2	-C
barcode89_consensus_vsearch	2184	C	C	253	1	0.39%	2	1	93	93	0.5000000000003686	1	1	108	145	0	1	+T
barcode89_consensus_vsearch	2185	T	T	246	3	1.17%	2	1	93	93	0.1242454728369122	1	1	105	141	0	3	+G
barcode89_consensus_vsearch	2186	G	G	249	3	1.18%	2	1	93	93	0.12425447316115633	1	1	105	144	0	3	A
barcode89_consensus_vsearch	2187	T	T	247	4	1.58%	2	1	93	93	0.061752247008950906	1	1	105	142	0	4	A
barcode89_consensus_vsearch	2188	A	A	256	1	0.39%	2	1	93	93	0.4999999999999138	1	1	106	150	1	0	G
barcode89_consensus_vsearch	2189	G	G	254	2	0.78%	2	1	93	93	0.2495107632092758	1	1	108	146	0	2	+T
barcode89_consensus_vsearch	2190	C	C	254	2	0.78%	2	2	93	93	0.2495107632092758	1	1	107	147	1	1	T
barcode89_consensus_vsearch	2191	G	G	257	1	0.39%	2	1	93	93	0.4999999999999138	1	1	107	150	1	0	-A
barcode89_consensus_vsearch	2192	A	*/-GA	230	24	9.3%	2	1	93	93	3.37119103050897E-8	1	1	80	150	24	0	-GA
barcode89_consensus_vsearch	2193	G	G	233	2	0.85%	2	1	93	93	0.2494669509597199	1	1	83	150	2	0	-A
barcode89_consensus_vsearch	2194	A	A	232	1	0.43%	2	1	93	93	0.4999999999999138	1	1	82	150	1	0	G
barcode89_consensus_vsearch	2195	A	A	253	2	0.77%	2	1	93	93	0.24950884086425928	1	1	106	147	2	0	-G
barcode89_consensus_vsearch	2196	G	*/-A	246	8	3.12%	2	1	93	93	0.003693711391797067	1	1	98	148	8	0	-A
barcode89_consensus_vsearch	2197	A	A	248	2	0.8%	2	1	93	93	0.24949899799584363	1	1	100	148	0	2	G
barcode89_consensus_vsearch	2198	A	A	258	1	0.39%	2	1	93	93	0.4999999999999138	1	1	108	150	1	0	G
barcode89_consensus_vsearch	2199	A	A	258	1	0.39%	2	1	93	93	0.4999999999999138	1	1	109	149	0	1	G
barcode89_consensus_vsearch	2200	T	T	256	3	1.16%	2	1	93	93	0.12427466150865948	1	1	106	150	3	0	G
barcode89_consensus_vsearch	2201	T	T	257	2	0.77%	2	2	93	93	0.24951644100587136	1	1	108	149	1	1	C
barcode89_consensus_vsearch	2202	A	A	256	1	0.39%	2	1	93	93	0.4999999999999138	1	1	108	148	1	0	+C
barcode89_consensus_vsearch	2203	C	C	252	4	1.54%	2	2	93	93	0.06176686569346045	1	1	108	144	1	3	-TAC
barcode89_consensus_vsearch	2204	T	T	253	1	0.39%	2	1	93	93	0.5000000000003686	1	1	107	146	1	0	C
barcode89_consensus_vsearch	2205	A	A	250	4	1.57%	2	2	93	93	0.061761087351402955	1	1	105	145	3	1	G
barcode89_consensus_vsearch	2206	C	C	251	2	0.78%	2	1	93	93	0.24950495049494414	1	1	105	146	2	0	-G
barcode89_consensus_vsearch	2207	G	G	255	2	0.78%	2	1	93	93	0.2495126705651419	1	1	105	150	2	0	A
barcode89_consensus_vsearch	2208	C	C	249	5	1.93%	2	1	93	93	0.03063545999571253	1	1	108	141	0	5	-T
barcode89_consensus_vsearch	2209	T	T	251	2	0.79%	2	2	93	93	0.24950495049494414	1	1	107	144	1	1	C
barcode89_consensus_vsearch	2210	T	T	254	3	1.16%	2	2	93	93	0.12426900584791233	1	1	107	147	1	2	C
barcode89_consensus_vsearch	2211	A	*/-G	229	25	9.65%	2	1	93	93	1.6020122665660995E-8	1	1	108	121	0	25	-G
barcode89_consensus_vsearch	2212	G	G	233	1	0.43%	2	1	93	93	0.5000000000003686	1	1	109	124	0	1	+T
barcode89_consensus_vsearch	2213	G	G	258	1	0.39%	2	1	93	93	0.4999999999999138	1	1	109	149	0	1	A
barcode89_consensus_vsearch	2214	A	A	254	3	1.16%	2	2	93	93	0.12426900584791233	1	1	105	149	2	1	-C
barcode89_consensus_vsearch	2215	C	C	255	0	0%	2	0	93	0	1.0	1	0	106	149	0	0	
barcode89_consensus_vsearch	2216	C	C	255	1	0.39%	2	1	93	93	0.4999999999999138	1	1	106	149	1	0	+A
barcode89_consensus_vsearch	2217	C	C	251	2	0.77%	2	2	93	93	0.24950495049494414	1	1	108	143	1	1	-G
barcode89_consensus_vsearch	2218	G	G	254	1	0.39%	2	1	93	93	0.4999999999999138	1	1	107	147	0	1	-C
barcode89_consensus_vsearch	2219	C	C	253	2	0.78%	2	1	93	93	0.24950884086425928	1	1	109	144	0	2	-A
barcode89_consensus_vsearch	2220	A	A	251	3	1.17%	2	1	93	93	0.12426035502961323	1	1	106	145	3	0	G
barcode89_consensus_vsearch	2221	G	G	253	1	0.39%	2	1	93	93	0.5000000000003686	1	1	107	146	1	0	+A
barcode89_consensus_vsearch	2222	G	G	253	1	0.39%	2	1	93	93	0.5000000000003686	1	1	107	146	0	1	-TG
barcode89_consensus_vsearch	2223	T	T	254	1	0.39%	2	1	93	93	0.4999999999999138	1	1	108	146	0	1	-G
barcode89_consensus_vsearch	2224	G	G	254	2	0.78%	2	1	93	93	0.2495107632092758	1	1	108	146	0	2	A
barcode89_consensus_vsearch	2225	A	A	256	1	0.39%	2	1	93	93	0.4999999999999138	1	1	107	149	0	1	-C
barcode89_consensus_vsearch	2226	C	C	254	2	0.78%	2	1	93	93	0.2495107632092758	1	1	107	147	2	0	-GC
barcode89_consensus_vsearch	2227	G	G	252	3	1.17%	2	2	93	93	0.12426326129665838	1	1	105	147	2	1	A
barcode89_consensus_vsearch	2228	C	C	252	4	1.56%	2	1	93	93	0.06176686569346045	1	1	107	145	0	4	T
barcode89_consensus_vsearch	2229	T	T	252	4	1.55%	2	2	93	93	0.06176686569346045	1	1	108	144	1	3	C
barcode89_consensus_vsearch	2230	A	A	256	1	0.39%	2	1	93	93	0.4999999999999138	1	1	107	149	0	1	-C
barcode89_consensus_vsearch	2231	C	C	256	1	0.39%	2	1	93	93	0.4999999999999138	1	1	108	148	0	1	+GC
barcode89_consensus_vsearch	2232	T	*/-G	247	11	4.25%	2	1	93	93	4.3793947047224713E-4	1	1	109	138	0	11	-G
barcode89_consensus_vsearch	2233	G	G	245	1	0.4%	2	1	93	93	0.4999999999999138	1	1	108	137	0	1	+T
barcode89_consensus_vsearch	2234	G	G	258	1	0.39%	2	1	93	93	0.4999999999999138	1	1	109	149	0	1	A
barcode89_consensus_vsearch	2235	A	A	255	3	1.16%	2	2	93	93	0.1242718446601877	1	1	107	148	1	2	+C
barcode89_consensus_vsearch	2236	C	*/-T	251	7	2.7%	2	1	93	93	0.007497030913500092	1	1	109	142	0	7	-T
barcode89_consensus_vsearch	2237	T	T	250	1	0.4%	2	1	93	93	0.4999999999999138	1	1	107	143	1	0	+C
barcode89_consensus_vsearch	2238	C	C	255	2	0.78%	2	1	93	93	0.2495126705651419	1	1	108	147	0	2	-T
barcode89_consensus_vsearch	2239	T	T	251	3	1.17%	2	1	93	93	0.12426035502961323	1	1	107	144	0	3	+CT
barcode89_consensus_vsearch	2240	A	*/-G	225	28	10.81%	2	2	93	93	1.6900222473046537E-9	1	1	106	119	1	27	-G
barcode89_consensus_vsearch	2241	G	G	228	0	0%	2	0	93	0	1.0	1	0	108	120	0	0	
barcode89_consensus_vsearch	2242	G	G	256	0	0%	2	0	93	0	1.0	1	0	109	147	0	0	
barcode89_consensus_vsearch	2243	G	G	258	1	0.39%	2	1	93	93	0.4999999999999138	1	1	108	150	1	0	+TG
barcode89_consensus_vsearch	2244	C	C	257	2	0.77%	2	1	93	93	0.24951644100587136	1	1	109	148	0	2	T
barcode89_consensus_vsearch	2245	T	T	258	1	0.39%	2	1	93	93	0.4999999999999138	1	1	108	150	1	0	C
barcode89_consensus_vsearch	2246	G	G	258	1	0.39%	2	1	93	93	0.4999999999999138	1	1	108	150	1	0	A
barcode89_consensus_vsearch	2247	C	*/-A	236	13	5.02%	2	2	93	93	1.0395109422588356E-4	1	1	99	137	8	5	-A
barcode89_consensus_vsearch	2248	A	A	244	2	0.81%	2	2	93	93	0.24949083503056865	1	1	100	144	1	1	G
barcode89_consensus_vsearch	2249	A	A	259	0	0%	2	0	93	0	1.0	1	0	109	150	0	0	
barcode89_consensus_vsearch	2250	A	A	258	1	0.39%	2	1	93	93	0.4999999999999138	1	1	108	150	1	0	+G
barcode89_consensus_vsearch	2251	A	A	257	1	0.39%	2	1	93	93	0.4999999999999138	1	1	108	149	1	0	-TT
barcode89_consensus_vsearch	2252	T	T	252	6	2.33%	2	1	93	93	0.015172562563020547	1	1	108	144	0	6	+C
barcode89_consensus_vsearch	2253	T	*/-C	240	15	5.81%	2	1	93	93	2.468919460222434E-5	1	1	108	132	0	15	-C
barcode89_consensus_vsearch	2254	C	C	230	5	2.05%	2	1	93	93	0.030585828885528864	1	1	106	124	0	5	+GG
barcode89_consensus_vsearch	2255	G	G	252	2	0.78%	2	1	93	93	0.2495069033532105	1	1	104	148	2	0	A
barcode89_consensus_vsearch	2256	C	Y	228	24	9.3%	2	2	93	93	3.355223097997583E-8	1	1	105	123	2	22	T
barcode89_consensus_vsearch	2257	A	A	251	2	0.79%	2	1	93	93	0.24950495049494414	1	1	106	145	2	0	G
barcode89_consensus_vsearch	2258	A	A	255	2	0.77%	2	1	93	93	0.2495126705651419	1	1	107	148	0	2	-T
barcode89_consensus_vsearch	2259	T	T	249	6	2.33%	2	2	93	93	0.015167261137354384	1	1	105	144	2	4	-C
barcode89_consensus_vsearch	2260	C	C	251	1	0.4%	2	1	93	93	0.5000000000003686	1	1	105	146	1	0	T
barcode89_consensus_vsearch	2261	C	C	258	0	0%	2	0	93	0	1.0	1	0	108	150	0	0	
barcode89_consensus_vsearch	2262	C	C	257	1	0.39%	2	1	93	93	0.4999999999999138	1	1	108	149	0	1	+T
barcode89_consensus_vsearch	2263	C	C	255	2	0.77%	2	1	93	93	0.2495126705651419	1	1	108	147	0	2	+A
barcode89_consensus_vsearch	2264	A	A	259	0	0%	2	0	93	0	1.0	1	0	109	150	0	0	
barcode89_consensus_vsearch	2265	A	A	255	3	1.16%	2	2	93	93	0.1242718446601877	1	1	107	148	2	1	G
barcode89_consensus_vsearch	2266	C	C	255	2	0.77%	2	2	93	93	0.2495126705651419	1	1	107	148	1	1	T
barcode89_consensus_vsearch	2267	A	A	254	2	0.78%	2	1	93	93	0.2495107632092758	1	1	107	147	0	2	+T
barcode89_consensus_vsearch	2268	C	C	254	2	0.78%	2	1	93	93	0.2495107632092758	1	1	107	147	0	2	T
barcode89_consensus_vsearch	2269	C	C	254	4	1.54%	2	1	93	93	0.06177255436325217	1	1	105	149	4	0	-A
barcode89_consensus_vsearch	2270	A	A	250	2	0.78%	2	2	93	93	0.2495029821073759	1	1	104	146	1	1	+G
barcode89_consensus_vsearch	2271	A	A	255	2	0.77%	2	1	93	93	0.2495126705651419	1	1	108	147	0	2	G
barcode89_consensus_vsearch	2272	G	G	254	2	0.78%	2	2	93	93	0.2495107632092758	1	1	106	148	1	1	A
barcode89_consensus_vsearch	2273	A	A	258	0	0%	2	0	93	0	1.0	1	0	108	150	0	0	
barcode89_consensus_vsearch	2274	C	C	258	1	0.39%	2	1	93	93	0.4999999999999138	1	1	108	150	1	0	+G
barcode89_consensus_vsearch	2275	A	A	249	4	1.54%	2	1	93	93	0.06175816388801474	1	1	108	141	0	4	+G
barcode89_consensus_vsearch	2276	G	G	255	1	0.39%	2	1	93	93	0.4999999999999138	1	1	108	147	1	0	A
barcode89_consensus_vsearch	2277	G	G	257	1	0.39%	2	1	93	93	0.4999999999999138	1	1	108	149	0	1	+C
barcode89_consensus_vsearch	2278	C	C	251	3	1.16%	2	1	93	93	0.12426035502961323	1	1	105	146	3	0	-TT
barcode89_consensus_vsearch	2279	T	T	252	2	0.79%	2	2	93	93	0.2495069033532105	1	1	104	148	1	1	C
barcode89_consensus_vsearch	2280	T	T	247	2	0.78%	2	1	93	93	0.24949698189118988	1	1	102	145	0	2	+G
barcode89_consensus_vsearch	2281	G	G	251	5	1.95%	2	2	93	93	0.03064025621010106	1	1	103	148	3	2	-A
barcode89_consensus_vsearch	2282	A	A	252	1	0.39%	2	1	93	93	0.5000000000003686	1	1	104	148	1	0	-G
barcode89_consensus_vsearch	2283	G	G	256	1	0.39%	2	1	93	93	0.4999999999999138	1	1	107	149	0	1	-T
barcode89_consensus_vsearch	2284	T	T	256	1	0.39%	2	1	93	93	0.4999999999999138	1	1	108	148	1	0	+CT
barcode89_consensus_vsearch	2285	G	G	259	0	0%	2	0	93	0	1.0	1	0	109	150	0	0	
barcode89_consensus_vsearch	2286	G	G	257	1	0.39%	2	1	93	93	0.4999999999999138	1	1	107	150	1	0	+T
barcode89_consensus_vsearch	2287	T	T	254	2	0.78%	2	1	93	93	0.2495107632092758	1	1	106	148	0	2	C
barcode89_consensus_vsearch	2288	T	T	256	2	0.77%	2	1	93	93	0.24951456310670525	1	1	107	149	2	0	C
barcode89_consensus_vsearch	2289	A	A	256	2	0.77%	2	1	93	93	0.24951456310670525	1	1	108	148	0	2	+G
barcode89_consensus_vsearch	2290	T	T	253	3	1.16%	2	1	93	93	0.124266144814075	1	1	107	146	0	3	-A
barcode89_consensus_vsearch	2291	A	A	253	2	0.78%	2	1	93	93	0.24950884086425928	1	1	106	147	2	0	G
barcode89_consensus_vsearch	2292	A	A	254	3	1.16%	2	1	93	93	0.12426900584791233	1	1	107	147	0	3	-T
barcode89_consensus_vsearch	2293	T	T	251	5	1.95%	2	2	93	93	0.03064025621010106	1	1	108	143	1	4	C
barcode89_consensus_vsearch	2294	G	G	255	1	0.39%	2	1	93	93	0.4999999999999138	1	1	108	147	1	0	+A
barcode89_consensus_vsearch	2295	A	A	255	2	0.78%	2	1	93	93	0.2495126705651419	1	1	106	149	2	0	G
barcode89_consensus_vsearch	2296	C	C	254	2	0.77%	2	2	93	93	0.2495107632092758	1	1	107	147	1	1	-G
barcode89_consensus_vsearch	2297	G	G	251	6	2.33%	2	1	93	93	0.015170809117680038	1	1	108	143	0	6	-C
barcode89_consensus_vsearch	2298	C	C	252	1	0.4%	2	1	93	93	0.5000000000003686	1	1	108	144	1	0	A
barcode89_consensus_vsearch	2299	T	T	257	2	0.77%	2	2	93	93	0.24951644100587136	1	1	108	149	1	1	C
barcode89_consensus_vsearch	2300	C	C	257	1	0.39%	2	1	93	93	0.4999999999999138	1	1	109	148	0	1	-G
barcode89_consensus_vsearch	2301	G	G	255	1	0.39%	2	1	93	93	0.4999999999999138	1	1	109	146	0	1	+A
barcode89_consensus_vsearch	2302	A	A	256	1	0.39%	2	1	93	93	0.4999999999999138	1	1	109	147	0	1	+GT
barcode89_consensus_vsearch	2303	A	A	249	4	1.55%	2	1	93	93	0.06175816388801474	1	1	109	140	0	4	-C
barcode89_consensus_vsearch	2304	C	*/-A	224	17	6.75%	2	2	93	93	5.696139726468511E-6	1	1	107	117	1	16	-A
barcode89_consensus_vsearch	2305	A	A	230	4	1.67%	2	1	93	93	0.06169786557982323	1	1	108	122	0	4	G
barcode89_consensus_vsearch	2306	A	*/-G	244	7	2.72%	2	2	93	93	0.00748830460110489	1	1	106	138	1	6	-G
barcode89_consensus_vsearch	2307	G	G	250	1	0.4%	2	1	93	93	0.4999999999999138	1	1	107	143	0	1	+T
barcode89_consensus_vsearch	2308	C	C	254	2	0.77%	2	1	93	93	0.2495107632092758	1	1	106	148	0	2	T
barcode89_consensus_vsearch	2309	A	A	255	1	0.39%	2	1	93	93	0.4999999999999138	1	1	107	148	0	1	+CA
barcode89_consensus_vsearch	2310	T	T	254	1	0.39%	2	1	93	93	0.4999999999999138	1	1	105	149	0	1	+GG
barcode89_consensus_vsearch	2311	A	R	247	7	2.71%	2	2	93	93	0.00749210286352295	1	1	100	147	4	3	G
barcode89_consensus_vsearch	2312	C	C	254	1	0.39%	2	1	93	93	0.4999999999999138	1	1	105	149	0	1	+T
barcode89_consensus_vsearch	2313	C	C	259	0	0%	2	0	93	0	1.0	1	0	109	150	0	0	
barcode89_consensus_vsearch	2314	C	C	255	3	1.16%	2	1	93	93	0.1242718446601877	1	1	108	147	0	3	T
barcode89_consensus_vsearch	2315	G	G	257	1	0.39%	2	1	93	93	0.4999999999999138	1	1	107	150	1	0	A
barcode89_consensus_vsearch	2316	G	G	256	1	0.39%	2	1	93	93	0.4999999999999138	1	1	106	150	1	0	-CGG
barcode89_consensus_vsearch	2317	C	C	253	2	0.78%	2	1	93	93	0.24950884086425928	1	1	107	146	0	2	-G
barcode89_consensus_vsearch	2318	G	G	253	1	0.39%	2	1	93	93	0.5000000000003686	1	1	107	146	0	1	+TG
barcode89_consensus_vsearch	2319	G	G	255	2	0.78%	2	1	93	93	0.2495126705651419	1	1	106	149	2	0	-A
barcode89_consensus_vsearch	2320	A	A	257	0	0%	2	0	93	0	1.0	1	0	107	150	0	0	
barcode89_consensus_vsearch	2321	A	A	257	1	0.39%	2	1	93	93	0.4999999999999138	1	1	109	148	0	1	G
barcode89_consensus_vsearch	2322	T	T	257	1	0.39%	2	1	93	93	0.4999999999999138	1	1	108	149	0	1	-ACCACCG
barcode89_consensus_vsearch	2323	A	A	254	2	0.78%	2	2	93	93	0.2495107632092758	1	1	108	146	1	1	G
barcode89_consensus_vsearch	2324	C	C	254	1	0.39%	2	1	93	93	0.4999999999999138	1	1	109	145	0	1	+T
barcode89_consensus_vsearch	2325	C	*/-ACC	245	10	3.89%	2	2	93	93	8.925864463478502E-4	1	1	100	145	9	1	-ACC
barcode89_consensus_vsearch	2326	A	A	242	2	0.81%	2	1	93	93	0.24948665297746256	1	1	99	143	0	2	-C
barcode89_consensus_vsearch	2327	C	C	242	1	0.41%	2	1	93	93	0.4999999999999138	1	1	100	142	0	1	+T
barcode89_consensus_vsearch	2328	C	Y	229	12	4.84%	2	1	93	93	2.1218410207391174E-4	1	1	100	129	0	12	T
barcode89_consensus_vsearch	2329	G	G	251	1	0.4%	2	1	93	93	0.5000000000003686	1	1	108	143	1	0	A
barcode89_consensus_vsearch	2330	G	G	255	1	0.39%	2	1	93	93	0.4999999999999138	1	1	109	146	0	1	C
barcode89_consensus_vsearch	2331	G	G	253	3	1.17%	2	1	93	93	0.124266144814075	1	1	109	144	0	3	-TG
barcode89_consensus_vsearch	2332	T	T	251	2	0.78%	2	2	93	93	0.24950495049494414	1	1	108	143	1	1	C
barcode89_consensus_vsearch	2333	G	G	254	1	0.39%	2	1	93	93	0.4999999999999138	1	1	109	145	0	1	A
barcode89_consensus_vsearch	2334	C	C	256	1	0.39%	2	1	93	93	0.4999999999999138	1	1	108	148	1	0	-A
barcode89_consensus_vsearch	2335	A	A	255	1	0.39%	2	1	93	93	0.4999999999999138	1	1	107	148	0	1	+G
barcode89_consensus_vsearch	2336	A	A	253	3	1.16%	2	2	93	93	0.124266144814075	1	1	107	146	1	2	G
barcode89_consensus_vsearch	2337	T	T	254	1	0.39%	2	1	93	93	0.4999999999999138	1	1	107	147	1	0	+A
barcode89_consensus_vsearch	2338	G	*/-TG	248	9	3.49%	2	1	93	93	0.0018188615104327871	1	1	108	140	0	9	-TG
barcode89_consensus_vsearch	2339	T	T	246	2	0.8%	2	2	93	93	0.24949494949494755	1	1	108	138	1	1	C
barcode89_consensus_vsearch	2340	G	G	242	3	1.2%	2	1	93	93	0.1242331288343819	1	1	104	138	3	0	A
barcode89_consensus_vsearch	2341	C	C	257	0	0%	2	0	93	0	1.0	1	0	109	148	0	0	
barcode89_consensus_vsearch	2342	G	G	252	2	0.78%	2	1	93	93	0.2495069033532105	1	1	106	146	2	0	-T
barcode89_consensus_vsearch	2343	T	T	254	2	0.78%	2	2	93	93	0.2495107632092758	1	1	106	148	1	1	C
barcode89_consensus_vsearch	2344	T	T	254	2	0.77%	2	1	93	93	0.2495107632092758	1	1	106	148	2	0	+C
barcode89_consensus_vsearch	2345	C	*/-A	243	9	3.5%	2	1	93	93	0.001816248829692974	1	1	95	148	9	0	-A
barcode89_consensus_vsearch	2346	A	A	246	3	1.2%	2	2	93	93	0.1242454728369122	1	1	98	148	1	2	G
barcode89_consensus_vsearch	2347	A	A	256	1	0.39%	2	1	93	93	0.4999999999999138	1	1	107	149	1	0	+G
barcode89_consensus_vsearch	2348	A	A	258	1	0.39%	2	1	93	93	0.4999999999999138	1	1	108	150	1	0	-G
barcode89_consensus_vsearch	2349	G	G	258	0	0%	2	0	93	0	1.0	1	0	108	150	0	0	
barcode89_consensus_vsearch	2350	A	A	257	2	0.77%	2	2	93	93	0.24951644100587136	1	1	108	149	1	1	G
barcode89_consensus_vsearch	2351	T	T	255	3	1.16%	2	1	93	93	0.1242718446601877	1	1	108	147	0	3	+C
barcode89_consensus_vsearch	2352	T	T	253	3	1.16%	2	2	93	93	0.124266144814075	1	1	107	146	1	2	C
barcode89_consensus_vsearch	2353	C	C	247	3	1.17%	2	2	93	93	0.12424849699405838	1	1	107	140	1	2	+G
barcode89_consensus_vsearch	2354	G	G	254	1	0.39%	2	1	93	93	0.4999999999999138	1	1	107	147	1	0	+C
barcode89_consensus_vsearch	2355	A	A	258	0	0%	2	0	93	0	1.0	1	0	108	150	0	0	
barcode89_consensus_vsearch	2356	T	T	256	1	0.39%	2	1	93	93	0.4999999999999138	1	1	108	148	0	1	-G
barcode89_consensus_vsearch	2357	G	G	258	0	0%	2	0	93	0	1.0	1	0	109	149	0	0	
barcode89_consensus_vsearch	2358	A	A	258	1	0.39%	2	1	93	93	0.4999999999999138	1	1	109	149	0	1	-T
barcode89_consensus_vsearch	2359	T	T	255	2	0.78%	2	1	93	93	0.2495126705651419	1	1	108	147	0	2	+C
barcode89_consensus_vsearch	2360	T	T	255	2	0.77%	2	1	93	93	0.2495126705651419	1	1	108	147	0	2	-C
barcode89_consensus_vsearch	2361	C	C	255	2	0.78%	2	1	93	93	0.2495126705651419	1	1	109	146	0	2	+A
barcode89_consensus_vsearch	2362	A	A	255	3	1.16%	2	2	93	93	0.1242718446601877	1	1	106	149	2	1	G
barcode89_consensus_vsearch	2363	C	C	257	1	0.39%	2	1	93	93	0.4999999999999138	1	1	108	149	0	1	T
barcode89_consensus_vsearch	2364	T	T	252	3	1.16%	2	1	93	93	0.12426326129665838	1	1	107	145	0	3	+G
barcode89_consensus_vsearch	2365	G	G	255	3	1.16%	2	2	93	93	0.1242718446601877	1	1	107	148	2	1	-A
barcode89_consensus_vsearch	2366	A	A	254	1	0.39%	2	1	93	93	0.4999999999999138	1	1	105	149	1	0	C
barcode89_consensus_vsearch	2367	A	A	254	2	0.77%	2	1	93	93	0.2495107632092758	1	1	109	145	0	2	+T
barcode89_consensus_vsearch	2368	T	T	256	1	0.39%	2	1	93	93	0.4999999999999138	1	1	108	148	0	1	+C
barcode89_consensus_vsearch	2369	T	T	253	3	1.16%	2	1	93	93	0.124266144814075	1	1	108	145	0	3	+C
barcode89_consensus_vsearch	2370	C	C	253	3	1.16%	2	2	93	93	0.124266144814075	1	1	108	145	1	2	-T
barcode89_consensus_vsearch	2371	T	T	248	5	1.95%	2	1	93	93	0.030633033482245435	1	1	108	140	0	5	C
barcode89_consensus_vsearch	2372	G	G	257	1	0.39%	2	1	93	93	0.4999999999999138	1	1	108	149	0	1	-C
barcode89_consensus_vsearch	2373	C	*/-A	247	8	3.1%	2	1	93	93	0.0036945340250354765	1	1	109	138	0	8	-A
barcode89_consensus_vsearch	2374	A	A	248	2	0.8%	2	1	93	93	0.24949899799584363	1	1	109	139	0	2	G
barcode89_consensus_vsearch	2375	A	*/-T	249	8	3.09%	2	1	93	93	0.0036961603384701837	1	1	108	141	0	8	-T
barcode89_consensus_vsearch	2376	T	T	246	5	1.99%	2	2	93	93	0.03062812251247695	1	1	108	138	1	4	C
barcode89_consensus_vsearch	2377	T	Y	247	7	2.7%	2	1	93	93	0.00749210286352295	1	1	108	139	0	7	C
barcode89_consensus_vsearch	2378	C	C	255	1	0.39%	2	1	93	93	0.4999999999999138	1	1	108	147	1	0	-ACA
barcode89_consensus_vsearch	2379	A	A	250	4	1.55%	2	1	93	93	0.061761087351402955	1	1	102	148	4	0	-CA
barcode89_consensus_vsearch	2380	C	C	251	2	0.79%	2	1	93	93	0.24950495049494414	1	1	102	149	2	0	-A
barcode89_consensus_vsearch	2381	A	A	249	2	0.8%	2	1	93	93	0.24950099800389156	1	1	100	149	2	0	G
barcode89_consensus_vsearch	2382	T	T	254	3	1.16%	2	1	93	93	0.12426900584791233	1	1	105	149	3	0	G
barcode89_consensus_vsearch	2383	T	T	258	1	0.39%	2	1	93	93	0.4999999999999138	1	1	109	149	0	1	C
barcode89_consensus_vsearch	2384	A	A	255	4	1.54%	2	2	93	93	0.06177536572082746	1	1	107	148	2	2	G
barcode89_consensus_vsearch	2385	C	C	254	2	0.77%	2	2	93	93	0.2495107632092758	1	1	107	147	1	1	-T
barcode89_consensus_vsearch	2386	T	T	255	2	0.78%	2	1	93	93	0.2495126705651419	1	1	108	147	0	2	C
barcode89_consensus_vsearch	2387	T	T	257	1	0.39%	2	1	93	93	0.4999999999999138	1	1	109	148	0	1	C
barcode89_consensus_vsearch	2388	A	A	258	1	0.39%	2	1	93	93	0.4999999999999138	1	1	109	149	0	1	G
barcode89_consensus_vsearch	2389	T	T	255	2	0.77%	2	2	93	93	0.2495126705651419	1	1	106	149	1	1	C
barcode89_consensus_vsearch	2390	C	C	258	0	0%	2	0	93	0	1.0	1	0	108	150	0	0	
barcode89_consensus_vsearch	2391	G	G	257	1	0.39%	2	1	93	93	0.4999999999999138	1	1	109	148	0	1	C
barcode89_consensus_vsearch	2392	C	C	254	5	1.93%	2	1	93	93	0.030647311787538743	1	1	109	145	0	5	T
barcode89_consensus_vsearch	2393	A	A	255	2	0.77%	2	1	93	93	0.2495126705651419	1	1	107	148	2	0	+T
barcode89_consensus_vsearch	2394	T	T	256	1	0.39%	2	1	93	93	0.4999999999999138	1	1	109	147	0	1	C
barcode89_consensus_vsearch	2395	T	T	257	1	0.39%	2	1	93	93	0.4999999999999138	1	1	109	148	0	1	+AC
barcode89_consensus_vsearch	2396	T	T	253	4	1.54%	2	1	93	93	0.0617697211064687	1	1	109	144	0	4	+C
barcode89_consensus_vsearch	2397	C	C	254	2	0.77%	2	1	93	93	0.2495107632092758	1	1	106	148	2	0	-G
barcode89_consensus_vsearch	2398	G	G	255	1	0.39%	2	1	93	93	0.4999999999999138	1	1	107	148	0	1	A
barcode89_consensus_vsearch	2399	C	C	252	3	1.16%	2	2	93	93	0.12426326129665838	1	1	106	146	2	1	A
barcode89_consensus_vsearch	2400	T	Y	247	7	2.75%	2	2	93	93	0.00749210286352295	1	1	105	142	3	4	C
barcode89_consensus_vsearch	2401	G	G	251	4	1.57%	2	1	93	93	0.06176398786346276	1	1	108	143	0	4	-CG
barcode89_consensus_vsearch	2402	C	C	245	5	1.98%	2	2	93	93	0.03062563759307	1	1	106	139	1	4	T
barcode89_consensus_vsearch	2403	G	G	252	1	0.4%	2	1	93	93	0.5000000000003686	1	1	107	145	1	0	+T
barcode89_consensus_vsearch	2404	T	T	255	1	0.39%	2	1	93	93	0.4999999999999138	1	1	109	146	0	1	+C
barcode89_consensus_vsearch	2405	T	T	256	1	0.39%	2	1	93	93	0.4999999999999138	1	1	109	147	0	1	-C
barcode89_consensus_vsearch	2406	C	C	255	2	0.78%	2	1	93	93	0.2495126705651419	1	1	109	146	0	2	+T
barcode89_consensus_vsearch	2407	T	T	256	1	0.39%	2	1	93	93	0.4999999999999138	1	1	109	147	0	1	+C
barcode89_consensus_vsearch	2408	T	T	259	0	0%	2	0	93	0	1.0	1	0	109	150	0	0	
barcode89_consensus_vsearch	2409	C	C	258	1	0.39%	2	1	93	93	0.4999999999999138	1	1	109	149	0	1	+TTC
barcode89_consensus_vsearch	2410	A	A	258	1	0.39%	2	1	93	93	0.4999999999999138	1	1	108	150	1	0	G
barcode89_consensus_vsearch	2411	T	T	257	1	0.39%	2	1	93	93	0.4999999999999138	1	1	107	150	1	0	C
barcode89_consensus_vsearch	2412	C	C	259	0	0%	2	0	93	0	1.0	1	0	109	150	0	0	
barcode89_consensus_vsearch	2413	G	G	257	1	0.39%	2	1	93	93	0.4999999999999138	1	1	108	149	1	0	-A
barcode89_consensus_vsearch	2414	A	A	256	2	0.78%	2	2	93	93	0.24951456310670525	1	1	107	149	1	1	G
barcode89_consensus_vsearch	2415	T	T	258	1	0.39%	2	1	93	93	0.4999999999999138	1	1	108	150	1	0	+C
barcode89_consensus_vsearch	2416	G	R	246	9	3.47%	2	1	93	93	0.0018178284943888832	1	1	97	149	9	0	A
barcode89_consensus_vsearch	2417	C	C	256	0	0%	2	0	93	0	1.0	1	0	106	150	0	0	
barcode89_consensus_vsearch	2418	C	C	256	1	0.39%	2	1	93	93	0.4999999999999138	1	1	107	149	1	0	+A
barcode89_consensus_vsearch	2419	A	A	251	4	1.55%	2	2	93	93	0.06176398786346276	1	1	107	144	1	3	G
barcode89_consensus_vsearch	2420	G	G	256	1	0.39%	2	1	93	93	0.4999999999999138	1	1	109	147	0	1	+A
barcode89_consensus_vsearch	2421	A	A	256	2	0.77%	2	2	93	93	0.24951456310670525	1	1	107	149	1	1	G
barcode89_consensus_vsearch	2422	A	A	255	2	0.77%	2	1	93	93	0.2495126705651419	1	1	107	148	2	0	-C
barcode89_consensus_vsearch	2423	C	C	255	1	0.39%	2	1	93	93	0.4999999999999138	1	1	107	148	0	1	+T
barcode89_consensus_vsearch	2424	C	C	254	3	1.16%	2	1	93	93	0.12426900584791233	1	1	104	150	3	0	+A
barcode89_consensus_vsearch	2425	A	A	255	1	0.39%	2	1	93	93	0.4999999999999138	1	1	106	149	1	0	+G
barcode89_consensus_vsearch	2426	A	A	253	3	1.16%	2	1	93	93	0.124266144814075	1	1	105	148	3	0	-G
barcode89_consensus_vsearch	2427	G	G	253	2	0.78%	2	1	93	93	0.24950884086425928	1	1	103	150	2	0	+A
barcode89_consensus_vsearch	2428	A	A	258	1	0.39%	2	1	93	93	0.4999999999999138	1	1	109	149	0	1	-G
barcode89_consensus_vsearch	2429	G	G	254	4	1.55%	2	1	93	93	0.06177255436325217	1	1	105	149	4	0	-A
barcode89_consensus_vsearch	2430	A	A	255	0	0%	2	0	93	0	1.0	1	0	105	150	0	0	
barcode89_consensus_vsearch	2431	T	T	257	2	0.77%	2	1	93	93	0.24951644100587136	1	1	107	150	2	0	+C
barcode89_consensus_vsearch	2432	C	C	259	0	0%	2	0	93	0	1.0	1	0	109	150	0	0	
barcode89_consensus_vsearch	2433	C	C	257	1	0.39%	2	1	93	93	0.4999999999999138	1	1	108	149	1	0	+A
barcode89_consensus_vsearch	2434	G	G	259	0	0%	2	0	93	0	1.0	1	0	109	150	0	0	
barcode89_consensus_vsearch	2435	T	T	257	2	0.77%	2	1	93	93	0.24951644100587136	1	1	109	148	0	2	C
barcode89_consensus_vsearch	2436	T	T	257	1	0.39%	2	1	93	93	0.4999999999999138	1	1	108	149	1	0	+C
barcode89_consensus_vsearch	2437	G	G	256	2	0.77%	2	2	93	93	0.24951456310670525	1	1	107	149	1	1	-TTG
barcode89_consensus_vsearch	2438	T	T	252	4	1.56%	2	2	93	93	0.06176686569346045	1	1	106	146	1	3	C
barcode89_consensus_vsearch	2439	T	T	255	1	0.39%	2	1	93	93	0.4999999999999138	1	1	107	148	0	1	+G
barcode89_consensus_vsearch	2440	G	G	250	3	1.17%	2	1	93	93	0.12425742574263329	1	1	104	146	3	0	-A
barcode89_consensus_vsearch	2441	A	A	255	1	0.39%	2	1	93	93	0.4999999999999138	1	1	105	150	1	0	+G
barcode89_consensus_vsearch	2442	A	A	258	1	0.39%	2	1	93	93	0.4999999999999138	1	1	108	150	1	0	G
barcode89_consensus_vsearch	2443	A	A	259	0	0%	2	0	93	0	1.0	1	0	109	150	0	0	
barcode89_consensus_vsearch	2444	G	G	254	3	1.16%	2	2	93	93	0.12426900584791233	1	1	107	147	2	1	-T
barcode89_consensus_vsearch	2445	T	T	254	1	0.39%	2	1	93	93	0.4999999999999138	1	1	106	148	0	1	C
barcode89_consensus_vsearch	2446	T	T	258	1	0.39%	2	1	93	93	0.4999999999999138	1	1	109	149	0	1	C
barcode89_consensus_vsearch	2447	T	T	257	1	0.39%	2	1	93	93	0.4999999999999138	1	1	109	148	0	1	+CCTT
barcode89_consensus_vsearch	2448	T	T	256	1	0.39%	2	1	93	93	0.4999999999999138	1	1	109	147	0	1	+A
barcode89_consensus_vsearch	2449	A	A	258	1	0.39%	2	1	93	93	0.4999999999999138	1	1	108	150	1	0	G
barcode89_consensus_vsearch	2450	A	A	257	2	0.77%	2	1	93	93	0.24951644100587136	1	1	109	148	0	2	+T
barcode89_consensus_vsearch	2451	C	C	255	2	0.77%	2	2	93	93	0.2495126705651419	1	1	108	147	1	1	+T
barcode89_consensus_vsearch	2452	T	T	251	1	0.39%	2	1	93	93	0.5000000000003686	1	1	105	146	1	0	+A
barcode89_consensus_vsearch	2453	A	A	254	3	1.16%	2	2	93	93	0.12426900584791233	1	1	107	147	1	2	-T
barcode89_consensus_vsearch	2454	T	T	254	2	0.78%	2	1	93	93	0.2495107632092758	1	1	108	146	0	2	C
barcode89_consensus_vsearch	2455	T	T	257	1	0.39%	2	1	93	93	0.4999999999999138	1	1	108	149	1	0	+CTATT
barcode89_consensus_vsearch	2456	A	A	258	1	0.39%	2	1	93	93	0.4999999999999138	1	1	109	149	0	1	+G
barcode89_consensus_vsearch	2457	T	T	258	1	0.39%	2	1	93	93	0.4999999999999138	1	1	109	149	0	1	C
barcode89_consensus_vsearch	2458	A	*/-TA	250	7	2.7%	2	2	93	93	0.007495813166417644	1	1	103	147	5	2	-TA
barcode89_consensus_vsearch	2459	T	T	250	1	0.4%	2	1	93	93	0.4999999999999138	1	1	104	146	0	1	C
barcode89_consensus_vsearch	2460	A	A	246	4	1.59%	2	1	93	93	0.061749253033287245	1	1	103	143	0	4	G
barcode89_consensus_vsearch	2461	G	G	258	0	0%	2	0	93	0	1.0	1	0	109	149	0	0	
barcode89_consensus_vsearch	2462	T	T	257	1	0.39%	2	1	93	93	0.4999999999999138	1	1	108	149	1	0	-A
barcode89_consensus_vsearch	2463	A	A	255	1	0.39%	2	1	93	93	0.4999999999999138	1	1	106	149	1	0	-C
barcode89_consensus_vsearch	2464	C	C	254	2	0.78%	2	1	93	93	0.2495107632092758	1	1	107	147	0	2	-T
barcode89_consensus_vsearch	2465	T	*/+C	245	10	3.89%	2	2	93	93	8.925864463478502E-4	1	1	99	146	9	1	+C
barcode89_consensus_vsearch	2466	C	C	253	1	0.39%	2	1	93	93	0.5000000000003686	1	1	106	147	1	0	+G
barcode89_consensus_vsearch	2467	A	A	251	3	1.16%	2	1	93	93	0.12426035502961323	1	1	107	144	0	3	+G
barcode89_consensus_vsearch	2468	G	G	256	2	0.78%	2	1	93	93	0.24951456310670525	1	1	106	150	2	0	+A
barcode89_consensus_vsearch	2469	A	A	254	2	0.77%	2	2	93	93	0.2495107632092758	1	1	106	148	1	1	G
barcode89_consensus_vsearch	2470	C	C	258	0	0%	2	0	93	0	1.0	1	0	109	149	0	0	
barcode89_consensus_vsearch	2471	A	A	256	2	0.78%	2	1	93	93	0.24951456310670525	1	1	109	147	0	2	G
barcode89_consensus_vsearch	2472	T	T	257	2	0.77%	2	2	93	93	0.24951644100587136	1	1	108	149	1	1	C
barcode89_consensus_vsearch	2473	C	C	259	0	0%	2	0	93	0	1.0	1	0	109	150	0	0	
barcode89_consensus_vsearch	2474	A	A	256	1	0.39%	2	1	93	93	0.4999999999999138	1	1	107	149	0	1	+TCA
barcode89_consensus_vsearch	2475	C	C	256	1	0.39%	2	1	93	93	0.4999999999999138	1	1	107	149	1	0	+A
barcode89_consensus_vsearch	2476	T	T	256	3	1.16%	2	1	93	93	0.12427466150865948	1	1	109	147	0	3	C
barcode89_consensus_vsearch	2477	A	A	258	1	0.39%	2	1	93	93	0.4999999999999138	1	1	109	149	0	1	G
barcode89_consensus_vsearch	2478	A	A	259	0	0%	2	0	93	0	1.0	1	0	109	150	0	0	
barcode89_consensus_vsearch	2479	C	C	258	1	0.39%	2	1	93	93	0.4999999999999138	1	1	109	149	0	1	G
barcode89_consensus_vsearch	2480	A	A	258	1	0.39%	2	1	93	93	0.4999999999999138	1	1	109	149	0	1	G
barcode89_consensus_vsearch	2481	T	T	256	3	1.16%	2	2	93	93	0.12427466150865948	1	1	108	148	1	2	C
barcode89_consensus_vsearch	2482	T	*/+C	247	8	3.09%	2	1	93	93	0.0036945340250354765	1	1	98	149	8	0	+C
barcode89_consensus_vsearch	2483	C	C	251	2	0.78%	2	2	93	93	0.24950495049494414	1	1	104	147	1	1	T
barcode89_consensus_vsearch	2484	A	A	252	2	0.78%	2	2	93	93	0.2495069033532105	1	1	103	149	1	1	G
barcode89_consensus_vsearch	2485	G	G	254	2	0.78%	2	1	93	93	0.2495107632092758	1	1	105	149	2	0	-A
barcode89_consensus_vsearch	2486	A	A	256	0	0%	2	0	93	0	1.0	1	0	106	150	0	0	
barcode89_consensus_vsearch	2487	G	G	251	3	1.16%	2	1	93	93	0.12426035502961323	1	1	106	145	0	3	-T
barcode89_consensus_vsearch	2488	T	T	252	2	0.78%	2	1	93	93	0.2495069033532105	1	1	109	143	0	2	C
barcode89_consensus_vsearch	2489	T	T	254	3	1.16%	2	1	93	93	0.12426900584791233	1	1	109	145	0	3	C
barcode89_consensus_vsearch	2490	T	*/-G	249	8	3.09%	2	1	93	93	0.0036961603384701837	1	1	108	141	0	8	-G
barcode89_consensus_vsearch	2491	G	G	248	2	0.8%	2	1	93	93	0.24949899799584363	1	1	108	140	0	2	C
barcode89_consensus_vsearch	2492	G	G	255	3	1.16%	2	1	93	93	0.1242718446601877	1	1	109	146	0	3	A
barcode89_consensus_vsearch	2493	T	T	256	2	0.77%	2	1	93	93	0.24951456310670525	1	1	107	149	2	0	-C
barcode89_consensus_vsearch	2494	C	C	257	0	0%	2	0	93	0	1.0	1	0	107	150	0	0	
barcode89_consensus_vsearch	2495	C	C	256	1	0.39%	2	1	93	93	0.4999999999999138	1	1	109	147	0	1	+T
barcode89_consensus_vsearch	2496	T	T	250	6	2.33%	2	2	93	93	0.015169042029074849	1	1	105	145	4	2	-C
barcode89_consensus_vsearch	2497	C	C	253	0	0%	2	0	93	0	1.0	1	0	105	148	0	0	
barcode89_consensus_vsearch	2498	C	C	253	3	1.16%	2	1	93	93	0.124266144814075	1	1	108	145	0	3	+T
barcode89_consensus_vsearch	2499	G	G	254	3	1.16%	2	1	93	93	0.12426900584791233	1	1	105	149	3	0	A
barcode89_consensus_vsearch	2500	G	G	253	5	1.93%	2	1	93	93	0.030644978141142375	1	1	109	144	0	5	-C
barcode89_consensus_vsearch	2501	C	Y	243	7	2.76%	2	2	93	93	0.007487018424394727	1	1	106	137	1	6	T
barcode89_consensus_vsearch	2502	A	*/-G	236	9	3.49%	2	2	93	93	0.0018124155419458562	1	1	105	131	2	7	-G
barcode89_consensus_vsearch	2503	G	G	241	1	0.41%	2	1	93	93	0.4999999999999138	1	1	105	136	0	1	+AA
barcode89_consensus_vsearch	2504	G	G	250	1	0.39%	2	1	93	93	0.4999999999999138	1	1	108	142	0	1	+C
barcode89_consensus_vsearch	2505	C	Y	237	16	6.23%	2	2	93	93	1.1946841269724289E-5	1	1	106	131	2	14	T
barcode89_consensus_vsearch	2506	A	*/-CA	242	9	3.52%	2	2	93	93	0.00181571404902803	1	1	105	137	3	6	-CA
barcode89_consensus_vsearch	2507	C	C	242	3	1.21%	2	1	93	93	0.1242331288343819	1	1	105	137	0	3	-AT
barcode89_consensus_vsearch	2508	A	A	240	2	0.81%	2	2	93	93	0.24948240165631827	1	1	103	137	1	1	+CA
barcode89_consensus_vsearch	2509	T	T	249	3	1.18%	2	1	93	93	0.12425447316115633	1	1	108	141	0	3	C
barcode89_consensus_vsearch	2510	G	G	251	4	1.56%	2	2	93	93	0.06176398786346276	1	1	106	145	2	2	A
barcode89_consensus_vsearch	2511	C	C	252	4	1.56%	2	2	93	93	0.06176686569346045	1	1	108	144	1	3	-A
barcode89_consensus_vsearch	2512	A	A	246	4	1.59%	2	1	93	93	0.061749253033287245	1	1	107	139	0	4	-GGCA
barcode89_consensus_vsearch	2513	G	G	250	1	0.4%	2	1	93	93	0.4999999999999138	1	1	108	142	1	0	+A
barcode89_consensus_vsearch	2514	G	G	254	1	0.39%	2	1	93	93	0.4999999999999138	1	1	108	146	1	0	A
barcode89_consensus_vsearch	2515	C	C	253	1	0.39%	2	1	93	93	0.5000000000003686	1	1	109	144	0	1	A
barcode89_consensus_vsearch	2516	A	A	254	1	0.39%	2	1	93	93	0.4999999999999138	1	1	108	146	1	0	+GG
barcode89_consensus_vsearch	2517	G	G	258	1	0.39%	2	1	93	93	0.4999999999999138	1	1	109	149	0	1	+CAG
barcode89_consensus_vsearch	2518	A	A	254	2	0.77%	2	1	93	93	0.2495107632092758	1	1	105	149	2	0	G
barcode89_consensus_vsearch	2519	G	G	253	2	0.78%	2	2	93	93	0.24950884086425928	1	1	105	148	1	1	A
barcode89_consensus_vsearch	2520	C	C	255	2	0.78%	2	2	93	93	0.2495126705651419	1	1	107	148	1	1	A
barcode89_consensus_vsearch	2521	C	C	257	1	0.39%	2	1	93	93	0.4999999999999138	1	1	109	148	0	1	+TC
barcode89_consensus_vsearch	2522	C	C	254	3	1.16%	2	2	93	93	0.12426900584791233	1	1	106	148	1	2	T
barcode89_consensus_vsearch	2523	A	A	251	1	0.39%	2	1	93	93	0.5000000000003686	1	1	106	145	0	1	+GCTA
barcode89_consensus_vsearch	2524	C	C	251	2	0.78%	2	2	93	93	0.24950495049494414	1	1	107	144	1	1	T
barcode89_consensus_vsearch	2525	A	A	247	5	1.96%	2	2	93	93	0.030630587731099716	1	1	104	143	4	1	G
barcode89_consensus_vsearch	2526	G	G	254	1	0.39%	2	1	93	93	0.4999999999999138	1	1	107	147	0	1	+T
barcode89_consensus_vsearch	2527	T	*/-G	233	13	5.08%	2	2	93	93	1.0374225858311641E-4	1	1	96	137	4	9	-G
barcode89_consensus_vsearch	2528	G	G	243	1	0.41%	2	1	93	93	0.4999999999999138	1	1	103	140	1	0	C
barcode89_consensus_vsearch	2529	G	G	257	0	0%	2	0	93	0	1.0	1	0	108	149	0	0	
barcode89_consensus_vsearch	2530	G	G	255	1	0.39%	2	1	93	93	0.4999999999999138	1	1	106	149	1	0	+A
barcode89_consensus_vsearch	2531	A	A	254	2	0.78%	2	1	93	93	0.2495107632092758	1	1	105	149	2	0	-G
barcode89_consensus_vsearch	2532	G	G	253	2	0.78%	2	1	93	93	0.24950884086425928	1	1	104	149	2	0	-A
barcode89_consensus_vsearch	2533	A	A	252	1	0.39%	2	1	93	93	0.5000000000003686	1	1	104	148	1	0	+C
barcode89_consensus_vsearch	2534	C	C	254	1	0.39%	2	1	93	93	0.4999999999999138	1	1	106	148	1	0	G
barcode89_consensus_vsearch	2535	C	C	255	2	0.78%	2	1	93	93	0.2495126705651419	1	1	106	149	2	0	T
barcode89_consensus_vsearch	2536	A	A	253	2	0.78%	2	1	93	93	0.24950884086425928	1	1	107	146	0	2	G
barcode89_consensus_vsearch	2537	C	C	248	4	1.55%	2	1	93	93	0.061755217199896344	1	1	107	141	0	4	-G
barcode89_consensus_vsearch	2538	G	G	253	0	0%	2	0	93	0	1.0	1	0	109	144	0	0	
barcode89_consensus_vsearch	2539	G	G	253	2	0.78%	2	1	93	93	0.24950884086425928	1	1	107	146	0	2	-C
barcode89_consensus_vsearch	2540	C	C	253	1	0.39%	2	1	93	93	0.5000000000003686	1	1	109	144	0	1	+T
barcode89_consensus_vsearch	2541	C	C	255	2	0.78%	2	1	93	93	0.2495126705651419	1	1	109	146	0	2	-T
barcode89_consensus_vsearch	2542	T	T	247	5	1.95%	2	1	93	93	0.030630587731099716	1	1	109	138	0	5	C
barcode89_consensus_vsearch	2543	G	G	251	2	0.78%	2	1	93	93	0.24950495049494414	1	1	107	144	2	0	-C
barcode89_consensus_vsearch	2544	C	C	252	1	0.39%	2	1	93	93	0.5000000000003686	1	1	107	145	0	1	+A
barcode89_consensus_vsearch	2545	C	*/-AA	243	7	2.71%	2	1	93	93	0.007487018424394727	1	1	103	140	0	7	-AA
barcode89_consensus_vsearch	2546	A	A	249	0	0%	2	0	93	0	1.0	1	0	107	142	0	0	
barcode89_consensus_vsearch	2547	A	A	250	1	0.4%	2	1	93	93	0.4999999999999138	1	1	108	142	1	0	G
barcode89_consensus_vsearch	2548	A	A	254	2	0.78%	2	2	93	93	0.2495107632092758	1	1	108	146	1	1	-G
barcode89_consensus_vsearch	2549	G	G	254	1	0.39%	2	1	93	93	0.4999999999999138	1	1	107	147	0	1	-C
barcode89_consensus_vsearch	2550	C	C	256	1	0.39%	2	1	93	93	0.4999999999999138	1	1	109	147	0	1	T
barcode89_consensus_vsearch	2551	A	A	256	2	0.78%	2	1	93	93	0.24951456310670525	1	1	109	147	0	2	G
barcode89_consensus_vsearch	2552	A	A	252	5	1.93%	2	2	93	93	0.030642626352771006	1	1	104	148	4	1	G
barcode89_consensus_vsearch	2553	C	*/-A	241	12	4.65%	2	1	93	93	2.1363402075967646E-4	1	1	93	148	12	0	-A
barcode89_consensus_vsearch	2554	A	A	244	1	0.41%	2	1	93	93	0.4999999999999138	1	1	95	149	0	1	+G
barcode89_consensus_vsearch	2555	A	A	253	3	1.16%	2	1	93	93	0.124266144814075	1	1	104	149	3	0	-G
barcode89_consensus_vsearch	2556	G	G	246	4	1.56%	2	1	93	93	0.061749253033287245	1	1	97	149	4	0	-A
barcode89_consensus_vsearch	2557	A	A	249	1	0.4%	2	1	93	93	0.5000000000003686	1	1	102	147	0	1	+C
barcode89_consensus_vsearch	2558	G	G	250	2	0.78%	2	2	93	93	0.2495029821073759	1	1	103	147	1	1	A
barcode89_consensus_vsearch	2559	T	T	257	1	0.39%	2	1	93	93	0.4999999999999138	1	1	108	149	1	0	+GGC
barcode89_consensus_vsearch	2560	A	A	257	1	0.39%	2	1	93	93	0.4999999999999138	1	1	109	148	0	1	+CA
barcode89_consensus_vsearch	2561	T	T	258	1	0.39%	2	1	93	93	0.4999999999999138	1	1	109	149	0	1	+G
barcode89_consensus_vsearch	2562	G	G	256	2	0.77%	2	2	93	93	0.24951456310670525	1	1	107	149	1	1	A
barcode89_consensus_vsearch	2563	T	T	253	2	0.78%	2	1	93	93	0.24950884086425928	1	1	107	146	0	2	-A
barcode89_consensus_vsearch	2564	A	A	254	2	0.78%	2	2	93	93	0.2495107632092758	1	1	107	147	1	1	G
barcode89_consensus_vsearch	2565	G	G	258	1	0.39%	2	1	93	93	0.4999999999999138	1	1	109	149	0	1	+T
barcode89_consensus_vsearch	2566	A	A	255	2	0.77%	2	2	93	93	0.2495126705651419	1	1	108	147	1	1	G
barcode89_consensus_vsearch	2567	C	C	254	2	0.78%	2	1	93	93	0.2495107632092758	1	1	109	145	0	2	+T
barcode89_consensus_vsearch	2568	A	A	256	1	0.39%	2	1	93	93	0.4999999999999138	1	1	108	148	0	1	G
barcode89_consensus_vsearch	2569	C	C	250	6	2.32%	2	1	93	93	0.015169042029074849	1	1	108	142	0	6	+G
barcode89_consensus_vsearch	2570	G	G	255	1	0.39%	2	1	93	93	0.4999999999999138	1	1	109	146	0	1	+TG
barcode89_consensus_vsearch	2571	G	G	258	1	0.39%	2	1	93	93	0.4999999999999138	1	1	108	150	1	0	-A
barcode89_consensus_vsearch	2572	A	A	257	1	0.39%	2	1	93	93	0.4999999999999138	1	1	108	149	0	1	C
barcode89_consensus_vsearch	2573	T	T	248	3	1.16%	2	1	93	93	0.12425149700602607	1	1	100	148	3	0	+G
barcode89_consensus_vsearch	2574	G	G	254	0	0%	2	0	93	0	1.0	1	0	104	150	0	0	
barcode89_consensus_vsearch	2575	G	G	254	1	0.39%	2	1	93	93	0.4999999999999138	1	1	104	150	1	0	+AG
barcode89_consensus_vsearch	2576	G	G	257	2	0.77%	2	1	93	93	0.24951644100587136	1	1	107	150	2	0	A
barcode89_consensus_vsearch	2577	G	G	258	1	0.39%	2	1	93	93	0.4999999999999138	1	1	108	150	1	0	-T
barcode89_consensus_vsearch	2578	T	T	249	5	1.94%	2	1	93	93	0.03063545999571253	1	1	105	144	0	5	C
barcode89_consensus_vsearch	2579	A	A	254	1	0.39%	2	1	93	93	0.4999999999999138	1	1	104	150	1	0	+G
barcode89_consensus_vsearch	2580	T	T	253	1	0.39%	2	1	93	93	0.5000000000003686	1	1	105	148	0	1	+A
barcode89_consensus_vsearch	2581	A	A	247	4	1.56%	2	2	93	93	0.061752247008950906	1	1	99	148	2	2	-C
barcode89_consensus_vsearch	2582	C	C	249	1	0.4%	2	1	93	93	0.5000000000003686	1	1	104	145	0	1	+G
barcode89_consensus_vsearch	2583	C	C	255	1	0.39%	2	1	93	93	0.4999999999999138	1	1	106	149	0	1	+TC
barcode89_consensus_vsearch	2584	C	Y	233	21	8.11%	2	1	93	93	3.0990918365356364E-7	1	1	107	126	0	21	T
barcode89_consensus_vsearch	2585	G	G	254	2	0.78%	2	1	93	93	0.2495107632092758	1	1	105	149	2	0	-AG
barcode89_consensus_vsearch	2586	A	*/-G	238	15	5.84%	2	2	93	93	2.4646634720268753E-5	1	1	94	144	11	4	-G
barcode89_consensus_vsearch	2587	G	G	238	3	1.24%	2	1	93	93	0.12422037422037172	1	1	93	145	3	0	A
barcode89_consensus_vsearch	2588	G	G	259	0	0%	2	0	93	0	1.0	1	0	109	150	0	0	
barcode89_consensus_vsearch	2589	G	G	257	1	0.39%	2	1	93	93	0.4999999999999138	1	1	107	150	1	0	+AG
barcode89_consensus_vsearch	2590	T	Y	247	8	3.09%	2	2	93	93	0.0036945340250354765	1	1	106	141	2	6	C
barcode89_consensus_vsearch	2591	A	A	257	1	0.39%	2	1	93	93	0.4999999999999138	1	1	109	148	0	1	-T
barcode89_consensus_vsearch	2592	T	T	246	5	1.94%	2	2	93	93	0.03062812251247695	1	1	106	140	2	3	-C
barcode89_consensus_vsearch	2593	C	C	251	1	0.39%	2	1	93	93	0.5000000000003686	1	1	106	145	1	0	+G
barcode89_consensus_vsearch	2594	C	*/-T	221	29	11.2%	2	2	93	93	7.869362521284706E-10	1	1	101	120	7	22	-T
barcode89_consensus_vsearch	2595	T	T	221	4	1.75%	2	2	93	93	0.06166574490670126	1	1	100	121	2	2	C
barcode89_consensus_vsearch	2596	T	T	253	3	1.17%	2	2	93	93	0.124266144814075	1	1	108	145	1	2	C
barcode89_consensus_vsearch	2597	T	T	258	1	0.39%	2	1	93	93	0.4999999999999138	1	1	109	149	0	1	C
barcode89_consensus_vsearch	2598	T	T	254	2	0.77%	2	2	93	93	0.2495107632092758	1	1	108	146	1	1	-A
barcode89_consensus_vsearch	2599	A	*/-TT	249	7	2.72%	2	1	93	93	0.007494585982750822	1	1	108	141	0	7	-TT
barcode89_consensus_vsearch	2600	T	T	248	2	0.79%	2	1	93	93	0.24949899799584363	1	1	108	140	0	2	C
barcode89_consensus_vsearch	2601	T	T	248	3	1.19%	2	2	93	93	0.12425149700602607	1	1	107	141	2	1	-A
barcode89_consensus_vsearch	2602	A	M	248	8	3.12%	2	1	93	93	0.0036953503162476236	1	1	107	141	0	8	C
barcode89_consensus_vsearch	2603	A	A	257	1	0.39%	2	1	93	93	0.4999999999999138	1	1	107	150	1	0	-T
barcode89_consensus_vsearch	2604	T	Y	249	7	2.71%	2	1	93	93	0.007494585982750822	1	1	107	142	0	7	C
barcode89_consensus_vsearch	2605	G	G	256	1	0.39%	2	1	93	93	0.4999999999999138	1	1	106	150	1	0	+AAG
barcode89_consensus_vsearch	2606	A	A	255	3	1.16%	2	2	93	93	0.1242718446601877	1	1	106	149	2	1	G
barcode89_consensus_vsearch	2607	T	T	250	4	1.54%	2	2	93	93	0.061761087351402955	1	1	104	146	2	2	+C
barcode89_consensus_vsearch	2608	C	C	253	1	0.39%	2	1	93	93	0.5000000000003686	1	1	104	149	1	0	+A
barcode89_consensus_vsearch	2609	C	C	252	4	1.55%	2	2	93	93	0.06176686569346045	1	1	106	146	2	2	-T
barcode89_consensus_vsearch	2610	T	T	252	1	0.39%	2	1	93	93	0.5000000000003686	1	1	106	146	0	1	+C
barcode89_consensus_vsearch	2611	T	T	252	2	0.78%	2	2	93	93	0.2495069033532105	1	1	106	146	1	1	+C
barcode89_consensus_vsearch	2612	C	C	256	0	0%	2	0	93	0	1.0	1	0	107	149	0	0	
barcode89_consensus_vsearch	2613	C	C	256	1	0.39%	2	1	93	93	0.4999999999999138	1	1	109	147	0	1	+T
barcode89_consensus_vsearch	2614	G	G	253	3	1.16%	2	1	93	93	0.124266144814075	1	1	105	148	3	0	A
barcode89_consensus_vsearch	2615	C	C	253	2	0.78%	2	1	93	93	0.24950884086425928	1	1	104	149	2	0	+G
barcode89_consensus_vsearch	2616	A	A	250	6	2.33%	2	2	93	93	0.015169042029074849	1	1	101	149	5	1	G
barcode89_consensus_vsearch	2617	G	G	255	1	0.39%	2	1	93	93	0.4999999999999138	1	1	106	149	0	1	A
barcode89_consensus_vsearch	2618	G	G	254	2	0.77%	2	1	93	93	0.2495107632092758	1	1	104	150	2	0	A
barcode89_consensus_vsearch	2619	T	T	254	2	0.78%	2	1	93	93	0.2495107632092758	1	1	107	147	0	2	C
barcode89_consensus_vsearch	2620	T	T	255	1	0.39%	2	1	93	93	0.4999999999999138	1	1	105	150	1	0	+C
barcode89_consensus_vsearch	2621	C	C	254	1	0.39%	2	1	93	93	0.4999999999999138	1	1	106	148	0	1	+A
barcode89_consensus_vsearch	2622	A	A	252	2	0.78%	2	2	93	93	0.2495069033532105	1	1	105	147	1	1	-C
barcode89_consensus_vsearch	2623	C	C	253	1	0.39%	2	1	93	93	0.5000000000003686	1	1	106	147	0	1	+AATT
barcode89_consensus_vsearch	2624	C	C	254	2	0.78%	2	1	93	93	0.2495107632092758	1	1	108	146	0	2	-T
barcode89_consensus_vsearch	2625	T	T	251	3	1.17%	2	2	93	93	0.12426035502961323	1	1	105	146	2	1	C
barcode89_consensus_vsearch	2626	A	A	253	2	0.78%	2	1	93	93	0.24950884086425928	1	1	105	148	2	0	G
barcode89_consensus_vsearch	2627	C	C	250	5	1.94%	2	2	93	93	0.030637867497453432	1	1	105	145	1	4	+G
barcode89_consensus_vsearch	2628	G	G	254	1	0.39%	2	1	93	93	0.4999999999999138	1	1	106	148	0	1	+C
barcode89_consensus_vsearch	2629	G	G	257	1	0.39%	2	1	93	93	0.4999999999999138	1	1	109	148	0	1	+A
barcode89_consensus_vsearch	2630	A	A	255	3	1.16%	2	2	93	93	0.1242718446601877	1	1	108	147	1	2	G
barcode89_consensus_vsearch	2631	A	A	257	1	0.39%	2	1	93	93	0.4999999999999138	1	1	109	148	0	1	G
barcode89_consensus_vsearch	2632	A	A	255	2	0.77%	2	1	93	93	0.2495126705651419	1	1	105	150	2	0	-C
barcode89_consensus_vsearch	2633	C	C	255	1	0.39%	2	1	93	93	0.4999999999999138	1	1	106	149	1	0	+A
barcode89_consensus_vsearch	2634	C	*/+T	242	9	3.47%	2	1	93	93	0.00181571404902803	1	1	108	134	0	9	+T
barcode89_consensus_vsearch	2635	T	T	251	0	0%	2	0	93	0	1.0	1	0	108	143	0	0	
barcode89_consensus_vsearch	2636	T	T	252	3	1.17%	2	1	93	93	0.12426326129665838	1	1	104	148	3	0	+A
barcode89_consensus_vsearch	2637	G	G	254	3	1.17%	2	1	93	93	0.12426900584791233	1	1	106	148	3	0	T
barcode89_consensus_vsearch	2638	T	T	255	2	0.78%	2	1	93	93	0.2495126705651419	1	1	107	148	2	0	C
barcode89_consensus_vsearch	2639	T	T	255	3	1.16%	2	1	93	93	0.1242718446601877	1	1	106	149	3	0	-AC
barcode89_consensus_vsearch	2640	A	A	255	1	0.39%	2	1	93	93	0.4999999999999138	1	1	106	149	0	1	-C
barcode89_consensus_vsearch	2641	C	C	248	4	1.57%	2	1	93	93	0.061755217199896344	1	1	100	148	4	0	-G
barcode89_consensus_vsearch	2642	G	G	252	2	0.78%	2	2	93	93	0.2495069033532105	1	1	104	148	1	1	-A
barcode89_consensus_vsearch	2643	A	A	251	3	1.17%	2	2	93	93	0.12426035502961323	1	1	106	145	1	2	G
barcode89_consensus_vsearch	2644	C	*/-T	219	19	7.36%	2	2	93	93	1.312379928099055E-6	1	1	87	132	9	10	-T
barcode89_consensus_vsearch	2645	T	T	235	2	0.84%	2	1	93	93	0.24947145877361238	1	1	100	135	0	2	C
barcode89_consensus_vsearch	2646	T	T	252	4	1.55%	2	2	93	93	0.06176686569346045	1	1	108	144	1	3	C
barcode89_consensus_vsearch	2647	T	T	257	1	0.39%	2	1	93	93	0.4999999999999138	1	1	108	149	0	1	+CT
barcode89_consensus_vsearch	2648	T	T	255	2	0.77%	2	1	93	93	0.2495126705651419	1	1	107	148	0	2	-AC
barcode89_consensus_vsearch	2649	A	A	255	2	0.78%	2	2	93	93	0.2495126705651419	1	1	108	147	1	1	G
barcode89_consensus_vsearch	2650	C	C	252	2	0.78%	2	1	93	93	0.2495069033532105	1	1	109	143	0	2	-T
barcode89_consensus_vsearch	2651	T	T	254	1	0.39%	2	1	93	93	0.4999999999999138	1	1	108	146	1	0	C
barcode89_consensus_vsearch	2652	T	*/-C	242	9	3.5%	2	1	93	93	0.00181571404902803	1	1	108	134	0	9	-C
barcode89_consensus_vsearch	2653	C	C	241	2	0.82%	2	1	93	93	0.2494845360824727	1	1	108	133	0	2	A
barcode89_consensus_vsearch	2654	C	C	251	2	0.79%	2	1	93	93	0.24950495049494414	1	1	109	142	0	2	-T
barcode89_consensus_vsearch	2655	T	T	248	2	0.79%	2	1	93	93	0.24949899799584363	1	1	107	141	2	0	+C
barcode89_consensus_vsearch	2656	C	C	254	1	0.39%	2	1	93	93	0.4999999999999138	1	1	109	145	0	1	-T
barcode89_consensus_vsearch	2657	T	T	245	4	1.56%	2	2	93	93	0.061746234985649476	1	1	106	139	1	3	-A
barcode89_consensus_vsearch	2658	A	A	254	1	0.39%	2	1	93	93	0.4999999999999138	1	1	107	147	1	0	G
barcode89_consensus_vsearch	2659	A	A	258	1	0.39%	2	1	93	93	0.4999999999999138	1	1	109	149	0	1	+C
barcode89_consensus_vsearch	2660	A	A	256	1	0.39%	2	1	93	93	0.4999999999999138	1	1	107	149	1	0	+G
barcode89_consensus_vsearch	2661	T	T	252	3	1.17%	2	2	93	93	0.12426326129665838	1	1	104	148	2	1	C
barcode89_consensus_vsearch	2662	G	G	255	1	0.39%	2	1	93	93	0.4999999999999138	1	1	106	149	1	0	-A
barcode89_consensus_vsearch	2663	A	A	255	1	0.39%	2	1	93	93	0.4999999999999138	1	1	106	149	0	1	-C
barcode89_consensus_vsearch	2664	C	C	255	1	0.39%	2	1	93	93	0.4999999999999138	1	1	106	149	1	0	+A
barcode89_consensus_vsearch	2665	C	C	250	4	1.55%	2	2	93	93	0.061761087351402955	1	1	103	147	2	2	-A
barcode89_consensus_vsearch	2666	A	A	253	1	0.39%	2	1	93	93	0.5000000000003686	1	1	105	148	1	0	+GA
barcode89_consensus_vsearch	2667	A	A	256	1	0.39%	2	1	93	93	0.4999999999999138	1	1	108	148	1	0	+TG
barcode89_consensus_vsearch	2668	G	G	257	1	0.39%	2	1	93	93	0.4999999999999138	1	1	108	149	1	0	+A
barcode89_consensus_vsearch	2669	T	T	254	4	1.54%	2	1	93	93	0.06177255436325217	1	1	109	145	0	4	C
barcode89_consensus_vsearch	2670	T	T	258	1	0.39%	2	1	93	93	0.4999999999999138	1	1	109	149	0	1	+C
barcode89_consensus_vsearch	2671	T	T	253	4	1.54%	2	1	93	93	0.0617697211064687	1	1	109	144	0	4	+G
barcode89_consensus_vsearch	2672	G	G	254	3	1.17%	2	1	93	93	0.12426900584791233	1	1	109	145	0	3	+A
barcode89_consensus_vsearch	2673	A	A	254	3	1.16%	2	2	93	93	0.12426900584791233	1	1	107	147	2	1	G
barcode89_consensus_vsearch	2674	A	A	259	0	0%	2	0	93	0	1.0	1	0	109	150	0	0	
barcode89_consensus_vsearch	2675	C	C	255	2	0.77%	2	1	93	93	0.2495126705651419	1	1	109	146	0	2	T
barcode89_consensus_vsearch	2676	A	A	256	1	0.39%	2	1	93	93	0.4999999999999138	1	1	109	147	0	1	C
barcode89_consensus_vsearch	2677	A	A	255	1	0.39%	2	1	93	93	0.4999999999999138	1	1	108	147	0	1	+T
barcode89_consensus_vsearch	2678	C	C	252	4	1.55%	2	1	93	93	0.06176686569346045	1	1	107	145	0	4	-T
barcode89_consensus_vsearch	2679	T	T	251	2	0.79%	2	1	93	93	0.24950495049494414	1	1	109	142	0	2	C
barcode89_consensus_vsearch	2680	T	T	253	3	1.16%	2	1	93	93	0.124266144814075	1	1	109	144	0	3	+C
barcode89_consensus_vsearch	2681	T	T	257	1	0.39%	2	1	93	93	0.4999999999999138	1	1	108	149	0	1	-C
barcode89_consensus_vsearch	2682	C	C	256	1	0.39%	2	1	93	93	0.4999999999999138	1	1	108	148	0	1	+T
barcode89_consensus_vsearch	2683	C	C	247	6	2.32%	2	1	93	93	0.015163657292611031	1	1	106	141	0	6	-G
barcode89_consensus_vsearch	2684	G	G	253	0	0%	2	0	93	0	1.0	1	0	109	144	0	0	
barcode89_consensus_vsearch	2685	G	G	258	1	0.39%	2	1	93	93	0.4999999999999138	1	1	109	149	0	1	+C
barcode89_consensus_vsearch	2686	C	C	258	1	0.39%	2	1	93	93	0.4999999999999138	1	1	109	149	0	1	T
barcode89_consensus_vsearch	2687	T	T	256	1	0.39%	2	1	93	93	0.4999999999999138	1	1	108	148	0	1	-C
barcode89_consensus_vsearch	2688	C	C	255	2	0.78%	2	1	93	93	0.2495126705651419	1	1	109	146	0	2	+T
barcode89_consensus_vsearch	2689	T	*/-G	222	29	11.24%	2	2	93	93	7.898088503404385E-10	1	1	105	117	2	27	-G
barcode89_consensus_vsearch	2690	G	G	220	3	1.32%	2	2	93	93	0.12415730337075404	1	1	103	117	2	1	A
barcode89_consensus_vsearch	2691	G	S	234	16	6.25%	2	1	93	93	1.1910682572909292E-5	1	1	106	128	0	16	C
barcode89_consensus_vsearch	2692	G	*/-TG	241	10	3.86%	2	1	93	93	8.912835697054955E-4	1	1	108	133	0	10	-TG
barcode89_consensus_vsearch	2693	T	*/-G	198	34	13.99%	2	2	93	93	1.5792968151385072E-11	1	1	107	91	1	33	-G
barcode89_consensus_vsearch	2694	G	G	207	2	0.95%	2	2	93	93	0.24940047961641743	1	1	107	100	1	1	A
barcode89_consensus_vsearch	2695	G	G	253	1	0.39%	2	1	93	93	0.5000000000003686	1	1	109	144	0	1	C
barcode89_consensus_vsearch	2696	G	G	253	1	0.39%	2	1	93	93	0.5000000000003686	1	1	109	144	0	1	+CA
barcode89_consensus_vsearch	2697	T	Y	243	7	2.76%	2	2	93	93	0.007487018424394727	1	1	107	136	1	6	C
barcode89_consensus_vsearch	2698	G	G	247	3	1.17%	2	2	93	93	0.12424849699405838	1	1	106	141	2	1	C
barcode89_consensus_vsearch	2699	T	Y	243	10	3.94%	2	1	93	93	8.91940019333984E-4	1	1	109	134	0	10	C
barcode89_consensus_vsearch	2700	T	T	254	2	0.78%	2	1	93	93	0.2495107632092758	1	1	109	145	0	2	C
barcode89_consensus_vsearch	2701	G	G	254	1	0.39%	2	1	93	93	0.4999999999999138	1	1	108	146	1	0	-C
barcode89_consensus_vsearch	2702	C	C	255	1	0.39%	2	1	93	93	0.4999999999999138	1	1	108	147	0	1	A
barcode89_consensus_vsearch	2703	C	C	253	4	1.55%	2	1	93	93	0.0617697211064687	1	1	108	145	0	4	-ACC
barcode89_consensus_vsearch	2704	A	*/-C	197	41	16.14%	2	2	93	93	6.900150161302809E-14	1	1	95	102	9	32	-C
barcode89_consensus_vsearch	2705	C	C	211	1	0.47%	2	1	93	93	0.5000000000001412	1	1	99	112	0	1	+T
barcode89_consensus_vsearch	2706	C	C	250	2	0.78%	2	1	93	93	0.2495029821073759	1	1	106	144	2	0	A
barcode89_consensus_vsearch	2707	C	C	254	2	0.77%	2	1	93	93	0.2495107632092758	1	1	107	147	0	2	-TC
barcode89_consensus_vsearch	2708	T	*/-C	213	38	14.84%	2	2	93	93	7.995762787168194E-13	1	1	83	130	23	15	-C
barcode89_consensus_vsearch	2709	C	C	217	0	0%	2	0	93	0	1.0	1	0	85	132	0	0	
barcode89_consensus_vsearch	2710	C	C	255	1	0.39%	2	1	93	93	0.4999999999999138	1	1	107	148	1	0	+A
barcode89_consensus_vsearch	2711	C	C	251	3	1.16%	2	1	93	93	0.12426035502961323	1	1	107	144	0	3	-T
barcode89_consensus_vsearch	2712	T	T	240	6	2.36%	2	2	93	93	0.01515058431619443	1	1	100	140	2	4	+G
barcode89_consensus_vsearch	2713	G	G	253	2	0.78%	2	1	93	93	0.24950884086425928	1	1	105	148	2	0	C
barcode89_consensus_vsearch	2714	A	A	252	2	0.78%	2	1	93	93	0.2495069033532105	1	1	103	149	2	0	-G
barcode89_consensus_vsearch	2715	G	G	247	4	1.56%	2	1	93	93	0.061752247008950906	1	1	98	149	4	0	-C
barcode89_consensus_vsearch	2716	C	C	252	1	0.39%	2	1	93	93	0.5000000000003686	1	1	104	148	0	1	+GC
barcode89_consensus_vsearch	2717	C	C	255	2	0.77%	2	1	93	93	0.2495126705651419	1	1	105	150	2	0	A
barcode89_consensus_vsearch	2718	A	A	249	5	1.93%	2	2	93	93	0.03063545999571253	1	1	102	147	4	1	G
barcode89_consensus_vsearch	2719	G	G	254	2	0.78%	2	2	93	93	0.2495107632092758	1	1	106	148	1	1	A
barcode89_consensus_vsearch	2720	T	*/-C	240	15	5.79%	2	2	93	93	2.468919460222434E-5	1	1	93	147	14	1	-C
barcode89_consensus_vsearch	2721	C	C	243	1	0.41%	2	1	93	93	0.4999999999999138	1	1	94	149	1	0	+G
barcode89_consensus_vsearch	2722	C	*/+G	220	13	5.02%	2	1	93	93	1.0277890006326556E-4	1	1	83	137	0	13	+G
barcode89_consensus_vsearch	2723	G	*/-A	217	9	3.67%	2	2	93	93	0.0018008401619304512	1	1	69	148	7	2	-A
barcode89_consensus_vsearch	2724	A	A	236	2	0.84%	2	1	93	93	0.2494736842105955	1	1	90	146	0	2	G
barcode89_consensus_vsearch	2725	A	A	243	2	0.8%	2	1	93	93	0.24948875255617758	1	1	95	148	2	0	C
barcode89_consensus_vsearch	2726	A	A	254	5	1.93%	2	1	93	93	0.030647311787538743	1	1	104	150	5	0	-G
barcode89_consensus_vsearch	2727	G	R	238	10	3.94%	2	1	93	93	8.902795873314557E-4	1	1	91	147	10	0	A
barcode89_consensus_vsearch	2728	C	C	252	2	0.78%	2	2	93	93	0.2495069033532105	1	1	105	147	1	1	T
barcode89_consensus_vsearch	2729	C	C	252	4	1.54%	2	1	93	93	0.06176686569346045	1	1	107	145	0	4	-T
barcode89_consensus_vsearch	2730	T	T	245	5	1.96%	2	2	93	93	0.03062563759307	1	1	105	140	1	4	C
barcode89_consensus_vsearch	2731	C	C	250	3	1.18%	2	1	93	93	0.12425742574263329	1	1	102	148	3	0	-AC
barcode89_consensus_vsearch	2732	A	A	251	3	1.17%	2	2	93	93	0.12426035502961323	1	1	104	147	2	1	G
barcode89_consensus_vsearch	2733	C	C	251	3	1.17%	2	1	93	93	0.12426035502961323	1	1	106	145	0	3	-T
barcode89_consensus_vsearch	2734	T	*/+G	241	8	3.12%	2	1	93	93	0.0036895004577195047	1	1	107	134	0	8	+G
barcode89_consensus_vsearch	2735	G	G	257	0	0%	2	0	93	0	1.0	1	0	108	149	0	0	
barcode89_consensus_vsearch	2736	A	A	256	2	0.77%	2	1	93	93	0.24951456310670525	1	1	106	150	2	0	G
barcode89_consensus_vsearch	2737	G	G	257	1	0.39%	2	1	93	93	0.4999999999999138	1	1	108	149	0	1	-C
barcode89_consensus_vsearch	2738	C	C	256	1	0.39%	2	1	93	93	0.4999999999999138	1	1	108	148	0	1	+TT
barcode89_consensus_vsearch	2739	C	C	258	1	0.39%	2	1	93	93	0.4999999999999138	1	1	109	149	0	1	+G
barcode89_consensus_vsearch	2740	A	A	257	2	0.77%	2	1	93	93	0.24951644100587136	1	1	107	150	2	0	-T
barcode89_consensus_vsearch	2741	T	T	256	1	0.39%	2	1	93	93	0.4999999999999138	1	1	106	150	1	0	A
barcode89_consensus_vsearch	2742	T	T	255	2	0.77%	2	1	93	93	0.2495126705651419	1	1	107	148	2	0	+C
barcode89_consensus_vsearch	2743	C	C	259	0	0%	2	0	93	0	1.0	1	0	109	150	0	0	
barcode89_consensus_vsearch	2744	A	A	259	0	0%	2	0	93	0	1.0	1	0	109	150	0	0	
barcode89_consensus_vsearch	2745	A	A	258	1	0.39%	2	1	93	93	0.4999999999999138	1	1	109	149	0	1	-T
barcode89_consensus_vsearch	2746	T	T	254	3	1.16%	2	1	93	93	0.12426900584791233	1	1	106	148	3	0	+C
barcode89_consensus_vsearch	2747	C	C	254	2	0.77%	2	1	93	93	0.2495107632092758	1	1	106	148	2	0	T
barcode89_consensus_vsearch	2748	G	G	256	1	0.39%	2	1	93	93	0.4999999999999138	1	1	107	149	1	0	+A
barcode89_consensus_vsearch	2749	G	G	258	1	0.39%	2	1	93	93	0.4999999999999138	1	1	108	150	1	0	T
barcode89_consensus_vsearch	2750	T	T	257	1	0.39%	2	1	93	93	0.4999999999999138	1	1	107	150	1	0	-A
barcode89_consensus_vsearch	2751	A	A	258	0	0%	2	0	93	0	1.0	1	0	108	150	0	0	
barcode89_consensus_vsearch	2752	G	G	254	5	1.93%	2	2	93	93	0.030647311787538743	1	1	106	148	3	2	-TAG
barcode89_consensus_vsearch	2753	T	T	249	1	0.39%	2	1	93	93	0.5000000000003686	1	1	105	144	0	1	+AA
barcode89_consensus_vsearch	2754	A	A	251	2	0.79%	2	1	93	93	0.24950495049494414	1	1	104	147	2	0	G
barcode89_consensus_vsearch	2755	G	G	251	1	0.4%	2	1	93	93	0.5000000000003686	1	1	105	146	0	1	-C
barcode89_consensus_vsearch	2756	C	C	255	1	0.39%	2	1	93	93	0.4999999999999138	1	1	108	147	0	1	+A
barcode89_consensus_vsearch	2757	G	G	257	1	0.39%	2	1	93	93	0.4999999999999138	1	1	109	148	0	1	+CG
barcode89_consensus_vsearch	2758	A	A	258	1	0.39%	2	1	93	93	0.4999999999999138	1	1	108	150	1	0	+GCC
barcode89_consensus_vsearch	2759	C	C	252	3	1.16%	2	1	93	93	0.12426326129665838	1	1	107	145	0	3	-G
barcode89_consensus_vsearch	2760	G	G	251	2	0.79%	2	1	93	93	0.24950495049494414	1	1	106	145	2	0	A
barcode89_consensus_vsearch	2761	G	G	256	1	0.39%	2	1	93	93	0.4999999999999138	1	1	108	148	0	1	T
barcode89_consensus_vsearch	2762	G	G	258	0	0%	2	0	93	0	1.0	1	0	108	150	0	0	
barcode89_consensus_vsearch	2763	C	C	255	1	0.39%	2	1	93	93	0.4999999999999138	1	1	106	149	0	1	+A
barcode89_consensus_vsearch	2764	G	G	253	3	1.16%	2	2	93	93	0.124266144814075	1	1	105	148	1	2	A
barcode89_consensus_vsearch	2765	G	G	257	1	0.39%	2	1	93	93	0.4999999999999138	1	1	107	150	1	0	+AT
barcode89_consensus_vsearch	2766	T	T	253	2	0.77%	2	1	93	93	0.24950884086425928	1	1	107	146	0	2	C
barcode89_consensus_vsearch	2767	G	G	257	1	0.39%	2	1	93	93	0.4999999999999138	1	1	107	150	1	0	-T
barcode89_consensus_vsearch	2768	T	*/-GT	233	19	7.36%	2	2	93	93	1.34099927897736E-6	1	1	99	134	6	13	-GT
barcode89_consensus_vsearch	2769	G	G	235	2	0.84%	2	2	93	93	0.24947145877361238	1	1	101	134	1	1	A
barcode89_consensus_vsearch	2770	T	T	234	3	1.25%	2	2	93	93	0.12420718816069089	1	1	101	133	1	2	C
barcode89_consensus_vsearch	2771	A	A	254	3	1.16%	2	2	93	93	0.12426900584791233	1	1	108	146	1	2	G
barcode89_consensus_vsearch	2772	C	*/-A	204	43	16.6%	2	2	93	93	1.534034788786043E-14	1	1	62	142	41	2	-A
barcode89_consensus_vsearch	2773	A	A	212	3	1.4%	2	2	93	93	0.1241258741259166	1	1	66	146	1	2	G
barcode89_consensus_vsearch	2774	A	A	254	2	0.78%	2	1	93	93	0.2495107632092758	1	1	107	147	0	2	G
barcode89_consensus_vsearch	2775	A	A	243	6	2.32%	2	2	93	93	0.015156276648152922	1	1	103	140	2	4	+G
barcode89_consensus_vsearch	2776	G	G	248	3	1.19%	2	1	93	93	0.12425149700602607	1	1	102	146	3	0	+A
barcode89_consensus_vsearch	2777	G	G	258	1	0.39%	2	1	93	93	0.4999999999999138	1	1	108	150	1	0	+A
barcode89_consensus_vsearch	2778	G	G	257	1	0.39%	2	1	93	93	0.4999999999999138	1	1	107	150	1	0	+AG
barcode89_consensus_vsearch	2779	C	C	255	1	0.39%	2	1	93	93	0.4999999999999138	1	1	105	150	1	0	+A
barcode89_consensus_vsearch	2780	A	*/-G	223	28	10.85%	2	2	93	93	1.678786524940686E-9	1	1	106	117	2	26	-G
barcode89_consensus_vsearch	2781	G	G	226	2	0.87%	2	2	93	93	0.24945054945064127	1	1	105	121	1	1	A
barcode89_consensus_vsearch	2782	G	G	255	2	0.78%	2	2	93	93	0.2495126705651419	1	1	108	147	1	1	+A
barcode89_consensus_vsearch	2783	G	G	255	2	0.78%	2	1	93	93	0.2495126705651419	1	1	107	148	2	0	-A
barcode89_consensus_vsearch	2784	A	*/+T	239	8	3.12%	2	1	93	93	0.0036877690019176544	1	1	105	134	0	8	+T
barcode89_consensus_vsearch	2785	C	Y	231	10	3.88%	2	1	93	93	8.878425014170833E-4	1	1	108	123	0	10	T
barcode89_consensus_vsearch	2786	G	G	257	1	0.39%	2	1	93	93	0.4999999999999138	1	1	109	148	0	1	-T
barcode89_consensus_vsearch	2787	T	T	246	6	2.33%	2	1	93	93	0.01516183400716267	1	1	109	137	0	6	C
barcode89_consensus_vsearch	2788	A	A	257	1	0.39%	2	1	93	93	0.4999999999999138	1	1	109	148	0	1	C
barcode89_consensus_vsearch	2789	A	A	257	2	0.77%	2	2	93	93	0.24951644100587136	1	1	108	149	1	1	G
barcode89_consensus_vsearch	2790	T	T	258	1	0.39%	2	1	93	93	0.4999999999999138	1	1	109	149	0	1	C
barcode89_consensus_vsearch	2791	C	C	257	2	0.77%	2	1	93	93	0.24951644100587136	1	1	107	150	2	0	-A
barcode89_consensus_vsearch	2792	A	A	255	2	0.78%	2	1	93	93	0.2495126705651419	1	1	107	148	0	2	-G
barcode89_consensus_vsearch	2793	G	G	257	0	0%	2	0	93	0	1.0	1	0	109	148	0	0	
barcode89_consensus_vsearch	2794	C	C	256	2	0.77%	2	1	93	93	0.24951456310670525	1	1	108	148	0	2	-GC
barcode89_consensus_vsearch	2795	G	G	256	1	0.39%	2	1	93	93	0.4999999999999138	1	1	108	148	1	0	A
barcode89_consensus_vsearch	2796	C	C	254	2	0.78%	2	1	93	93	0.2495107632092758	1	1	108	146	0	2	+GC
barcode89_consensus_vsearch	2797	A	A	259	0	0%	2	0	93	0	1.0	1	0	109	150	0	0	
barcode89_consensus_vsearch	2798	A	A	255	4	1.54%	2	2	93	93	0.06177536572082746	1	1	106	149	3	1	G
barcode89_consensus_vsearch	2799	G	G	257	2	0.77%	2	1	93	93	0.24951644100587136	1	1	107	150	2	0	-CTGA
barcode89_consensus_vsearch	2800	C	C	251	2	0.78%	2	2	93	93	0.24950495049494414	1	1	105	146	1	1	T
barcode89_consensus_vsearch	2801	T	T	249	3	1.18%	2	1	93	93	0.12425447316115633	1	1	106	143	0	3	+G
barcode89_consensus_vsearch	2802	G	G	253	1	0.39%	2	1	93	93	0.5000000000003686	1	1	106	147	0	1	+CTG
barcode89_consensus_vsearch	2803	A	A	252	2	0.78%	2	2	93	93	0.2495069033532105	1	1	105	147	1	1	-TGA
barcode89_consensus_vsearch	2804	T	T	254	1	0.39%	2	1	93	93	0.4999999999999138	1	1	107	147	0	1	C
barcode89_consensus_vsearch	2805	G	G	255	1	0.39%	2	1	93	93	0.4999999999999138	1	1	107	148	1	0	C
barcode89_consensus_vsearch	2806	A	A	255	1	0.39%	2	1	93	93	0.4999999999999138	1	1	108	147	0	1	G
barcode89_consensus_vsearch	2807	C	C	251	3	1.16%	2	2	93	93	0.12426035502961323	1	1	104	147	1	2	-T
barcode89_consensus_vsearch	2808	T	T	251	2	0.79%	2	1	93	93	0.24950495049494414	1	1	106	145	0	2	C
barcode89_consensus_vsearch	2809	T	T	255	1	0.39%	2	1	93	93	0.4999999999999138	1	1	107	148	0	1	-G
barcode89_consensus_vsearch	2810	G	G	254	2	0.78%	2	1	93	93	0.2495107632092758	1	1	105	149	2	0	A
barcode89_consensus_vsearch	2811	C	C	251	2	0.78%	2	1	93	93	0.24950495049494414	1	1	105	146	0	2	T
barcode89_consensus_vsearch	2812	G	G	255	1	0.39%	2	1	93	93	0.4999999999999138	1	1	106	149	1	0	A
barcode89_consensus_vsearch	2813	C	*/-T	239	13	5.06%	2	1	93	93	1.041552345920223E-4	1	1	106	133	0	13	-T
barcode89_consensus_vsearch	2814	T	T	242	1	0.41%	2	1	93	93	0.4999999999999138	1	1	107	135	0	1	+G
barcode89_consensus_vsearch	2815	T	T	253	2	0.78%	2	1	93	93	0.24950884086425928	1	1	106	147	2	0	-AC
barcode89_consensus_vsearch	2816	A	A	247	3	1.17%	2	1	93	93	0.12424849699405838	1	1	101	146	3	0	+C
barcode89_consensus_vsearch	2817	C	C	250	2	0.79%	2	1	93	93	0.2495029821073759	1	1	104	146	0	2	T
barcode89_consensus_vsearch	2818	T	T	241	4	1.56%	2	1	93	93	0.06173391617646867	1	1	94	147	4	0	+A
barcode89_consensus_vsearch	2819	A	*/-G	225	24	9.45%	2	2	93	93	3.330912321018651E-8	1	1	94	131	10	14	-G
barcode89_consensus_vsearch	2820	G	R	223	7	3.02%	2	2	93	93	0.007458967428082863	1	1	90	133	6	1	A
barcode89_consensus_vsearch	2821	G	*/-A	250	7	2.71%	2	2	93	93	0.007495813166417644	1	1	103	147	5	2	-A
barcode89_consensus_vsearch	2822	A	A	251	0	0%	2	0	93	0	1.0	1	0	103	148	0	0	
barcode89_consensus_vsearch	2823	A	A	256	1	0.39%	2	1	93	93	0.4999999999999138	1	1	109	147	0	1	-T
barcode89_consensus_vsearch	2824	T	T	255	2	0.78%	2	1	93	93	0.2495126705651419	1	1	109	146	0	2	C
barcode89_consensus_vsearch	2825	T	T	248	4	1.55%	2	1	93	93	0.061755217199896344	1	1	109	139	0	4	-CCT
barcode89_consensus_vsearch	2826	C	C	251	1	0.4%	2	1	93	93	0.5000000000003686	1	1	109	142	0	1	+T
barcode89_consensus_vsearch	2827	C	C	249	3	1.18%	2	1	93	93	0.12425447316115633	1	1	108	141	0	3	+T
barcode89_consensus_vsearch	2828	T	T	249	1	0.39%	2	1	93	93	0.5000000000003686	1	1	107	142	1	0	+C
barcode89_consensus_vsearch	2829	C	C	253	2	0.78%	2	2	93	93	0.24950884086425928	1	1	108	145	1	1	+A
barcode89_consensus_vsearch	2830	G	G	256	1	0.39%	2	1	93	93	0.4999999999999138	1	1	107	149	1	0	-T
barcode89_consensus_vsearch	2831	T	T	253	2	0.78%	2	1	93	93	0.24950884086425928	1	1	104	149	2	0	C
barcode89_consensus_vsearch	2832	T	T	255	1	0.39%	2	1	93	93	0.4999999999999138	1	1	107	148	0	1	+G
barcode89_consensus_vsearch	2833	G	G	251	4	1.55%	2	1	93	93	0.06176398786346276	1	1	103	148	4	0	+A
barcode89_consensus_vsearch	2834	A	A	253	1	0.39%	2	1	93	93	0.5000000000003686	1	1	106	147	1	0	+G
barcode89_consensus_vsearch	2835	A	A	254	1	0.39%	2	1	93	93	0.4999999999999138	1	1	108	146	0	1	+G
barcode89_consensus_vsearch	2836	G	G	247	4	1.56%	2	1	93	93	0.061752247008950906	1	1	101	146	4	0	-A
barcode89_consensus_vsearch	2837	A	A	247	3	1.2%	2	1	93	93	0.12424849699405838	1	1	103	144	0	3	G
barcode89_consensus_vsearch	2838	G	G	252	2	0.78%	2	1	93	93	0.2495069033532105	1	1	104	148	2	0	A
barcode89_consensus_vsearch	2839	C	*/-A	252	7	2.7%	2	1	93	93	0.007498239332403135	1	1	109	143	0	7	-A
barcode89_consensus_vsearch	2840	A	A	250	1	0.4%	2	1	93	93	0.4999999999999138	1	1	109	141	0	1	C
barcode89_consensus_vsearch	2841	A	A	252	3	1.16%	2	1	93	93	0.12426326129665838	1	1	108	144	0	3	G
barcode89_consensus_vsearch	2842	T	Y	245	10	3.89%	2	1	93	93	8.925864463478502E-4	1	1	107	138	0	10	C
barcode89_consensus_vsearch	2843	A	A	254	1	0.39%	2	1	93	93	0.4999999999999138	1	1	106	148	0	1	C
barcode89_consensus_vsearch	2844	A	A	255	2	0.78%	2	2	93	93	0.2495126705651419	1	1	107	148	1	1	G
barcode89_consensus_vsearch	2845	T	T	252	3	1.16%	2	1	93	93	0.12426326129665838	1	1	108	144	0	3	C
barcode89_consensus_vsearch	2846	T	T	256	1	0.39%	2	1	93	93	0.4999999999999138	1	1	108	148	0	1	-G
barcode89_consensus_vsearch	2847	G	G	256	1	0.39%	2	1	93	93	0.4999999999999138	1	1	109	147	0	1	-C
barcode89_consensus_vsearch	2848	C	C	254	3	1.16%	2	1	93	93	0.12426900584791233	1	1	109	145	0	3	T
barcode89_consensus_vsearch	2849	A	A	255	1	0.39%	2	1	93	93	0.4999999999999138	1	1	109	146	0	1	+C
barcode89_consensus_vsearch	2850	A	A	256	1	0.39%	2	1	93	93	0.4999999999999138	1	1	109	147	0	1	-T
barcode89_consensus_vsearch	2851	T	T	254	1	0.39%	2	1	93	93	0.4999999999999138	1	1	108	146	0	1	+GGT
barcode89_consensus_vsearch	2852	G	G	246	5	1.94%	2	1	93	93	0.03062812251247695	1	1	106	140	0	5	+T
barcode89_consensus_vsearch	2853	C	Y	242	7	2.76%	2	1	93	93	0.007485722003053852	1	1	107	135	0	7	T
barcode89_consensus_vsearch	2854	T	T	257	1	0.39%	2	1	93	93	0.4999999999999138	1	1	108	149	1	0	+GCT
barcode89_consensus_vsearch	2855	C	*/-T	241	11	4.25%	2	2	93	93	4.3678210722142475E-4	1	1	106	135	1	10	-T
barcode89_consensus_vsearch	2856	T	T	243	2	0.81%	2	1	93	93	0.24948875255617758	1	1	108	135	0	2	+C
barcode89_consensus_vsearch	2857	A	A	254	2	0.78%	2	1	93	93	0.2495107632092758	1	1	107	147	2	0	C
barcode89_consensus_vsearch	2858	T	T	252	5	1.93%	2	2	93	93	0.030642626352771006	1	1	106	146	2	3	-C
barcode89_consensus_vsearch	2859	C	C	249	4	1.57%	2	1	93	93	0.06175816388801474	1	1	107	142	0	4	T
barcode89_consensus_vsearch	2860	C	C	256	1	0.39%	2	1	93	93	0.4999999999999138	1	1	109	147	0	1	+TGT
barcode89_consensus_vsearch	2861	C	C	254	2	0.77%	2	2	93	93	0.2495107632092758	1	1	108	146	1	1	A
barcode89_consensus_vsearch	2862	C	C	258	1	0.39%	2	1	93	93	0.4999999999999138	1	1	108	150	1	0	-AGCAC
barcode89_consensus_vsearch	2863	A	A	258	0	0%	2	0	93	0	1.0	1	0	108	150	0	0	
barcode89_consensus_vsearch	2864	G	G	252	4	1.55%	2	2	93	93	0.06176686569346045	1	1	104	148	2	2	A
barcode89_consensus_vsearch	2865	C	C	253	4	1.56%	2	1	93	93	0.0617697211064687	1	1	103	150	4	0	-AC
barcode89_consensus_vsearch	2866	A	A	250	2	0.79%	2	1	93	93	0.2495029821073759	1	1	101	149	2	0	G
barcode89_consensus_vsearch	2867	C	C	252	1	0.39%	2	1	93	93	0.5000000000003686	1	1	103	149	0	1	+G
barcode89_consensus_vsearch	2868	G	G	258	1	0.39%	2	1	93	93	0.4999999999999138	1	1	108	150	1	0	-AC
barcode89_consensus_vsearch	2869	A	A	255	1	0.39%	2	1	93	93	0.4999999999999138	1	1	107	148	1	0	+CC
barcode89_consensus_vsearch	2870	C	C	251	4	1.56%	2	1	93	93	0.06176398786346276	1	1	102	149	4	0	-A
barcode89_consensus_vsearch	2871	A	A	248	3	1.18%	2	2	93	93	0.12425149700602607	1	1	102	146	1	2	G
barcode89_consensus_vsearch	2872	G	G	257	0	0%	2	0	93	0	1.0	1	0	107	150	0	0	
barcode89_consensus_vsearch	2873	A	A	257	1	0.39%	2	1	93	93	0.4999999999999138	1	1	108	149	1	0	-G
barcode89_consensus_vsearch	2874	G	G	258	0	0%	2	0	93	0	1.0	1	0	108	150	0	0	
barcode89_consensus_vsearch	2875	T	T	257	2	0.77%	2	1	93	93	0.24951644100587136	1	1	109	148	0	2	C
barcode89_consensus_vsearch	2876	T	T	259	0	0%	2	0	93	0	1.0	1	0	109	150	0	0	
barcode89_consensus_vsearch	2877	T	T	257	1	0.39%	2	1	93	93	0.4999999999999138	1	1	108	149	0	1	+CTT
barcode89_consensus_vsearch	2878	A	A	257	1	0.39%	2	1	93	93	0.4999999999999138	1	1	108	149	0	1	G
barcode89_consensus_vsearch	2879	A	A	254	3	1.16%	2	2	93	93	0.12426900584791233	1	1	107	147	2	1	G
barcode89_consensus_vsearch	2880	C	C	249	5	1.94%	2	1	93	93	0.03063545999571253	1	1	102	147	5	0	+A
barcode89_consensus_vsearch	2881	A	A	252	2	0.78%	2	1	93	93	0.2495069033532105	1	1	103	149	2	0	G
barcode89_consensus_vsearch	2882	A	A	255	1	0.39%	2	1	93	93	0.4999999999999138	1	1	107	148	0	1	+G
barcode89_consensus_vsearch	2883	G	G	256	2	0.78%	2	1	93	93	0.24951456310670525	1	1	106	150	2	0	-A
barcode89_consensus_vsearch	2884	A	A	254	1	0.39%	2	1	93	93	0.4999999999999138	1	1	107	147	0	1	+TTTC
barcode89_consensus_vsearch	2885	T	T	256	1	0.39%	2	1	93	93	0.4999999999999138	1	1	109	147	0	1	C
barcode89_consensus_vsearch	2886	T	T	251	6	2.33%	2	1	93	93	0.015170809117680038	1	1	103	148	6	0	-AC
barcode89_consensus_vsearch	2887	A	A	249	2	0.79%	2	2	93	93	0.24950099800389156	1	1	101	148	1	1	G
barcode89_consensus_vsearch	2888	C	C	245	4	1.59%	2	1	93	93	0.061746234985649476	1	1	99	146	0	4	+T
barcode89_consensus_vsearch	2889	C	S	248	7	2.7%	2	1	93	93	0.007493349252391194	1	1	101	147	7	0	G
barcode89_consensus_vsearch	2890	C	C	253	2	0.77%	2	2	93	93	0.24950884086425928	1	1	106	147	1	1	G
barcode89_consensus_vsearch	2891	A	A	254	2	0.77%	2	1	93	93	0.2495107632092758	1	1	107	147	0	2	T
barcode89_consensus_vsearch	2892	G	G	256	1	0.39%	2	1	93	93	0.4999999999999138	1	1	108	148	0	1	A
barcode89_consensus_vsearch	2893	A	A	256	1	0.39%	2	1	93	93	0.4999999999999138	1	1	108	148	0	1	+GA
barcode89_consensus_vsearch	2894	C	C	257	1	0.39%	2	1	93	93	0.4999999999999138	1	1	109	148	0	1	+T
barcode89_consensus_vsearch	2895	C	*/-T	232	23	8.88%	2	1	93	93	7.093206266327472E-8	1	1	108	124	0	23	-T
barcode89_consensus_vsearch	2896	T	T	233	0	0%	2	0	93	0	1.0	1	0	109	124	0	0	
barcode89_consensus_vsearch	2897	T	T	256	0	0%	2	0	93	0	1.0	1	0	109	147	0	0	
barcode89_consensus_vsearch	2898	T	T	254	2	0.78%	2	1	93	93	0.2495107632092758	1	1	107	147	0	2	-C
barcode89_consensus_vsearch	2899	C	C	255	2	0.78%	2	1	93	93	0.2495126705651419	1	1	109	146	0	2	-G
barcode89_consensus_vsearch	2900	G	G	257	0	0%	2	0	93	0	1.0	1	0	109	148	0	0	
barcode89_consensus_vsearch	2901	G	G	257	2	0.77%	2	1	93	93	0.24951644100587136	1	1	109	148	0	2	-T
barcode89_consensus_vsearch	2902	T	T	251	6	2.33%	2	1	93	93	0.015170809117680038	1	1	103	148	6	0	+C
barcode89_consensus_vsearch	2903	C	C	249	6	2.32%	2	2	93	93	0.015167261137354384	1	1	101	148	4	2	-A
barcode89_consensus_vsearch	2904	A	A	247	2	0.79%	2	1	93	93	0.24949698189118988	1	1	101	146	2	0	C
barcode89_consensus_vsearch	2905	A	A	250	3	1.16%	2	2	93	93	0.12425742574263329	1	1	104	146	2	1	-G
barcode89_consensus_vsearch	2906	G	G	251	2	0.78%	2	1	93	93	0.24950495049494414	1	1	105	146	0	2	+C
barcode89_consensus_vsearch	2907	G	G	252	4	1.54%	2	1	93	93	0.06176686569346045	1	1	103	149	4	0	-A
barcode89_consensus_vsearch	2908	A	A	252	1	0.39%	2	1	93	93	0.5000000000003686	1	1	103	149	1	0	C
barcode89_consensus_vsearch	2909	A	A	255	2	0.78%	2	1	93	93	0.2495126705651419	1	1	107	148	0	2	G
barcode89_consensus_vsearch	2910	T	T	256	1	0.39%	2	1	93	93	0.4999999999999138	1	1	106	150	1	0	+A
barcode89_consensus_vsearch	2911	G	G	257	1	0.39%	2	1	93	93	0.4999999999999138	1	1	108	149	0	1	+AAA
barcode89_consensus_vsearch	2912	A	A	256	2	0.78%	2	2	93	93	0.24951456310670525	1	1	107	149	1	1	G
barcode89_consensus_vsearch	2913	A	A	254	3	1.16%	2	2	93	93	0.12426900584791233	1	1	107	147	2	1	G
barcode89_consensus_vsearch	2914	C	C	257	1	0.39%	2	1	93	93	0.4999999999999138	1	1	109	148	0	1	+T
barcode89_consensus_vsearch	2915	T	T	254	2	0.78%	2	2	93	93	0.2495107632092758	1	1	107	147	1	1	C
barcode89_consensus_vsearch	2916	C	C	254	1	0.39%	2	1	93	93	0.4999999999999138	1	1	108	146	0	1	+AA
barcode89_consensus_vsearch	2917	G	G	258	0	0%	2	0	93	0	1.0	1	0	108	150	0	0	
barcode89_consensus_vsearch	2918	T	T	255	3	1.16%	2	1	93	93	0.1242718446601877	1	1	108	147	0	3	C
barcode89_consensus_vsearch	2919	T	T	257	1	0.39%	2	1	93	93	0.4999999999999138	1	1	109	148	0	1	+G
barcode89_consensus_vsearch	2920	G	G	256	1	0.39%	2	1	93	93	0.4999999999999138	1	1	107	149	1	0	+AA
barcode89_consensus_vsearch	2921	G	G	254	3	1.16%	2	1	93	93	0.12426900584791233	1	1	108	146	0	3	+C
barcode89_consensus_vsearch	2922	C	C	254	4	1.54%	2	2	93	93	0.06177255436325217	1	1	106	148	2	2	T
barcode89_consensus_vsearch	2923	T	T	255	3	1.16%	2	1	93	93	0.1242718446601877	1	1	108	147	0	3	-C
barcode89_consensus_vsearch	2924	C	C	251	4	1.56%	2	1	93	93	0.06176398786346276	1	1	109	142	0	4	+T
barcode89_consensus_vsearch	2925	T	T	253	2	0.78%	2	2	93	93	0.24950884086425928	1	1	108	145	1	1	+G
barcode89_consensus_vsearch	2926	G	G	257	1	0.39%	2	1	93	93	0.4999999999999138	1	1	109	148	0	1	-T
barcode89_consensus_vsearch	2927	T	T	251	3	1.16%	2	2	93	93	0.12426035502961323	1	1	105	146	2	1	+C
barcode89_consensus_vsearch	2928	C	C	257	1	0.39%	2	1	93	93	0.4999999999999138	1	1	108	149	1	0	+TCA
barcode89_consensus_vsearch	2929	A	A	251	4	1.54%	2	2	93	93	0.06176398786346276	1	1	107	144	2	2	G
barcode89_consensus_vsearch	2930	G	G	255	1	0.39%	2	1	93	93	0.4999999999999138	1	1	108	147	1	0	T
barcode89_consensus_vsearch	2931	T	T	248	5	1.94%	2	1	93	93	0.030633033482245435	1	1	108	140	0	5	-GT
barcode89_consensus_vsearch	2932	G	G	253	0	0%	2	0	93	0	1.0	1	0	109	144	0	0	
barcode89_consensus_vsearch	2933	T	T	247	3	1.18%	2	1	93	93	0.12424849699405838	1	1	106	141	0	3	A
barcode89_consensus_vsearch	2934	A	A	255	1	0.39%	2	1	93	93	0.4999999999999138	1	1	107	148	0	1	-G
barcode89_consensus_vsearch	2935	G	G	254	2	0.78%	2	1	93	93	0.2495107632092758	1	1	106	148	2	0	A
barcode89_consensus_vsearch	2936	C	C	254	2	0.78%	2	1	93	93	0.2495107632092758	1	1	107	147	0	2	T
barcode89_consensus_vsearch	2937	G	*/-CGCG	248	7	2.72%	2	1	93	93	0.007493349252391194	1	1	107	141	0	7	-CGCG
barcode89_consensus_vsearch	2938	C	C	247	2	0.8%	2	1	93	93	0.24949698189118988	1	1	107	140	0	2	T
barcode89_consensus_vsearch	2939	G	*/-CG	180	66	26.4%	2	2	93	93	8.692707920064498E-23	1	1	87	93	19	47	-CG
barcode89_consensus_vsearch	2940	C	C	180	3	1.62%	2	1	93	93	0.12397260273979696	1	1	88	92	0	3	T
barcode89_consensus_vsearch	2941	G	G	175	2	1.09%	2	2	93	93	0.2492917847025028	1	1	86	89	1	1	+CG
barcode89_consensus_vsearch	2942	T	T	251	3	1.17%	2	2	93	93	0.12426035502961323	1	1	105	146	2	1	C
barcode89_consensus_vsearch	2943	G	G	251	2	0.78%	2	2	93	93	0.24950495049494414	1	1	107	144	1	1	A
barcode89_consensus_vsearch	2944	C	C	250	4	1.56%	2	2	93	93	0.061761087351402955	1	1	106	144	1	3	T
barcode89_consensus_vsearch	2945	G	G	253	3	1.17%	2	1	93	93	0.124266144814075	1	1	106	147	3	0	A
barcode89_consensus_vsearch	2946	G	G	248	6	2.33%	2	2	93	93	0.015165466280175907	1	1	100	148	5	1	-C
barcode89_consensus_vsearch	2947	C	C	246	3	1.19%	2	2	93	93	0.1242454728369122	1	1	101	145	1	2	T
barcode89_consensus_vsearch	2948	C	C	257	2	0.77%	2	2	93	93	0.24951644100587136	1	1	108	149	1	1	T
barcode89_consensus_vsearch	2949	C	C	253	3	1.16%	2	1	93	93	0.124266144814075	1	1	105	148	3	0	-A
barcode89_consensus_vsearch	2950	A	A	246	5	1.95%	2	1	93	93	0.03062812251247695	1	1	104	142	0	5	+G
barcode89_consensus_vsearch	2951	G	G	252	2	0.78%	2	1	93	93	0.2495069033532105	1	1	105	147	0	2	+A
barcode89_consensus_vsearch	2952	A	A	252	3	1.18%	2	2	93	93	0.12426326129665838	1	1	104	148	2	1	G
barcode89_consensus_vsearch	2953	A	A	252	3	1.17%	2	2	93	93	0.12426326129665838	1	1	104	148	2	1	G
barcode89_consensus_vsearch	2954	C	C	254	2	0.78%	2	2	93	93	0.2495107632092758	1	1	106	148	1	1	T
barcode89_consensus_vsearch	2955	A	A	254	2	0.78%	2	1	93	93	0.2495107632092758	1	1	107	147	0	2	+C
barcode89_consensus_vsearch	2956	T	T	252	3	1.16%	2	1	93	93	0.12426326129665838	1	1	104	148	3	0	+C
barcode89_consensus_vsearch	2957	C	C	253	2	0.78%	2	2	93	93	0.24950884086425928	1	1	106	147	1	1	-T
barcode89_consensus_vsearch	2958	T	T	246	5	1.96%	2	1	93	93	0.03062812251247695	1	1	99	147	5	0	+A
barcode89_consensus_vsearch	2959	A	A	250	3	1.17%	2	2	93	93	0.12425742574263329	1	1	103	147	1	2	+C
barcode89_consensus_vsearch	2960	A	A	247	5	1.95%	2	2	93	93	0.030630587731099716	1	1	104	143	1	4	+G
barcode89_consensus_vsearch	2961	G	G	257	0	0%	2	0	93	0	1.0	1	0	108	149	0	0	
barcode89_consensus_vsearch	2962	G	G	254	2	0.78%	2	1	93	93	0.2495107632092758	1	1	105	149	2	0	+A
barcode89_consensus_vsearch	2963	G	G	257	1	0.39%	2	1	93	93	0.4999999999999138	1	1	107	150	1	0	A
barcode89_consensus_vsearch	2964	C	C	256	2	0.78%	2	2	93	93	0.24951456310670525	1	1	107	149	1	1	+A
barcode89_consensus_vsearch	2965	A	A	256	1	0.39%	2	1	93	93	0.4999999999999138	1	1	107	149	1	0	+C
barcode89_consensus_vsearch	2966	T	T	254	3	1.16%	2	1	93	93	0.12426900584791233	1	1	107	147	0	3	C
barcode89_consensus_vsearch	2967	C	C	254	1	0.39%	2	1	93	93	0.4999999999999138	1	1	106	148	0	1	+A
barcode89_consensus_vsearch	2968	A	A	250	2	0.78%	2	1	93	93	0.2495029821073759	1	1	105	145	0	2	-C
barcode89_consensus_vsearch	2969	C	C	252	2	0.78%	2	1	93	93	0.2495069033532105	1	1	106	146	2	0	+G
barcode89_consensus_vsearch	2970	A	A	253	2	0.78%	2	2	93	93	0.24950884086425928	1	1	107	146	1	1	-G
barcode89_consensus_vsearch	2971	G	G	254	2	0.78%	2	1	93	93	0.2495107632092758	1	1	108	146	0	2	+A
barcode89_consensus_vsearch	2972	A	A	255	2	0.78%	2	1	93	93	0.2495126705651419	1	1	107	148	2	0	G
barcode89_consensus_vsearch	2973	C	C	255	2	0.77%	2	1	93	93	0.2495126705651419	1	1	108	147	0	2	T
barcode89_consensus_vsearch	2974	C	C	254	4	1.54%	2	2	93	93	0.06177255436325217	1	1	107	147	2	2	-T
barcode89_consensus_vsearch	2975	T	T	246	6	2.36%	2	2	93	93	0.01516183400716267	1	1	105	141	1	5	C
barcode89_consensus_vsearch	2976	G	G	254	3	1.16%	2	1	93	93	0.12426900584791233	1	1	105	149	3	0	-TTAT
barcode89_consensus_vsearch	2977	T	T	252	2	0.78%	2	2	93	93	0.2495069033532105	1	1	104	148	1	1	C
barcode89_consensus_vsearch	2978	T	T	249	3	1.17%	2	2	93	93	0.12425447316115633	1	1	101	148	2	1	-ATT
barcode89_consensus_vsearch	2979	A	A	250	1	0.4%	2	1	93	93	0.4999999999999138	1	1	102	148	0	1	G
barcode89_consensus_vsearch	2980	T	T	249	2	0.79%	2	2	93	93	0.24950099800389156	1	1	101	148	1	1	C
barcode89_consensus_vsearch	2981	T	T	255	1	0.39%	2	1	93	93	0.4999999999999138	1	1	106	149	1	0	A
barcode89_consensus_vsearch	2982	G	*/-C	237	21	8.11%	2	1	93	93	3.120739667501159E-7	1	1	109	128	0	21	-C
barcode89_consensus_vsearch	2983	C	C	234	2	0.84%	2	1	93	93	0.24946921443740738	1	1	109	125	0	2	+T
barcode89_consensus_vsearch	2984	C	C	255	2	0.77%	2	1	93	93	0.2495126705651419	1	1	109	146	0	2	+T
barcode89_consensus_vsearch	2985	T	T	254	2	0.78%	2	1	93	93	0.2495107632092758	1	1	107	147	2	0	+C
barcode89_consensus_vsearch	2986	C	C	248	6	2.33%	2	1	93	93	0.015165466280175907	1	1	107	141	0	6	-A
barcode89_consensus_vsearch	2987	A	A	253	0	0%	2	0	93	0	1.0	1	0	109	144	0	0	
barcode89_consensus_vsearch	2988	A	A	258	1	0.39%	2	1	93	93	0.4999999999999138	1	1	109	149	0	1	+GA
barcode89_consensus_vsearch	2989	A	A	254	5	1.93%	2	2	93	93	0.030647311787538743	1	1	106	148	3	2	G
barcode89_consensus_vsearch	2990	C	C	256	2	0.77%	2	2	93	93	0.24951456310670525	1	1	107	149	1	1	-T
barcode89_consensus_vsearch	2991	T	T	255	1	0.39%	2	1	93	93	0.4999999999999138	1	1	108	147	0	1	+C
barcode89_consensus_vsearch	2992	T	T	253	3	1.16%	2	2	93	93	0.124266144814075	1	1	106	147	1	2	C
barcode89_consensus_vsearch	2993	C	C	255	1	0.39%	2	1	93	93	0.4999999999999138	1	1	106	149	0	1	+T
barcode89_consensus_vsearch	2994	C	C	256	1	0.39%	2	1	93	93	0.4999999999999138	1	1	106	150	1	0	+A
barcode89_consensus_vsearch	2995	A	A	254	2	0.78%	2	2	93	93	0.2495107632092758	1	1	106	148	1	1	G
barcode89_consensus_vsearch	2996	T	T	254	1	0.39%	2	1	93	93	0.4999999999999138	1	1	105	149	1	0	-CGGCTT
barcode89_consensus_vsearch	2997	C	C	253	1	0.39%	2	1	93	93	0.5000000000003686	1	1	106	147	0	1	+AC
barcode89_consensus_vsearch	2998	G	G	255	1	0.39%	2	1	93	93	0.4999999999999138	1	1	107	148	1	0	A
barcode89_consensus_vsearch	2999	G	G	258	0	0%	2	0	93	0	1.0	1	0	108	150	0	0	
barcode89_consensus_vsearch	3000	C	*/-TT	247	7	2.71%	2	1	93	93	0.00749210286352295	1	1	97	150	7	0	-TT
barcode89_consensus_vsearch	3001	T	T	245	3	1.21%	2	1	93	93	0.1242424242424468	1	1	98	147	0	3	C
barcode89_consensus_vsearch	3002	T	T	246	1	0.4%	2	1	93	93	0.5000000000003686	1	1	97	149	0	1	+C
barcode89_consensus_vsearch	3003	G	G	252	2	0.78%	2	2	93	93	0.2495069033532105	1	1	104	148	1	1	-A
barcode89_consensus_vsearch	3004	A	A	252	2	0.78%	2	1	93	93	0.2495069033532105	1	1	103	149	2	0	-G
barcode89_consensus_vsearch	3005	G	G	255	1	0.39%	2	1	93	93	0.4999999999999138	1	1	105	150	1	0	+CC
barcode89_consensus_vsearch	3006	C	C	257	1	0.39%	2	1	93	93	0.4999999999999138	1	1	108	149	0	1	A
barcode89_consensus_vsearch	3007	C	C	253	2	0.77%	2	2	93	93	0.24950884086425928	1	1	107	146	1	1	A
barcode89_consensus_vsearch	3008	G	G	255	2	0.78%	2	1	93	93	0.2495126705651419	1	1	107	148	2	0	A
barcode89_consensus_vsearch	3009	A	A	256	1	0.39%	2	1	93	93	0.4999999999999138	1	1	109	147	0	1	-T
barcode89_consensus_vsearch	3010	T	T	257	0	0%	2	0	93	0	1.0	1	0	109	148	0	0	
barcode89_consensus_vsearch	3011	A	A	252	4	1.54%	2	2	93	93	0.06176686569346045	1	1	105	147	3	1	G
barcode89_consensus_vsearch	3012	G	G	256	1	0.39%	2	1	93	93	0.4999999999999138	1	1	109	147	0	1	+C
barcode89_consensus_vsearch	3013	T	*/-C	236	18	6.98%	2	2	93	93	2.7923090541651273E-6	1	1	105	131	3	15	-C
barcode89_consensus_vsearch	3014	C	C	239	1	0.42%	2	1	93	93	0.4999999999999138	1	1	106	133	0	1	T
barcode89_consensus_vsearch	3015	C	C	257	1	0.39%	2	1	93	93	0.4999999999999138	1	1	108	149	1	0	+T
barcode89_consensus_vsearch	3016	C	C	257	2	0.77%	2	2	93	93	0.24951644100587136	1	1	108	149	1	1	-T
barcode89_consensus_vsearch	3017	T	T	250	3	1.17%	2	1	93	93	0.12425742574263329	1	1	103	147	3	0	+C
barcode89_consensus_vsearch	3018	C	C	249	4	1.56%	2	1	93	93	0.06175816388801474	1	1	106	143	0	4	+T
barcode89_consensus_vsearch	3019	T	T	248	2	0.79%	2	1	93	93	0.24949899799584363	1	1	103	145	2	0	-A
barcode89_consensus_vsearch	3020	A	A	254	1	0.39%	2	1	93	93	0.4999999999999138	1	1	105	149	0	1	G
barcode89_consensus_vsearch	3021	A	A	250	4	1.55%	2	1	93	93	0.061761087351402955	1	1	101	149	4	0	-GA
barcode89_consensus_vsearch	3022	G	G	248	4	1.57%	2	2	93	93	0.061755217199896344	1	1	100	148	3	1	-AA
barcode89_consensus_vsearch	3023	A	A	244	5	2%	2	2	93	93	0.030623132735815337	1	1	98	146	3	2	G
barcode89_consensus_vsearch	3024	A	A	248	3	1.18%	2	1	93	93	0.12425149700602607	1	1	101	147	3	0	-G
barcode89_consensus_vsearch	3025	G	G	251	1	0.39%	2	1	93	93	0.5000000000003686	1	1	101	150	1	0	+C
barcode89_consensus_vsearch	3026	C	C	255	1	0.39%	2	1	93	93	0.4999999999999138	1	1	106	149	0	1	+T
barcode89_consensus_vsearch	3027	C	C	251	3	1.16%	2	1	93	93	0.12426035502961323	1	1	107	144	0	3	-G
barcode89_consensus_vsearch	3028	G	G	253	1	0.39%	2	1	93	93	0.5000000000003686	1	1	106	147	1	0	A
barcode89_consensus_vsearch	3029	G	G	255	2	0.78%	2	2	93	93	0.2495126705651419	1	1	106	149	1	1	A
barcode89_consensus_vsearch	3030	C	C	257	1	0.39%	2	1	93	93	0.4999999999999138	1	1	108	149	0	1	T
barcode89_consensus_vsearch	3031	G	G	259	0	0%	2	0	93	0	1.0	1	0	109	150	0	0	
barcode89_consensus_vsearch	3032	A	A	257	1	0.39%	2	1	93	93	0.4999999999999138	1	1	108	149	1	0	-C
barcode89_consensus_vsearch	3033	C	C	255	2	0.78%	2	2	93	93	0.2495126705651419	1	1	107	148	1	1	T
barcode89_consensus_vsearch	3034	C	C	256	1	0.39%	2	1	93	93	0.4999999999999138	1	1	108	148	0	1	+GT
barcode89_consensus_vsearch	3035	A	A	252	2	0.78%	2	1	93	93	0.2495069033532105	1	1	106	146	0	2	-G
barcode89_consensus_vsearch	3036	G	G	255	1	0.39%	2	1	93	93	0.4999999999999138	1	1	108	147	1	0	-C
barcode89_consensus_vsearch	3037	C	C	254	2	0.78%	2	1	93	93	0.2495107632092758	1	1	107	147	0	2	A
barcode89_consensus_vsearch	3038	C	*/+A	235	10	3.86%	2	2	93	93	8.892517004154109E-4	1	1	99	136	4	6	+A
barcode89_consensus_vsearch	3039	A	A	247	2	0.8%	2	2	93	93	0.24949698189118988	1	1	104	143	1	1	G
barcode89_consensus_vsearch	3040	A	A	254	2	0.78%	2	1	93	93	0.2495107632092758	1	1	109	145	0	2	G
barcode89_consensus_vsearch	3041	A	A	253	4	1.54%	2	1	93	93	0.0617697211064687	1	1	109	144	0	4	G
barcode89_consensus_vsearch	3042	G	G	256	1	0.39%	2	1	93	93	0.4999999999999138	1	1	107	149	1	0	+C
barcode89_consensus_vsearch	3043	C	C	251	2	0.78%	2	1	93	93	0.24950495049494414	1	1	106	145	2	0	-T
barcode89_consensus_vsearch	3044	T	T	248	3	1.17%	2	2	93	93	0.12425149700602607	1	1	104	144	1	2	C
barcode89_consensus_vsearch	3045	A	A	249	6	2.33%	2	2	93	93	0.015167261137354384	1	1	105	144	2	4	G
barcode89_consensus_vsearch	3046	G	R	244	8	3.1%	2	1	93	93	0.0036920468013430033	1	1	94	150	8	0	A
barcode89_consensus_vsearch	3047	C	C	252	3	1.17%	2	1	93	93	0.12426326129665838	1	1	106	146	0	3	+T
barcode89_consensus_vsearch	3048	C	C	254	2	0.78%	2	1	93	93	0.2495107632092758	1	1	108	146	0	2	-T
barcode89_consensus_vsearch	3049	T	T	251	3	1.17%	2	2	93	93	0.12426035502961323	1	1	106	145	1	2	C
barcode89_consensus_vsearch	3050	G	G	257	1	0.39%	2	1	93	93	0.4999999999999138	1	1	108	149	0	1	A
barcode89_consensus_vsearch	3051	G	G	257	2	0.77%	2	2	93	93	0.24951644100587136	1	1	108	149	1	1	A
barcode89_consensus_vsearch	3052	C	C	254	3	1.16%	2	1	93	93	0.12426900584791233	1	1	107	147	0	3	T
barcode89_consensus_vsearch	3053	T	T	255	1	0.39%	2	1	93	93	0.4999999999999138	1	1	106	149	1	0	-A
barcode89_consensus_vsearch	3054	A	A	253	1	0.39%	2	1	93	93	0.5000000000003686	1	1	105	148	1	0	-T
barcode89_consensus_vsearch	3055	T	T	254	1	0.39%	2	1	93	93	0.4999999999999138	1	1	105	149	1	0	G
barcode89_consensus_vsearch	3056	T	T	256	1	0.39%	2	1	93	93	0.4999999999999138	1	1	107	149	1	0	C
barcode89_consensus_vsearch	3057	T	T	253	3	1.16%	2	1	93	93	0.124266144814075	1	1	103	150	3	0	-A
barcode89_consensus_vsearch	3058	A	A	248	4	1.56%	2	1	93	93	0.061755217199896344	1	1	102	146	4	0	G
barcode89_consensus_vsearch	3059	G	G	255	1	0.39%	2	1	93	93	0.4999999999999138	1	1	108	147	0	1	+TTA
barcode89_consensus_vsearch	3060	C	C	248	3	1.16%	2	1	93	93	0.12425149700602607	1	1	102	146	0	3	T
barcode89_consensus_vsearch	3061	A	A	251	3	1.17%	2	2	93	93	0.12426035502961323	1	1	103	148	2	1	-G
barcode89_consensus_vsearch	3062	G	G	252	4	1.56%	2	2	93	93	0.06176686569346045	1	1	106	146	1	3	A
barcode89_consensus_vsearch	3063	G	G	253	2	0.77%	2	1	93	93	0.24950884086425928	1	1	104	149	2	0	-T
barcode89_consensus_vsearch	3064	T	T	252	3	1.17%	2	2	93	93	0.12426326129665838	1	1	106	146	1	2	C
barcode89_consensus_vsearch	3065	T	*/-A	226	15	5.81%	2	2	93	93	2.4377685733588186E-5	1	1	80	146	13	2	-A
barcode89_consensus_vsearch	3066	A	A	238	2	0.82%	2	1	93	93	0.24947807933195232	1	1	93	145	2	0	G
barcode89_consensus_vsearch	3067	A	A	250	4	1.54%	2	2	93	93	0.061761087351402955	1	1	104	146	3	1	G
barcode89_consensus_vsearch	3068	G	G	256	0	0%	2	0	93	0	1.0	1	0	107	149	0	0	
barcode89_consensus_vsearch	3069	G	G	259	0	0%	2	0	93	0	1.0	1	0	109	150	0	0	
barcode89_consensus_vsearch	3070	T	T	256	2	0.77%	2	1	93	93	0.24951456310670525	1	1	109	147	0	2	+C
barcode89_consensus_vsearch	3071	C	C	259	0	0%	2	0	93	0	1.0	1	0	109	150	0	0	
barcode89_consensus_vsearch	3072	T	T	255	3	1.16%	2	2	93	93	0.1242718446601877	1	1	108	147	1	2	C
barcode89_consensus_vsearch	3073	C	C	253	2	0.78%	2	1	93	93	0.24950884086425928	1	1	108	145	0	2	+A
barcode89_consensus_vsearch	3074	G	G	255	2	0.77%	2	1	93	93	0.2495126705651419	1	1	109	146	0	2	C
barcode89_consensus_vsearch	3075	T	T	254	5	1.93%	2	2	93	93	0.030647311787538743	1	1	108	146	1	4	C
barcode89_consensus_vsearch	3076	T	T	256	3	1.16%	2	2	93	93	0.12427466150865948	1	1	108	148	1	2	-C
barcode89_consensus_vsearch	3077	C	C	255	1	0.39%	2	1	93	93	0.4999999999999138	1	1	108	147	0	1	G
barcode89_consensus_vsearch	3078	G	G	257	2	0.77%	2	1	93	93	0.24951644100587136	1	1	107	150	2	0	A
barcode89_consensus_vsearch	3079	T	T	257	1	0.39%	2	1	93	93	0.4999999999999138	1	1	109	148	0	1	+A
barcode89_consensus_vsearch	3080	T	T	257	1	0.39%	2	1	93	93	0.4999999999999138	1	1	109	148	0	1	+A
barcode89_consensus_vsearch	3081	A	A	258	1	0.39%	2	1	93	93	0.4999999999999138	1	1	108	150	1	0	C
barcode89_consensus_vsearch	3082	T	T	256	1	0.39%	2	1	93	93	0.4999999999999138	1	1	108	148	1	0	+GT
barcode89_consensus_vsearch	3083	C	C	257	1	0.39%	2	1	93	93	0.4999999999999138	1	1	108	149	1	0	+ATC
barcode89_consensus_vsearch	3084	G	G	257	1	0.39%	2	1	93	93	0.4999999999999138	1	1	108	149	0	1	+T
barcode89_consensus_vsearch	3085	C	C	254	2	0.77%	2	2	93	93	0.2495107632092758	1	1	108	146	1	1	-A
barcode89_consensus_vsearch	3086	A	A	252	3	1.17%	2	2	93	93	0.12426326129665838	1	1	105	147	2	1	G
barcode89_consensus_vsearch	3087	A	A	253	2	0.78%	2	2	93	93	0.24950884086425928	1	1	107	146	1	1	-T
barcode89_consensus_vsearch	3088	T	T	254	2	0.78%	2	1	93	93	0.2495107632092758	1	1	108	146	0	2	C
barcode89_consensus_vsearch	3089	T	*/-A	236	15	5.81%	2	1	93	93	2.4603451297384386E-5	1	1	106	130	0	15	-A
barcode89_consensus_vsearch	3090	A	A	237	2	0.83%	2	2	93	93	0.24947589098518488	1	1	107	130	1	1	C
barcode89_consensus_vsearch	3091	A	*/-G	238	15	5.88%	2	1	93	93	2.4646634720268753E-5	1	1	108	130	0	15	-G
barcode89_consensus_vsearch	3092	G	G	240	1	0.41%	2	1	93	93	0.4999999999999138	1	1	107	133	1	0	+C
barcode89_consensus_vsearch	3093	C	C	256	1	0.39%	2	1	93	93	0.4999999999999138	1	1	109	147	0	1	+T
barcode89_consensus_vsearch	3094	A	A	256	1	0.39%	2	1	93	93	0.4999999999999138	1	1	108	148	1	0	+G
barcode89_consensus_vsearch	3095	G	G	257	1	0.39%	2	1	93	93	0.4999999999999138	1	1	108	149	1	0	+A
barcode89_consensus_vsearch	3096	A	A	253	2	0.77%	2	1	93	93	0.24950884086425928	1	1	107	146	2	0	+C
barcode89_consensus_vsearch	3097	C	*/-A	243	11	4.26%	2	2	93	93	4.3717375701073373E-4	1	1	105	138	2	9	-A
barcode89_consensus_vsearch	3098	A	A	246	1	0.4%	2	1	93	93	0.5000000000003686	1	1	107	139	0	1	G
barcode89_consensus_vsearch	3099	A	A	259	0	0%	2	0	93	0	1.0	1	0	109	150	0	0	
barcode89_consensus_vsearch	3100	A	A	257	1	0.39%	2	1	93	93	0.4999999999999138	1	1	109	148	0	1	-T
barcode89_consensus_vsearch	3101	T	Y	249	8	3.11%	2	1	93	93	0.0036961603384701837	1	1	109	140	0	8	C
barcode89_consensus_vsearch	3102	C	C	252	5	1.94%	2	1	93	93	0.030642626352771006	1	1	103	149	5	0	-A
barcode89_consensus_vsearch	3103	A	A	249	1	0.4%	2	1	93	93	0.5000000000003686	1	1	102	147	0	1	+C
barcode89_consensus_vsearch	3104	C	C	254	3	1.17%	2	1	93	93	0.12426900584791233	1	1	108	146	0	3	-T
barcode89_consensus_vsearch	3105	T	T	245	5	1.96%	2	1	93	93	0.03062563759307	1	1	105	140	0	5	C
barcode89_consensus_vsearch	3106	C	C	256	1	0.39%	2	1	93	93	0.4999999999999138	1	1	108	148	0	1	A
barcode89_consensus_vsearch	3107	C	C	256	3	1.16%	2	2	93	93	0.12427466150865948	1	1	107	149	2	1	-A
barcode89_consensus_vsearch	3108	A	A	254	1	0.39%	2	1	93	93	0.4999999999999138	1	1	107	147	0	1	+C
barcode89_consensus_vsearch	3109	C	C	257	2	0.77%	2	1	93	93	0.24951644100587136	1	1	107	150	2	0	G
barcode89_consensus_vsearch	3110	C	C	258	1	0.39%	2	1	93	93	0.4999999999999138	1	1	109	149	0	1	-A
barcode89_consensus_vsearch	3111	A	A	256	1	0.39%	2	1	93	93	0.4999999999999138	1	1	107	149	1	0	C
barcode89_consensus_vsearch	3112	A	A	257	2	0.77%	2	1	93	93	0.24951644100587136	1	1	107	150	2	0	G
barcode89_consensus_vsearch	3113	C	C	259	0	0%	2	0	93	0	1.0	1	0	109	150	0	0	
barcode89_consensus_vsearch	3114	T	T	251	5	1.93%	2	1	93	93	0.03064025621010106	1	1	103	148	5	0	+A
barcode89_consensus_vsearch	3115	A	A	257	1	0.39%	2	1	93	93	0.4999999999999138	1	1	107	150	1	0	G
barcode89_consensus_vsearch	3116	A	A	259	0	0%	2	0	93	0	1.0	1	0	109	150	0	0	
barcode89_consensus_vsearch	3117	G	G	255	3	1.16%	2	1	93	93	0.1242718446601877	1	1	106	149	3	0	-A
barcode89_consensus_vsearch	3118	A	A	255	1	0.39%	2	1	93	93	0.4999999999999138	1	1	105	150	1	0	G
barcode89_consensus_vsearch	3119	A	A	256	3	1.16%	2	2	93	93	0.12427466150865948	1	1	108	148	1	2	G
barcode89_consensus_vsearch	3120	C	C	254	2	0.77%	2	1	93	93	0.2495107632092758	1	1	109	145	0	2	+G
barcode89_consensus_vsearch	3121	G	G	255	2	0.78%	2	1	93	93	0.2495126705651419	1	1	107	148	2	0	A
barcode89_consensus_vsearch	3122	G	G	257	2	0.77%	2	1	93	93	0.24951644100587136	1	1	109	148	0	2	-C
barcode89_consensus_vsearch	3123	C	C	255	1	0.39%	2	1	93	93	0.4999999999999138	1	1	109	146	0	1	+ATT
barcode89_consensus_vsearch	3124	C	C	255	1	0.39%	2	1	93	93	0.4999999999999138	1	1	107	148	1	0	+G
barcode89_consensus_vsearch	3125	A	A	248	5	1.95%	2	2	93	93	0.030633033482245435	1	1	103	145	2	3	G
barcode89_consensus_vsearch	3126	T	T	256	1	0.39%	2	1	93	93	0.4999999999999138	1	1	106	150	1	0	-GC
barcode89_consensus_vsearch	3127	G	G	255	2	0.78%	2	1	93	93	0.2495126705651419	1	1	105	150	2	0	A
barcode89_consensus_vsearch	3128	C	C	253	5	1.94%	2	1	93	93	0.030644978141142375	1	1	103	150	5	0	-AC
barcode89_consensus_vsearch	3129	A	A	250	2	0.79%	2	1	93	93	0.2495029821073759	1	1	100	150	2	0	-C
barcode89_consensus_vsearch	3130	C	C	252	0	0%	2	0	93	0	1.0	1	0	102	150	0	0	
barcode89_consensus_vsearch	3131	C	C	258	1	0.39%	2	1	93	93	0.4999999999999138	1	1	108	150	1	0	T
barcode89_consensus_vsearch	3132	A	A	257	1	0.39%	2	1	93	93	0.4999999999999138	1	1	107	150	1	0	-C
barcode89_consensus_vsearch	3133	C	C	255	1	0.39%	2	1	93	93	0.4999999999999138	1	1	106	149	0	1	+TG
barcode89_consensus_vsearch	3134	C	C	255	1	0.39%	2	1	93	93	0.4999999999999138	1	1	107	148	0	1	+A
barcode89_consensus_vsearch	3135	A	A	248	6	2.33%	2	2	93	93	0.015165466280175907	1	1	100	148	5	1	-C
barcode89_consensus_vsearch	3136	C	C	247	1	0.4%	2	1	93	93	0.4999999999999138	1	1	100	147	0	1	+T
barcode89_consensus_vsearch	3137	C	C	255	1	0.39%	2	1	93	93	0.4999999999999138	1	1	105	150	1	0	T
barcode89_consensus_vsearch	3138	C	C	256	3	1.16%	2	2	93	93	0.12427466150865948	1	1	107	149	2	1	T
barcode89_consensus_vsearch	3139	A	A	256	2	0.77%	2	1	93	93	0.24951456310670525	1	1	106	150	2	0	-CA
barcode89_consensus_vsearch	3140	C	C	246	6	2.33%	2	2	93	93	0.01516183400716267	1	1	104	142	1	5	+A
barcode89_consensus_vsearch	3141	A	A	252	0	0%	2	0	93	0	1.0	1	0	105	147	0	0	
barcode89_consensus_vsearch	3142	A	A	257	1	0.39%	2	1	93	93	0.4999999999999138	1	1	107	150	1	0	+G
barcode89_consensus_vsearch	3143	A	A	256	2	0.77%	2	1	93	93	0.24951456310670525	1	1	108	148	0	2	G
barcode89_consensus_vsearch	3144	A	A	257	2	0.77%	2	1	93	93	0.24951644100587136	1	1	107	150	2	0	G
barcode89_consensus_vsearch	3145	T	T	258	1	0.39%	2	1	93	93	0.4999999999999138	1	1	108	150	1	0	-C
barcode89_consensus_vsearch	3146	C	*/-A	230	12	4.65%	2	1	93	93	2.1231016338203528E-4	1	1	80	150	12	0	-A
barcode89_consensus_vsearch	3147	A	A	235	3	1.26%	2	1	93	93	0.1242105263157532	1	1	86	149	3	0	+G
barcode89_consensus_vsearch	3148	A	A	246	3	1.2%	2	1	93	93	0.1242454728369122	1	1	97	149	3	0	-G
barcode89_consensus_vsearch	3149	G	*/-A	230	15	5.86%	2	1	93	93	2.4470020356425385E-5	1	1	83	147	15	0	-A
barcode89_consensus_vsearch	3150	A	A	241	0	0%	2	0	93	0	1.0	1	0	92	149	0	0	
barcode89_consensus_vsearch	3151	A	A	256	0	0%	2	0	93	0	1.0	1	0	107	149	0	0	
barcode89_consensus_vsearch	3152	A	A	253	3	1.17%	2	2	93	93	0.124266144814075	1	1	105	148	2	1	G
barcode89_consensus_vsearch	3153	G	G	254	1	0.39%	2	1	93	93	0.4999999999999138	1	1	106	148	1	0	+AA
barcode89_consensus_vsearch	3154	A	A	254	2	0.78%	2	1	93	93	0.2495107632092758	1	1	105	149	2	0	+G
barcode89_consensus_vsearch	3155	G	G	255	2	0.78%	2	1	93	93	0.2495126705651419	1	1	108	147	0	2	+C
barcode89_consensus_vsearch	3156	C	C	253	3	1.16%	2	1	93	93	0.124266144814075	1	1	109	144	0	3	-T
barcode89_consensus_vsearch	3157	T	T	249	6	2.34%	2	2	93	93	0.015167261137354384	1	1	106	143	2	4	+C
barcode89_consensus_vsearch	3158	C	*/-TC	252	7	2.7%	2	1	93	93	0.007498239332403135	1	1	109	143	0	7	-TC
barcode89_consensus_vsearch	3159	T	T	247	3	1.19%	2	1	93	93	0.12424849699405838	1	1	106	141	3	0	+C
barcode89_consensus_vsearch	3160	C	C	246	2	0.8%	2	1	93	93	0.24949494949494755	1	1	109	137	0	2	T
barcode89_consensus_vsearch	3161	A	A	258	1	0.39%	2	1	93	93	0.4999999999999138	1	1	109	149	0	1	G
barcode89_consensus_vsearch	3162	A	A	256	2	0.77%	2	1	93	93	0.24951456310670525	1	1	109	147	0	2	+T
barcode89_consensus_vsearch	3163	T	T	254	4	1.55%	2	2	93	93	0.06177255436325217	1	1	108	146	1	3	C
barcode89_consensus_vsearch	3164	C	C	255	3	1.16%	2	2	93	93	0.1242718446601877	1	1	108	147	1	2	-T
barcode89_consensus_vsearch	3165	T	T	249	3	1.17%	2	2	93	93	0.12425447316115633	1	1	105	144	2	1	C
barcode89_consensus_vsearch	3166	G	G	257	2	0.77%	2	1	93	93	0.24951644100587136	1	1	107	150	2	0	A
barcode89_consensus_vsearch	3167	T	T	257	1	0.39%	2	1	93	93	0.4999999999999138	1	1	107	150	1	0	+C
barcode89_consensus_vsearch	3168	C	C	258	1	0.39%	2	1	93	93	0.4999999999999138	1	1	108	150	1	0	T
barcode89_consensus_vsearch	3169	A	A	257	1	0.39%	2	1	93	93	0.4999999999999138	1	1	109	148	0	1	+GCTTC
barcode89_consensus_vsearch	3170	A	A	252	4	1.54%	2	1	93	93	0.06176686569346045	1	1	109	143	0	4	-TC
barcode89_consensus_vsearch	3171	T	T	247	4	1.57%	2	2	93	93	0.061752247008950906	1	1	105	142	2	2	-C
barcode89_consensus_vsearch	3172	C	C	251	0	0%	2	0	93	0	1.0	1	0	107	144	0	0	
barcode89_consensus_vsearch	3173	C	C	255	2	0.77%	2	2	93	93	0.2495126705651419	1	1	107	148	1	1	-T
barcode89_consensus_vsearch	3174	T	T	255	1	0.39%	2	1	93	93	0.4999999999999138	1	1	107	148	1	0	A
barcode89_consensus_vsearch	3175	T	T	251	2	0.77%	2	1	93	93	0.24950495049494414	1	1	106	145	2	0	-ATT
barcode89_consensus_vsearch	3176	A	A	249	3	1.17%	2	2	93	93	0.12425447316115633	1	1	102	147	2	1	G
barcode89_consensus_vsearch	3177	T	T	252	3	1.17%	2	2	93	93	0.12426326129665838	1	1	105	147	1	2	C
barcode89_consensus_vsearch	3178	T	T	254	1	0.39%	2	1	93	93	0.4999999999999138	1	1	105	149	1	0	+A
barcode89_consensus_vsearch	3179	G	G	255	1	0.39%	2	1	93	93	0.4999999999999138	1	1	107	148	1	0	+C
barcode89_consensus_vsearch	3180	T	T	250	3	1.16%	2	1	93	93	0.12425742574263329	1	1	105	145	3	0	-GT
barcode89_consensus_vsearch	3181	G	G	252	3	1.17%	2	1	93	93	0.12426326129665838	1	1	105	147	0	3	+T
barcode89_consensus_vsearch	3182	T	T	250	3	1.17%	2	1	93	93	0.12425742574263329	1	1	104	146	0	3	C
barcode89_consensus_vsearch	3183	C	C	255	2	0.78%	2	1	93	93	0.2495126705651419	1	1	109	146	0	2	-T
barcode89_consensus_vsearch	3184	T	*/-G	248	7	2.72%	2	1	93	93	0.007493349252391194	1	1	109	139	0	7	-G
barcode89_consensus_vsearch	3185	G	G	248	3	1.19%	2	1	93	93	0.12425149700602607	1	1	109	139	0	3	C
barcode89_consensus_vsearch	3186	G	G	257	2	0.77%	2	2	93	93	0.24951644100587136	1	1	108	149	1	1	A
barcode89_consensus_vsearch	3187	A	A	256	2	0.77%	2	2	93	93	0.24951456310670525	1	1	108	148	1	1	-C
barcode89_consensus_vsearch	3188	C	C	252	3	1.17%	2	1	93	93	0.12426326129665838	1	1	107	145	0	3	+T
barcode89_consensus_vsearch	3189	C	C	254	5	1.93%	2	2	93	93	0.030647311787538743	1	1	108	146	1	4	-T
barcode89_consensus_vsearch	3190	T	*/-G	242	10	3.94%	2	1	93	93	8.916130618494134E-4	1	1	108	134	0	10	-G
barcode89_consensus_vsearch	3191	G	G	242	5	2.01%	2	1	93	93	0.030618062239993613	1	1	104	138	5	0	+A
barcode89_consensus_vsearch	3192	G	G	257	1	0.39%	2	1	93	93	0.4999999999999138	1	1	108	149	0	1	A
barcode89_consensus_vsearch	3193	T	T	250	3	1.16%	2	1	93	93	0.12425742574263329	1	1	105	145	3	0	+A
barcode89_consensus_vsearch	3194	G	G	254	2	0.77%	2	2	93	93	0.2495107632092758	1	1	106	148	1	1	+A
barcode89_consensus_vsearch	3195	A	A	256	1	0.39%	2	1	93	93	0.4999999999999138	1	1	107	149	0	1	G
barcode89_consensus_vsearch	3196	G	G	255	2	0.77%	2	1	93	93	0.2495126705651419	1	1	106	149	2	0	+T
barcode89_consensus_vsearch	3197	T	T	257	1	0.39%	2	1	93	93	0.4999999999999138	1	1	109	148	0	1	C
barcode89_consensus_vsearch	3198	T	T	257	2	0.77%	2	1	93	93	0.24951644100587136	1	1	109	148	0	2	C
barcode89_consensus_vsearch	3199	T	*/-C	190	48	18.53%	2	2	93	93	2.540711996370289E-16	1	1	98	92	9	39	-C
barcode89_consensus_vsearch	3200	C	C	194	1	0.51%	2	1	93	93	0.4999999999999138	1	1	99	95	1	0	T
barcode89_consensus_vsearch	3201	C	C	241	2	0.82%	2	2	93	93	0.2494845360824727	1	1	108	133	1	1	T
barcode89_consensus_vsearch	3202	C	C	253	1	0.39%	2	1	93	93	0.5000000000003686	1	1	109	144	0	1	+G
barcode89_consensus_vsearch	3203	C	C	250	6	2.32%	2	1	93	93	0.015169042029074849	1	1	109	141	0	6	T
barcode89_consensus_vsearch	3204	G	G	257	1	0.39%	2	1	93	93	0.4999999999999138	1	1	109	148	0	1	+T
barcode89_consensus_vsearch	3205	T	T	255	1	0.39%	2	1	93	93	0.4999999999999138	1	1	108	147	0	1	+AA
barcode89_consensus_vsearch	3206	G	G	256	1	0.39%	2	1	93	93	0.4999999999999138	1	1	108	148	1	0	+T
barcode89_consensus_vsearch	3207	T	T	257	1	0.39%	2	1	93	93	0.4999999999999138	1	1	109	148	0	1	C
barcode89_consensus_vsearch	3208	T	*/+G	249	8	3.1%	2	2	93	93	0.0036961603384701837	1	1	103	146	5	3	+G
barcode89_consensus_vsearch	3209	G	G	255	2	0.78%	2	2	93	93	0.2495126705651419	1	1	108	147	1	1	-A
barcode89_consensus_vsearch	3210	A	A	251	5	1.95%	2	2	93	93	0.03064025621010106	1	1	104	147	4	1	G
barcode89_consensus_vsearch	3211	G	G	258	1	0.39%	2	1	93	93	0.4999999999999138	1	1	109	149	0	1	A
barcode89_consensus_vsearch	3212	T	T	254	2	0.77%	2	2	93	93	0.2495107632092758	1	1	108	146	1	1	C
barcode89_consensus_vsearch	3213	C	*/-A	240	10	3.89%	2	2	93	93	8.909515133367017E-4	1	1	107	133	2	8	-A
barcode89_consensus_vsearch	3214	A	A	235	4	1.66%	2	1	93	93	0.06171466401859809	1	1	101	134	4	0	+G
barcode89_consensus_vsearch	3215	A	A	249	2	0.79%	2	1	93	93	0.24950099800389156	1	1	108	141	0	2	C
barcode89_consensus_vsearch	3216	A	A	249	4	1.54%	2	1	93	93	0.06175816388801474	1	1	105	144	0	4	C
barcode89_consensus_vsearch	3217	T	Y	244	8	3.12%	2	1	93	93	0.0036920468013430033	1	1	104	140	0	8	C
barcode89_consensus_vsearch	3218	T	*/-AA	237	16	6.23%	2	1	93	93	1.1946841269724289E-5	1	1	106	131	0	16	-AA
barcode89_consensus_vsearch	3219	A	A	237	5	2.07%	2	2	93	93	0.030605019735419046	1	1	105	132	3	2	C
barcode89_consensus_vsearch	3220	A	A	240	2	0.83%	2	2	93	93	0.24948240165631827	1	1	107	133	1	1	-GC
barcode89_consensus_vsearch	3221	G	G	253	2	0.78%	2	1	93	93	0.24950884086425928	1	1	104	149	2	0	A
barcode89_consensus_vsearch	3222	C	C	254	1	0.39%	2	1	93	93	0.4999999999999138	1	1	106	148	0	1	+TT
barcode89_consensus_vsearch	3223	C	C	250	6	2.32%	2	2	93	93	0.015169042029074849	1	1	106	144	1	5	T
barcode89_consensus_vsearch	3224	G	G	257	2	0.77%	2	1	93	93	0.24951644100587136	1	1	107	150	2	0	C
barcode89_consensus_vsearch	3225	C	C	255	3	1.16%	2	1	93	93	0.1242718446601877	1	1	105	150	3	0	+G
barcode89_consensus_vsearch	3226	A	A	253	3	1.16%	2	2	93	93	0.124266144814075	1	1	106	147	2	1	-G
barcode89_consensus_vsearch	3227	G	G	256	0	0%	2	0	93	0	1.0	1	0	107	149	0	0	
barcode89_consensus_vsearch	3228	G	G	253	2	0.77%	2	1	93	93	0.24950884086425928	1	1	108	145	0	2	+C
barcode89_consensus_vsearch	3229	C	C	254	2	0.77%	2	1	93	93	0.2495107632092758	1	1	109	145	0	2	-T
barcode89_consensus_vsearch	3230	T	T	250	6	2.33%	2	1	93	93	0.015169042029074849	1	1	103	147	6	0	+C
barcode89_consensus_vsearch	3231	C	C	256	2	0.78%	2	1	93	93	0.24951456310670525	1	1	109	147	0	2	T
barcode89_consensus_vsearch	3232	C	C	251	3	1.16%	2	1	93	93	0.12426035502961323	1	1	103	148	3	0	-A
barcode89_consensus_vsearch	3233	A	A	247	2	0.79%	2	1	93	93	0.24949698189118988	1	1	100	147	0	2	-C
barcode89_consensus_vsearch	3234	C	C	241	5	1.97%	2	2	93	93	0.030615496107849846	1	1	102	139	3	2	-T
barcode89_consensus_vsearch	3235	T	*/+C	226	9	3.57%	2	1	93	93	0.0018065516263558758	1	1	86	140	9	0	+C
barcode89_consensus_vsearch	3236	C	Y	235	8	3.28%	2	1	93	93	0.003684221776127662	1	1	101	134	0	8	T
barcode89_consensus_vsearch	3237	C	C	252	2	0.78%	2	1	93	93	0.2495069033532105	1	1	109	143	0	2	-T
barcode89_consensus_vsearch	3238	T	T	245	4	1.57%	2	1	93	93	0.061746234985649476	1	1	105	140	0	4	C
barcode89_consensus_vsearch	3239	G	R	247	7	2.73%	2	1	93	93	0.00749210286352295	1	1	99	148	7	0	A
barcode89_consensus_vsearch	3240	G	G	255	3	1.16%	2	1	93	93	0.1242718446601877	1	1	105	150	3	0	T
barcode89_consensus_vsearch	3241	T	T	246	5	1.94%	2	1	93	93	0.03062812251247695	1	1	105	141	0	5	C
barcode89_consensus_vsearch	3242	G	G	252	1	0.4%	2	1	93	93	0.5000000000003686	1	1	106	146	1	0	A
barcode89_consensus_vsearch	3243	G	G	255	0	0%	2	0	93	0	1.0	1	0	107	148	0	0	
barcode89_consensus_vsearch	3244	T	T	253	1	0.39%	2	1	93	93	0.5000000000003686	1	1	107	146	0	1	-GC
barcode89_consensus_vsearch	3245	G	G	253	3	1.16%	2	1	93	93	0.124266144814075	1	1	107	146	0	3	+C
barcode89_consensus_vsearch	3246	C	C	253	1	0.39%	2	1	93	93	0.5000000000003686	1	1	106	147	0	1	+T
barcode89_consensus_vsearch	3247	C	C	251	3	1.16%	2	1	93	93	0.12426035502961323	1	1	106	145	0	3	+TC
barcode89_consensus_vsearch	3248	C	C	254	2	0.77%	2	1	93	93	0.2495107632092758	1	1	107	147	0	2	+T
barcode89_consensus_vsearch	3249	T	*/+CT	251	7	2.71%	2	1	93	93	0.007497030913500092	1	1	109	142	0	7	+CT
barcode89_consensus_vsearch	3250	T	T	257	1	0.39%	2	1	93	93	0.4999999999999138	1	1	107	150	1	0	+C
barcode89_consensus_vsearch	3251	C	C	256	1	0.39%	2	1	93	93	0.4999999999999138	1	1	108	148	0	1	+T
barcode89_consensus_vsearch	3252	C	C	256	2	0.77%	2	1	93	93	0.24951456310670525	1	1	107	149	2	0	T
barcode89_consensus_vsearch	3253	G	G	257	1	0.39%	2	1	93	93	0.4999999999999138	1	1	109	148	0	1	+C
barcode89_consensus_vsearch	3254	T	T	255	2	0.78%	2	2	93	93	0.2495126705651419	1	1	107	148	1	1	-C
barcode89_consensus_vsearch	3255	C	C	254	1	0.39%	2	1	93	93	0.4999999999999138	1	1	107	147	1	0	+G
barcode89_consensus_vsearch	3256	A	A	255	1	0.39%	2	1	93	93	0.4999999999999138	1	1	108	147	1	0	C
barcode89_consensus_vsearch	3257	A	A	251	3	1.16%	2	1	93	93	0.12426035502961323	1	1	106	145	3	0	-T
barcode89_consensus_vsearch	3258	T	T	253	0	0%	2	0	93	0	1.0	1	0	106	147	0	0	
barcode89_consensus_vsearch	3259	T	T	253	3	1.17%	2	2	93	93	0.124266144814075	1	1	108	145	1	2	C
barcode89_consensus_vsearch	3260	T	T	254	1	0.39%	2	1	93	93	0.4999999999999138	1	1	109	145	0	1	+C
barcode89_consensus_vsearch	3261	C	*/-T	244	8	3.1%	2	1	93	93	0.0036920468013430033	1	1	109	135	0	8	-T
barcode89_consensus_vsearch	3262	T	T	249	0	0%	2	0	93	0	1.0	1	0	109	140	0	0	
barcode89_consensus_vsearch	3263	T	T	256	1	0.39%	2	1	93	93	0.4999999999999138	1	1	109	147	0	1	G
barcode89_consensus_vsearch	3264	T	T	253	3	1.16%	2	1	93	93	0.124266144814075	1	1	108	145	0	3	-AA
barcode89_consensus_vsearch	3265	A	A	255	0	0%	2	0	93	0	1.0	1	0	109	146	0	0	
barcode89_consensus_vsearch	3266	A	A	255	1	0.39%	2	1	93	93	0.4999999999999138	1	1	109	146	0	1	G
barcode89_consensus_vsearch	3267	G	G	256	1	0.39%	2	1	93	93	0.4999999999999138	1	1	108	148	1	0	-T
barcode89_consensus_vsearch	3268	T	T	253	3	1.17%	2	2	93	93	0.124266144814075	1	1	107	146	1	2	C
barcode89_consensus_vsearch	3269	T	T	257	0	0%	2	0	93	0	1.0	1	0	109	148	0	0	
barcode89_consensus_vsearch	3270	T	T	253	4	1.55%	2	2	93	93	0.0617697211064687	1	1	105	148	3	1	+C
barcode89_consensus_vsearch	3271	C	C	256	1	0.39%	2	1	93	93	0.4999999999999138	1	1	108	148	1	0	+A
barcode89_consensus_vsearch	3272	A	A	252	2	0.78%	2	1	93	93	0.2495069033532105	1	1	106	146	0	2	+G
barcode89_consensus_vsearch	3273	G	G	255	3	1.16%	2	2	93	93	0.1242718446601877	1	1	107	148	2	1	A
barcode89_consensus_vsearch	3274	C	C	256	2	0.77%	2	1	93	93	0.24951456310670525	1	1	109	147	0	2	+T
barcode89_consensus_vsearch	3275	C	C	246	6	2.32%	2	1	93	93	0.01516183400716267	1	1	106	140	0	6	+T
barcode89_consensus_vsearch	3276	T	T	252	1	0.39%	2	1	93	93	0.5000000000003686	1	1	105	147	0	1	A
barcode89_consensus_vsearch	3277	T	T	251	3	1.16%	2	1	93	93	0.12426035502961323	1	1	104	147	3	0	C
barcode89_consensus_vsearch	3278	G	G	250	5	1.94%	2	1	93	93	0.030637867497453432	1	1	106	144	0	5	A
barcode89_consensus_vsearch	3279	C	Y	244	9	3.49%	2	1	93	93	0.001816779465609443	1	1	105	139	0	9	T
barcode89_consensus_vsearch	3280	G	G	256	1	0.39%	2	1	93	93	0.4999999999999138	1	1	108	148	1	0	-A
barcode89_consensus_vsearch	3281	A	A	256	1	0.39%	2	1	93	93	0.4999999999999138	1	1	106	150	1	0	+C
barcode89_consensus_vsearch	3282	C	C	259	0	0%	2	0	93	0	1.0	1	0	109	150	0	0	
barcode89_consensus_vsearch	3283	C	C	259	0	0%	2	0	93	0	1.0	1	0	109	150	0	0	
barcode89_consensus_vsearch	3284	A	A	252	4	1.54%	2	1	93	93	0.06176686569346045	1	1	107	145	0	4	-TA
barcode89_consensus_vsearch	3285	T	T	252	1	0.39%	2	1	93	93	0.5000000000003686	1	1	108	144	1	0	+A
barcode89_consensus_vsearch	3286	A	A	251	1	0.39%	2	1	93	93	0.5000000000003686	1	1	107	144	0	1	+C
barcode89_consensus_vsearch	3287	C	C	252	4	1.54%	2	1	93	93	0.06176686569346045	1	1	109	143	0	4	-T
barcode89_consensus_vsearch	3288	T	*/+C	121	88	34.51%	2	2	93	93	2.622435440151574E-32	1	1	44	77	38	50	+C
barcode89_consensus_vsearch	3289	C	C	218	1	0.45%	2	1	93	93	0.5000000000003686	1	1	87	131	0	1	+TC
barcode89_consensus_vsearch	3290	C	C	249	0	0%	2	0	93	0	1.0	1	0	104	145	0	0	
barcode89_consensus_vsearch	3291	C	C	256	1	0.39%	2	1	93	93	0.4999999999999138	1	1	109	147	0	1	+TGA
barcode89_consensus_vsearch	3292	C	C	257	1	0.39%	2	1	93	93	0.4999999999999138	1	1	109	148	0	1	A
barcode89_consensus_vsearch	3293	C	C	257	1	0.39%	2	1	93	93	0.4999999999999138	1	1	109	148	0	1	G
barcode89_consensus_vsearch	3294	A	A	255	2	0.77%	2	1	93	93	0.2495126705651419	1	1	107	148	2	0	-G
barcode89_consensus_vsearch	3295	G	G	252	2	0.78%	2	1	93	93	0.2495069033532105	1	1	105	147	0	2	+A
barcode89_consensus_vsearch	3296	A	A	255	1	0.39%	2	1	93	93	0.4999999999999138	1	1	106	149	1	0	+G
barcode89_consensus_vsearch	3297	A	A	253	2	0.78%	2	1	93	93	0.24950884086425928	1	1	105	148	2	0	-C
barcode89_consensus_vsearch	3298	C	C	254	1	0.39%	2	1	93	93	0.4999999999999138	1	1	104	150	1	0	G
barcode89_consensus_vsearch	3299	C	C	256	1	0.39%	2	1	93	93	0.4999999999999138	1	1	106	150	1	0	G
barcode89_consensus_vsearch	3300	C	C	255	2	0.77%	2	1	93	93	0.2495126705651419	1	1	107	148	0	2	+A
barcode89_consensus_vsearch	3301	A	A	257	2	0.77%	2	1	93	93	0.24951644100587136	1	1	107	150	2	0	G
barcode89_consensus_vsearch	3302	A	A	258	1	0.39%	2	1	93	93	0.4999999999999138	1	1	109	149	0	1	G
barcode89_consensus_vsearch	3303	A	A	258	1	0.39%	2	1	93	93	0.4999999999999138	1	1	109	149	0	1	G
barcode89_consensus_vsearch	3304	G	G	259	0	0%	2	0	93	0	1.0	1	0	109	150	0	0	
barcode89_consensus_vsearch	3305	A	A	258	1	0.39%	2	1	93	93	0.4999999999999138	1	1	108	150	1	0	G
barcode89_consensus_vsearch	3306	C	C	251	6	2.32%	2	2	93	93	0.015170809117680038	1	1	108	143	1	5	-T
barcode89_consensus_vsearch	3307	T	T	248	3	1.19%	2	2	93	93	0.12425149700602607	1	1	107	141	1	2	C
barcode89_consensus_vsearch	3308	T	T	258	1	0.39%	2	1	93	93	0.4999999999999138	1	1	108	150	1	0	A
barcode89_consensus_vsearch	3309	T	T	257	2	0.77%	2	2	93	93	0.24951644100587136	1	1	108	149	1	1	C
barcode89_consensus_vsearch	3310	G	G	258	1	0.39%	2	1	93	93	0.4999999999999138	1	1	108	150	1	0	-A
barcode89_consensus_vsearch	3311	A	A	253	5	1.94%	2	2	93	93	0.030644978141142375	1	1	107	146	1	4	-T
barcode89_consensus_vsearch	3312	T	T	251	2	0.79%	2	1	93	93	0.24950495049494414	1	1	105	146	2	0	C
barcode89_consensus_vsearch	3313	T	T	259	0	0%	2	0	93	0	1.0	1	0	109	150	0	0	
barcode89_consensus_vsearch	3314	T	T	247	4	1.54%	2	1	93	93	0.061752247008950906	1	1	109	138	0	4	+C
barcode89_consensus_vsearch	3315	C	*/-TC	238	9	3.56%	2	1	93	93	0.0018135324927119494	1	1	109	129	0	9	-TC
barcode89_consensus_vsearch	3316	T	T	242	1	0.41%	2	1	93	93	0.4999999999999138	1	1	109	133	0	1	C
barcode89_consensus_vsearch	3317	C	C	240	3	1.23%	2	1	93	93	0.12422680412363393	1	1	109	131	0	3	-G
barcode89_consensus_vsearch	3318	G	G	244	5	1.98%	2	2	93	93	0.030623132735815337	1	1	107	137	2	3	A
barcode89_consensus_vsearch	3319	T	W	231	7	2.78%	2	2	93	93	0.007470748618496003	1	1	100	131	1	6	A
barcode89_consensus_vsearch	3320	A	A	246	2	0.8%	2	1	93	93	0.24949494949494755	1	1	100	146	2	0	+G
barcode89_consensus_vsearch	3321	A	A	249	3	1.17%	2	2	93	93	0.12425447316115633	1	1	104	145	2	1	-G
barcode89_consensus_vsearch	3322	G	G	254	0	0%	2	0	93	0	1.0	1	0	107	147	0	0	
barcode89_consensus_vsearch	3323	G	G	254	2	0.78%	2	1	93	93	0.2495107632092758	1	1	107	147	2	0	T
barcode89_consensus_vsearch	3324	T	T	256	1	0.39%	2	1	93	93	0.4999999999999138	1	1	109	147	0	1	A
barcode89_consensus_vsearch	3325	G	G	257	1	0.39%	2	1	93	93	0.4999999999999138	1	1	108	149	1	0	A
barcode89_consensus_vsearch	3326	C	C	257	1	0.39%	2	1	93	93	0.4999999999999138	1	1	108	149	0	1	+T
barcode89_consensus_vsearch	3327	C	C	253	4	1.54%	2	1	93	93	0.0617697211064687	1	1	108	145	0	4	+GG
barcode89_consensus_vsearch	3328	G	G	256	1	0.39%	2	1	93	93	0.4999999999999138	1	1	108	148	0	1	-AGC
barcode89_consensus_vsearch	3329	A	A	255	3	1.16%	2	1	93	93	0.1242718446601877	1	1	109	146	0	3	-G
barcode89_consensus_vsearch	3330	G	G	251	2	0.78%	2	1	93	93	0.24950495049494414	1	1	105	146	2	0	+AG
barcode89_consensus_vsearch	3331	C	C	245	6	2.34%	2	2	93	93	0.015159996253657923	1	1	102	143	1	5	T
barcode89_consensus_vsearch	3332	G	G	249	6	2.33%	2	1	93	93	0.015167261137354384	1	1	100	149	6	0	-A
barcode89_consensus_vsearch	3333	A	A	243	4	1.59%	2	2	93	93	0.061740125504571274	1	1	97	146	1	3	G
barcode89_consensus_vsearch	3334	G	G	256	1	0.39%	2	1	93	93	0.4999999999999138	1	1	108	148	0	1	-T
barcode89_consensus_vsearch	3335	T	T	251	3	1.17%	2	1	93	93	0.12426035502961323	1	1	106	145	0	3	C
barcode89_consensus_vsearch	3336	C	*/-A	185	37	14.4%	2	2	93	93	1.4162748574902171E-12	1	1	74	111	15	22	-A
barcode89_consensus_vsearch	3337	A	A	190	2	1.04%	2	1	93	93	0.2493472584856949	1	1	75	115	0	2	G
barcode89_consensus_vsearch	3338	A	A	228	2	0.87%	2	2	93	93	0.2494553376906602	1	1	89	139	1	1	C
barcode89_consensus_vsearch	3339	A	A	253	1	0.39%	2	1	93	93	0.5000000000003686	1	1	104	149	0	1	G
barcode89_consensus_vsearch	3340	A	A	257	1	0.39%	2	1	93	93	0.4999999999999138	1	1	107	150	1	0	+G
barcode89_consensus_vsearch	3341	A	A	257	1	0.39%	2	1	93	93	0.4999999999999138	1	1	107	150	1	0	-G
barcode89_consensus_vsearch	3342	G	G	256	1	0.39%	2	1	93	93	0.4999999999999138	1	1	106	150	1	0	+AAG
barcode89_consensus_vsearch	3343	A	A	255	3	1.16%	2	2	93	93	0.1242718446601877	1	1	106	149	2	1	G
barcode89_consensus_vsearch	3344	T	T	256	1	0.39%	2	1	93	93	0.4999999999999138	1	1	107	149	0	1	+A
barcode89_consensus_vsearch	3345	A	A	257	1	0.39%	2	1	93	93	0.4999999999999138	1	1	107	150	1	0	G
barcode89_consensus_vsearch	3346	A	A	255	2	0.78%	2	1	93	93	0.2495126705651419	1	1	106	149	2	0	G
barcode89_consensus_vsearch	3347	C	C	257	1	0.39%	2	1	93	93	0.4999999999999138	1	1	109	148	0	1	A
barcode89_consensus_vsearch	3348	A	A	257	1	0.39%	2	1	93	93	0.4999999999999138	1	1	107	150	1	0	C
barcode89_consensus_vsearch	3349	T	T	258	1	0.39%	2	1	93	93	0.4999999999999138	1	1	109	149	0	1	+AT
barcode89_consensus_vsearch	3350	C	C	257	2	0.77%	2	1	93	93	0.24951644100587136	1	1	109	148	0	2	T
barcode89_consensus_vsearch	3351	G	G	255	2	0.77%	2	1	93	93	0.2495126705651419	1	1	107	148	2	0	+C
barcode89_consensus_vsearch	3352	C	C	257	2	0.77%	2	1	93	93	0.24951644100587136	1	1	107	150	2	0	+GC
barcode89_consensus_vsearch	3353	C	C	256	2	0.77%	2	2	93	93	0.24951456310670525	1	1	108	148	1	1	T
barcode89_consensus_vsearch	3354	C	Y	244	9	3.47%	2	2	93	93	0.001816779465609443	1	1	107	137	2	7	T
barcode89_consensus_vsearch	3355	G	G	258	1	0.39%	2	1	93	93	0.4999999999999138	1	1	108	150	1	0	T
barcode89_consensus_vsearch	3356	A	A	257	1	0.39%	2	1	93	93	0.4999999999999138	1	1	107	150	1	0	+G
barcode89_consensus_vsearch	3357	T	*/-C	226	29	11.24%	2	2	93	93	8.011615104821872E-10	1	1	79	147	27	2	-C
barcode89_consensus_vsearch	3358	C	C	229	0	0%	2	0	93	0	1.0	1	0	81	148	0	0	
barcode89_consensus_vsearch	3359	C	C	254	4	1.55%	2	1	93	93	0.06177255436325217	1	1	108	146	0	4	+T
barcode89_consensus_vsearch	3360	C	C	254	4	1.54%	2	1	93	93	0.06177255436325217	1	1	109	145	0	4	-T
barcode89_consensus_vsearch	3361	T	T	252	1	0.39%	2	1	93	93	0.5000000000003686	1	1	109	143	0	1	+A
barcode89_consensus_vsearch	3362	A	A	257	1	0.39%	2	1	93	93	0.4999999999999138	1	1	109	148	0	1	G
barcode89_consensus_vsearch	3363	G	G	255	1	0.39%	2	1	93	93	0.4999999999999138	1	1	109	146	0	1	+CT
barcode89_consensus_vsearch	3364	T	T	258	1	0.39%	2	1	93	93	0.4999999999999138	1	1	109	149	0	1	-C
barcode89_consensus_vsearch	3365	C	C	255	1	0.39%	2	1	93	93	0.4999999999999138	1	1	108	147	0	1	+G
barcode89_consensus_vsearch	3366	G	G	255	3	1.16%	2	2	93	93	0.1242718446601877	1	1	106	149	2	1	A
barcode89_consensus_vsearch	3367	G	G	258	1	0.39%	2	1	93	93	0.4999999999999138	1	1	108	150	1	0	T
barcode89_consensus_vsearch	3368	C	C	255	3	1.16%	2	2	93	93	0.1242718446601877	1	1	107	148	1	2	T
barcode89_consensus_vsearch	3369	A	A	255	2	0.77%	2	1	93	93	0.2495126705651419	1	1	105	150	2	0	T
barcode89_consensus_vsearch	3370	T	T	257	1	0.39%	2	1	93	93	0.4999999999999138	1	1	107	150	1	0	+G
barcode89_consensus_vsearch	3371	A	A	257	1	0.39%	2	1	93	93	0.4999999999999138	1	1	107	150	1	0	-G
barcode89_consensus_vsearch	3372	G	G	257	1	0.39%	2	1	93	93	0.4999999999999138	1	1	107	150	1	0	A
barcode89_consensus_vsearch	3373	T	T	258	1	0.39%	2	1	93	93	0.4999999999999138	1	1	109	149	0	1	C
barcode89_consensus_vsearch	3374	T	T	258	1	0.39%	2	1	93	93	0.4999999999999138	1	1	108	150	1	0	C
barcode89_consensus_vsearch	3375	T	T	256	1	0.39%	2	1	93	93	0.4999999999999138	1	1	107	149	0	1	+A
barcode89_consensus_vsearch	3376	A	A	257	2	0.77%	2	1	93	93	0.24951644100587136	1	1	109	148	0	2	G
barcode89_consensus_vsearch	3377	T	T	256	1	0.39%	2	1	93	93	0.4999999999999138	1	1	108	148	1	0	-G
barcode89_consensus_vsearch	3378	G	G	253	5	1.94%	2	1	93	93	0.030644978141142375	1	1	103	150	5	0	A
barcode89_consensus_vsearch	3379	G	G	256	1	0.39%	2	1	93	93	0.4999999999999138	1	1	106	150	1	0	+AC
barcode89_consensus_vsearch	3380	T	T	257	1	0.39%	2	1	93	93	0.4999999999999138	1	1	107	150	1	0	C
barcode89_consensus_vsearch	3381	T	T	257	1	0.39%	2	1	93	93	0.4999999999999138	1	1	107	150	1	0	C
barcode89_consensus_vsearch	3382	A	A	256	1	0.39%	2	1	93	93	0.4999999999999138	1	1	107	149	1	0	+G
barcode89_consensus_vsearch	3383	A	A	256	2	0.77%	2	1	93	93	0.24951456310670525	1	1	107	149	2	0	-G
barcode89_consensus_vsearch	3384	G	G	257	0	0%	2	0	93	0	1.0	1	0	107	150	0	0	
barcode89_consensus_vsearch	3385	A	A	258	1	0.39%	2	1	93	93	0.4999999999999138	1	1	108	150	1	0	G
barcode89_consensus_vsearch	3386	C	C	257	1	0.39%	2	1	93	93	0.4999999999999138	1	1	108	149	0	1	+G
barcode89_consensus_vsearch	3387	T	T	251	6	2.32%	2	2	93	93	0.015170809117680038	1	1	106	145	2	4	C
barcode89_consensus_vsearch	3388	A	A	255	1	0.39%	2	1	93	93	0.4999999999999138	1	1	107	148	0	1	+T
barcode89_consensus_vsearch	3389	C	C	252	3	1.16%	2	1	93	93	0.12426326129665838	1	1	108	144	0	3	T
barcode89_consensus_vsearch	3390	G	G	254	2	0.78%	2	1	93	93	0.2495107632092758	1	1	107	147	0	2	T
barcode89_consensus_vsearch	3391	A	A	254	2	0.78%	2	1	93	93	0.2495107632092758	1	1	107	147	0	2	G
barcode89_consensus_vsearch	3392	C	C	256	2	0.78%	2	2	93	93	0.24951456310670525	1	1	107	149	1	1	T
barcode89_consensus_vsearch	3393	G	G	252	4	1.55%	2	1	93	93	0.06176686569346045	1	1	104	148	4	0	A
barcode89_consensus_vsearch	3394	G	G	257	1	0.39%	2	1	93	93	0.4999999999999138	1	1	109	148	0	1	+T
barcode89_consensus_vsearch	3395	T	T	255	3	1.16%	2	1	93	93	0.1242718446601877	1	1	109	146	0	3	C
barcode89_consensus_vsearch	3396	A	A	255	3	1.16%	2	1	93	93	0.1242718446601877	1	1	109	146	0	3	+T
barcode89_consensus_vsearch	3397	T	T	259	0	0%	2	0	93	0	1.0	1	0	109	150	0	0	
barcode89_consensus_vsearch	3398	C	C	253	4	1.54%	2	2	93	93	0.0617697211064687	1	1	107	146	1	3	-T
barcode89_consensus_vsearch	3399	T	T	247	3	1.18%	2	1	93	93	0.12424849699405838	1	1	106	141	0	3	+G
barcode89_consensus_vsearch	3400	G	G	257	1	0.39%	2	1	93	93	0.4999999999999138	1	1	108	149	0	1	+A
barcode89_consensus_vsearch	3401	A	A	256	1	0.39%	2	1	93	93	0.4999999999999138	1	1	106	150	1	0	+G
barcode89_consensus_vsearch	3402	T	T	255	2	0.78%	2	2	93	93	0.2495126705651419	1	1	107	148	1	1	-C
barcode89_consensus_vsearch	3403	C	C	253	1	0.39%	2	1	93	93	0.5000000000003686	1	1	105	148	1	0	+TC
barcode89_consensus_vsearch	3404	G	G	256	1	0.39%	2	1	93	93	0.4999999999999138	1	1	107	149	1	0	A
barcode89_consensus_vsearch	3405	T	T	255	1	0.39%	2	1	93	93	0.4999999999999138	1	1	107	148	1	0	-C
barcode89_consensus_vsearch	3406	C	C	254	2	0.78%	2	1	93	93	0.2495107632092758	1	1	108	146	0	2	-T
barcode89_consensus_vsearch	3407	T	T	256	0	0%	2	0	93	0	1.0	1	0	109	147	0	0	
barcode89_consensus_vsearch	3408	T	T	250	5	1.93%	2	1	93	93	0.030637867497453432	1	1	102	148	5	0	+C
barcode89_consensus_vsearch	3409	C	C	248	4	1.56%	2	1	93	93	0.061755217199896344	1	1	107	141	0	4	+G
barcode89_consensus_vsearch	3410	G	G	256	1	0.39%	2	1	93	93	0.4999999999999138	1	1	107	149	1	0	-A
barcode89_consensus_vsearch	3411	A	A	255	2	0.78%	2	2	93	93	0.2495126705651419	1	1	107	148	1	1	G
barcode89_consensus_vsearch	3412	T	*/-C	191	49	18.99%	2	2	93	93	1.1572074077417527E-16	1	1	55	136	39	10	-C
barcode89_consensus_vsearch	3413	C	C	200	0	0%	2	0	93	0	1.0	1	0	64	136	0	0	
barcode89_consensus_vsearch	3414	C	C	250	0	0%	2	0	93	0	1.0	1	0	103	147	0	0	
barcode89_consensus_vsearch	3415	C	C	254	2	0.78%	2	1	93	93	0.2495107632092758	1	1	108	146	0	2	+T
barcode89_consensus_vsearch	3416	C	C	247	5	1.93%	2	2	93	93	0.030630587731099716	1	1	107	140	1	4	-T
barcode89_consensus_vsearch	3417	T	T	250	3	1.18%	2	2	93	93	0.12425742574263329	1	1	106	144	1	2	-A
barcode89_consensus_vsearch	3418	A	A	255	0	0%	2	0	93	0	1.0	1	0	107	148	0	0	
barcode89_consensus_vsearch	3419	A	A	246	4	1.55%	2	1	93	93	0.061749253033287245	1	1	106	140	0	4	-C
barcode89_consensus_vsearch	3420	C	C	238	6	2.38%	2	1	93	93	0.015146711995383567	1	1	103	135	0	6	-T
barcode89_consensus_vsearch	3421	T	T	244	2	0.81%	2	2	93	93	0.24949083503056865	1	1	104	140	1	1	C
barcode89_consensus_vsearch	3422	T	T	248	6	2.35%	2	1	93	93	0.015165466280175907	1	1	106	142	0	6	C
barcode89_consensus_vsearch	3423	T	T	256	1	0.39%	2	1	93	93	0.4999999999999138	1	1	109	147	0	1	-C
barcode89_consensus_vsearch	3424	C	C	257	1	0.39%	2	1	93	93	0.4999999999999138	1	1	109	148	0	1	+TC
barcode89_consensus_vsearch	3425	G	G	259	0	0%	2	0	93	0	1.0	1	0	109	150	0	0	
barcode89_consensus_vsearch	3426	T	T	257	1	0.39%	2	1	93	93	0.4999999999999138	1	1	108	149	0	1	+C
barcode89_consensus_vsearch	3427	T	T	256	1	0.39%	2	1	93	93	0.4999999999999138	1	1	109	147	0	1	-C
barcode89_consensus_vsearch	3428	C	C	257	1	0.39%	2	1	93	93	0.4999999999999138	1	1	109	148	0	1	+T
barcode89_consensus_vsearch	3429	A	A	257	1	0.39%	2	1	93	93	0.4999999999999138	1	1	107	150	1	0	-C
barcode89_consensus_vsearch	3430	C	C	257	1	0.39%	2	1	93	93	0.4999999999999138	1	1	108	149	0	1	+AC
barcode89_consensus_vsearch	3431	T	T	253	4	1.54%	2	1	93	93	0.0617697211064687	1	1	109	144	0	4	C
barcode89_consensus_vsearch	3432	G	G	259	0	0%	2	0	93	0	1.0	1	0	109	150	0	0	
barcode89_consensus_vsearch	3433	A	A	257	2	0.77%	2	2	93	93	0.24951644100587136	1	1	108	149	1	1	G
barcode89_consensus_vsearch	3434	T	T	257	2	0.77%	2	2	93	93	0.24951644100587136	1	1	108	149	1	1	C
barcode89_consensus_vsearch	3435	T	T	257	1	0.39%	2	1	93	93	0.4999999999999138	1	1	108	149	0	1	+A
barcode89_consensus_vsearch	3436	A	A	257	1	0.39%	2	1	93	93	0.4999999999999138	1	1	107	150	1	0	G
barcode89_consensus_vsearch	3437	A	A	258	1	0.39%	2	1	93	93	0.4999999999999138	1	1	108	150	1	0	G
barcode89_consensus_vsearch	3438	T	T	254	2	0.77%	2	1	93	93	0.2495107632092758	1	1	105	149	2	0	-G
barcode89_consensus_vsearch	3439	G	*/+A	240	7	2.73%	2	1	93	93	0.007483097933064014	1	1	104	136	0	7	+A
barcode89_consensus_vsearch	3440	A	A	249	1	0.4%	2	1	93	93	0.5000000000003686	1	1	104	145	1	0	+G
barcode89_consensus_vsearch	3441	A	A	252	3	1.17%	2	2	93	93	0.12426326129665838	1	1	103	149	2	1	G
barcode89_consensus_vsearch	3442	A	A	254	3	1.17%	2	1	93	93	0.12426900584791233	1	1	104	150	3	0	G
barcode89_consensus_vsearch	3443	A	A	253	3	1.16%	2	1	93	93	0.124266144814075	1	1	106	147	3	0	G
barcode89_consensus_vsearch	3444	C	C	256	1	0.39%	2	1	93	93	0.4999999999999138	1	1	108	148	1	0	+TT
barcode89_consensus_vsearch	3445	A	A	257	1	0.39%	2	1	93	93	0.4999999999999138	1	1	108	149	1	0	G
barcode89_consensus_vsearch	3446	T	T	256	2	0.77%	2	2	93	93	0.24951456310670525	1	1	108	148	1	1	-C
barcode89_consensus_vsearch	3447	C	C	255	2	0.78%	2	1	93	93	0.2495126705651419	1	1	108	147	0	2	+T
barcode89_consensus_vsearch	3448	C	*/-T	244	11	4.25%	2	1	93	93	4.373673587096424E-4	1	1	108	136	0	11	-T
barcode89_consensus_vsearch	3449	T	T	245	2	0.81%	2	1	93	93	0.24949290060873971	1	1	108	137	0	2	C
barcode89_consensus_vsearch	3450	T	T	254	2	0.78%	2	2	93	93	0.2495107632092758	1	1	107	147	1	1	C
barcode89_consensus_vsearch	3451	G	G	257	1	0.39%	2	1	93	93	0.4999999999999138	1	1	108	149	1	0	A
barcode89_consensus_vsearch	3452	A	A	257	1	0.39%	2	1	93	93	0.4999999999999138	1	1	108	149	1	0	+C
barcode89_consensus_vsearch	3453	T	T	249	3	1.16%	2	1	93	93	0.12425447316115633	1	1	106	143	0	3	-A
barcode89_consensus_vsearch	3454	A	A	252	1	0.39%	2	1	93	93	0.5000000000003686	1	1	106	146	1	0	+GA
barcode89_consensus_vsearch	3455	A	A	257	0	0%	2	0	93	0	1.0	1	0	108	149	0	0	
barcode89_consensus_vsearch	3456	A	A	255	2	0.78%	2	1	93	93	0.2495126705651419	1	1	108	147	0	2	-T
barcode89_consensus_vsearch	3457	T	T	255	1	0.39%	2	1	93	93	0.4999999999999138	1	1	108	147	0	1	C
barcode89_consensus_vsearch	3458	G	G	253	5	1.93%	2	1	93	93	0.030644978141142375	1	1	108	145	0	5	-CT
barcode89_consensus_vsearch	3459	C	C	241	5	1.97%	2	1	93	93	0.030615496107849846	1	1	107	134	0	5	-TT
barcode89_consensus_vsearch	3460	T	T	241	4	1.63%	2	1	93	93	0.06173391617646867	1	1	108	133	0	4	C
barcode89_consensus_vsearch	3461	T	T	250	2	0.79%	2	2	93	93	0.2495029821073759	1	1	108	142	1	1	C
barcode89_consensus_vsearch	3462	T	*/-C	245	11	4.28%	2	1	93	93	4.375595006058856E-4	1	1	109	136	0	11	-C
barcode89_consensus_vsearch	3463	C	C	241	2	0.81%	2	1	93	93	0.2494845360824727	1	1	108	133	0	2	+T
barcode89_consensus_vsearch	3464	G	G	252	2	0.78%	2	2	93	93	0.2495069033532105	1	1	107	145	1	1	-C
barcode89_consensus_vsearch	3465	C	C	252	3	1.17%	2	1	93	93	0.12426326129665838	1	1	105	147	3	0	+G
barcode89_consensus_vsearch	3466	A	A	251	5	1.94%	2	2	93	93	0.03064025621010106	1	1	104	147	4	1	-G
barcode89_consensus_vsearch	3467	G	G	252	2	0.79%	2	1	93	93	0.2495069033532105	1	1	103	149	2	0	A
barcode89_consensus_vsearch	3468	T	T	255	1	0.39%	2	1	93	93	0.4999999999999138	1	1	107	148	1	0	+A
barcode89_consensus_vsearch	3469	A	R	237	20	7.72%	2	2	93	93	6.493660318237696E-7	1	1	89	148	19	1	G
barcode89_consensus_vsearch	3470	G	*/+T	235	20	7.75%	2	1	93	93	6.473329437938356E-7	1	1	86	149	20	0	+T
barcode89_consensus_vsearch	3471	T	T	258	0	0%	2	0	93	0	1.0	1	0	109	149	0	0	
barcode89_consensus_vsearch	3472	T	*/+G	249	7	2.7%	2	1	93	93	0.007494585982750822	1	1	102	147	7	0	+G
barcode89_consensus_vsearch	3473	A	A	248	5	1.94%	2	1	93	93	0.030633033482245435	1	1	103	145	5	0	G
barcode89_consensus_vsearch	3474	G	G	251	3	1.17%	2	2	93	93	0.12426035502961323	1	1	106	145	2	1	A
barcode89_consensus_vsearch	3475	T	T	255	1	0.39%	2	1	93	93	0.4999999999999138	1	1	108	147	1	0	-C
barcode89_consensus_vsearch	3476	C	C	253	2	0.78%	2	1	93	93	0.24950884086425928	1	1	106	147	0	2	-T
barcode89_consensus_vsearch	3477	T	T	251	2	0.79%	2	1	93	93	0.24950495049494414	1	1	106	145	0	2	+C
barcode89_consensus_vsearch	3478	T	T	253	3	1.17%	2	2	93	93	0.124266144814075	1	1	105	148	2	1	C
barcode89_consensus_vsearch	3479	C	C	253	2	0.78%	2	1	93	93	0.24950884086425928	1	1	107	146	0	2	-A
barcode89_consensus_vsearch	3480	A	A	255	1	0.39%	2	1	93	93	0.4999999999999138	1	1	109	146	0	1	+CA
barcode89_consensus_vsearch	3481	A	A	256	1	0.39%	2	1	93	93	0.4999999999999138	1	1	108	148	1	0	+GC
barcode89_consensus_vsearch	3482	T	*/+A	243	7	2.71%	2	2	93	93	0.007487018424394727	1	1	105	138	3	4	+A
barcode89_consensus_vsearch	3483	A	A	252	1	0.4%	2	1	93	93	0.5000000000003686	1	1	108	144	1	0	+G
barcode89_consensus_vsearch	3484	A	A	257	1	0.39%	2	1	93	93	0.4999999999999138	1	1	108	149	1	0	+CG
barcode89_consensus_vsearch	3485	A	A	251	4	1.54%	2	1	93	93	0.06176398786346276	1	1	108	143	0	4	-T
barcode89_consensus_vsearch	3486	T	T	249	4	1.57%	2	2	93	93	0.06175816388801474	1	1	106	143	3	1	-C
barcode89_consensus_vsearch	3487	C	C	254	1	0.39%	2	1	93	93	0.4999999999999138	1	1	105	149	1	0	T
barcode89_consensus_vsearch	3488	C	*/-A	239	14	5.41%	2	1	93	93	5.073700536561113E-5	1	1	90	149	14	0	-A
barcode89_consensus_vsearch	3489	A	A	243	1	0.41%	2	1	93	93	0.4999999999999138	1	1	94	149	1	0	+G
barcode89_consensus_vsearch	3490	A	A	254	4	1.54%	2	1	93	93	0.06177255436325217	1	1	105	149	4	0	-G
barcode89_consensus_vsearch	3491	G	G	254	1	0.39%	2	1	93	93	0.4999999999999138	1	1	105	149	0	1	-A
barcode89_consensus_vsearch	3492	A	A	253	3	1.16%	2	1	93	93	0.124266144814075	1	1	108	145	0	3	C
barcode89_consensus_vsearch	3493	A	A	253	2	0.77%	2	1	93	93	0.24950884086425928	1	1	108	145	0	2	-T
barcode89_consensus_vsearch	3494	T	T	253	2	0.78%	2	1	93	93	0.24950884086425928	1	1	109	144	0	2	C
barcode89_consensus_vsearch	3495	T	T	256	1	0.39%	2	1	93	93	0.4999999999999138	1	1	108	148	0	1	+C
barcode89_consensus_vsearch	3496	T	T	252	3	1.16%	2	1	93	93	0.12426326129665838	1	1	108	144	0	3	C
barcode89_consensus_vsearch	3497	C	C	251	2	0.78%	2	1	93	93	0.24950495049494414	1	1	107	144	0	2	+TC
barcode89_consensus_vsearch	3498	A	A	254	1	0.39%	2	1	93	93	0.4999999999999138	1	1	107	147	0	1	+C
barcode89_consensus_vsearch	3499	C	C	255	1	0.39%	2	1	93	93	0.4999999999999138	1	1	108	147	0	1	+T
barcode89_consensus_vsearch	3500	C	C	251	4	1.54%	2	1	93	93	0.06176398786346276	1	1	108	143	0	4	-T
barcode89_consensus_vsearch	3501	T	T	249	4	1.57%	2	2	93	93	0.06175816388801474	1	1	107	142	2	2	+C
barcode89_consensus_vsearch	3502	C	C	255	3	1.16%	2	2	93	93	0.1242718446601877	1	1	107	148	2	1	-T
barcode89_consensus_vsearch	3503	T	T	249	3	1.18%	2	1	93	93	0.12425447316115633	1	1	107	142	0	3	+G
barcode89_consensus_vsearch	3504	G	G	259	0	0%	2	0	93	0	1.0	1	0	109	150	0	0	
barcode89_consensus_vsearch	3505	A	A	256	1	0.39%	2	1	93	93	0.4999999999999138	1	1	108	148	0	1	C
barcode89_consensus_vsearch	3506	C	C	256	2	0.77%	2	1	93	93	0.24951456310670525	1	1	108	148	0	2	+A
barcode89_consensus_vsearch	3507	A	A	258	1	0.39%	2	1	93	93	0.4999999999999138	1	1	109	149	0	1	G
barcode89_consensus_vsearch	3508	A	A	257	1	0.39%	2	1	93	93	0.4999999999999138	1	1	107	150	1	0	+T
barcode89_consensus_vsearch	3509	T	T	257	1	0.39%	2	1	93	93	0.4999999999999138	1	1	107	150	1	0	C
barcode89_consensus_vsearch	3510	T	T	257	1	0.39%	2	1	93	93	0.4999999999999138	1	1	109	148	0	1	+C
barcode89_consensus_vsearch	3511	G	G	258	1	0.39%	2	1	93	93	0.4999999999999138	1	1	108	150	1	0	+TG
barcode89_consensus_vsearch	3512	A	A	257	1	0.39%	2	1	93	93	0.4999999999999138	1	1	108	149	0	1	G
barcode89_consensus_vsearch	3513	A	A	259	0	0%	2	0	93	0	1.0	1	0	109	150	0	0	
barcode89_consensus_vsearch	3514	T	T	258	1	0.39%	2	1	93	93	0.4999999999999138	1	1	109	149	0	1	C
barcode89_consensus_vsearch	3515	A	A	258	1	0.39%	2	1	93	93	0.4999999999999138	1	1	109	149	0	1	G
barcode89_consensus_vsearch	3516	C	C	256	2	0.77%	2	1	93	93	0.24951456310670525	1	1	109	147	0	2	T
barcode89_consensus_vsearch	3517	T	T	255	2	0.78%	2	1	93	93	0.2495126705651419	1	1	109	146	0	2	+G
barcode89_consensus_vsearch	3518	G	G	257	1	0.39%	2	1	93	93	0.4999999999999138	1	1	109	148	0	1	C
barcode89_consensus_vsearch	3519	A	A	257	2	0.77%	2	2	93	93	0.24951644100587136	1	1	108	149	1	1	G
barcode89_consensus_vsearch	3520	T	T	256	2	0.77%	2	2	93	93	0.24951456310670525	1	1	108	148	1	1	C
barcode89_consensus_vsearch	3521	A	A	258	1	0.39%	2	1	93	93	0.4999999999999138	1	1	109	149	0	1	G
barcode89_consensus_vsearch	3522	T	*/-C	247	10	3.86%	2	1	93	93	8.932230783903669E-4	1	1	107	140	0	10	-C
barcode89_consensus_vsearch	3523	C	C	247	1	0.4%	2	1	93	93	0.4999999999999138	1	1	108	139	0	1	T
barcode89_consensus_vsearch	3524	C	C	257	1	0.39%	2	1	93	93	0.4999999999999138	1	1	107	150	1	0	T
barcode89_consensus_vsearch	3525	C	C	256	3	1.16%	2	2	93	93	0.12427466150865948	1	1	108	148	1	2	T
barcode89_consensus_vsearch	3526	C	Y	234	22	8.49%	2	2	93	93	1.4884857318176255E-7	1	1	107	127	1	21	T
barcode89_consensus_vsearch	3527	G	G	258	0	0%	2	0	93	0	1.0	1	0	108	150	0	0	
barcode89_consensus_vsearch	3528	A	A	257	1	0.39%	2	1	93	93	0.4999999999999138	1	1	109	148	0	1	+T
barcode89_consensus_vsearch	3529	C	C	256	1	0.39%	2	1	93	93	0.4999999999999138	1	1	106	150	1	0	+GC
barcode89_consensus_vsearch	3530	T	T	254	4	1.54%	2	1	93	93	0.06177255436325217	1	1	109	145	0	4	C
barcode89_consensus_vsearch	3531	G	G	258	1	0.39%	2	1	93	93	0.4999999999999138	1	1	109	149	0	1	+C
barcode89_consensus_vsearch	3532	T	*/-C	235	18	6.95%	2	2	93	93	2.788743065390371E-6	1	1	89	146	16	2	-C
barcode89_consensus_vsearch	3533	C	C	237	1	0.42%	2	1	93	93	0.5000000000003686	1	1	89	148	1	0	+T
barcode89_consensus_vsearch	3534	C	C	253	2	0.78%	2	1	93	93	0.24950884086425928	1	1	106	147	0	2	+T
barcode89_consensus_vsearch	3535	C	C	253	4	1.54%	2	1	93	93	0.0617697211064687	1	1	109	144	0	4	-T
barcode89_consensus_vsearch	3536	T	T	251	3	1.18%	2	1	93	93	0.12426035502961323	1	1	108	143	0	3	C
barcode89_consensus_vsearch	3537	A	A	249	6	2.32%	2	1	93	93	0.015167261137354384	1	1	102	147	6	0	-TTA
barcode89_consensus_vsearch	3538	T	T	247	2	0.79%	2	1	93	93	0.24949698189118988	1	1	101	146	0	2	C
barcode89_consensus_vsearch	3539	T	T	248	3	1.19%	2	1	93	93	0.12425149700602607	1	1	99	149	3	0	-A
barcode89_consensus_vsearch	3540	A	A	250	0	0%	2	0	93	0	1.0	1	0	100	150	0	0	
barcode89_consensus_vsearch	3541	A	A	259	0	0%	2	0	93	0	1.0	1	0	109	150	0	0	
barcode89_consensus_vsearch	3542	T	T	258	1	0.39%	2	1	93	93	0.4999999999999138	1	1	109	149	0	1	+C
barcode89_consensus_vsearch	3543	C	C	257	1	0.39%	2	1	93	93	0.4999999999999138	1	1	107	150	1	0	+G
barcode89_consensus_vsearch	3544	A	A	254	1	0.39%	2	1	93	93	0.4999999999999138	1	1	105	149	1	0	+CA
barcode89_consensus_vsearch	3545	T	T	257	0	0%	2	0	93	0	1.0	1	0	108	149	0	0	
barcode89_consensus_vsearch	3546	T	T	256	1	0.39%	2	1	93	93	0.4999999999999138	1	1	107	149	1	0	-AC
barcode89_consensus_vsearch	3547	A	A	256	1	0.39%	2	1	93	93	0.4999999999999138	1	1	107	149	1	0	G
barcode89_consensus_vsearch	3548	C	C	255	2	0.78%	2	1	93	93	0.2495126705651419	1	1	107	148	0	2	-G
barcode89_consensus_vsearch	3549	G	G	254	3	1.17%	2	1	93	93	0.12426900584791233	1	1	106	148	3	0	A
barcode89_consensus_vsearch	3550	G	G	257	1	0.39%	2	1	93	93	0.4999999999999138	1	1	107	150	1	0	-CGG
barcode89_consensus_vsearch	3551	C	C	256	1	0.39%	2	1	93	93	0.4999999999999138	1	1	108	148	0	1	-G
barcode89_consensus_vsearch	3552	G	G	255	2	0.78%	2	1	93	93	0.2495126705651419	1	1	106	149	2	0	A
barcode89_consensus_vsearch	3553	G	G	258	0	0%	2	0	93	0	1.0	1	0	108	150	0	0	
barcode89_consensus_vsearch	3554	T	*/-C	237	19	7.34%	2	2	93	93	1.3486832968659411E-6	1	1	90	147	18	1	-C
barcode89_consensus_vsearch	3555	C	C	239	1	0.42%	2	1	93	93	0.4999999999999138	1	1	90	149	1	0	+A
barcode89_consensus_vsearch	3556	C	C	250	4	1.54%	2	1	93	93	0.061761087351402955	1	1	102	148	4	0	-T
barcode89_consensus_vsearch	3557	T	T	241	5	1.98%	2	2	93	93	0.030615496107849846	1	1	94	147	4	1	-A
barcode89_consensus_vsearch	3558	A	A	246	2	0.79%	2	1	93	93	0.24949494949494755	1	1	101	145	2	0	+C
barcode89_consensus_vsearch	3559	G	G	243	6	2.33%	2	2	93	93	0.015156276648152922	1	1	105	138	1	5	-A
barcode89_consensus_vsearch	3560	A	A	252	1	0.4%	2	1	93	93	0.5000000000003686	1	1	107	145	1	0	+T
barcode89_consensus_vsearch	3561	A	A	257	2	0.77%	2	1	93	93	0.24951644100587136	1	1	107	150	2	0	G
barcode89_consensus_vsearch	3562	A	A	256	1	0.39%	2	1	93	93	0.4999999999999138	1	1	107	149	1	0	+TG
barcode89_consensus_vsearch	3563	C	C	257	1	0.39%	2	1	93	93	0.4999999999999138	1	1	107	150	1	0	+T
barcode89_consensus_vsearch	3564	C	C	256	2	0.77%	2	1	93	93	0.24951456310670525	1	1	109	147	0	2	+A
barcode89_consensus_vsearch	3565	A	A	257	1	0.39%	2	1	93	93	0.4999999999999138	1	1	108	149	0	1	+GTA
barcode89_consensus_vsearch	3566	A	A	253	3	1.16%	2	2	93	93	0.124266144814075	1	1	107	146	2	1	G
barcode89_consensus_vsearch	3567	C	*/-A	232	13	5.04%	2	2	93	93	1.0367157527188826E-4	1	1	96	136	6	7	-A
barcode89_consensus_vsearch	3568	A	A	244	0	0%	2	0	93	0	1.0	1	0	102	142	0	0	
barcode89_consensus_vsearch	3569	A	A	255	1	0.39%	2	1	93	93	0.4999999999999138	1	1	107	148	1	0	+GGA
barcode89_consensus_vsearch	3570	A	A	257	1	0.39%	2	1	93	93	0.4999999999999138	1	1	108	149	1	0	+T
barcode89_consensus_vsearch	3571	A	A	258	1	0.39%	2	1	93	93	0.4999999999999138	1	1	108	150	1	0	-T
barcode89_consensus_vsearch	3572	T	T	253	2	0.78%	2	2	93	93	0.24950884086425928	1	1	104	149	1	1	C
barcode89_consensus_vsearch	3573	A	A	253	2	0.78%	2	2	93	93	0.24950884086425928	1	1	105	148	1	1	G
barcode89_consensus_vsearch	3574	G	G	255	2	0.78%	2	1	93	93	0.2495126705651419	1	1	107	148	0	2	+A
barcode89_consensus_vsearch	3575	A	A	256	2	0.77%	2	1	93	93	0.24951456310670525	1	1	107	149	2	0	+G
barcode89_consensus_vsearch	3576	A	A	254	2	0.77%	2	2	93	93	0.2495107632092758	1	1	106	148	1	1	G
barcode89_consensus_vsearch	3577	C	C	255	1	0.39%	2	1	93	93	0.4999999999999138	1	1	106	149	1	0	G
barcode89_consensus_vsearch	3578	C	C	252	2	0.78%	2	1	93	93	0.2495069033532105	1	1	104	148	2	0	-A
barcode89_consensus_vsearch	3579	A	A	249	3	1.17%	2	1	93	93	0.12425447316115633	1	1	104	145	0	3	G
barcode89_consensus_vsearch	3580	C	*/-AC	241	14	5.45%	2	2	93	93	5.081261627675223E-5	1	1	94	147	13	1	-AC
barcode89_consensus_vsearch	3581	A	A	241	1	0.41%	2	1	93	93	0.4999999999999138	1	1	94	147	0	1	+G
barcode89_consensus_vsearch	3582	C	C	242	2	0.82%	2	2	93	93	0.24948665297746256	1	1	94	148	1	1	T
barcode89_consensus_vsearch	3583	G	G	257	1	0.39%	2	1	93	93	0.4999999999999138	1	1	109	148	0	1	+C
barcode89_consensus_vsearch	3584	T	*/-C	246	10	3.86%	2	2	93	93	8.92905972782949E-4	1	1	97	149	9	1	-C
barcode89_consensus_vsearch	3585	C	C	248	1	0.4%	2	1	93	93	0.4999999999999138	1	1	99	149	1	0	+T
barcode89_consensus_vsearch	3586	C	C	259	0	0%	2	0	93	0	1.0	1	0	109	150	0	0	
barcode89_consensus_vsearch	3587	T	T	258	1	0.39%	2	1	93	93	0.4999999999999138	1	1	109	149	0	1	C
barcode89_consensus_vsearch	3588	A	A	256	1	0.39%	2	1	93	93	0.4999999999999138	1	1	109	147	0	1	+T
barcode89_consensus_vsearch	3589	T	T	258	0	0%	2	0	93	0	1.0	1	0	109	149	0	0	
barcode89_consensus_vsearch	3590	T	T	254	4	1.54%	2	1	93	93	0.06177255436325217	1	1	108	146	0	4	+C
barcode89_consensus_vsearch	3591	C	C	252	2	0.78%	2	1	93	93	0.2495069033532105	1	1	105	147	0	2	-T
barcode89_consensus_vsearch	3592	T	T	251	1	0.39%	2	1	93	93	0.5000000000003686	1	1	104	147	0	1	+CT
barcode89_consensus_vsearch	3593	A	A	255	1	0.39%	2	1	93	93	0.4999999999999138	1	1	105	150	1	0	G
barcode89_consensus_vsearch	3594	T	T	255	4	1.54%	2	1	93	93	0.06177536572082746	1	1	105	150	4	0	G
barcode89_consensus_vsearch	3595	T	T	255	3	1.16%	2	2	93	93	0.1242718446601877	1	1	107	148	2	1	-ATT
barcode89_consensus_vsearch	3596	A	A	255	1	0.39%	2	1	93	93	0.4999999999999138	1	1	107	148	0	1	+G
barcode89_consensus_vsearch	3597	T	T	253	1	0.39%	2	1	93	93	0.5000000000003686	1	1	106	147	0	1	+C
barcode89_consensus_vsearch	3598	T	T	253	1	0.39%	2	1	93	93	0.5000000000003686	1	1	106	147	0	1	+C
barcode89_consensus_vsearch	3599	C	C	256	1	0.39%	2	1	93	93	0.4999999999999138	1	1	107	149	1	0	T
barcode89_consensus_vsearch	3600	C	C	258	0	0%	2	0	93	0	1.0	1	0	109	149	0	0	
barcode89_consensus_vsearch	3601	A	A	256	1	0.39%	2	1	93	93	0.4999999999999138	1	1	108	148	0	1	G
barcode89_consensus_vsearch	3602	T	T	256	1	0.39%	2	1	93	93	0.4999999999999138	1	1	109	147	0	1	-GCT
barcode89_consensus_vsearch	3603	G	G	257	0	0%	2	0	93	0	1.0	1	0	109	148	0	0	
barcode89_consensus_vsearch	3604	C	C	258	0	0%	2	0	93	0	1.0	1	0	109	149	0	0	
barcode89_consensus_vsearch	3605	T	T	255	3	1.16%	2	2	93	93	0.1242718446601877	1	1	108	147	1	2	C
barcode89_consensus_vsearch	3606	A	A	255	3	1.16%	2	1	93	93	0.1242718446601877	1	1	109	146	0	3	G
barcode89_consensus_vsearch	3607	A	A	254	4	1.54%	2	2	93	93	0.06177255436325217	1	1	107	147	1	3	G
barcode89_consensus_vsearch	3608	T	T	257	1	0.39%	2	1	93	93	0.4999999999999138	1	1	107	150	1	0	-GTATTCG
barcode89_consensus_vsearch	3609	G	G	257	1	0.39%	2	1	93	93	0.4999999999999138	1	1	108	149	0	1	T
barcode89_consensus_vsearch	3610	T	T	254	1	0.39%	2	1	93	93	0.4999999999999138	1	1	107	147	0	1	+G
barcode89_consensus_vsearch	3611	A	A	251	2	0.78%	2	1	93	93	0.24950495049494414	1	1	107	144	0	2	-T
barcode89_consensus_vsearch	3612	T	T	248	5	1.95%	2	1	93	93	0.030633033482245435	1	1	108	140	0	5	+C
barcode89_consensus_vsearch	3613	T	T	250	5	1.94%	2	1	93	93	0.030637867497453432	1	1	107	143	0	5	-C
barcode89_consensus_vsearch	3614	C	C	249	2	0.79%	2	1	93	93	0.24950099800389156	1	1	107	142	0	2	+G
barcode89_consensus_vsearch	3615	G	G	255	1	0.39%	2	1	93	93	0.4999999999999138	1	1	106	149	0	1	+AA
barcode89_consensus_vsearch	3616	A	A	254	2	0.78%	2	2	93	93	0.2495107632092758	1	1	106	148	1	1	G
barcode89_consensus_vsearch	3617	G	G	257	0	0%	2	0	93	0	1.0	1	0	108	149	0	0	
barcode89_consensus_vsearch	3618	C	C	256	2	0.78%	2	2	93	93	0.24951456310670525	1	1	107	149	1	1	T
barcode89_consensus_vsearch	3619	A	A	256	2	0.77%	2	2	93	93	0.24951456310670525	1	1	107	149	1	1	G
barcode89_consensus_vsearch	3620	T	T	255	2	0.78%	2	2	93	93	0.2495126705651419	1	1	106	149	1	1	C
barcode89_consensus_vsearch	3621	A	A	253	3	1.16%	2	2	93	93	0.124266144814075	1	1	107	146	1	2	-G
barcode89_consensus_vsearch	3622	G	G	253	1	0.39%	2	1	93	93	0.5000000000003686	1	1	106	147	1	0	+A
barcode89_consensus_vsearch	3623	G	G	253	2	0.78%	2	1	93	93	0.24950884086425928	1	1	105	148	2	0	-C
barcode89_consensus_vsearch	3624	C	C	252	2	0.78%	2	1	93	93	0.2495069033532105	1	1	106	146	0	2	+T
barcode89_consensus_vsearch	3625	C	C	254	1	0.39%	2	1	93	93	0.4999999999999138	1	1	108	146	0	1	+A
barcode89_consensus_vsearch	3626	T	T	253	3	1.17%	2	1	93	93	0.124266144814075	1	1	108	145	0	3	C
barcode89_consensus_vsearch	3627	G	G	253	2	0.78%	2	1	93	93	0.24950884086425928	1	1	107	146	0	2	+T
barcode89_consensus_vsearch	3628	C	C	241	6	2.33%	2	1	93	93	0.01515249705946412	1	1	106	135	0	6	-T
barcode89_consensus_vsearch	3629	T	T	249	2	0.8%	2	1	93	93	0.24950099800389156	1	1	107	142	0	2	C
barcode89_consensus_vsearch	3630	T	T	257	0	0%	2	0	93	0	1.0	1	0	107	150	0	0	
barcode89_consensus_vsearch	3631	T	T	255	1	0.39%	2	1	93	93	0.4999999999999138	1	1	106	149	1	0	+A
barcode89_consensus_vsearch	3632	G	G	256	2	0.78%	2	2	93	93	0.24951456310670525	1	1	107	149	1	1	-A
barcode89_consensus_vsearch	3633	A	A	256	1	0.39%	2	1	93	93	0.4999999999999138	1	1	107	149	1	0	+G
barcode89_consensus_vsearch	3634	A	A	255	3	1.16%	2	2	93	93	0.1242718446601877	1	1	107	148	2	1	G
barcode89_consensus_vsearch	3635	C	C	255	2	0.78%	2	2	93	93	0.2495126705651419	1	1	107	148	1	1	-A
barcode89_consensus_vsearch	3636	A	A	254	1	0.39%	2	1	93	93	0.4999999999999138	1	1	106	148	0	1	+C
barcode89_consensus_vsearch	3637	C	C	254	1	0.39%	2	1	93	93	0.4999999999999138	1	1	107	147	1	0	+AC
barcode89_consensus_vsearch	3638	T	T	249	6	2.33%	2	2	93	93	0.015167261137354384	1	1	103	146	5	1	+C
barcode89_consensus_vsearch	3639	C	C	254	2	0.78%	2	1	93	93	0.2495107632092758	1	1	108	146	0	2	+T
barcode89_consensus_vsearch	3640	T	T	258	1	0.39%	2	1	93	93	0.4999999999999138	1	1	109	149	0	1	C
barcode89_consensus_vsearch	3641	A	A	259	0	0%	2	0	93	0	1.0	1	0	109	150	0	0	
barcode89_consensus_vsearch	3642	A	*/-T	195	45	17.37%	2	2	93	93	2.9151906052994424E-15	1	1	86	109	18	27	-T
barcode89_consensus_vsearch	3643	T	T	212	0	0%	2	0	93	0	1.0	1	0	90	122	0	0	
barcode89_consensus_vsearch	3644	T	T	257	0	0%	2	0	93	0	1.0	1	0	108	149	0	0	
barcode89_consensus_vsearch	3645	T	T	259	0	0%	2	0	93	0	1.0	1	0	109	150	0	0	
barcode89_consensus_vsearch	3646	T	T	259	0	0%	2	0	93	0	1.0	1	0	109	150	0	0	
barcode89_consensus_vsearch	3647	T	T	259	0	0%	2	0	93	0	1.0	1	0	109	150	0	0	
barcode89_consensus_vsearch	3648	T	T	254	3	1.16%	2	1	93	93	0.12426900584791233	1	1	104	150	3	0	C
barcode89_consensus_vsearch	3649	C	*/-AA	227	15	5.79%	2	2	93	93	2.4401031534927477E-5	1	1	104	123	1	14	-AA
barcode89_consensus_vsearch	3650	A	A	236	1	0.42%	2	1	93	93	0.4999999999999138	1	1	104	132	0	1	G
barcode89_consensus_vsearch	3651	A	A	243	1	0.41%	2	1	93	93	0.4999999999999138	1	1	107	136	1	0	G
barcode89_consensus_vsearch	3652	A	A	256	2	0.77%	2	2	93	93	0.24951456310670525	1	1	108	148	1	1	T
barcode89_consensus_vsearch	3653	G	G	258	1	0.39%	2	1	93	93	0.4999999999999138	1	1	108	150	1	0	-T
barcode89_consensus_vsearch	3654	T	*/-A	210	31	12.02%	2	2	93	93	1.6613071760789332E-10	1	1	90	120	15	16	-A
barcode89_consensus_vsearch	3655	A	A	218	1	0.46%	2	1	93	93	0.5000000000003686	1	1	92	126	1	0	C
barcode89_consensus_vsearch	3656	A	A	249	1	0.4%	2	1	93	93	0.5000000000003686	1	1	108	141	0	1	G
barcode89_consensus_vsearch	3657	A	A	249	5	1.97%	2	1	93	93	0.03063545999571253	1	1	109	140	0	5	G
barcode89_consensus_vsearch	3658	A	A	251	3	1.18%	2	1	93	93	0.12426035502961323	1	1	108	143	0	3	T
barcode89_consensus_vsearch	3659	G	G	259	0	0%	2	0	93	0	1.0	1	0	109	150	0	0	
barcode89_consensus_vsearch	3660	T	*/-C	243	14	5.41%	2	1	93	93	5.088712817288902E-5	1	1	94	149	14	0	-C
barcode89_consensus_vsearch	3661	C	C	242	3	1.22%	2	1	93	93	0.1242331288343819	1	1	92	150	3	0	+A
barcode89_consensus_vsearch	3662	C	*/+T	248	10	3.86%	2	1	93	93	8.935377905624525E-4	1	1	108	140	0	10	+T
barcode89_consensus_vsearch	3663	T	T	251	2	0.77%	2	1	93	93	0.24950495049494414	1	1	105	146	0	2	+G
barcode89_consensus_vsearch	3664	G	G	255	3	1.16%	2	2	93	93	0.1242718446601877	1	1	107	148	2	1	-A
barcode89_consensus_vsearch	3665	A	A	251	2	0.78%	2	1	93	93	0.24950495049494414	1	1	107	144	0	2	+C
barcode89_consensus_vsearch	3666	T	T	254	3	1.17%	2	2	93	93	0.12426900584791233	1	1	108	146	1	2	C
barcode89_consensus_vsearch	3667	T	*/+C	230	14	5.43%	2	2	93	93	5.038248401810262E-5	1	1	96	134	9	5	+C
barcode89_consensus_vsearch	3668	C	C	245	0	0%	2	0	93	0	1.0	1	0	106	139	0	0	
barcode89_consensus_vsearch	3669	C	C	253	1	0.39%	2	1	93	93	0.5000000000003686	1	1	108	145	0	1	T
barcode89_consensus_vsearch	3670	C	C	251	4	1.57%	2	1	93	93	0.06176398786346276	1	1	108	143	0	4	T
barcode89_consensus_vsearch	3671	C	Y	240	11	4.25%	2	1	93	93	4.3658402499770964E-4	1	1	106	134	0	11	T
barcode89_consensus_vsearch	3672	G	G	257	0	0%	2	0	93	0	1.0	1	0	107	150	0	0	
barcode89_consensus_vsearch	3673	A	A	255	1	0.39%	2	1	93	93	0.4999999999999138	1	1	105	150	1	0	+T
barcode89_consensus_vsearch	3674	C	C	255	2	0.78%	2	1	93	93	0.2495126705651419	1	1	106	149	2	0	T
barcode89_consensus_vsearch	3675	A	A	253	5	1.93%	2	2	93	93	0.030644978141142375	1	1	106	147	3	2	G
barcode89_consensus_vsearch	3676	C	*/-AC	239	18	6.95%	2	2	93	93	2.8028611534991314E-6	1	1	98	141	11	7	-AC
barcode89_consensus_vsearch	3677	A	A	237	1	0.41%	2	1	93	93	0.5000000000003686	1	1	96	141	0	1	+C
barcode89_consensus_vsearch	3678	C	C	235	2	0.83%	2	2	93	93	0.24947145877361238	1	1	95	140	1	1	+AC
barcode89_consensus_vsearch	3679	C	S	245	11	4.26%	2	2	93	93	4.375595006058856E-4	1	1	98	147	10	1	G
barcode89_consensus_vsearch	3680	C	C	255	1	0.39%	2	1	93	93	0.4999999999999138	1	1	107	148	1	0	+A
barcode89_consensus_vsearch	3681	A	A	255	1	0.39%	2	1	93	93	0.4999999999999138	1	1	106	149	0	1	-G
barcode89_consensus_vsearch	3682	G	G	256	2	0.78%	2	1	93	93	0.24951456310670525	1	1	109	147	0	2	-T
barcode89_consensus_vsearch	3683	T	T	254	2	0.78%	2	2	93	93	0.2495107632092758	1	1	107	147	1	1	C
barcode89_consensus_vsearch	3684	G	*/-A	249	8	3.09%	2	2	93	93	0.0036961603384701837	1	1	102	147	7	1	-A
barcode89_consensus_vsearch	3685	A	A	247	2	0.8%	2	1	93	93	0.24949698189118988	1	1	99	148	2	0	G
barcode89_consensus_vsearch	3686	A	*/-G	246	11	4.25%	2	2	93	93	4.3775019913159645E-4	1	1	99	147	9	2	-G
barcode89_consensus_vsearch	3687	G	G	244	2	0.81%	2	2	93	93	0.24949083503056865	1	1	98	146	1	1	+A
barcode89_consensus_vsearch	3688	G	G	258	1	0.39%	2	1	93	93	0.4999999999999138	1	1	109	149	0	1	A
barcode89_consensus_vsearch	3689	G	G	258	1	0.39%	2	1	93	93	0.4999999999999138	1	1	108	150	1	0	+AG
barcode89_consensus_vsearch	3690	C	C	255	4	1.54%	2	1	93	93	0.06177536572082746	1	1	109	146	0	4	T
barcode89_consensus_vsearch	3691	A	A	254	3	1.16%	2	1	93	93	0.12426900584791233	1	1	106	148	3	0	G
barcode89_consensus_vsearch	3692	T	T	255	3	1.16%	2	1	93	93	0.1242718446601877	1	1	108	147	0	3	C
barcode89_consensus_vsearch	3693	G	G	253	3	1.16%	2	1	93	93	0.124266144814075	1	1	105	148	3	0	A
barcode89_consensus_vsearch	3694	C	C	249	2	0.78%	2	2	93	93	0.24950099800389156	1	1	106	143	1	1	-G
barcode89_consensus_vsearch	3695	G	G	250	3	1.19%	2	1	93	93	0.12425742574263329	1	1	105	145	3	0	A
barcode89_consensus_vsearch	3696	G	G	252	2	0.78%	2	1	93	93	0.2495069033532105	1	1	104	148	2	0	A
barcode89_consensus_vsearch	3697	C	C	248	4	1.56%	2	1	93	93	0.061755217199896344	1	1	106	142	0	4	-TC
barcode89_consensus_vsearch	3698	T	T	243	3	1.18%	2	2	93	93	0.12423625254575449	1	1	104	139	2	1	+C
barcode89_consensus_vsearch	3699	C	C	248	1	0.4%	2	1	93	93	0.4999999999999138	1	1	108	140	1	0	+TC
barcode89_consensus_vsearch	3700	C	C	250	2	0.78%	2	2	93	93	0.2495029821073759	1	1	107	143	1	1	-TC
barcode89_consensus_vsearch	3701	T	T	244	6	2.37%	2	1	93	93	0.015158143859196256	1	1	105	139	0	6	C
barcode89_consensus_vsearch	3702	C	*/-A	245	9	3.5%	2	2	93	93	0.0018173060047634259	1	1	100	145	5	4	-A
barcode89_consensus_vsearch	3703	A	*/+G	238	9	3.6%	2	2	93	93	0.0018135324927119494	1	1	102	136	1	8	+G
barcode89_consensus_vsearch	3704	G	*/-A	244	10	3.88%	2	2	93	93	8.922644712756052E-4	1	1	103	141	6	4	-A
barcode89_consensus_vsearch	3705	A	A	244	2	0.81%	2	1	93	93	0.24949083503056865	1	1	102	142	0	2	G
barcode89_consensus_vsearch	3706	A	*/+G	245	9	3.49%	2	2	93	93	0.0018173060047634259	1	1	103	142	4	5	+G
barcode89_consensus_vsearch	3707	G	G	249	2	0.78%	2	2	93	93	0.24950099800389156	1	1	107	142	1	1	+A
barcode89_consensus_vsearch	3708	G	*/-A	240	9	3.49%	2	2	93	93	0.0018146318577743554	1	1	100	140	7	2	-A
barcode89_consensus_vsearch	3709	A	A	243	2	0.81%	2	1	93	93	0.24948875255617758	1	1	100	143	0	2	+GA
barcode89_consensus_vsearch	3710	A	A	255	2	0.78%	2	1	93	93	0.2495126705651419	1	1	108	147	0	2	G
barcode89_consensus_vsearch	3711	A	A	253	3	1.16%	2	2	93	93	0.124266144814075	1	1	106	147	2	1	+G
barcode89_consensus_vsearch	3712	G	G	255	1	0.39%	2	1	93	93	0.4999999999999138	1	1	108	147	0	1	+C
barcode89_consensus_vsearch	3713	G	G	258	1	0.39%	2	1	93	93	0.4999999999999138	1	1	108	150	1	0	-CC
barcode89_consensus_vsearch	3714	C	C	255	2	0.78%	2	1	93	93	0.2495126705651419	1	1	108	147	0	2	+T
barcode89_consensus_vsearch	3715	C	C	258	0	0%	2	0	93	0	1.0	1	0	108	150	0	0	
barcode89_consensus_vsearch	3716	C	C	252	3	1.16%	2	1	93	93	0.12426326129665838	1	1	108	144	0	3	+G
barcode89_consensus_vsearch	3717	G	G	253	3	1.17%	2	2	93	93	0.124266144814075	1	1	106	147	2	1	A
barcode89_consensus_vsearch	3718	G	G	255	3	1.16%	2	2	93	93	0.1242718446601877	1	1	107	148	1	2	A
barcode89_consensus_vsearch	3719	T	T	252	5	1.93%	2	1	93	93	0.030642626352771006	1	1	104	148	5	0	+C
barcode89_consensus_vsearch	3720	C	C	252	3	1.17%	2	1	93	93	0.12426326129665838	1	1	107	145	0	3	-G
barcode89_consensus_vsearch	3721	G	G	254	1	0.39%	2	1	93	93	0.4999999999999138	1	1	108	146	0	1	+T
barcode89_consensus_vsearch	3722	G	G	258	1	0.39%	2	1	93	93	0.4999999999999138	1	1	109	149	0	1	A
barcode89_consensus_vsearch	3723	A	A	258	1	0.39%	2	1	93	93	0.4999999999999138	1	1	109	149	0	1	+T
barcode89_consensus_vsearch	3724	C	C	258	1	0.39%	2	1	93	93	0.4999999999999138	1	1	109	149	0	1	T
barcode89_consensus_vsearch	3725	C	C	258	1	0.39%	2	1	93	93	0.4999999999999138	1	1	108	150	1	0	+A
barcode89_consensus_vsearch	3726	A	A	259	0	0%	2	0	93	0	1.0	1	0	109	150	0	0	
barcode89_consensus_vsearch	3727	G	G	255	1	0.39%	2	1	93	93	0.4999999999999138	1	1	108	147	0	1	-T
barcode89_consensus_vsearch	3728	T	T	253	3	1.17%	2	2	93	93	0.124266144814075	1	1	108	145	1	2	C
barcode89_consensus_vsearch	3729	G	G	257	0	0%	2	0	93	0	1.0	1	0	109	148	0	0	
barcode89_consensus_vsearch	3730	C	C	253	3	1.16%	2	1	93	93	0.124266144814075	1	1	105	148	3	0	-AC
barcode89_consensus_vsearch	3731	A	A	252	2	0.78%	2	1	93	93	0.2495069033532105	1	1	104	148	2	0	G
barcode89_consensus_vsearch	3732	C	C	254	1	0.39%	2	1	93	93	0.4999999999999138	1	1	105	149	1	0	+AC
barcode89_consensus_vsearch	3733	G	G	255	4	1.54%	2	2	93	93	0.06177536572082746	1	1	106	149	3	1	A
barcode89_consensus_vsearch	3734	C	C	255	4	1.54%	2	2	93	93	0.06177536572082746	1	1	108	147	1	3	T
barcode89_consensus_vsearch	3735	G	R	249	9	3.47%	2	2	93	93	0.0018193721277701645	1	1	102	147	7	2	A
barcode89_consensus_vsearch	3736	G	G	255	2	0.77%	2	1	93	93	0.2495126705651419	1	1	107	148	0	2	-TG
barcode89_consensus_vsearch	3737	T	T	254	2	0.78%	2	2	93	93	0.2495107632092758	1	1	107	147	1	1	C
barcode89_consensus_vsearch	3738	G	G	257	0	0%	2	0	93	0	1.0	1	0	109	148	0	0	
barcode89_consensus_vsearch	3739	A	A	254	4	1.54%	2	2	93	93	0.06177255436325217	1	1	107	147	2	2	-G
barcode89_consensus_vsearch	3740	G	G	254	1	0.39%	2	1	93	93	0.4999999999999138	1	1	107	147	0	1	+TAA
barcode89_consensus_vsearch	3741	G	G	258	1	0.39%	2	1	93	93	0.4999999999999138	1	1	109	149	0	1	A
barcode89_consensus_vsearch	3742	C	C	252	3	1.16%	2	2	93	93	0.12426326129665838	1	1	108	144	1	2	-G
barcode89_consensus_vsearch	3743	G	G	253	2	0.78%	2	1	93	93	0.24950884086425928	1	1	107	146	0	2	+T
barcode89_consensus_vsearch	3744	G	G	259	0	0%	2	0	93	0	1.0	1	0	109	150	0	0	
barcode89_consensus_vsearch	3745	A	A	257	1	0.39%	2	1	93	93	0.4999999999999138	1	1	108	149	0	1	-C
barcode89_consensus_vsearch	3746	C	C	257	1	0.39%	2	1	93	93	0.4999999999999138	1	1	108	149	1	0	T
barcode89_consensus_vsearch	3747	C	C	249	3	1.16%	2	1	93	93	0.12425447316115633	1	1	108	141	0	3	T
barcode89_consensus_vsearch	3748	G	G	253	2	0.78%	2	1	93	93	0.24950884086425928	1	1	108	145	0	2	A
barcode89_consensus_vsearch	3749	G	G	253	3	1.16%	2	1	93	93	0.124266144814075	1	1	103	150	3	0	+C
barcode89_consensus_vsearch	3750	C	C	254	1	0.39%	2	1	93	93	0.4999999999999138	1	1	106	148	0	1	A
barcode89_consensus_vsearch	3751	C	C	249	5	1.95%	2	2	93	93	0.03063545999571253	1	1	103	146	4	1	-A
barcode89_consensus_vsearch	3752	A	A	252	1	0.4%	2	1	93	93	0.5000000000003686	1	1	104	148	1	0	T
barcode89_consensus_vsearch	3753	A	R	241	12	4.65%	2	1	93	93	2.1363402075967646E-4	1	1	94	147	12	0	G
barcode89_consensus_vsearch	3754	C	C	249	4	1.57%	2	1	93	93	0.06175816388801474	1	1	102	147	4	0	G
barcode89_consensus_vsearch	3755	C	C	255	2	0.78%	2	2	93	93	0.2495126705651419	1	1	107	148	1	1	T
barcode89_consensus_vsearch	3756	A	A	244	5	1.93%	2	2	93	93	0.030623132735815337	1	1	103	141	1	4	-G
barcode89_consensus_vsearch	3757	G	G	250	3	1.18%	2	1	93	93	0.12425742574263329	1	1	105	145	3	0	A
barcode89_consensus_vsearch	3758	G	G	245	6	2.32%	2	2	93	93	0.015159996253657923	1	1	99	146	4	2	-C
barcode89_consensus_vsearch	3759	C	C	250	1	0.4%	2	1	93	93	0.4999999999999138	1	1	103	147	0	1	+T
barcode89_consensus_vsearch	3760	C	C	254	3	1.16%	2	2	93	93	0.12426900584791233	1	1	106	148	1	2	T
barcode89_consensus_vsearch	3761	C	C	242	5	1.93%	2	1	93	93	0.030618062239993613	1	1	97	145	5	0	+A
barcode89_consensus_vsearch	3762	A	A	239	6	2.4%	2	1	93	93	0.015148656024950557	1	1	94	145	6	0	C
barcode89_consensus_vsearch	3763	A	A	247	5	1.97%	2	1	93	93	0.030630587731099716	1	1	102	145	5	0	-G
barcode89_consensus_vsearch	3764	G	G	249	3	1.19%	2	1	93	93	0.12425447316115633	1	1	104	145	0	3	T
barcode89_consensus_vsearch	3765	G	G	259	0	0%	2	0	93	0	1.0	1	0	109	150	0	0	
barcode89_consensus_vsearch	3766	T	T	257	1	0.39%	2	1	93	93	0.4999999999999138	1	1	109	148	0	1	+C
barcode89_consensus_vsearch	3767	T	T	256	1	0.39%	2	1	93	93	0.4999999999999138	1	1	108	148	0	1	+C
barcode89_consensus_vsearch	3768	C	C	257	1	0.39%	2	1	93	93	0.4999999999999138	1	1	108	149	1	0	T
barcode89_consensus_vsearch	3769	A	A	258	1	0.39%	2	1	93	93	0.4999999999999138	1	1	108	150	1	0	T
barcode89_consensus_vsearch	3770	A	A	254	4	1.54%	2	1	93	93	0.06177255436325217	1	1	104	150	4	0	G
barcode89_consensus_vsearch	3771	C	C	257	1	0.39%	2	1	93	93	0.4999999999999138	1	1	109	148	0	1	+T
barcode89_consensus_vsearch	3772	T	T	254	2	0.78%	2	1	93	93	0.2495107632092758	1	1	107	147	2	0	C
barcode89_consensus_vsearch	3773	A	A	253	3	1.16%	2	1	93	93	0.124266144814075	1	1	106	147	3	0	T
barcode89_consensus_vsearch	3774	C	C	247	4	1.54%	2	1	93	93	0.061752247008950906	1	1	103	144	4	0	+A
barcode89_consensus_vsearch	3775	G	G	250	5	1.94%	2	1	93	93	0.030637867497453432	1	1	103	147	5	0	-A
barcode89_consensus_vsearch	3776	A	A	249	3	1.18%	2	2	93	93	0.12425447316115633	1	1	101	148	2	1	G
barcode89_consensus_vsearch	3777	G	G	257	1	0.39%	2	1	93	93	0.4999999999999138	1	1	108	149	0	1	-CTTTTT
barcode89_consensus_vsearch	3778	C	*/-T	214	27	10.47%	2	2	93	93	3.4462131426831007E-9	1	1	92	122	15	12	-T
barcode89_consensus_vsearch	3779	T	T	222	4	1.77%	2	2	93	93	0.061669440342892484	1	1	93	129	1	3	C
barcode89_consensus_vsearch	3780	T	T	252	1	0.4%	2	1	93	93	0.5000000000003686	1	1	108	144	1	0	C
barcode89_consensus_vsearch	3781	T	T	254	3	1.16%	2	2	93	93	0.12426900584791233	1	1	107	147	2	1	C
barcode89_consensus_vsearch	3782	T	T	257	1	0.39%	2	1	93	93	0.4999999999999138	1	1	109	148	0	1	+AC
barcode89_consensus_vsearch	3783	T	T	253	3	1.16%	2	2	93	93	0.124266144814075	1	1	107	146	2	1	-A
barcode89_consensus_vsearch	3784	A	A	254	1	0.39%	2	1	93	93	0.4999999999999138	1	1	106	148	1	0	G
barcode89_consensus_vsearch	3785	A	A	255	3	1.16%	2	1	93	93	0.1242718446601877	1	1	106	149	3	0	G
barcode89_consensus_vsearch	3786	C	C	258	1	0.39%	2	1	93	93	0.4999999999999138	1	1	109	149	0	1	G
barcode89_consensus_vsearch	3787	T	T	254	1	0.39%	2	1	93	93	0.4999999999999138	1	1	108	146	1	0	+AC
barcode89_consensus_vsearch	3788	G	G	255	2	0.78%	2	1	93	93	0.2495126705651419	1	1	108	147	0	2	A
barcode89_consensus_vsearch	3789	C	C	257	2	0.77%	2	1	93	93	0.24951644100587136	1	1	109	148	0	2	A
barcode89_consensus_vsearch	3790	A	A	255	4	1.54%	2	2	93	93	0.06177536572082746	1	1	107	148	2	2	G
barcode89_consensus_vsearch	3791	A	A	250	6	2.32%	2	2	93	93	0.015169042029074849	1	1	104	146	5	1	G
barcode89_consensus_vsearch	3792	C	C	251	3	1.16%	2	1	93	93	0.12426035502961323	1	1	105	146	0	3	A
barcode89_consensus_vsearch	3793	A	A	256	1	0.39%	2	1	93	93	0.4999999999999138	1	1	108	148	0	1	+TA
barcode89_consensus_vsearch	3794	A	A	251	5	1.94%	2	1	93	93	0.03064025621010106	1	1	103	148	5	0	G
barcode89_consensus_vsearch	3795	C	C	253	3	1.16%	2	1	93	93	0.124266144814075	1	1	109	144	0	3	+TT
barcode89_consensus_vsearch	3796	T	T	259	0	0%	2	0	93	0	1.0	1	0	109	150	0	0	
barcode89_consensus_vsearch	3797	T	T	259	0	0%	2	0	93	0	1.0	1	0	109	150	0	0	
barcode89_consensus_vsearch	3798	T	T	258	1	0.39%	2	1	93	93	0.4999999999999138	1	1	108	150	1	0	C
barcode89_consensus_vsearch	3799	A	A	256	1	0.39%	2	1	93	93	0.4999999999999138	1	1	108	148	0	1	+G
barcode89_consensus_vsearch	3800	A	A	257	1	0.39%	2	1	93	93	0.4999999999999138	1	1	109	148	0	1	C
barcode89_consensus_vsearch	3801	T	T	257	1	0.39%	2	1	93	93	0.4999999999999138	1	1	109	148	0	1	+C
barcode89_consensus_vsearch	3802	A	A	258	1	0.39%	2	1	93	93	0.4999999999999138	1	1	108	150	1	0	-TA
barcode89_consensus_vsearch	3803	T	T	256	1	0.39%	2	1	93	93	0.4999999999999138	1	1	107	149	0	1	+GTTGG
barcode89_consensus_vsearch	3804	A	A	253	2	0.78%	2	1	93	93	0.24950884086425928	1	1	104	149	2	0	G
barcode89_consensus_vsearch	3805	C	C	258	1	0.39%	2	1	93	93	0.4999999999999138	1	1	109	149	0	1	-GC
barcode89_consensus_vsearch	3806	G	G	258	0	0%	2	0	93	0	1.0	1	0	109	149	0	0	
barcode89_consensus_vsearch	3807	C	C	255	2	0.78%	2	1	93	93	0.2495126705651419	1	1	108	147	0	2	+T
barcode89_consensus_vsearch	3808	T	T	257	2	0.77%	2	1	93	93	0.24951644100587136	1	1	109	148	0	2	C
barcode89_consensus_vsearch	3809	A	A	257	1	0.39%	2	1	93	93	0.4999999999999138	1	1	109	148	0	1	-TTG
barcode89_consensus_vsearch	3810	T	T	257	1	0.39%	2	1	93	93	0.4999999999999138	1	1	109	148	0	1	+GGT
barcode89_consensus_vsearch	3811	T	*/-G	245	11	4.26%	2	1	93	93	4.375595006058856E-4	1	1	109	136	0	11	-G
barcode89_consensus_vsearch	3812	G	G	247	0	0%	2	0	93	0	1.0	1	0	109	138	0	0	
barcode89_consensus_vsearch	3813	G	G	257	1	0.39%	2	1	93	93	0.4999999999999138	1	1	108	149	1	0	-A
barcode89_consensus_vsearch	3814	A	A	256	1	0.39%	2	1	93	93	0.4999999999999138	1	1	108	148	0	1	-GC
barcode89_consensus_vsearch	3815	G	G	258	0	0%	2	0	93	0	1.0	1	0	109	149	0	0	
barcode89_consensus_vsearch	3816	C	C	255	1	0.39%	2	1	93	93	0.4999999999999138	1	1	108	147	0	1	+TT
barcode89_consensus_vsearch	3817	T	*/-G	243	12	4.65%	2	2	93	93	2.1386299704443686E-4	1	1	106	137	2	10	-G
barcode89_consensus_vsearch	3818	G	G	246	0	0%	2	0	93	0	1.0	1	0	106	140	0	0	
barcode89_consensus_vsearch	3819	G	G	256	2	0.77%	2	1	93	93	0.24951456310670525	1	1	107	149	2	0	-A
barcode89_consensus_vsearch	3820	A	A	255	1	0.39%	2	1	93	93	0.4999999999999138	1	1	106	149	0	1	C
barcode89_consensus_vsearch	3821	A	A	253	3	1.16%	2	1	93	93	0.124266144814075	1	1	108	145	0	3	-T
barcode89_consensus_vsearch	3822	T	T	256	0	0%	2	0	93	0	1.0	1	0	109	147	0	0	
barcode89_consensus_vsearch	3823	T	T	255	1	0.39%	2	1	93	93	0.4999999999999138	1	1	107	148	0	1	+G
barcode89_consensus_vsearch	3824	A	A	252	2	0.78%	2	1	93	93	0.2495069033532105	1	1	106	146	0	2	G
barcode89_consensus_vsearch	3825	C	C	250	5	1.95%	2	1	93	93	0.030637867497453432	1	1	106	144	0	5	T
barcode89_consensus_vsearch	3826	C	C	251	2	0.78%	2	2	93	93	0.24950495049494414	1	1	107	144	1	1	-G
barcode89_consensus_vsearch	3827	G	G	254	2	0.78%	2	1	93	93	0.2495107632092758	1	1	108	146	0	2	-C
barcode89_consensus_vsearch	3828	C	C	243	5	1.95%	2	1	93	93	0.030620607699729043	1	1	109	134	0	5	+G
barcode89_consensus_vsearch	3829	G	G	250	1	0.39%	2	1	93	93	0.4999999999999138	1	1	108	142	0	1	+TAG
barcode89_consensus_vsearch	3830	G	G	254	2	0.78%	2	1	93	93	0.2495107632092758	1	1	109	145	0	2	A
barcode89_consensus_vsearch	3831	C	C	251	5	1.94%	2	1	93	93	0.03064025621010106	1	1	108	143	0	5	T
barcode89_consensus_vsearch	3832	T	T	253	4	1.55%	2	1	93	93	0.0617697211064687	1	1	108	145	0	4	C
barcode89_consensus_vsearch	3833	G	G	255	2	0.77%	2	2	93	93	0.2495126705651419	1	1	106	149	1	1	-C
barcode89_consensus_vsearch	3834	C	C	249	4	1.56%	2	1	93	93	0.06175816388801474	1	1	104	145	0	4	T
barcode89_consensus_vsearch	3835	T	T	248	6	2.35%	2	2	93	93	0.015165466280175907	1	1	102	146	2	4	-G
barcode89_consensus_vsearch	3836	G	G	246	2	0.8%	2	2	93	93	0.24949494949494755	1	1	102	144	1	1	A
barcode89_consensus_vsearch	3837	G	G	252	5	1.94%	2	2	93	93	0.030642626352771006	1	1	103	149	4	1	A
barcode89_consensus_vsearch	3838	C	C	246	5	1.94%	2	1	93	93	0.03062812251247695	1	1	99	147	5	0	-A
barcode89_consensus_vsearch	3839	A	A	249	2	0.79%	2	2	93	93	0.24950099800389156	1	1	101	148	1	1	G
barcode89_consensus_vsearch	3840	C	C	247	4	1.54%	2	2	93	93	0.061752247008950906	1	1	98	149	3	1	T
barcode89_consensus_vsearch	3841	C	C	254	1	0.39%	2	1	93	93	0.4999999999999138	1	1	105	149	1	0	+A
barcode89_consensus_vsearch	3842	A	A	257	1	0.39%	2	1	93	93	0.4999999999999138	1	1	107	150	1	0	-G
barcode89_consensus_vsearch	3843	G	G	255	1	0.39%	2	1	93	93	0.4999999999999138	1	1	107	148	0	1	+TG
barcode89_consensus_vsearch	3844	A	A	255	1	0.39%	2	1	93	93	0.4999999999999138	1	1	108	147	0	1	+C
barcode89_consensus_vsearch	3845	C	C	248	6	2.33%	2	1	93	93	0.015165466280175907	1	1	104	144	0	6	+T
barcode89_consensus_vsearch	3846	T	T	253	1	0.39%	2	1	93	93	0.5000000000003686	1	1	105	148	0	1	A
barcode89_consensus_vsearch	3847	T	T	251	1	0.39%	2	1	93	93	0.5000000000003686	1	1	103	148	0	1	+C
barcode89_consensus_vsearch	3848	G	G	241	6	2.34%	2	2	93	93	0.01515249705946412	1	1	99	142	1	5	+C
barcode89_consensus_vsearch	3849	C	C	249	2	0.79%	2	1	93	93	0.24950099800389156	1	1	102	147	0	2	+T
barcode89_consensus_vsearch	3850	C	C	251	4	1.54%	2	1	93	93	0.06176398786346276	1	1	104	147	4	0	+A
barcode89_consensus_vsearch	3851	C	C	254	3	1.16%	2	2	93	93	0.12426900584791233	1	1	106	148	1	2	-TC
barcode89_consensus_vsearch	3852	T	*/-C	230	23	9.02%	2	1	93	93	7.062784514333123E-8	1	1	83	147	23	0	-C
barcode89_consensus_vsearch	3853	C	C	229	1	0.43%	2	1	93	93	0.4999999999999138	1	1	83	146	0	1	+TC
barcode89_consensus_vsearch	3854	C	C	255	1	0.39%	2	1	93	93	0.4999999999999138	1	1	106	149	1	0	G
barcode89_consensus_vsearch	3855	A	A	258	1	0.39%	2	1	93	93	0.4999999999999138	1	1	109	149	0	1	G
barcode89_consensus_vsearch	3856	A	A	257	1	0.39%	2	1	93	93	0.4999999999999138	1	1	109	148	0	1	C
barcode89_consensus_vsearch	3857	T	T	259	0	0%	2	0	93	0	1.0	1	0	109	150	0	0	
barcode89_consensus_vsearch	3858	T	T	256	2	0.77%	2	1	93	93	0.24951456310670525	1	1	109	147	0	2	C
barcode89_consensus_vsearch	3859	G	G	259	0	0%	2	0	93	0	1.0	1	0	109	150	0	0	
barcode89_consensus_vsearch	3860	T	T	257	1	0.39%	2	1	93	93	0.4999999999999138	1	1	109	148	0	1	+CT
barcode89_consensus_vsearch	3861	T	T	255	2	0.77%	2	1	93	93	0.2495126705651419	1	1	108	147	0	2	+C
barcode89_consensus_vsearch	3862	C	C	257	0	0%	2	0	93	0	1.0	1	0	108	149	0	0	
barcode89_consensus_vsearch	3863	C	C	258	0	0%	2	0	93	0	1.0	1	0	109	149	0	0	
barcode89_consensus_vsearch	3864	T	T	252	2	0.78%	2	1	93	93	0.2495069033532105	1	1	106	146	2	0	A
barcode89_consensus_vsearch	3865	C	C	256	2	0.78%	2	1	93	93	0.24951456310670525	1	1	107	149	2	0	-GTT
barcode89_consensus_vsearch	3866	G	G	256	1	0.39%	2	1	93	93	0.4999999999999138	1	1	107	149	0	1	A
barcode89_consensus_vsearch	3867	T	T	256	1	0.39%	2	1	93	93	0.4999999999999138	1	1	107	149	0	1	C
barcode89_consensus_vsearch	3868	T	T	245	5	1.95%	2	2	93	93	0.03062563759307	1	1	100	145	1	4	-A
barcode89_consensus_vsearch	3869	A	A	254	0	0%	2	0	93	0	1.0	1	0	108	146	0	0	
barcode89_consensus_vsearch	3870	A	*/-G	234	11	4.25%	2	2	93	93	4.353628116613763E-4	1	1	105	129	2	9	-G
barcode89_consensus_vsearch	3871	G	G	243	2	0.81%	2	1	93	93	0.24948875255617758	1	1	105	138	2	0	A
barcode89_consensus_vsearch	3872	G	G	251	4	1.55%	2	1	93	93	0.06176398786346276	1	1	108	143	0	4	T
barcode89_consensus_vsearch	3873	G	G	256	2	0.77%	2	1	93	93	0.24951456310670525	1	1	106	150	2	0	-A
barcode89_consensus_vsearch	3874	A	A	251	3	1.17%	2	2	93	93	0.12426035502961323	1	1	105	146	1	2	-T
barcode89_consensus_vsearch	3875	T	T	254	0	0%	2	0	93	0	1.0	1	0	107	147	0	0	
barcode89_consensus_vsearch	3876	T	T	255	2	0.78%	2	1	93	93	0.2495126705651419	1	1	108	147	0	2	C
barcode89_consensus_vsearch	3877	T	T	251	4	1.54%	2	2	93	93	0.06176398786346276	1	1	104	147	3	1	+A
barcode89_consensus_vsearch	3878	A	A	254	2	0.78%	2	1	93	93	0.2495107632092758	1	1	107	147	0	2	G
barcode89_consensus_vsearch	3879	A	A	257	2	0.77%	2	2	93	93	0.24951644100587136	1	1	108	149	1	1	G
barcode89_consensus_vsearch	3880	A	A	257	1	0.39%	2	1	93	93	0.4999999999999138	1	1	108	149	0	1	-T
barcode89_consensus_vsearch	3881	T	T	253	2	0.78%	2	1	93	93	0.24950884086425928	1	1	107	146	0	2	C
barcode89_consensus_vsearch	3882	T	T	256	3	1.16%	2	2	93	93	0.12427466150865948	1	1	108	148	1	2	-GT
barcode89_consensus_vsearch	3883	G	G	253	2	0.78%	2	1	93	93	0.24950884086425928	1	1	105	148	2	0	-TA
barcode89_consensus_vsearch	3884	T	T	250	2	0.79%	2	1	93	93	0.2495029821073759	1	1	105	145	0	2	+A
barcode89_consensus_vsearch	3885	A	A	251	3	1.17%	2	1	93	93	0.12426035502961323	1	1	107	144	0	3	+C
barcode89_consensus_vsearch	3886	C	C	252	3	1.16%	2	2	93	93	0.12426326129665838	1	1	108	144	1	2	T
barcode89_consensus_vsearch	3887	T	T	253	2	0.78%	2	1	93	93	0.24950884086425928	1	1	108	145	0	2	-C
barcode89_consensus_vsearch	3888	C	C	255	1	0.39%	2	1	93	93	0.4999999999999138	1	1	108	147	1	0	+G
barcode89_consensus_vsearch	3889	A	A	256	2	0.78%	2	1	93	93	0.24951456310670525	1	1	107	149	2	0	G
barcode89_consensus_vsearch	3890	T	T	259	0	0%	2	0	93	0	1.0	1	0	109	150	0	0	
barcode89_consensus_vsearch	3891	T	T	256	2	0.77%	2	1	93	93	0.24951456310670525	1	1	107	149	2	0	-C
barcode89_consensus_vsearch	3892	C	C	255	1	0.39%	2	1	93	93	0.4999999999999138	1	1	106	149	0	1	+TC
barcode89_consensus_vsearch	3893	C	C	253	5	1.93%	2	2	93	93	0.030644978141142375	1	1	107	146	1	4	-A
barcode89_consensus_vsearch	3894	A	A	253	1	0.39%	2	1	93	93	0.5000000000003686	1	1	108	145	0	1	C
barcode89_consensus_vsearch	3895	A	A	258	1	0.39%	2	1	93	93	0.4999999999999138	1	1	108	150	1	0	G
barcode89_consensus_vsearch	3896	T	T	254	5	1.93%	2	1	93	93	0.030647311787538743	1	1	109	145	0	5	C
barcode89_consensus_vsearch	3897	T	T	255	3	1.16%	2	1	93	93	0.1242718446601877	1	1	109	146	0	3	C
barcode89_consensus_vsearch	3898	A	A	256	1	0.39%	2	1	93	93	0.4999999999999138	1	1	106	150	1	0	+C
barcode89_consensus_vsearch	3899	C	C	251	4	1.55%	2	1	93	93	0.06176398786346276	1	1	107	144	0	4	T
barcode89_consensus_vsearch	3900	A	A	254	2	0.78%	2	2	93	93	0.2495107632092758	1	1	106	148	1	1	G
barcode89_consensus_vsearch	3901	A	A	257	2	0.77%	2	2	93	93	0.24951644100587136	1	1	108	149	1	1	G
barcode89_consensus_vsearch	3902	G	G	257	1	0.39%	2	1	93	93	0.4999999999999138	1	1	109	148	0	1	+C
barcode89_consensus_vsearch	3903	A	A	253	3	1.16%	2	1	93	93	0.124266144814075	1	1	105	148	3	0	-C
barcode89_consensus_vsearch	3904	C	C	253	1	0.39%	2	1	93	93	0.5000000000003686	1	1	104	149	1	0	+T
barcode89_consensus_vsearch	3905	C	C	258	0	0%	2	0	93	0	1.0	1	0	109	149	0	0	
barcode89_consensus_vsearch	3906	C	*/-A	185	36	13.95%	2	2	93	93	3.0830946529165486E-12	1	1	57	128	29	7	-A
barcode89_consensus_vsearch	3907	A	A	215	0	0%	2	0	93	0	1.0	1	0	74	141	0	0	
barcode89_consensus_vsearch	3908	A	A	251	0	0%	2	0	93	0	1.0	1	0	103	148	0	0	
barcode89_consensus_vsearch	3909	A	A	255	2	0.78%	2	2	93	93	0.2495126705651419	1	1	107	148	1	1	G
barcode89_consensus_vsearch	3910	A	A	255	2	0.78%	2	2	93	93	0.2495126705651419	1	1	107	148	1	1	G
barcode89_consensus_vsearch	3911	G	G	251	5	1.94%	2	1	93	93	0.03064025621010106	1	1	104	147	5	0	-A
barcode89_consensus_vsearch	3912	A	A	250	2	0.79%	2	1	93	93	0.2495029821073759	1	1	103	147	0	2	-G
barcode89_consensus_vsearch	3913	G	G	249	5	1.95%	2	2	93	93	0.03063545999571253	1	1	104	145	4	1	-C
barcode89_consensus_vsearch	3914	C	C	249	2	0.79%	2	1	93	93	0.24950099800389156	1	1	104	145	0	2	+T
barcode89_consensus_vsearch	3915	C	C	251	3	1.16%	2	1	93	93	0.12426035502961323	1	1	108	143	0	3	+T
barcode89_consensus_vsearch	3916	C	C	254	1	0.39%	2	1	93	93	0.4999999999999138	1	1	108	146	1	0	+ACC
barcode89_consensus_vsearch	3917	T	T	254	1	0.39%	2	1	93	93	0.4999999999999138	1	1	108	146	0	1	+G
barcode89_consensus_vsearch	3918	G	G	256	0	0%	2	0	93	0	1.0	1	0	108	148	0	0	
barcode89_consensus_vsearch	3919	T	T	256	2	0.78%	2	1	93	93	0.24951456310670525	1	1	108	148	0	2	C
barcode89_consensus_vsearch	3920	A	A	259	0	0%	2	0	93	0	1.0	1	0	109	150	0	0	
barcode89_consensus_vsearch	3921	T	T	255	2	0.77%	2	1	93	93	0.2495126705651419	1	1	106	149	2	0	+C
barcode89_consensus_vsearch	3922	C	C	258	1	0.39%	2	1	93	93	0.4999999999999138	1	1	108	150	1	0	+G
barcode89_consensus_vsearch	3923	A	A	256	2	0.77%	2	1	93	93	0.24951456310670525	1	1	107	149	2	0	G
barcode89_consensus_vsearch	3924	G	G	258	0	0%	2	0	93	0	1.0	1	0	109	149	0	0	
barcode89_consensus_vsearch	3925	T	T	256	3	1.16%	2	1	93	93	0.12427466150865948	1	1	109	147	0	3	C
barcode89_consensus_vsearch	3926	A	A	254	2	0.77%	2	1	93	93	0.2495107632092758	1	1	107	147	2	0	+T
barcode89_consensus_vsearch	3927	T	T	257	1	0.39%	2	1	93	93	0.4999999999999138	1	1	109	148	0	1	G
barcode89_consensus_vsearch	3928	T	T	257	1	0.39%	2	1	93	93	0.4999999999999138	1	1	108	149	1	0	C
barcode89_consensus_vsearch	3929	T	T	254	2	0.77%	2	2	93	93	0.2495107632092758	1	1	107	147	1	1	-A
barcode89_consensus_vsearch	3930	A	A	256	0	0%	2	0	93	0	1.0	1	0	107	149	0	0	
barcode89_consensus_vsearch	3931	T	T	257	1	0.39%	2	1	93	93	0.4999999999999138	1	1	107	150	1	0	G
barcode89_consensus_vsearch	3932	T	T	257	1	0.39%	2	1	93	93	0.4999999999999138	1	1	108	149	0	1	C
barcode89_consensus_vsearch	3933	G	G	258	1	0.39%	2	1	93	93	0.4999999999999138	1	1	109	149	0	1	+C
barcode89_consensus_vsearch	3934	T	T	257	1	0.39%	2	1	93	93	0.4999999999999138	1	1	108	149	1	0	+C
barcode89_consensus_vsearch	3935	C	C	258	0	0%	2	0	93	0	1.0	1	0	109	149	0	0	
barcode89_consensus_vsearch	3936	A	A	254	3	1.16%	2	1	93	93	0.12426900584791233	1	1	108	146	0	3	+T
barcode89_consensus_vsearch	3937	C	C	253	2	0.77%	2	1	93	93	0.24950884086425928	1	1	108	145	0	2	-T
barcode89_consensus_vsearch	3938	T	T	251	2	0.78%	2	1	93	93	0.24950495049494414	1	1	107	144	0	2	+A
barcode89_consensus_vsearch	3939	A	A	246	6	2.33%	2	2	93	93	0.01516183400716267	1	1	107	139	2	4	-C
barcode89_consensus_vsearch	3940	C	*/+T	227	16	6.37%	2	1	93	93	1.182318022827354E-5	1	1	107	120	0	16	+T
barcode89_consensus_vsearch	3941	C	C	242	6	2.33%	2	1	93	93	0.015154394442017034	1	1	109	133	0	6	+T
barcode89_consensus_vsearch	3942	T	*/-C	210	39	15.12%	2	2	93	93	3.6195649957591575E-13	1	1	91	119	15	24	-C
barcode89_consensus_vsearch	3943	C	C	205	6	2.79%	2	1	93	93	0.015072272591959035	1	1	91	114	0	6	T
barcode89_consensus_vsearch	3944	C	C	249	2	0.79%	2	2	93	93	0.24950099800389156	1	1	106	143	1	1	+TC
barcode89_consensus_vsearch	3945	C	C	251	5	1.95%	2	1	93	93	0.03064025621010106	1	1	108	143	0	5	T
barcode89_consensus_vsearch	3946	C	C	251	3	1.16%	2	1	93	93	0.12426035502961323	1	1	108	143	0	3	G
barcode89_consensus_vsearch	3947	G	G	256	1	0.39%	2	1	93	93	0.4999999999999138	1	1	109	147	0	1	-T
barcode89_consensus_vsearch	3948	T	T	252	4	1.56%	2	2	93	93	0.06176686569346045	1	1	108	144	1	3	C
barcode89_consensus_vsearch	3949	G	G	256	1	0.39%	2	1	93	93	0.4999999999999138	1	1	109	147	0	1	-TCG
barcode89_consensus_vsearch	3950	T	T	255	1	0.39%	2	1	93	93	0.4999999999999138	1	1	108	147	1	0	+C
barcode89_consensus_vsearch	3951	C	C	252	2	0.78%	2	1	93	93	0.2495069033532105	1	1	106	146	2	0	+A
barcode89_consensus_vsearch	3952	G	R	247	8	3.12%	2	1	93	93	0.0036945340250354765	1	1	101	146	8	0	A
barcode89_consensus_vsearch	3953	G	G	256	3	1.16%	2	2	93	93	0.12427466150865948	1	1	107	149	2	1	A
barcode89_consensus_vsearch	3954	G	G	255	4	1.54%	2	1	93	93	0.06177536572082746	1	1	105	150	4	0	-A
barcode89_consensus_vsearch	3955	A	A	254	1	0.39%	2	1	93	93	0.4999999999999138	1	1	104	150	1	0	-T
barcode89_consensus_vsearch	3956	T	T	257	1	0.39%	2	1	93	93	0.4999999999999138	1	1	108	149	0	1	C
barcode89_consensus_vsearch	3957	T	T	247	5	1.93%	2	1	93	93	0.030630587731099716	1	1	106	141	0	5	-GG
barcode89_consensus_vsearch	3958	G	G	251	3	1.18%	2	1	93	93	0.12426035502961323	1	1	106	145	3	0	A
barcode89_consensus_vsearch	3959	G	G	254	0	0%	2	0	93	0	1.0	1	0	109	145	0	0	
barcode89_consensus_vsearch	3960	G	G	258	1	0.39%	2	1	93	93	0.4999999999999138	1	1	109	149	0	1	-T
barcode89_consensus_vsearch	3961	T	Y	242	14	5.43%	2	2	93	93	5.0850008103496704E-5	1	1	106	136	1	13	C
barcode89_consensus_vsearch	3962	A	A	255	2	0.78%	2	1	93	93	0.2495126705651419	1	1	108	147	0	2	C
barcode89_consensus_vsearch	3963	A	*/-T	233	20	7.72%	2	2	93	93	6.452729203788659E-7	1	1	89	144	18	2	-T
barcode89_consensus_vsearch	3964	T	T	239	0	0%	2	0	93	0	1.0	1	0	91	148	0	0	
barcode89_consensus_vsearch	3965	T	T	256	1	0.39%	2	1	93	93	0.4999999999999138	1	1	108	148	0	1	+C
barcode89_consensus_vsearch	3966	T	T	256	2	0.77%	2	1	93	93	0.24951456310670525	1	1	109	147	0	2	G
barcode89_consensus_vsearch	3967	G	G	253	3	1.16%	2	2	93	93	0.124266144814075	1	1	108	145	1	2	-C
barcode89_consensus_vsearch	3968	C	C	250	4	1.56%	2	1	93	93	0.061761087351402955	1	1	107	143	0	4	T
barcode89_consensus_vsearch	3969	G	G	255	1	0.39%	2	1	93	93	0.4999999999999138	1	1	107	148	1	0	+TA
barcode89_consensus_vsearch	3970	C	C	244	6	2.33%	2	2	93	93	0.015158143859196256	1	1	105	139	2	4	-GC
barcode89_consensus_vsearch	3971	G	G	248	1	0.4%	2	1	93	93	0.4999999999999138	1	1	104	144	0	1	+AT
barcode89_consensus_vsearch	3972	C	C	245	2	0.8%	2	2	93	93	0.24949290060873971	1	1	104	141	1	1	A
barcode89_consensus_vsearch	3973	C	C	253	1	0.39%	2	1	93	93	0.5000000000003686	1	1	108	145	0	1	+A
barcode89_consensus_vsearch	3974	T	T	253	2	0.78%	2	1	93	93	0.24950884086425928	1	1	108	145	0	2	C
barcode89_consensus_vsearch	3975	G	G	255	1	0.39%	2	1	93	93	0.4999999999999138	1	1	108	147	0	1	-C
barcode89_consensus_vsearch	3976	C	Y	240	10	3.88%	2	1	93	93	8.909515133367017E-4	1	1	106	134	0	10	T
barcode89_consensus_vsearch	3977	T	T	251	1	0.39%	2	1	93	93	0.5000000000003686	1	1	105	146	0	1	-G
barcode89_consensus_vsearch	3978	G	G	245	4	1.57%	2	1	93	93	0.061746234985649476	1	1	98	147	4	0	-C
barcode89_consensus_vsearch	3979	C	C	245	3	1.2%	2	1	93	93	0.1242424242424468	1	1	101	144	0	3	+T
barcode89_consensus_vsearch	3980	C	*/+T	238	8	3.09%	2	1	93	93	0.0036868928614731586	1	1	106	132	0	8	+T
barcode89_consensus_vsearch	3981	T	T	251	0	0%	2	0	93	0	1.0	1	0	107	144	0	0	
barcode89_consensus_vsearch	3982	T	*/-C	242	12	4.65%	2	2	93	93	2.1374893954455973E-4	1	1	104	138	1	11	-C
barcode89_consensus_vsearch	3983	C	C	236	4	1.65%	2	1	93	93	0.0617179396278951	1	1	99	137	4	0	+G
barcode89_consensus_vsearch	3984	C	C	235	6	2.34%	2	2	93	93	0.015140783526168764	1	1	103	132	2	4	-T
barcode89_consensus_vsearch	3985	T	T	244	2	0.8%	2	1	93	93	0.24949083503056865	1	1	100	144	2	0	A
barcode89_consensus_vsearch	3986	T	*/-G	235	19	7.45%	2	1	93	93	1.3448672179231312E-6	1	1	105	130	0	19	-G
barcode89_consensus_vsearch	3987	G	G	236	3	1.25%	2	2	93	93	0.12421383647810401	1	1	107	129	1	2	T
barcode89_consensus_vsearch	3988	G	G	257	1	0.39%	2	1	93	93	0.4999999999999138	1	1	108	149	1	0	-A
barcode89_consensus_vsearch	3989	A	A	257	1	0.39%	2	1	93	93	0.4999999999999138	1	1	108	149	0	1	T
barcode89_consensus_vsearch	3990	T	T	256	1	0.39%	2	1	93	93	0.4999999999999138	1	1	106	150	1	0	+A
barcode89_consensus_vsearch	3991	G	G	256	1	0.39%	2	1	93	93	0.4999999999999138	1	1	107	149	0	1	+CCG
barcode89_consensus_vsearch	3992	T	T	249	3	1.16%	2	2	93	93	0.12425447316115633	1	1	105	144	2	1	+A
barcode89_consensus_vsearch	3993	G	G	251	2	0.79%	2	1	93	93	0.24950495049494414	1	1	104	147	2	0	T
barcode89_consensus_vsearch	3994	G	G	255	2	0.78%	2	1	93	93	0.2495126705651419	1	1	106	149	2	0	T
barcode89_consensus_vsearch	3995	T	T	253	4	1.55%	2	1	93	93	0.0617697211064687	1	1	109	144	0	4	C
barcode89_consensus_vsearch	3996	A	A	257	1	0.39%	2	1	93	93	0.4999999999999138	1	1	107	150	1	0	+T
barcode89_consensus_vsearch	3997	G	G	256	1	0.39%	2	1	93	93	0.4999999999999138	1	1	106	150	1	0	+C
barcode89_consensus_vsearch	3998	C	C	257	1	0.39%	2	1	93	93	0.4999999999999138	1	1	107	150	1	0	T
barcode89_consensus_vsearch	3999	C	C	254	4	1.54%	2	1	93	93	0.06177255436325217	1	1	108	146	0	4	T
barcode89_consensus_vsearch	4000	G	G	256	2	0.77%	2	1	93	93	0.24951456310670525	1	1	107	149	2	0	-T
barcode89_consensus_vsearch	4001	T	T	255	2	0.78%	2	1	93	93	0.2495126705651419	1	1	107	148	0	2	C
barcode89_consensus_vsearch	4002	T	T	258	1	0.39%	2	1	93	93	0.4999999999999138	1	1	108	150	1	0	C
barcode89_consensus_vsearch	4003	T	T	259	0	0%	2	0	93	0	1.0	1	0	109	150	0	0	
barcode89_consensus_vsearch	4004	C	C	254	2	0.77%	2	1	93	93	0.2495107632092758	1	1	109	145	0	2	-TC
barcode89_consensus_vsearch	4005	T	T	248	4	1.57%	2	1	93	93	0.061755217199896344	1	1	105	143	4	0	+C
barcode89_consensus_vsearch	4006	C	C	245	3	1.19%	2	2	93	93	0.1242424242424468	1	1	105	140	2	1	+G
barcode89_consensus_vsearch	4007	A	A	238	4	1.59%	2	1	93	93	0.061724409550499286	1	1	103	135	0	4	+G
barcode89_consensus_vsearch	4008	G	G	247	3	1.19%	2	2	93	93	0.12424849699405838	1	1	106	141	2	1	A
barcode89_consensus_vsearch	4009	G	G	253	4	1.54%	2	2	93	93	0.0617697211064687	1	1	106	147	3	1	A
barcode89_consensus_vsearch	4010	C	C	242	6	2.33%	2	1	93	93	0.015154394442017034	1	1	104	138	0	6	-TC
barcode89_consensus_vsearch	4011	T	*/-C	197	39	15.73%	2	2	93	93	3.2846893108535395E-13	1	1	92	105	11	28	-C
barcode89_consensus_vsearch	4012	C	C	209	1	0.48%	2	1	93	93	0.4999999999999138	1	1	97	112	0	1	A
barcode89_consensus_vsearch	4013	C	C	249	5	1.96%	2	2	93	93	0.03063545999571253	1	1	106	143	1	4	+T
barcode89_consensus_vsearch	4014	C	C	254	2	0.78%	2	2	93	93	0.2495107632092758	1	1	108	146	1	1	T
barcode89_consensus_vsearch	4015	T	T	251	2	0.78%	2	1	93	93	0.24950495049494414	1	1	107	144	0	2	+C
barcode89_consensus_vsearch	4016	C	*/-TC	238	17	6.59%	2	1	93	93	5.791404745360032E-6	1	1	107	131	0	17	-TC
barcode89_consensus_vsearch	4017	T	*/-C	230	7	2.93%	2	1	93	93	0.0074693190837354945	1	1	99	131	7	0	-C
barcode89_consensus_vsearch	4018	C	C	231	2	0.85%	2	1	93	93	0.24946236559140877	1	1	98	133	2	0	+T
barcode89_consensus_vsearch	4019	C	*/-G	237	18	6.98%	2	2	93	93	2.7958505667288594E-6	1	1	101	136	4	14	-G
barcode89_consensus_vsearch	4020	G	G	239	1	0.41%	2	1	93	93	0.4999999999999138	1	1	104	135	1	0	A
barcode89_consensus_vsearch	4021	G	G	257	2	0.77%	2	1	93	93	0.24951644100587136	1	1	107	150	2	0	-A
barcode89_consensus_vsearch	4022	A	A	253	2	0.78%	2	2	93	93	0.24950884086425928	1	1	104	149	1	1	G
barcode89_consensus_vsearch	4023	A	A	257	1	0.39%	2	1	93	93	0.4999999999999138	1	1	107	150	1	0	-T
barcode89_consensus_vsearch	4024	T	T	250	4	1.55%	2	1	93	93	0.061761087351402955	1	1	100	150	4	0	-A
barcode89_consensus_vsearch	4025	A	A	247	5	1.96%	2	1	93	93	0.030630587731099716	1	1	102	145	0	5	+G
barcode89_consensus_vsearch	4026	G	G	258	0	0%	2	0	93	0	1.0	1	0	108	150	0	0	
barcode89_consensus_vsearch	4027	A	A	256	2	0.77%	2	1	93	93	0.24951456310670525	1	1	108	148	0	2	G
barcode89_consensus_vsearch	4028	A	*/-C	225	22	8.49%	2	1	93	93	1.4619930146121474E-7	1	1	77	148	22	0	-C
barcode89_consensus_vsearch	4029	C	C	235	0	0%	2	0	93	0	1.0	1	0	85	150	0	0	
barcode89_consensus_vsearch	4030	C	C	255	1	0.39%	2	1	93	93	0.4999999999999138	1	1	107	148	0	1	+TC
barcode89_consensus_vsearch	4031	C	C	247	5	1.94%	2	1	93	93	0.030630587731099716	1	1	108	139	0	5	-T
barcode89_consensus_vsearch	4032	T	T	249	1	0.4%	2	1	93	93	0.5000000000003686	1	1	109	140	0	1	-A
barcode89_consensus_vsearch	4033	A	A	254	1	0.39%	2	1	93	93	0.4999999999999138	1	1	109	145	0	1	C
barcode89_consensus_vsearch	4034	A	A	254	2	0.77%	2	2	93	93	0.2495107632092758	1	1	108	146	1	1	-T
barcode89_consensus_vsearch	4035	T	T	254	2	0.78%	2	1	93	93	0.2495107632092758	1	1	108	146	0	2	C
barcode89_consensus_vsearch	4036	T	*/-C	232	18	6.98%	2	2	93	93	2.7778957071010484E-6	1	1	100	132	7	11	-C
barcode89_consensus_vsearch	4037	C	C	240	0	0%	2	0	93	0	1.0	1	0	102	138	0	0	
barcode89_consensus_vsearch	4038	C	C	257	1	0.39%	2	1	93	93	0.4999999999999138	1	1	108	149	1	0	+T
barcode89_consensus_vsearch	4039	C	C	255	2	0.77%	2	1	93	93	0.2495126705651419	1	1	108	147	0	2	+T
barcode89_consensus_vsearch	4040	C	Y	217	38	14.67%	2	1	93	93	8.203974563318798E-13	1	1	107	110	0	38	T
barcode89_consensus_vsearch	4041	G	G	250	4	1.54%	2	1	93	93	0.061761087351402955	1	1	101	149	4	0	-T
barcode89_consensus_vsearch	4042	T	T	254	1	0.39%	2	1	93	93	0.4999999999999138	1	1	104	150	1	0	A
barcode89_consensus_vsearch	4043	T	T	256	1	0.39%	2	1	93	93	0.4999999999999138	1	1	108	148	1	0	-A
barcode89_consensus_vsearch	4044	A	A	248	5	1.95%	2	1	93	93	0.030633033482245435	1	1	99	149	5	0	-C
barcode89_consensus_vsearch	4045	C	C	249	3	1.19%	2	1	93	93	0.12425447316115633	1	1	103	146	0	3	+T
barcode89_consensus_vsearch	4046	C	C	254	3	1.16%	2	1	93	93	0.12426900584791233	1	1	108	146	0	3	T
barcode89_consensus_vsearch	4047	C	Y	169	90	34.75%	2	1	93	93	6.578202196565176E-32	1	1	109	60	0	90	T
barcode89_consensus_vsearch	4048	G	G	257	1	0.39%	2	1	93	93	0.4999999999999138	1	1	109	148	0	1	+C
barcode89_consensus_vsearch	4049	T	Y	250	8	3.09%	2	1	93	93	0.0036969641636293116	1	1	109	141	0	8	C
barcode89_consensus_vsearch	4050	T	T	256	1	0.39%	2	1	93	93	0.4999999999999138	1	1	108	148	1	0	+G
barcode89_consensus_vsearch	4051	G	G	258	1	0.39%	2	1	93	93	0.4999999999999138	1	1	109	149	0	1	-A
barcode89_consensus_vsearch	4052	A	A	257	1	0.39%	2	1	93	93	0.4999999999999138	1	1	108	149	1	0	T
barcode89_consensus_vsearch	4053	A	A	257	1	0.39%	2	1	93	93	0.4999999999999138	1	1	108	149	1	0	G
barcode89_consensus_vsearch	4054	A	A	256	2	0.77%	2	2	93	93	0.24951456310670525	1	1	108	148	1	1	G
barcode89_consensus_vsearch	4055	C	C	259	0	0%	2	0	93	0	1.0	1	0	109	150	0	0	
barcode89_consensus_vsearch	4056	C	C	257	2	0.77%	2	1	93	93	0.24951644100587136	1	1	109	148	0	2	T
barcode89_consensus_vsearch	4057	A	A	257	1	0.39%	2	1	93	93	0.4999999999999138	1	1	109	148	0	1	+CA
barcode89_consensus_vsearch	4058	T	T	258	0	0%	2	0	93	0	1.0	1	0	109	149	0	0	
barcode89_consensus_vsearch	4059	G	G	257	1	0.39%	2	1	93	93	0.4999999999999138	1	1	108	149	1	0	A
barcode89_consensus_vsearch	4060	G	G	257	1	0.39%	2	1	93	93	0.4999999999999138	1	1	108	149	0	1	-T
barcode89_consensus_vsearch	4061	T	T	244	4	1.55%	2	1	93	93	0.06174319257487946	1	1	101	143	4	0	-A
barcode89_consensus_vsearch	4062	A	A	251	2	0.79%	2	1	93	93	0.24950495049494414	1	1	105	146	0	2	G
barcode89_consensus_vsearch	4063	A	A	252	5	1.95%	2	2	93	93	0.030642626352771006	1	1	108	144	1	4	G
barcode89_consensus_vsearch	4064	G	G	252	2	0.77%	2	1	93	93	0.2495069033532105	1	1	103	149	2	0	-C
barcode89_consensus_vsearch	4065	C	C	254	2	0.78%	2	2	93	93	0.2495107632092758	1	1	106	148	1	1	T
barcode89_consensus_vsearch	4066	C	C	253	3	1.16%	2	1	93	93	0.124266144814075	1	1	105	148	3	0	-A
barcode89_consensus_vsearch	4067	A	A	252	2	0.78%	2	2	93	93	0.2495069033532105	1	1	105	147	1	1	G
barcode89_consensus_vsearch	4068	A	A	254	3	1.16%	2	1	93	93	0.12426900584791233	1	1	109	145	0	3	T
barcode89_consensus_vsearch	4069	G	G	258	1	0.39%	2	1	93	93	0.4999999999999138	1	1	109	149	0	1	+CATG
barcode89_consensus_vsearch	4070	A	A	258	1	0.39%	2	1	93	93	0.4999999999999138	1	1	108	150	1	0	G
barcode89_consensus_vsearch	4071	C	C	258	1	0.39%	2	1	93	93	0.4999999999999138	1	1	109	149	0	1	T
barcode89_consensus_vsearch	4072	C	C	256	2	0.77%	2	2	93	93	0.24951456310670525	1	1	108	148	1	1	T
barcode89_consensus_vsearch	4073	A	A	253	2	0.77%	2	1	93	93	0.24950884086425928	1	1	107	146	0	2	G
barcode89_consensus_vsearch	4074	T	T	255	1	0.39%	2	1	93	93	0.4999999999999138	1	1	109	146	0	1	+GT
barcode89_consensus_vsearch	4075	A	A	252	5	1.95%	2	1	93	93	0.030642626352771006	1	1	104	148	5	0	G
barcode89_consensus_vsearch	4076	C	C	257	2	0.77%	2	2	93	93	0.24951644100587136	1	1	108	149	1	1	T
barcode89_consensus_vsearch	4077	C	C	256	2	0.77%	2	1	93	93	0.24951456310670525	1	1	108	148	0	2	T
barcode89_consensus_vsearch	4078	A	A	258	1	0.39%	2	1	93	93	0.4999999999999138	1	1	108	150	1	0	G
barcode89_consensus_vsearch	4079	T	T	257	1	0.39%	2	1	93	93	0.4999999999999138	1	1	107	150	1	0	+C
barcode89_consensus_vsearch	4080	C	C	255	2	0.77%	2	1	93	93	0.2495126705651419	1	1	105	150	2	0	-GAA
barcode89_consensus_vsearch	4081	G	G	247	5	1.95%	2	2	93	93	0.030630587731099716	1	1	99	148	4	1	-A
barcode89_consensus_vsearch	4082	A	A	245	3	1.2%	2	1	93	93	0.1242424242424468	1	1	97	148	3	0	+G
barcode89_consensus_vsearch	4083	A	A	253	1	0.39%	2	1	93	93	0.5000000000003686	1	1	104	149	1	0	+GAGA
barcode89_consensus_vsearch	4084	A	A	257	2	0.77%	2	1	93	93	0.24951644100587136	1	1	107	150	2	0	-G
barcode89_consensus_vsearch	4085	G	G	252	2	0.78%	2	1	93	93	0.2495069033532105	1	1	104	148	0	2	+T
barcode89_consensus_vsearch	4086	T	T	255	1	0.39%	2	1	93	93	0.4999999999999138	1	1	106	149	1	0	C
barcode89_consensus_vsearch	4087	T	T	259	0	0%	2	0	93	0	1.0	1	0	109	150	0	0	
barcode89_consensus_vsearch	4088	G	G	259	0	0%	2	0	93	0	1.0	1	0	109	150	0	0	
barcode89_consensus_vsearch	4089	A	A	259	0	0%	2	0	93	0	1.0	1	0	109	150	0	0	
barcode89_consensus_vsearch	4090	T	T	257	1	0.39%	2	1	93	93	0.4999999999999138	1	1	108	149	1	0	+G
barcode89_consensus_vsearch	4091	A	*/-G	245	9	3.47%	2	2	93	93	0.0018173060047634259	1	1	104	141	1	8	-G
barcode89_consensus_vsearch	4092	G	G	248	1	0.4%	2	1	93	93	0.4999999999999138	1	1	107	141	1	0	A
barcode89_consensus_vsearch	4093	G	G	258	0	0%	2	0	93	0	1.0	1	0	109	149	0	0	
barcode89_consensus_vsearch	4094	G	G	257	1	0.39%	2	1	93	93	0.4999999999999138	1	1	107	150	1	0	+CC
barcode89_consensus_vsearch	4095	C	C	252	3	1.16%	2	1	93	93	0.12426326129665838	1	1	103	149	3	0	-A
barcode89_consensus_vsearch	4096	A	A	254	1	0.39%	2	1	93	93	0.4999999999999138	1	1	106	148	0	1	-GA
barcode89_consensus_vsearch	4097	G	*/-A	250	8	3.1%	2	2	93	93	0.0036969641636293116	1	1	102	148	7	1	-A
barcode89_consensus_vsearch	4098	A	A	249	1	0.4%	2	1	93	93	0.5000000000003686	1	1	102	147	0	1	G
barcode89_consensus_vsearch	4099	A	A	257	2	0.77%	2	2	93	93	0.24951644100587136	1	1	108	149	1	1	G
barcode89_consensus_vsearch	4100	A	A	255	3	1.16%	2	1	93	93	0.1242718446601877	1	1	108	147	0	3	-T
barcode89_consensus_vsearch	4101	T	T	256	0	0%	2	0	93	0	1.0	1	0	109	147	0	0	
barcode89_consensus_vsearch	4102	T	T	258	1	0.39%	2	1	93	93	0.4999999999999138	1	1	109	149	0	1	A
barcode89_consensus_vsearch	4103	T	T	254	2	0.77%	2	1	93	93	0.2495107632092758	1	1	107	147	0	2	A
barcode89_consensus_vsearch	4104	G	G	259	0	0%	2	0	93	0	1.0	1	0	109	150	0	0	
barcode89_consensus_vsearch	4105	A	A	257	1	0.39%	2	1	93	93	0.4999999999999138	1	1	108	149	1	0	+C
barcode89_consensus_vsearch	4106	A	A	258	1	0.39%	2	1	93	93	0.4999999999999138	1	1	108	150	1	0	-T
barcode89_consensus_vsearch	4107	T	T	258	0	0%	2	0	93	0	1.0	1	0	108	150	0	0	
barcode89_consensus_vsearch	4108	G	G	258	1	0.39%	2	1	93	93	0.4999999999999138	1	1	108	150	1	0	-A
barcode89_consensus_vsearch	4109	A	A	257	1	0.39%	2	1	93	93	0.4999999999999138	1	1	108	149	0	1	G
barcode89_consensus_vsearch	4110	A	A	257	1	0.39%	2	1	93	93	0.4999999999999138	1	1	109	148	0	1	+T
barcode89_consensus_vsearch	4111	C	C	259	0	0%	2	0	93	0	1.0	1	0	109	150	0	0	
barcode89_consensus_vsearch	4112	C	C	256	2	0.77%	2	1	93	93	0.24951456310670525	1	1	108	148	0	2	T
barcode89_consensus_vsearch	4113	A	A	256	2	0.78%	2	2	93	93	0.24951456310670525	1	1	107	149	1	1	G
barcode89_consensus_vsearch	4114	T	T	257	1	0.39%	2	1	93	93	0.4999999999999138	1	1	108	149	0	1	C
barcode89_consensus_vsearch	4115	C	C	258	0	0%	2	0	93	0	1.0	1	0	108	150	0	0	
barcode89_consensus_vsearch	4116	G	G	257	1	0.39%	2	1	93	93	0.4999999999999138	1	1	109	148	0	1	-C
barcode89_consensus_vsearch	4117	C	C	257	1	0.39%	2	1	93	93	0.4999999999999138	1	1	109	148	0	1	T
barcode89_consensus_vsearch	4118	C	C	252	5	1.93%	2	2	93	93	0.030642626352771006	1	1	107	145	2	3	-G
barcode89_consensus_vsearch	4119	G	G	249	3	1.18%	2	1	93	93	0.12425447316115633	1	1	104	145	3	0	A
barcode89_consensus_vsearch	4120	G	G	259	0	0%	2	0	93	0	1.0	1	0	109	150	0	0	
barcode89_consensus_vsearch	4121	C	C	254	2	0.77%	2	1	93	93	0.2495107632092758	1	1	105	149	2	0	T
barcode89_consensus_vsearch	4122	A	A	254	3	1.16%	2	1	93	93	0.12426900584791233	1	1	105	149	3	0	T
barcode89_consensus_vsearch	4123	C	C	250	3	1.17%	2	1	93	93	0.12425742574263329	1	1	102	148	3	0	+A
barcode89_consensus_vsearch	4124	A	A	253	2	0.78%	2	1	93	93	0.24950884086425928	1	1	105	148	2	0	G
barcode89_consensus_vsearch	4125	A	A	255	2	0.77%	2	1	93	93	0.2495126705651419	1	1	107	148	0	2	G
barcode89_consensus_vsearch	4126	G	G	257	1	0.39%	2	1	93	93	0.4999999999999138	1	1	107	150	1	0	+A
barcode89_consensus_vsearch	4127	G	G	258	1	0.39%	2	1	93	93	0.4999999999999138	1	1	108	150	1	0	-C
barcode89_consensus_vsearch	4128	C	C	258	0	0%	2	0	93	0	1.0	1	0	108	150	0	0	
barcode89_consensus_vsearch	4129	C	C	258	1	0.39%	2	1	93	93	0.4999999999999138	1	1	108	150	1	0	+AA
barcode89_consensus_vsearch	4130	A	A	253	2	0.77%	2	1	93	93	0.24950884086425928	1	1	107	146	0	2	G
barcode89_consensus_vsearch	4131	T	T	259	0	0%	2	0	93	0	1.0	1	0	109	150	0	0	
barcode89_consensus_vsearch	4132	G	G	255	2	0.77%	2	1	93	93	0.2495126705651419	1	1	107	148	0	2	-CG
barcode89_consensus_vsearch	4133	C	C	255	1	0.39%	2	1	93	93	0.4999999999999138	1	1	108	147	0	1	T
barcode89_consensus_vsearch	4134	G	G	254	3	1.17%	2	1	93	93	0.12426900584791233	1	1	106	148	3	0	-A
barcode89_consensus_vsearch	4135	A	A	253	2	0.78%	2	2	93	93	0.24950884086425928	1	1	105	148	1	1	G
barcode89_consensus_vsearch	4136	T	T	254	3	1.16%	2	1	93	93	0.12426900584791233	1	1	108	146	0	3	+C
barcode89_consensus_vsearch	4137	T	T	255	2	0.77%	2	1	93	93	0.2495126705651419	1	1	109	146	0	2	-C
barcode89_consensus_vsearch	4138	C	C	257	0	0%	2	0	93	0	1.0	1	0	109	148	0	0	
barcode89_consensus_vsearch	4139	G	G	257	1	0.39%	2	1	93	93	0.4999999999999138	1	1	107	150	1	0	+T
barcode89_consensus_vsearch	4140	T	T	257	1	0.39%	2	1	93	93	0.4999999999999138	1	1	108	149	1	0	A
barcode89_consensus_vsearch	4141	T	T	253	3	1.16%	2	2	93	93	0.124266144814075	1	1	107	146	1	2	-A
barcode89_consensus_vsearch	4142	A	A	249	5	1.97%	2	2	93	93	0.03063545999571253	1	1	107	142	1	4	G
barcode89_consensus_vsearch	4143	A	A	251	5	1.95%	2	2	93	93	0.03064025621010106	1	1	108	143	1	4	G
barcode89_consensus_vsearch	4144	G	G	253	2	0.78%	2	2	93	93	0.24950884086425928	1	1	108	145	1	1	+T
barcode89_consensus_vsearch	4145	T	T	253	3	1.17%	2	1	93	93	0.124266144814075	1	1	109	144	0	3	C
barcode89_consensus_vsearch	4146	T	T	250	3	1.17%	2	2	93	93	0.12425742574263329	1	1	105	145	1	2	C
barcode89_consensus_vsearch	4147	A	*/-TTA	246	7	2.71%	2	2	93	93	0.007490846702557751	1	1	106	140	1	6	-TTA
barcode89_consensus_vsearch	4148	T	T	246	2	0.8%	2	2	93	93	0.24949494949494755	1	1	105	141	1	1	C
barcode89_consensus_vsearch	4149	T	T	251	1	0.4%	2	1	93	93	0.5000000000003686	1	1	108	143	0	1	-A
barcode89_consensus_vsearch	4150	A	A	245	6	2.39%	2	1	93	93	0.015159996253657923	1	1	108	137	0	6	G
barcode89_consensus_vsearch	4151	T	Y	251	7	2.7%	2	2	93	93	0.007497030913500092	1	1	108	143	1	6	C
barcode89_consensus_vsearch	4152	G	G	258	1	0.39%	2	1	93	93	0.4999999999999138	1	1	109	149	0	1	-A
barcode89_consensus_vsearch	4153	A	A	253	5	1.94%	2	2	93	93	0.030644978141142375	1	1	108	145	1	4	G
barcode89_consensus_vsearch	4154	A	A	259	0	0%	2	0	93	0	1.0	1	0	109	150	0	0	
barcode89_consensus_vsearch	4155	T	T	256	2	0.77%	2	2	93	93	0.24951456310670525	1	1	108	148	1	1	-C
barcode89_consensus_vsearch	4156	C	*/-A	245	11	4.28%	2	1	93	93	4.375595006058856E-4	1	1	96	149	11	0	-A
barcode89_consensus_vsearch	4157	A	A	243	3	1.21%	2	2	93	93	0.12423625254575449	1	1	94	149	2	1	G
barcode89_consensus_vsearch	4158	C	S	241	9	3.49%	2	1	93	93	0.0018151750748872056	1	1	96	145	9	0	G
barcode89_consensus_vsearch	4159	C	C	247	5	1.93%	2	2	93	93	0.030630587731099716	1	1	101	146	1	4	T
barcode89_consensus_vsearch	4160	A	R	248	8	3.11%	2	2	93	93	0.0036953503162476236	1	1	101	147	5	3	G
barcode89_consensus_vsearch	4161	A	A	252	3	1.16%	2	1	93	93	0.12426326129665838	1	1	106	146	0	3	G
barcode89_consensus_vsearch	4162	G	G	247	6	2.33%	2	2	93	93	0.015163657292611031	1	1	101	146	5	1	A
barcode89_consensus_vsearch	4163	G	G	249	5	1.93%	2	1	93	93	0.03063545999571253	1	1	99	150	5	0	-A
barcode89_consensus_vsearch	4164	A	A	245	3	1.2%	2	2	93	93	0.1242424242424468	1	1	97	148	1	2	G
barcode89_consensus_vsearch	4165	G	*/-C	232	8	3.16%	2	2	93	93	0.0036814848550168837	1	1	89	143	2	6	-C
barcode89_consensus_vsearch	4166	C	C	244	2	0.81%	2	1	93	93	0.24949083503056865	1	1	101	143	2	0	A
barcode89_consensus_vsearch	4167	C	C	252	3	1.18%	2	2	93	93	0.12426326129665838	1	1	103	149	2	1	T
barcode89_consensus_vsearch	4168	C	C	253	3	1.17%	2	2	93	93	0.124266144814075	1	1	104	149	2	1	T
barcode89_consensus_vsearch	4169	C	Y	228	26	10.04%	2	2	93	93	7.595461884955472E-9	1	1	103	125	4	22	T
barcode89_consensus_vsearch	4170	G	*/-A	247	7	2.71%	2	1	93	93	0.00749210286352295	1	1	99	148	7	0	-A
barcode89_consensus_vsearch	4171	A	A	251	1	0.4%	2	1	93	93	0.5000000000003686	1	1	101	150	1	0	G
barcode89_consensus_vsearch	4172	A	*/+G	245	8	3.09%	2	2	93	93	0.003692882342347513	1	1	99	146	5	3	+G
barcode89_consensus_vsearch	4173	G	G	250	2	0.79%	2	1	93	93	0.2495029821073759	1	1	102	148	2	0	+A
barcode89_consensus_vsearch	4174	G	R	247	7	2.71%	2	1	93	93	0.00749210286352295	1	1	97	150	7	0	A
barcode89_consensus_vsearch	4175	G	R	246	8	3.09%	2	1	93	93	0.003693711391797067	1	1	96	150	8	0	A
barcode89_consensus_vsearch	4176	C	Y	231	14	5.47%	2	2	93	93	5.0423072249628895E-5	1	1	84	147	11	3	T
barcode89_consensus_vsearch	4177	A	R	234	16	6.27%	2	1	93	93	1.1910682572909292E-5	1	1	85	149	16	0	G
barcode89_consensus_vsearch	4178	T	T	251	3	1.17%	2	1	93	93	0.12426035502961323	1	1	103	148	3	0	G
barcode89_consensus_vsearch	4179	T	T	254	3	1.16%	2	2	93	93	0.12426900584791233	1	1	106	148	2	1	-G
barcode89_consensus_vsearch	4180	G	G	253	1	0.39%	2	1	93	93	0.5000000000003686	1	1	105	148	0	1	+C
barcode89_consensus_vsearch	4181	G	*/-T	191	34	13.13%	2	2	93	93	1.5114044505292772E-11	1	1	57	134	29	5	-T
barcode89_consensus_vsearch	4182	T	T	205	1	0.48%	2	1	93	93	0.5000000000001412	1	1	65	140	0	1	+G
barcode89_consensus_vsearch	4183	T	T	239	1	0.41%	2	1	93	93	0.4999999999999138	1	1	94	145	1	0	+A
barcode89_consensus_vsearch	4184	T	T	253	1	0.39%	2	1	93	93	0.5000000000003686	1	1	105	148	1	0	G
barcode89_consensus_vsearch	4185	T	T	259	0	0%	2	0	93	0	1.0	1	0	109	150	0	0	
barcode89_consensus_vsearch	4186	T	T	256	2	0.77%	2	1	93	93	0.24951456310670525	1	1	108	148	0	2	C
barcode89_consensus_vsearch	4187	T	T	255	1	0.39%	2	1	93	93	0.4999999999999138	1	1	106	149	1	0	+A
barcode89_consensus_vsearch	4188	A	A	258	1	0.39%	2	1	93	93	0.4999999999999138	1	1	109	149	0	1	C
barcode89_consensus_vsearch	4189	T	T	255	3	1.16%	2	1	93	93	0.1242718446601877	1	1	105	150	3	0	+C
barcode89_consensus_vsearch	4190	C	C	257	1	0.39%	2	1	93	93	0.4999999999999138	1	1	109	148	0	1	+TT
barcode89_consensus_vsearch	4191	T	T	255	2	0.78%	2	2	93	93	0.2495126705651419	1	1	108	147	1	1	C
barcode89_consensus_vsearch	4192	A	A	258	1	0.39%	2	1	93	93	0.4999999999999138	1	1	109	149	0	1	+C
barcode89_consensus_vsearch	4193	A	A	256	2	0.77%	2	1	93	93	0.24951456310670525	1	1	109	147	0	2	C
barcode89_consensus_vsearch	4194	T	T	254	2	0.77%	2	2	93	93	0.2495107632092758	1	1	108	146	1	1	-A
barcode89_consensus_vsearch	4195	A	A	254	1	0.39%	2	1	93	93	0.4999999999999138	1	1	108	146	0	1	G
barcode89_consensus_vsearch	4196	A	A	257	0	0%	2	0	93	0	1.0	1	0	109	148	0	0	
barcode89_consensus_vsearch	4197	A	A	256	1	0.39%	2	1	93	93	0.4999999999999138	1	1	109	147	0	1	-TA
barcode89_consensus_vsearch	4198	T	T	255	1	0.39%	2	1	93	93	0.4999999999999138	1	1	109	146	0	1	+A
barcode89_consensus_vsearch	4199	A	A	252	5	1.94%	2	2	93	93	0.030642626352771006	1	1	104	148	4	1	G
barcode89_consensus_vsearch	4200	C	C	254	3	1.16%	2	2	93	93	0.12426900584791233	1	1	107	147	2	1	T
barcode89_consensus_vsearch	4201	A	*/-C	214	21	8.11%	2	2	93	93	2.9881596198374193E-7	1	1	96	118	3	18	-C
barcode89_consensus_vsearch	4202	C	C	220	2	0.89%	2	2	93	93	0.2494356659142869	1	1	96	124	1	1	+AC
barcode89_consensus_vsearch	4203	C	C	244	2	0.81%	2	1	93	93	0.24949083503056865	1	1	99	145	2	0	T
barcode89_consensus_vsearch	4204	C	C	255	2	0.77%	2	1	93	93	0.2495126705651419	1	1	107	148	0	2	T
barcode89_consensus_vsearch	4205	C	C	258	1	0.39%	2	1	93	93	0.4999999999999138	1	1	108	150	1	0	-T
barcode89_consensus_vsearch	4206	T	T	257	1	0.39%	2	1	93	93	0.4999999999999138	1	1	107	150	1	0	C
barcode89_consensus_vsearch	4207	T	*/-C	243	11	4.25%	2	2	93	93	4.3717375701073373E-4	1	1	96	147	10	1	-C
barcode89_consensus_vsearch	4208	C	C	245	2	0.81%	2	2	93	93	0.24949290060873971	1	1	97	148	1	1	T
barcode89_consensus_vsearch	4209	C	C	249	3	1.16%	2	1	93	93	0.12425447316115633	1	1	103	146	0	3	+G
barcode89_consensus_vsearch	4210	G	G	251	1	0.39%	2	1	93	93	0.5000000000003686	1	1	101	150	1	0	+AA
barcode89_consensus_vsearch	4211	A	A	254	1	0.39%	2	1	93	93	0.4999999999999138	1	1	104	150	1	0	+GA
barcode89_consensus_vsearch	4212	A	A	257	1	0.39%	2	1	93	93	0.4999999999999138	1	1	107	150	1	0	G
barcode89_consensus_vsearch	4213	G	G	259	0	0%	2	0	93	0	1.0	1	0	109	150	0	0	
barcode89_consensus_vsearch	4214	T	T	255	3	1.16%	2	1	93	93	0.1242718446601877	1	1	105	150	3	0	+C
barcode89_consensus_vsearch	4215	C	C	257	2	0.77%	2	1	93	93	0.24951644100587136	1	1	107	150	2	0	-G
barcode89_consensus_vsearch	4216	G	G	250	5	1.95%	2	2	93	93	0.030637867497453432	1	1	101	149	4	1	-A
barcode89_consensus_vsearch	4217	A	A	244	6	2.36%	2	1	93	93	0.015158143859196256	1	1	97	147	6	0	-G
barcode89_consensus_vsearch	4218	G	G	249	1	0.4%	2	1	93	93	0.5000000000003686	1	1	102	147	0	1	+T
barcode89_consensus_vsearch	4219	G	*/-T	233	16	6.2%	2	2	93	93	1.1898454573762536E-5	1	1	88	145	12	4	-T
barcode89_consensus_vsearch	4220	T	T	237	0	0%	2	0	93	0	1.0	1	0	92	145	0	0	
barcode89_consensus_vsearch	4221	T	T	250	2	0.79%	2	1	93	93	0.2495029821073759	1	1	103	147	0	2	C
barcode89_consensus_vsearch	4222	T	T	258	1	0.39%	2	1	93	93	0.4999999999999138	1	1	109	149	0	1	C
barcode89_consensus_vsearch	4223	T	T	258	1	0.39%	2	1	93	93	0.4999999999999138	1	1	109	149	0	1	+CG
barcode89_consensus_vsearch	4224	T	T	256	2	0.77%	2	1	93	93	0.24951456310670525	1	1	109	147	0	2	+G
barcode89_consensus_vsearch	4225	A	A	255	2	0.77%	2	1	93	93	0.2495126705651419	1	1	107	148	0	2	T
barcode89_consensus_vsearch	4226	G	G	255	2	0.78%	2	2	93	93	0.2495126705651419	1	1	107	148	1	1	A
barcode89_consensus_vsearch	4227	C	C	255	2	0.78%	2	2	93	93	0.2495126705651419	1	1	107	148	1	1	T
barcode89_consensus_vsearch	4228	A	A	256	1	0.39%	2	1	93	93	0.4999999999999138	1	1	108	148	0	1	+CA
barcode89_consensus_vsearch	4229	T	T	249	3	1.16%	2	1	93	93	0.12425447316115633	1	1	106	143	0	3	C
barcode89_consensus_vsearch	4230	G	G	249	4	1.55%	2	2	93	93	0.06175816388801474	1	1	104	145	3	1	A
barcode89_consensus_vsearch	4231	T	T	250	3	1.18%	2	2	93	93	0.12425742574263329	1	1	107	143	1	2	C
barcode89_consensus_vsearch	4232	A	A	252	2	0.78%	2	1	93	93	0.2495069033532105	1	1	107	145	0	2	G
barcode89_consensus_vsearch	4233	T	T	250	3	1.17%	2	1	93	93	0.12425742574263329	1	1	106	144	3	0	G
barcode89_consensus_vsearch	4234	T	T	254	2	0.78%	2	2	93	93	0.2495107632092758	1	1	108	146	1	1	C
barcode89_consensus_vsearch	4235	A	A	252	4	1.56%	2	1	93	93	0.06176686569346045	1	1	105	147	4	0	G
barcode89_consensus_vsearch	4236	G	G	257	2	0.77%	2	2	93	93	0.24951644100587136	1	1	108	149	1	1	-C
barcode89_consensus_vsearch	4237	C	C	252	4	1.56%	2	1	93	93	0.06176686569346045	1	1	108	144	0	4	+T
barcode89_consensus_vsearch	4238	T	T	256	1	0.39%	2	1	93	93	0.4999999999999138	1	1	107	149	1	0	+A
barcode89_consensus_vsearch	4239	C	C	252	3	1.16%	2	1	93	93	0.12426326129665838	1	1	107	145	0	3	-T
barcode89_consensus_vsearch	4240	T	T	253	1	0.39%	2	1	93	93	0.5000000000003686	1	1	107	146	1	0	+GC
barcode89_consensus_vsearch	4241	A	A	256	1	0.39%	2	1	93	93	0.4999999999999138	1	1	108	148	1	0	-G
barcode89_consensus_vsearch	4242	G	G	258	0	0%	2	0	93	0	1.0	1	0	108	150	0	0	
barcode89_consensus_vsearch	4243	A	A	258	1	0.39%	2	1	93	93	0.4999999999999138	1	1	108	150	1	0	G
barcode89_consensus_vsearch	4244	A	A	258	1	0.39%	2	1	93	93	0.4999999999999138	1	1	108	150	1	0	G
barcode89_consensus_vsearch	4245	T	T	258	1	0.39%	2	1	93	93	0.4999999999999138	1	1	109	149	0	1	+CTC
barcode89_consensus_vsearch	4246	T	T	256	2	0.77%	2	1	93	93	0.24951456310670525	1	1	107	149	2	0	-A
barcode89_consensus_vsearch	4247	A	A	251	4	1.56%	2	2	93	93	0.06176398786346276	1	1	102	149	3	1	G
barcode89_consensus_vsearch	4248	C	C	255	2	0.78%	2	1	93	93	0.2495126705651419	1	1	107	148	0	2	+TT
barcode89_consensus_vsearch	4249	C	C	254	2	0.77%	2	1	93	93	0.2495107632092758	1	1	106	148	2	0	-A
barcode89_consensus_vsearch	4250	A	A	253	1	0.39%	2	1	93	93	0.5000000000003686	1	1	103	150	1	0	+C
barcode89_consensus_vsearch	4251	C	C	249	3	1.17%	2	2	93	93	0.12425447316115633	1	1	102	147	2	1	T
barcode89_consensus_vsearch	4252	G	G	252	1	0.39%	2	1	93	93	0.5000000000003686	1	1	105	147	1	0	+A
barcode89_consensus_vsearch	4253	G	G	254	2	0.78%	2	1	93	93	0.2495107632092758	1	1	104	150	2	0	T
barcode89_consensus_vsearch	4254	T	T	254	2	0.78%	2	1	93	93	0.2495107632092758	1	1	107	147	0	2	C
barcode89_consensus_vsearch	4255	T	T	255	3	1.16%	2	1	93	93	0.1242718446601877	1	1	108	147	0	3	C
barcode89_consensus_vsearch	4256	A	A	256	2	0.78%	2	1	93	93	0.24951456310670525	1	1	106	150	2	0	G
barcode89_consensus_vsearch	4257	T	*/-C	242	16	6.18%	2	1	93	93	1.2005409850526221E-5	1	1	93	149	16	0	-C
barcode89_consensus_vsearch	4258	C	C	240	3	1.23%	2	1	93	93	0.12422680412363393	1	1	90	150	3	0	+A
barcode89_consensus_vsearch	4259	C	C	252	3	1.16%	2	1	93	93	0.12426326129665838	1	1	103	149	3	0	G
barcode89_consensus_vsearch	4260	A	A	254	2	0.78%	2	2	93	93	0.2495107632092758	1	1	107	147	1	1	G
barcode89_consensus_vsearch	4261	A	A	257	1	0.39%	2	1	93	93	0.4999999999999138	1	1	108	149	1	0	G
barcode89_consensus_vsearch	4262	G	G	258	0	0%	2	0	93	0	1.0	1	0	109	149	0	0	
barcode89_consensus_vsearch	4263	T	T	255	2	0.78%	2	1	93	93	0.2495126705651419	1	1	108	147	0	2	C
barcode89_consensus_vsearch	4264	A	A	256	1	0.39%	2	1	93	93	0.4999999999999138	1	1	108	148	1	0	-G
barcode89_consensus_vsearch	4265	G	G	252	3	1.17%	2	1	93	93	0.12426326129665838	1	1	104	148	3	0	A
barcode89_consensus_vsearch	4266	T	*/-A	242	11	4.28%	2	1	93	93	4.369786788264191E-4	1	1	94	148	11	0	-A
barcode89_consensus_vsearch	4267	A	A	244	1	0.41%	2	1	93	93	0.4999999999999138	1	1	95	149	1	0	C
barcode89_consensus_vsearch	4268	A	A	249	6	2.33%	2	2	93	93	0.015167261137354384	1	1	102	147	4	2	-G
barcode89_consensus_vsearch	4269	G	G	251	2	0.79%	2	1	93	93	0.24950495049494414	1	1	103	148	2	0	+A
barcode89_consensus_vsearch	4270	G	G	258	1	0.39%	2	1	93	93	0.4999999999999138	1	1	108	150	1	0	T
barcode89_consensus_vsearch	4271	T	T	256	2	0.77%	2	1	93	93	0.24951456310670525	1	1	109	147	0	2	C
barcode89_consensus_vsearch	4272	A	A	255	1	0.39%	2	1	93	93	0.4999999999999138	1	1	109	146	0	1	+T
barcode89_consensus_vsearch	4273	C	C	255	1	0.39%	2	1	93	93	0.4999999999999138	1	1	109	146	0	1	+TTC
barcode89_consensus_vsearch	4274	T	T	255	1	0.39%	2	1	93	93	0.4999999999999138	1	1	109	146	0	1	+C
barcode89_consensus_vsearch	4275	A	A	256	1	0.39%	2	1	93	93	0.4999999999999138	1	1	109	147	0	1	+C
barcode89_consensus_vsearch	4276	T	T	255	1	0.39%	2	1	93	93	0.4999999999999138	1	1	109	146	0	1	-C
barcode89_consensus_vsearch	4277	C	C	254	1	0.39%	2	1	93	93	0.4999999999999138	1	1	107	147	1	0	+A
barcode89_consensus_vsearch	4278	A	A	258	0	0%	2	0	93	0	1.0	1	0	109	149	0	0	
barcode89_consensus_vsearch	4279	A	A	256	1	0.39%	2	1	93	93	0.4999999999999138	1	1	109	147	0	1	+C
barcode89_consensus_vsearch	4280	A	A	253	3	1.16%	2	2	93	93	0.124266144814075	1	1	108	145	1	2	G
barcode89_consensus_vsearch	4281	T	T	252	1	0.39%	2	1	93	93	0.5000000000003686	1	1	108	144	1	0	-A
barcode89_consensus_vsearch	4282	A	A	252	1	0.39%	2	1	93	93	0.5000000000003686	1	1	107	145	0	1	+C
barcode89_consensus_vsearch	4283	A	A	254	2	0.78%	2	1	93	93	0.2495107632092758	1	1	109	145	0	2	G
barcode89_consensus_vsearch	4284	A	A	254	2	0.78%	2	2	93	93	0.2495107632092758	1	1	108	146	1	1	G
barcode89_consensus_vsearch	4285	C	C	256	1	0.39%	2	1	93	93	0.4999999999999138	1	1	109	147	0	1	-G
barcode89_consensus_vsearch	4286	G	G	258	0	0%	2	0	93	0	1.0	1	0	109	149	0	0	
barcode89_consensus_vsearch	4287	A	A	258	1	0.39%	2	1	93	93	0.4999999999999138	1	1	109	149	0	1	T
barcode89_consensus_vsearch	4288	T	T	257	1	0.39%	2	1	93	93	0.4999999999999138	1	1	108	149	0	1	-A
barcode89_consensus_vsearch	4289	A	A	257	1	0.39%	2	1	93	93	0.4999999999999138	1	1	108	149	1	0	G
barcode89_consensus_vsearch	4290	A	A	256	2	0.77%	2	1	93	93	0.24951456310670525	1	1	109	147	0	2	+T
barcode89_consensus_vsearch	4291	C	C	256	1	0.39%	2	1	93	93	0.4999999999999138	1	1	109	147	0	1	+T
barcode89_consensus_vsearch	4292	T	T	250	6	2.33%	2	1	93	93	0.015169042029074849	1	1	108	142	0	6	C
barcode89_consensus_vsearch	4293	G	G	255	1	0.39%	2	1	93	93	0.4999999999999138	1	1	108	147	0	1	+TG
barcode89_consensus_vsearch	4294	A	A	255	2	0.77%	2	1	93	93	0.2495126705651419	1	1	108	147	0	2	-T
barcode89_consensus_vsearch	4295	T	T	257	0	0%	2	0	93	0	1.0	1	0	109	148	0	0	
barcode89_consensus_vsearch	4296	T	T	259	0	0%	2	0	93	0	1.0	1	0	109	150	0	0	
barcode89_consensus_vsearch	4297	T	T	257	1	0.39%	2	1	93	93	0.4999999999999138	1	1	108	149	1	0	-A
barcode89_consensus_vsearch	4298	A	A	258	0	0%	2	0	93	0	1.0	1	0	108	150	0	0	
barcode89_consensus_vsearch	4299	A	A	258	1	0.39%	2	1	93	93	0.4999999999999138	1	1	109	149	0	1	G
barcode89_consensus_vsearch	4300	T	T	256	1	0.39%	2	1	93	93	0.4999999999999138	1	1	107	149	1	0	+AT
barcode89_consensus_vsearch	4301	G	G	257	1	0.39%	2	1	93	93	0.4999999999999138	1	1	107	150	1	0	-A
barcode89_consensus_vsearch	4302	A	A	254	1	0.39%	2	1	93	93	0.4999999999999138	1	1	106	148	0	1	-G
barcode89_consensus_vsearch	4303	G	G	256	1	0.39%	2	1	93	93	0.4999999999999138	1	1	107	149	1	0	A
barcode89_consensus_vsearch	4304	C	C	257	1	0.39%	2	1	93	93	0.4999999999999138	1	1	108	149	0	1	A
barcode89_consensus_vsearch	4305	C	C	254	3	1.16%	2	1	93	93	0.12426900584791233	1	1	108	146	0	3	T
barcode89_consensus_vsearch	4306	A	A	258	1	0.39%	2	1	93	93	0.4999999999999138	1	1	108	150	1	0	G
barcode89_consensus_vsearch	4307	T	T	256	3	1.16%	2	1	93	93	0.12427466150865948	1	1	109	147	0	3	+C
barcode89_consensus_vsearch	4308	T	T	252	4	1.54%	2	1	93	93	0.06176686569346045	1	1	108	144	0	4	-C
barcode89_consensus_vsearch	4309	C	C	251	1	0.39%	2	1	93	93	0.5000000000003686	1	1	107	144	0	1	+A
barcode89_consensus_vsearch	4310	G	G	253	3	1.16%	2	2	93	93	0.124266144814075	1	1	105	148	2	1	A
barcode89_consensus_vsearch	4311	C	C	255	2	0.78%	2	1	93	93	0.2495126705651419	1	1	107	148	0	2	T
barcode89_consensus_vsearch	4312	A	A	254	2	0.77%	2	2	93	93	0.2495107632092758	1	1	107	147	1	1	-G
barcode89_consensus_vsearch	4313	G	G	251	3	1.17%	2	1	93	93	0.12426035502961323	1	1	105	146	3	0	+T
barcode89_consensus_vsearch	4314	T	T	253	5	1.94%	2	1	93	93	0.030644978141142375	1	1	109	144	0	5	C
barcode89_consensus_vsearch	4315	T	T	257	1	0.39%	2	1	93	93	0.4999999999999138	1	1	108	149	1	0	C
barcode89_consensus_vsearch	4316	T	T	254	2	0.78%	2	2	93	93	0.2495107632092758	1	1	107	147	1	1	C
barcode89_consensus_vsearch	4317	C	C	255	1	0.39%	2	1	93	93	0.4999999999999138	1	1	107	148	0	1	+A
barcode89_consensus_vsearch	4318	A	A	256	1	0.39%	2	1	93	93	0.4999999999999138	1	1	107	149	1	0	G
barcode89_consensus_vsearch	4319	C	C	254	3	1.16%	2	2	93	93	0.12426900584791233	1	1	108	146	1	2	T
barcode89_consensus_vsearch	4320	G	G	253	4	1.55%	2	1	93	93	0.0617697211064687	1	1	104	149	4	0	A
barcode89_consensus_vsearch	4321	G	G	257	1	0.39%	2	1	93	93	0.4999999999999138	1	1	108	149	1	0	+CGG
barcode89_consensus_vsearch	4322	T	T	254	3	1.16%	2	2	93	93	0.12426900584791233	1	1	108	146	1	2	C
barcode89_consensus_vsearch	4323	A	A	258	0	0%	2	0	93	0	1.0	1	0	109	149	0	0	
barcode89_consensus_vsearch	4324	T	T	252	3	1.16%	2	1	93	93	0.12426326129665838	1	1	103	149	3	0	+G
barcode89_consensus_vsearch	4325	A	A	248	3	1.17%	2	1	93	93	0.12425149700602607	1	1	103	145	0	3	+G
barcode89_consensus_vsearch	4326	G	G	252	3	1.17%	2	1	93	93	0.12426326129665838	1	1	102	150	3	0	-A
barcode89_consensus_vsearch	4327	A	A	255	1	0.39%	2	1	93	93	0.4999999999999138	1	1	106	149	0	1	G
barcode89_consensus_vsearch	4328	T	T	255	3	1.16%	2	1	93	93	0.1242718446601877	1	1	105	150	3	0	G
barcode89_consensus_vsearch	4329	T	T	254	2	0.77%	2	1	93	93	0.2495107632092758	1	1	107	147	0	2	+AA
barcode89_consensus_vsearch	4330	G	G	254	1	0.39%	2	1	93	93	0.4999999999999138	1	1	106	148	0	1	-C
barcode89_consensus_vsearch	4331	C	C	252	2	0.78%	2	1	93	93	0.2495069033532105	1	1	107	145	0	2	-T
barcode89_consensus_vsearch	4332	T	T	253	1	0.39%	2	1	93	93	0.5000000000003686	1	1	106	147	1	0	C
barcode89_consensus_vsearch	4333	T	T	255	1	0.39%	2	1	93	93	0.4999999999999138	1	1	108	147	0	1	+G
barcode89_consensus_vsearch	4334	A	A	257	1	0.39%	2	1	93	93	0.4999999999999138	1	1	108	149	1	0	-TA
barcode89_consensus_vsearch	4335	T	T	256	1	0.39%	2	1	93	93	0.4999999999999138	1	1	106	150	1	0	-A
barcode89_consensus_vsearch	4336	A	A	253	1	0.39%	2	1	93	93	0.5000000000003686	1	1	104	149	0	1	+T
barcode89_consensus_vsearch	4337	C	C	250	4	1.56%	2	1	93	93	0.061761087351402955	1	1	106	144	0	4	-T
barcode89_consensus_vsearch	4338	T	T	250	1	0.4%	2	1	93	93	0.4999999999999138	1	1	105	145	1	0	+GC
barcode89_consensus_vsearch	4339	T	T	256	1	0.39%	2	1	93	93	0.4999999999999138	1	1	108	148	0	1	+GG
barcode89_consensus_vsearch	4340	A	A	251	2	0.77%	2	1	93	93	0.24950495049494414	1	1	108	143	0	2	+G
barcode89_consensus_vsearch	4341	G	G	255	2	0.78%	2	1	93	93	0.2495126705651419	1	1	109	146	0	2	T
barcode89_consensus_vsearch	4342	A	A	256	1	0.39%	2	1	93	93	0.4999999999999138	1	1	109	147	0	1	+T
barcode89_consensus_vsearch	4343	C	C	257	1	0.39%	2	1	93	93	0.4999999999999138	1	1	109	148	0	1	T
barcode89_consensus_vsearch	4344	A	A	253	3	1.16%	2	2	93	93	0.124266144814075	1	1	107	146	2	1	G
barcode89_consensus_vsearch	4345	T	T	254	3	1.16%	2	2	93	93	0.12426900584791233	1	1	106	148	1	2	C
barcode89_consensus_vsearch	4346	G	G	258	1	0.39%	2	1	93	93	0.4999999999999138	1	1	108	150	1	0	+C
barcode89_consensus_vsearch	4347	C	C	257	2	0.77%	2	2	93	93	0.24951644100587136	1	1	108	149	1	1	-AT
barcode89_consensus_vsearch	4348	A	A	253	2	0.78%	2	1	93	93	0.24950884086425928	1	1	104	149	2	0	-T
barcode89_consensus_vsearch	4349	T	T	253	2	0.78%	2	2	93	93	0.24950884086425928	1	1	105	148	1	1	C
barcode89_consensus_vsearch	4350	G	G	255	2	0.77%	2	1	93	93	0.2495126705651419	1	1	106	149	2	0	A
barcode89_consensus_vsearch	4351	G	G	256	2	0.77%	2	2	93	93	0.24951456310670525	1	1	108	148	1	1	A
barcode89_consensus_vsearch	4352	C	Y	246	7	2.7%	2	1	93	93	0.007490846702557751	1	1	106	140	0	7	T
barcode89_consensus_vsearch	4353	T	T	254	1	0.39%	2	1	93	93	0.4999999999999138	1	1	105	149	1	0	A
barcode89_consensus_vsearch	4354	T	T	254	1	0.39%	2	1	93	93	0.4999999999999138	1	1	105	149	0	1	+C
barcode89_consensus_vsearch	4355	A	A	258	0	0%	2	0	93	0	1.0	1	0	108	150	0	0	
barcode89_consensus_vsearch	4356	A	A	254	2	0.77%	2	1	93	93	0.2495107632092758	1	1	108	146	0	2	+T
barcode89_consensus_vsearch	4357	T	T	253	2	0.78%	2	1	93	93	0.24950884086425928	1	1	107	146	0	2	-C
barcode89_consensus_vsearch	4358	C	*/-T	223	25	9.73%	2	1	93	93	1.5768799849423273E-8	1	1	109	114	0	25	-T
barcode89_consensus_vsearch	4359	T	T	232	1	0.43%	2	1	93	93	0.4999999999999138	1	1	109	123	0	1	C
barcode89_consensus_vsearch	4360	T	T	258	0	0%	2	0	93	0	1.0	1	0	109	149	0	0	
barcode89_consensus_vsearch	4361	T	T	254	2	0.77%	2	2	93	93	0.2495107632092758	1	1	106	148	1	1	+G
barcode89_consensus_vsearch	4362	G	G	258	0	0%	2	0	93	0	1.0	1	0	108	150	0	0	
barcode89_consensus_vsearch	4363	A	A	252	4	1.54%	2	1	93	93	0.06176686569346045	1	1	103	149	4	0	-G
barcode89_consensus_vsearch	4364	G	G	255	0	0%	2	0	93	0	1.0	1	0	105	150	0	0	
barcode89_consensus_vsearch	4365	A	A	256	2	0.77%	2	1	93	93	0.24951456310670525	1	1	109	147	0	2	-C
barcode89_consensus_vsearch	4366	C	C	251	3	1.17%	2	2	93	93	0.12426035502961323	1	1	106	145	1	2	-A
barcode89_consensus_vsearch	4367	A	A	254	2	0.78%	2	1	93	93	0.2495107632092758	1	1	108	146	0	2	T
barcode89_consensus_vsearch	4368	A	A	257	2	0.77%	2	1	93	93	0.24951644100587136	1	1	109	148	0	2	-G
barcode89_consensus_vsearch	4369	G	G	249	5	1.95%	2	1	93	93	0.03063545999571253	1	1	103	146	5	0	A
barcode89_consensus_vsearch	4370	C	C	251	5	1.95%	2	1	93	93	0.03064025621010106	1	1	108	143	0	5	T
barcode89_consensus_vsearch	4371	A	A	256	1	0.39%	2	1	93	93	0.4999999999999138	1	1	107	149	0	1	-T
barcode89_consensus_vsearch	4372	T	T	256	0	0%	2	0	93	0	1.0	1	0	107	149	0	0	
barcode89_consensus_vsearch	4373	A	A	253	2	0.78%	2	2	93	93	0.24950884086425928	1	1	104	149	1	1	-T
barcode89_consensus_vsearch	4374	T	T	248	2	0.79%	2	1	93	93	0.24949899799584363	1	1	103	145	0	2	A
barcode89_consensus_vsearch	4375	G	G	246	0	0%	2	0	93	0	1.0	1	0	96	150	0	0	
barcode89_consensus_vsearch	4376	A	A	235	1	0.42%	2	1	93	93	0.4999999999999138	1	1	86	149	1	0	+G
barcode89_consensus_vsearch	4377	C	C	225	1	0.44%	2	1	93	93	0.5000000000003686	1	1	76	149	0	1	T
barcode89_consensus_vsearch	4378	T	T	205	1	0.48%	2	1	93	93	0.5000000000001412	1	1	58	147	0	1	+A
barcode89_consensus_vsearch	4379	A	A	188	0	0%	2	0	93	0	1.0	1	0	39	149	0	0	
barcode89_consensus_vsearch	4380	C	C	172	0	0%	2	0	93	0	1.0	1	0	22	150	0	0	
barcode89_consensus_vsearch	4381	T	T	157	0	0%	2	0	93	0	1.0	1	0	12	145	0	0	
barcode89_consensus_vsearch	4382	G	G	148	0	0%	2	0	93	0	1.0	1	0	3	145	0	0	
