Chrom	Position	Ref	Cons	Reads1	Reads2	VarFreq	Strands1	Strands2	Qual1	Qual2	Pvalue	MapQual1	MapQual2	Reads1Plus	Reads1Minus	Reads2Plus	Reads2Minus	VarAllele
barcode26_consensus_vsearch	44	G	*/-AG	71	20	21.98%	2	2	93	93	2.9538575088167854E-7	1	1	33	38	18	2	-AG
barcode26_consensus_vsearch	117	A	*/-T	82	7	7.53%	2	2	93	93	0.006911923189966942	1	1	50	32	1	6	-T
barcode26_consensus_vsearch	258	A	*/+G	74	11	11.96%	2	1	93	93	3.4578543837704336E-4	1	1	50	24	0	11	+G
barcode26_consensus_vsearch	364	T	*/-C	84	9	9.68%	2	2	93	93	0.0015944646655782606	1	1	45	39	8	1	-C
barcode26_consensus_vsearch	366	C	*/-G	85	7	7.53%	2	1	93	93	0.006940610897217693	1	1	53	32	0	7	-G
barcode26_consensus_vsearch	419	C	*/-A	78	12	12.9%	2	2	93	93	1.6496814457182555E-4	1	1	47	31	4	8	-A
barcode26_consensus_vsearch	435	C	*/-AC	76	13	14.13%	2	2	93	93	7.616134471908988E-5	1	1	38	38	12	1	-AC
barcode26_consensus_vsearch	442	G	*/-TG	80	11	12.09%	2	2	93	93	3.5424699703522257E-4	1	1	50	30	3	8	-TG
barcode26_consensus_vsearch	494	T	*/-G	84	7	7.61%	2	1	93	93	0.00693125337097071	1	1	51	33	0	7	-G
barcode26_consensus_vsearch	627	A	*/-G	76	13	13.98%	2	2	93	93	7.616134471908988E-5	1	1	45	31	6	7	-G
barcode26_consensus_vsearch	653	T	*/-C	81	8	8.89%	2	2	93	93	0.003314489482909416	1	1	46	35	6	2	-C
barcode26_consensus_vsearch	675	G	*/-C	73	14	15.56%	2	1	93	93	3.459841454875879E-5	1	1	35	38	14	0	-C
barcode26_consensus_vsearch	830	A	*/-G	84	7	7.53%	2	2	93	93	0.00693125337097071	1	1	51	33	2	5	-G
barcode26_consensus_vsearch	838	T	*/-C	82	9	9.68%	2	1	93	93	0.0015870180132160528	1	1	53	29	0	9	-C
barcode26_consensus_vsearch	863	A	*/-G	67	17	18.68%	2	2	93	93	3.103551592495373E-6	1	1	38	29	11	6	-G
barcode26_consensus_vsearch	947	T	*/+G	28	50	55.56%	2	2	93	93	5.698733610249646E-21	1	1	12	16	32	18	+G
barcode26_consensus_vsearch	1065	T	*/+G	51	26	28.26%	2	2	93	93	1.1681671483588338E-9	1	1	31	20	13	13	+G
barcode26_consensus_vsearch	1065	T	*/-G	51	13	14.13%	2	2	93	93	6.205139317803629E-5	1	1	31	20	9	4	+G
barcode26_consensus_vsearch	1138	C	*/-TT	80	11	11.96%	2	1	93	93	3.5424699703522257E-4	1	1	41	39	11	0	-TT
barcode26_consensus_vsearch	1142	A	*/-T	80	11	11.83%	2	1	93	93	3.5424699703522257E-4	1	1	41	39	11	0	-T
barcode26_consensus_vsearch	1155	C	*/-G	66	24	26.09%	2	2	93	93	1.0150152563666223E-8	1	1	29	37	21	3	-G
barcode26_consensus_vsearch	1252	T	*/-G	78	9	10.11%	2	1	93	93	0.001571160607841898	1	1	52	26	0	9	-G
barcode26_consensus_vsearch	1318	C	*/-TC	77	10	11.24%	2	1	93	93	7.427304691615481E-4	1	1	52	25	0	10	-TC
barcode26_consensus_vsearch	1326	C	*/-T	68	19	20.43%	2	2	93	93	6.334591144173418E-7	1	1	48	20	2	17	-T
barcode26_consensus_vsearch	1396	C	*/-T	82	7	7.78%	2	1	93	93	0.006911923189966942	1	1	43	39	7	0	-T
barcode26_consensus_vsearch	1446	C	*/-GC	72	17	18.89%	2	2	93	93	3.2819626004164924E-6	1	1	39	33	11	6	-GC
barcode26_consensus_vsearch	1520	T	*/-G	79	10	10.87%	2	2	93	93	7.475771614775334E-4	1	1	42	37	9	1	-G
barcode26_consensus_vsearch	1598	T	*/-C	76	15	16.13%	2	1	93	93	1.6291743559238175E-5	1	1	36	40	15	0	-C
barcode26_consensus_vsearch	1606	C	*/-T	76	17	18.28%	2	2	93	93	3.4157080426369687E-6	1	1	51	25	2	15	-T
barcode26_consensus_vsearch	1673	C	*/-GC	68	18	20.69%	2	2	93	93	1.4140442166994235E-6	1	1	37	31	11	7	-GC
barcode26_consensus_vsearch	1801	C	*/-T	68	19	20.65%	2	2	93	93	6.334591144173418E-7	1	1	34	34	15	4	-T
barcode26_consensus_vsearch	1817	C	*/-GG	82	9	9.89%	2	1	93	93	0.0015870180132160528	1	1	53	29	0	9	-GG
barcode26_consensus_vsearch	1851	A	*/-C	79	10	10.87%	2	2	93	93	7.475771614775334E-4	1	1	51	28	1	9	-C
barcode26_consensus_vsearch	1867	T	*/-A	81	7	7.53%	2	1	93	93	0.006901936923231458	1	1	51	30	0	7	-A
barcode26_consensus_vsearch	1949	C	*/-T	71	15	16.13%	2	2	93	93	1.5653572152005465E-5	1	1	45	26	6	9	-T
barcode26_consensus_vsearch	2109	C	*/-T	79	8	8.6%	2	1	93	93	0.0033014260873630128	1	1	49	30	0	8	-T
barcode26_consensus_vsearch	2132	C	*/-G	80	7	7.53%	2	2	93	93	0.006891726957368562	1	1	45	35	6	1	-G
barcode26_consensus_vsearch	2140	C	*/-T	71	14	15.05%	2	2	93	93	3.409886417825403E-5	1	1	47	24	4	10	-T
barcode26_consensus_vsearch	2160	C	*/-G	61	31	33.33%	2	2	93	93	2.2063550541439167E-11	1	1	35	26	17	14	-G
barcode26_consensus_vsearch	2193	C	*/-T	81	7	7.78%	2	2	93	93	0.006901936923231458	1	1	52	29	1	6	-T
barcode26_consensus_vsearch	2273	A	*/-C	85	8	8.6%	2	2	93	93	0.0033389965937982964	1	1	52	33	1	7	-C
barcode26_consensus_vsearch	2338	T	*/-G	80	8	8.79%	2	2	93	93	0.003308028939537178	1	1	52	28	1	7	-G
barcode26_consensus_vsearch	2403	T	*/-C	80	8	8.6%	2	2	93	93	0.003308028939537178	1	1	51	29	1	7	-C
barcode26_consensus_vsearch	2464	T	*/-CC	73	12	13.19%	2	1	93	93	1.6093158767229742E-4	1	1	36	37	12	0	-CC
barcode26_consensus_vsearch	2471	T	*/-C	85	7	7.61%	2	1	93	93	0.006940610897217693	1	1	46	39	7	0	-C
barcode26_consensus_vsearch	2583	C	*/-A	85	8	8.6%	2	1	93	93	0.0033389965937982964	1	1	53	32	0	8	-A
barcode26_consensus_vsearch	2695	A	*/+G	71	7	7.69%	2	2	93	93	0.006788393631324507	1	1	35	36	5	2	+G
barcode26_consensus_vsearch	2695	A	*/-G	71	12	13.19%	2	2	93	93	1.5920136372256564E-4	1	1	35	36	10	2	-G
barcode26_consensus_vsearch	2698	G	*/-A	81	10	10.75%	2	2	93	93	7.52228191235035E-4	1	1	42	39	9	1	-A
barcode26_consensus_vsearch	2718	G	*/-A	78	10	10.75%	2	2	93	93	7.451790311476478E-4	1	1	49	29	2	8	-A
barcode26_consensus_vsearch	2781	C	*/-T	77	11	11.96%	2	1	93	93	3.501443640331993E-4	1	1	53	24	0	11	-T
barcode26_consensus_vsearch	2815	G	*/-C	80	9	9.78%	2	1	93	93	0.0015792567536216308	1	1	40	40	9	0	-C
barcode26_consensus_vsearch	2847	C	*/-GC	84	8	8.6%	2	2	93	93	0.003333061730303187	1	1	48	36	5	3	-GC
barcode26_consensus_vsearch	2853	A	*/-G	73	8	8.7%	2	2	93	93	0.003258539328248754	1	1	39	34	7	1	-G
barcode26_consensus_vsearch	2964	C	*/-A	85	7	7.53%	2	2	93	93	0.006940610897217693	1	1	46	39	6	1	-A
barcode26_consensus_vsearch	3029	T	*/-G	79	9	9.68%	2	2	93	93	0.0015752518759707308	1	1	43	36	6	3	-G
barcode26_consensus_vsearch	3040	C	*/-T	80	12	12.9%	2	2	93	93	1.6647673084717405E-4	1	1	50	30	2	10	-T
barcode26_consensus_vsearch	3121	T	*/-A	81	8	8.6%	2	2	93	93	0.003314489482909416	1	1	42	39	7	1	-A
barcode26_consensus_vsearch	3204	G	*/-A	80	7	7.53%	2	1	93	93	0.006891726957368562	1	1	40	40	7	0	-A
barcode26_consensus_vsearch	3239	T	*/+C	23	64	72.73%	1	2	93	93	2.0153102542105145E-28	1	1	23	0	27	37	+C
barcode26_consensus_vsearch	3247	T	*/-C	72	14	15.05%	2	2	93	93	3.435089444467519E-5	1	1	47	25	3	11	-C
barcode26_consensus_vsearch	3307	A	*/-G	75	7	7.53%	2	2	93	93	0.00683704333734377	1	1	46	29	1	6	-G
barcode26_consensus_vsearch	3394	G	*/-A	80	9	9.68%	2	2	93	93	0.0015792567536216308	1	1	49	31	3	6	-A
barcode26_consensus_vsearch	3496	T	*/-A	77	7	7.61%	2	2	93	93	0.006859677187733745	1	1	41	36	6	1	-A
barcode26_consensus_vsearch	3563	T	*/-GT	82	11	11.83%	2	2	93	93	3.5685052800487515E-4	1	1	52	30	1	10	-GT
barcode26_consensus_vsearch	3664	A	*/-G	78	9	9.89%	2	2	93	93	0.001571160607841898	1	1	41	37	7	2	-G
barcode26_consensus_vsearch	3687	A	*/-GA	83	9	9.68%	2	1	93	93	0.0015907794621904416	1	1	43	40	9	0	-GA
barcode26_consensus_vsearch	3792	T	*/-C	85	7	7.53%	2	2	93	93	0.006940610897217693	1	1	48	37	5	2	-C
barcode26_consensus_vsearch	3827	T	*/-C	79	9	9.89%	2	2	93	93	0.0015752518759707308	1	1	42	37	8	1	-C
barcode26_consensus_vsearch	3839	G	*/+C	82	8	8.6%	2	1	93	93	0.003320812258867606	1	1	42	40	8	0	+C
barcode26_consensus_vsearch	3889	A	*/-G	76	13	14.13%	2	1	93	93	7.616134471908988E-5	1	1	39	37	13	0	-G
barcode26_consensus_vsearch	3901	T	*/-A	81	9	9.78%	2	1	93	93	0.0015831779373667988	1	1	43	38	9	0	-A
barcode26_consensus_vsearch	3955	A	*/-G	83	7	7.53%	2	1	93	93	0.0069216930214951	1	1	52	31	0	7	-G
barcode26_consensus_vsearch	4015	C	*/-G	79	12	13.04%	2	2	93	93	1.6572958925623843E-4	1	1	44	35	9	3	-G
barcode26_consensus_vsearch	4034	G	*/-A	79	8	8.6%	2	2	93	93	0.0033014260873630128	1	1	42	37	6	2	-A
barcode26_consensus_vsearch	4035	A	*/-G	68	9	11.25%	2	1	93	93	0.001524811000003712	1	1	32	36	9	0	-G
barcode26_consensus_vsearch	4040	G	*/+C	3	48	51.61%	2	2	93	93	6.207069662725423E-26	1	1	1	2	21	27	+C
barcode26_consensus_vsearch	4051	A	*/-G	82	7	7.69%	2	2	93	93	0.006911923189966942	1	1	43	39	6	1	-G
barcode26_consensus_vsearch	4053	G	*/+A	73	8	8.79%	2	1	93	93	0.003258539328248754	1	1	33	40	8	0	+A
barcode26_consensus_vsearch	4085	G	*/-C	72	16	17.2%	2	2	93	93	7.216240748741985E-6	1	1	46	26	3	13	-C
barcode26_consensus_vsearch	4155	T	*/-C	76	14	15.22%	2	1	93	93	3.5315036936783395E-5	1	1	37	39	14	0	-C
barcode26_consensus_vsearch	4197	A	*/-G	69	16	17.39%	2	2	93	93	7.008740900161372E-6	1	1	33	36	13	3	-G
barcode26_consensus_vsearch	4232	T	*/-A	85	7	7.53%	2	1	93	93	0.006940610897217693	1	1	45	40	7	0	-A
barcode26_consensus_vsearch	4267	C	*/-G	83	7	7.61%	2	2	93	93	0.0069216930214951	1	1	51	32	1	6	-G
barcode26_consensus_vsearch	4380	T	*/-G	79	8	8.7%	2	2	93	93	0.0033014260873630128	1	1	41	38	6	2	-G
