Chrom	Position	Ref	Cons	Reads1	Reads2	VarFreq	Strands1	Strands2	Qual1	Qual2	Pvalue	MapQual1	MapQual2	Reads1Plus	Reads1Minus	Reads2Plus	Reads2Minus	VarAllele
barcode61_consensus_vsearch	44	G	*/+A	24	236	52.68%	1	2	93	93	3.744538139486715E-121	1	1	24	0	141	95	+A
barcode61_consensus_vsearch	44	G	*/-T	24	184	41.07%	1	2	93	93	4.200967421809466E-92	1	1	24	0	172	12	+A
barcode61_consensus_vsearch	48	C	*/+A	401	32	7.17%	2	1	93	93	1.2848375480404283E-10	1	1	295	106	32	0	+A
barcode61_consensus_vsearch	48	C	*/-A	401	12	2.69%	2	2	93	93	2.251372974218295E-4	1	1	295	106	11	1	+A
barcode61_consensus_vsearch	49	A	*/+G	417	11	2.53%	2	2	93	93	4.575287206333824E-4	1	1	320	97	3	8	+G
barcode61_consensus_vsearch	55	C	*/-T	431	10	2.23%	2	2	93	93	9.274712732448419E-4	1	1	335	96	3	7	-T
barcode61_consensus_vsearch	113	C	*/-G	393	50	11.21%	2	1	93	93	2.0517889249360997E-16	1	1	288	105	50	0	-G
barcode61_consensus_vsearch	116	A	*/+T	397	20	4.47%	2	2	93	93	7.55234345906367E-7	1	1	305	92	17	3	+T
barcode61_consensus_vsearch	116	A	*/-T	397	24	5.37%	2	2	93	93	4.2541714349285464E-8	1	1	305	92	15	9	-T
barcode61_consensus_vsearch	132	G	*/-C	430	7	1.57%	2	1	93	93	0.007625648020175149	1	1	327	103	7	0	-C
barcode61_consensus_vsearch	144	T	*/+C	438	7	1.56%	2	2	93	93	0.007628991869306366	1	1	333	105	6	1	+C
barcode61_consensus_vsearch	146	A	*/+G	401	18	4.07%	2	2	93	93	3.165704383176564E-6	1	1	306	95	17	1	+G
barcode61_consensus_vsearch	146	A	*/-G	401	11	2.49%	2	2	93	93	4.5635938666550835E-4	1	1	306	95	4	7	+G
barcode61_consensus_vsearch	152	T	*/-A	431	7	1.57%	2	2	93	93	0.007626072650234986	1	1	328	103	6	1	-A
barcode61_consensus_vsearch	159	T	*/-GC	436	8	1.79%	2	1	93	93	0.003783983718069795	1	1	330	106	8	0	-GC
barcode61_consensus_vsearch	176	T	*/+C	428	8	1.81%	2	2	93	93	0.0037817572285023734	1	1	325	103	7	1	+C
barcode61_consensus_vsearch	177	C	*/+A	414	8	1.79%	2	2	93	93	0.00377765934383424	1	1	309	105	7	1	+A
barcode61_consensus_vsearch	177	C	*/-A	414	21	4.71%	2	1	93	93	3.7239194258898957E-7	1	1	309	105	21	0	-A
barcode61_consensus_vsearch	180	G	*/-AG	422	9	2.03%	2	1	93	93	0.0018724555760242295	1	1	316	106	9	0	-AG
barcode61_consensus_vsearch	188	G	*/-TG	431	7	1.56%	2	1	93	93	0.007626072650234986	1	1	331	100	0	7	-TG
barcode61_consensus_vsearch	196	T	*/+A	422	7	1.57%	2	1	93	93	0.007622180052576428	1	1	318	104	7	0	+A
barcode61_consensus_vsearch	196	T	*/+G	422	9	2.01%	2	1	93	93	0.0018724555760242295	1	1	318	104	9	0	+G
barcode61_consensus_vsearch	197	A	*/-G	421	12	2.7%	2	2	93	93	2.259929805737435E-4	1	1	321	100	11	1	-G
barcode61_consensus_vsearch	200	T	*/-C	396	45	10.04%	2	1	93	93	8.710309792628713E-15	1	1	291	105	45	0	-C
barcode61_consensus_vsearch	211	T	*/-C	432	8	1.79%	2	2	93	93	0.0037828805172695963	1	1	327	105	7	1	-C
barcode61_consensus_vsearch	212	C	*/+A	433	7	1.59%	2	1	93	93	0.0076269161468125015	1	1	327	106	7	0	+A
barcode61_consensus_vsearch	221	A	*/-G	421	12	2.7%	2	2	93	93	2.259929805737435E-4	1	1	317	104	11	1	-G
barcode61_consensus_vsearch	223	G	*/+C	430	8	1.79%	2	1	93	93	0.0037823214180042796	1	1	325	105	8	0	+C
barcode61_consensus_vsearch	223	G	*/-C	430	7	1.56%	2	2	93	93	0.007625648020175149	1	1	325	105	5	2	+C
barcode61_consensus_vsearch	236	T	*/-A	414	7	1.58%	2	2	93	93	0.007618580925465677	1	1	311	103	6	1	-A
barcode61_consensus_vsearch	246	T	*/+C	432	7	1.56%	2	1	93	93	0.0076264953547406375	1	1	327	105	7	0	+C
barcode61_consensus_vsearch	252	C	*/-G	426	7	1.56%	2	1	93	93	0.007623929979105209	1	1	320	106	7	0	-G
barcode61_consensus_vsearch	257	A	*/+G	393	20	4.48%	2	1	93	93	7.534883126777725E-7	1	1	319	74	0	20	+G
barcode61_consensus_vsearch	257	A	*/-G	393	14	3.14%	2	2	93	93	5.447629985509777E-5	1	1	319	74	4	10	+G
barcode61_consensus_vsearch	260	C	*/-T	415	13	2.94%	2	2	93	93	1.1128806504032547E-4	1	1	332	83	1	12	-T
barcode61_consensus_vsearch	262	T	*/+C	407	8	1.81%	2	2	93	93	0.0037755075508262973	1	1	328	79	2	6	+C
barcode61_consensus_vsearch	262	T	*/-C	407	17	3.84%	2	1	93	93	6.478169526462627E-6	1	1	328	79	0	17	-C
barcode61_consensus_vsearch	276	C	*/-T	416	19	4.29%	2	2	93	93	1.5602972177488376E-6	1	1	316	100	13	6	-T
barcode61_consensus_vsearch	278	T	*/+C	373	17	3.85%	2	1	93	93	6.384464791951477E-6	1	1	269	104	17	0	+C
barcode61_consensus_vsearch	278	T	*/-C	373	11	2.49%	2	2	93	93	4.5408391815452684E-4	1	1	269	104	9	2	+C
barcode61_consensus_vsearch	279	C	*/-A	413	9	2.07%	2	1	93	93	0.001870754746824021	1	1	310	103	9	0	-A
barcode61_consensus_vsearch	282	T	*/-C	434	7	1.57%	2	2	93	93	0.007627335039353406	1	1	330	104	6	1	-C
barcode61_consensus_vsearch	283	C	*/-A	424	7	1.6%	2	1	93	93	0.007623059056742502	1	1	320	104	7	0	-A
barcode61_consensus_vsearch	292	G	*/-C	432	10	2.25%	2	1	93	93	9.275806861447792E-4	1	1	325	107	10	0	-C
barcode61_consensus_vsearch	299	C	*/-AC	434	10	2.24%	2	1	93	93	9.277980556005647E-4	1	1	328	106	10	0	-AC
barcode61_consensus_vsearch	313	T	*/-GT	438	7	1.57%	2	1	93	93	0.007628991869306366	1	1	332	106	7	0	-GT
barcode61_consensus_vsearch	327	G	*/-A	437	8	1.79%	2	1	93	93	0.00378425644253265	1	1	330	107	8	0	-A
barcode61_consensus_vsearch	337	C	*/-A	427	9	2.01%	2	2	93	93	0.0018733704789343226	1	1	331	96	1	8	-A
barcode61_consensus_vsearch	344	C	*/+G	366	24	5.39%	2	2	93	93	4.1381624104060524E-8	1	1	273	93	23	1	+G
barcode61_consensus_vsearch	344	C	*/-G	366	42	9.44%	2	2	93	93	7.476709021380856E-14	1	1	273	93	34	8	-G
barcode61_consensus_vsearch	348	G	*/-A	399	35	7.81%	2	2	93	93	1.4250740771115744E-11	1	1	293	106	34	1	-A
barcode61_consensus_vsearch	349	A	*/+G	402	7	1.71%	2	1	93	93	0.0076129195598281015	1	1	296	106	7	0	+G
barcode61_consensus_vsearch	350	A	*/-T	415	23	5.17%	2	2	93	93	8.862553133435044E-8	1	1	310	105	21	2	-T
barcode61_consensus_vsearch	352	T	*/-A	420	9	2.01%	2	2	93	93	0.0018720837112055043	1	1	315	105	8	1	-A
barcode61_consensus_vsearch	353	A	*/+G	414	11	2.51%	2	2	93	93	4.573160388822809E-4	1	1	318	96	4	7	+G
barcode61_consensus_vsearch	354	G	*/-A	405	34	7.69%	2	2	93	93	2.9950454991493754E-11	1	1	301	104	33	1	-A
barcode61_consensus_vsearch	358	T	*/-C	436	7	1.57%	2	2	93	93	0.007628167177128368	1	1	337	99	2	5	-C
barcode61_consensus_vsearch	363	T	*/-C	371	73	16.29%	2	2	93	93	4.2016535446009716E-24	1	1	270	101	70	3	-C
barcode61_consensus_vsearch	365	C	*/-G	417	24	5.37%	2	1	93	93	4.321564132228603E-8	1	1	335	82	0	24	-G
barcode61_consensus_vsearch	369	G	*/-A	382	48	10.93%	2	1	93	93	8.856909121728878E-16	1	1	279	103	48	0	-A
barcode61_consensus_vsearch	383	C	*/-AC	422	16	3.58%	2	2	93	93	1.327250199574337E-5	1	1	321	101	14	2	-AC
barcode61_consensus_vsearch	390	C	*/-T	431	9	2.02%	2	1	93	93	0.0018740875957096264	1	1	336	95	0	9	-T
barcode61_consensus_vsearch	396	T	*/-C	420	23	5.16%	2	2	93	93	8.893039670889079E-8	1	1	316	104	22	1	-C
barcode61_consensus_vsearch	398	C	*/+A	410	10	2.23%	2	1	93	93	9.250551591024766E-4	1	1	309	101	10	0	+A
barcode61_consensus_vsearch	398	C	*/-A	410	17	3.79%	2	2	93	93	6.485766389258528E-6	1	1	309	101	15	2	-A
barcode61_consensus_vsearch	400	A	*/-G	427	14	3.15%	2	2	93	93	5.4963399351985964E-5	1	1	324	103	12	2	-G
barcode61_consensus_vsearch	402	G	*/+A	419	12	2.68%	2	1	93	93	2.2591089391076449E-4	1	1	318	101	12	0	+A
barcode61_consensus_vsearch	402	G	*/-A	419	9	2.01%	2	1	93	93	0.0018718964903564012	1	1	318	101	9	0	+A
barcode61_consensus_vsearch	416	C	*/-GC	425	16	3.57%	2	2	93	93	1.328532663205171E-5	1	1	327	98	10	6	-GC
barcode61_consensus_vsearch	418	C	*/-A	397	24	5.58%	2	2	93	93	4.2541714349285464E-8	1	1	317	80	6	18	-A
barcode61_consensus_vsearch	423	T	*/-AC	427	16	3.57%	2	2	93	93	1.3293784930690262E-5	1	1	322	105	15	1	-AC
barcode61_consensus_vsearch	434	C	*/-AC	381	53	11.86%	2	2	93	93	2.0466754296832825E-17	1	1	278	103	52	1	-AC
barcode61_consensus_vsearch	434	C	*/-ACGT	381	11	2.46%	2	2	93	93	4.547664803982017E-4	1	1	278	103	8	3	-AC
barcode61_consensus_vsearch	441	G	*/-TG	407	38	8.5%	2	2	93	93	1.594450255287653E-12	1	1	323	84	15	23	-TG
barcode61_consensus_vsearch	443	G	*/+TG	382	8	1.96%	2	2	93	93	0.0037671973936205536	1	1	302	80	4	4	+TG
barcode61_consensus_vsearch	443	G	*/-AG	382	11	2.69%	2	1	93	93	4.548498903980809E-4	1	1	302	80	11	0	-AG
barcode61_consensus_vsearch	444	A	*/-G	421	12	2.75%	2	2	93	93	2.259929805737435E-4	1	1	315	106	11	1	-G
barcode61_consensus_vsearch	466	T	*/-G	431	8	1.79%	2	2	93	93	0.003782601599602771	1	1	334	97	5	3	-G
barcode61_consensus_vsearch	486	A	*/+C	422	11	2.46%	2	1	93	93	4.57876773436784E-4	1	1	318	104	11	0	+C
barcode61_consensus_vsearch	486	A	*/-C	422	7	1.57%	2	2	93	93	0.007622180052576428	1	1	318	104	6	1	+C
barcode61_consensus_vsearch	489	T	*/-A	392	48	10.79%	2	1	93	93	9.15780298905023E-16	1	1	288	104	48	0	-A
barcode61_consensus_vsearch	493	T	*/-G	425	18	4.03%	2	2	93	93	3.198505438225124E-6	1	1	330	95	8	10	-G
barcode61_consensus_vsearch	498	T	*/+A	436	7	1.56%	2	1	93	93	0.007628167177128368	1	1	329	107	7	0	+A
barcode61_consensus_vsearch	499	G	*/-A	435	9	2.01%	2	1	93	93	0.0018747919330438447	1	1	328	107	9	0	-A
barcode61_consensus_vsearch	501	G	*/-C	423	17	3.84%	2	1	93	93	6.517562209625466E-6	1	1	316	107	17	0	-C
barcode61_consensus_vsearch	502	C	*/+T	418	7	1.62%	2	1	93	93	0.007620397344640596	1	1	323	95	0	7	+T
barcode61_consensus_vsearch	503	C	*/-T	429	10	2.23%	2	2	93	93	9.272509747675099E-4	1	1	338	91	1	9	-T
barcode61_consensus_vsearch	507	T	*/+C	432	10	2.24%	2	1	93	93	9.275806861447792E-4	1	1	328	104	10	0	+C
barcode61_consensus_vsearch	518	G	*/-A	437	9	2.01%	2	2	93	93	0.0018751394156906677	1	1	332	105	8	1	-A
barcode61_consensus_vsearch	520	G	*/-T	435	7	1.57%	2	2	93	93	0.007627752045228881	1	1	336	99	1	6	-T
barcode61_consensus_vsearch	532	T	*/-G	423	19	4.24%	2	2	93	93	1.5653751377054059E-6	1	1	335	88	1	18	-G
barcode61_consensus_vsearch	535	A	*/-G	411	20	4.51%	2	2	93	93	7.611138031103958E-7	1	1	310	101	14	6	-G
barcode61_consensus_vsearch	537	G	*/+A	397	27	6.14%	2	1	93	93	4.859574198197612E-9	1	1	290	107	27	0	+A
barcode61_consensus_vsearch	539	C	*/+A	417	12	2.69%	2	1	93	93	2.2582806164226E-4	1	1	311	106	12	0	+A
barcode61_consensus_vsearch	539	C	*/-A	417	7	1.57%	2	2	93	93	0.007619946437356769	1	1	311	106	6	1	+A
barcode61_consensus_vsearch	563	T	*/-A	428	10	2.25%	2	1	93	93	9.271400825692105E-4	1	1	322	106	10	0	-A
barcode61_consensus_vsearch	567	T	*/-C	429	14	3.14%	2	2	93	93	5.498981101612605E-5	1	1	326	103	13	1	-C
barcode61_consensus_vsearch	575	C	*/-A	437	7	1.57%	2	1	93	93	0.007628580447648388	1	1	331	106	7	0	-A
barcode61_consensus_vsearch	579	A	*/-G	431	7	1.58%	2	2	93	93	0.007626072650234986	1	1	325	106	6	1	-G
barcode61_consensus_vsearch	585	T	*/-AT	430	14	3.13%	2	1	93	93	5.500293094702783E-5	1	1	324	106	14	0	-AT
barcode61_consensus_vsearch	588	G	*/-TG	426	12	2.68%	2	2	93	93	2.2619500050778872E-4	1	1	322	104	10	2	-TG
barcode61_consensus_vsearch	594	T	*/+A	435	9	2.01%	2	1	93	93	0.0018747919330438447	1	1	329	106	9	0	+A
barcode61_consensus_vsearch	624	T	*/+C	421	22	4.93%	2	1	93	93	1.8250798754561758E-7	1	1	317	104	22	0	+C
barcode61_consensus_vsearch	626	A	*/+G	368	10	2.25%	2	1	93	93	9.194317755037062E-4	1	1	285	83	10	0	+G
barcode61_consensus_vsearch	626	A	*/-G	368	47	10.56%	2	2	93	93	1.7866493930385787E-15	1	1	285	83	31	16	-G
barcode61_consensus_vsearch	637	C	*/+A	359	26	5.83%	2	2	93	93	9.629385304093858E-9	1	1	270	89	25	1	+A
barcode61_consensus_vsearch	637	C	*/-A	359	40	8.97%	2	2	93	93	3.250824904352613E-13	1	1	270	89	32	8	-A
barcode61_consensus_vsearch	638	A	*/+G	384	7	1.75%	2	1	93	93	0.007603779356567615	1	1	289	95	7	0	+G
barcode61_consensus_vsearch	639	A	*/+G	404	7	1.59%	2	1	93	93	0.007613885964194907	1	1	304	100	7	0	+G
barcode61_consensus_vsearch	639	A	*/-G	404	15	3.41%	2	2	93	93	2.6864125215700153E-5	1	1	304	100	14	1	-G
barcode61_consensus_vsearch	640	G	*/+A	393	14	3.26%	2	1	93	93	5.447629985509777E-5	1	1	297	96	14	0	+A
barcode61_consensus_vsearch	640	G	*/+C	393	7	1.63%	2	2	93	93	0.007608451759263046	1	1	297	96	3	4	+A
barcode61_consensus_vsearch	641	G	*/+C	378	23	5.16%	2	1	93	93	8.616540172478816E-8	1	1	282	96	23	0	+C
barcode61_consensus_vsearch	641	G	*/+CT	378	7	1.57%	2	1	93	93	0.007600543705812317	1	1	282	96	7	0	+C
barcode61_consensus_vsearch	641	G	*/-T	378	14	3.14%	2	2	93	93	5.423567585746075E-5	1	1	282	96	12	2	-T
barcode61_consensus_vsearch	642	T	*/-AAGT	295	8	1.89%	2	1	93	93	0.0037277059675883554	1	1	213	82	0	8	-AAGT
barcode61_consensus_vsearch	644	A	*/+G	396	7	1.62%	2	1	93	93	0.007609963086240239	1	1	317	79	7	0	+G
barcode61_consensus_vsearch	647	A	*/-C	421	10	2.25%	2	2	93	93	9.263496519144309E-4	1	1	326	95	5	5	-C
barcode61_consensus_vsearch	650	C	*/-T	432	9	2.01%	2	2	93	93	0.001874264864679625	1	1	337	95	1	8	-T
barcode61_consensus_vsearch	652	T	*/+C	428	11	2.47%	2	1	93	93	4.5828417992626897E-4	1	1	328	100	11	0	+C
barcode61_consensus_vsearch	653	C	*/+G	390	17	3.85%	2	2	93	93	6.4331446822125955E-6	1	1	306	84	13	4	+G
barcode61_consensus_vsearch	653	C	*/-G	390	13	2.95%	2	2	93	93	1.1064141909323187E-4	1	1	306	84	6	7	+G
barcode61_consensus_vsearch	660	T	*/-C	431	9	2.01%	2	2	93	93	0.0018740875957096264	1	1	329	102	8	1	-C
barcode61_consensus_vsearch	662	C	*/-T	428	10	2.24%	2	2	93	93	9.271400825692105E-4	1	1	326	102	7	3	-T
barcode61_consensus_vsearch	674	A	*/+C	325	27	6.09%	2	1	93	93	4.4374457293294035E-9	1	1	229	96	27	0	+C
barcode61_consensus_vsearch	674	A	*/-C	325	68	15.35%	2	2	93	93	1.4157950677597215E-22	1	1	229	96	57	11	-C
barcode61_consensus_vsearch	674	A	*/-CC	325	15	3.39%	2	1	93	93	2.606293941980223E-5	1	1	229	96	15	0	-C
barcode61_consensus_vsearch	678	T	*/-A	407	18	4.08%	2	2	93	93	3.1742267644279673E-6	1	1	318	89	9	9	-A
barcode61_consensus_vsearch	678	T	*/-AAT	407	8	1.81%	2	1	93	93	0.0037755075508262973	1	1	318	89	8	0	-A
barcode61_consensus_vsearch	681	T	*/+C	407	14	3.23%	2	2	93	93	5.468602328051435E-5	1	1	320	87	1	13	+C
barcode61_consensus_vsearch	692	C	*/-T	436	11	2.46%	2	2	93	93	4.588107080951123E-4	1	1	338	98	2	9	-T
barcode61_consensus_vsearch	697	T	*/-C	419	16	3.58%	2	2	93	93	1.3259509871934923E-5	1	1	313	106	15	1	-C
barcode61_consensus_vsearch	697	T	*/-CC	419	9	2.01%	2	1	93	93	0.0018718964903564012	1	1	313	106	9	0	-C
barcode61_consensus_vsearch	706	C	*/+G	422	7	1.58%	2	1	93	93	0.007622180052576428	1	1	319	103	7	0	+G
barcode61_consensus_vsearch	707	G	*/+A	423	7	1.58%	2	1	93	93	0.007622620571895094	1	1	317	106	7	0	+A
barcode61_consensus_vsearch	714	T	*/+C	423	7	1.59%	2	1	93	93	0.007622620571895094	1	1	325	98	7	0	+C
barcode61_consensus_vsearch	715	C	*/+A	422	8	1.82%	2	1	93	93	0.003780033413733114	1	1	327	95	8	0	+A
barcode61_consensus_vsearch	725	A	*/+G	435	7	1.57%	2	2	93	93	0.007627752045228881	1	1	331	104	6	1	+G
barcode61_consensus_vsearch	726	G	*/-A	418	10	2.24%	2	1	93	93	9.260031044371504E-4	1	1	312	106	10	0	-A
barcode61_consensus_vsearch	726	G	*/-AG	418	13	2.91%	2	1	93	93	1.1136078182173557E-4	1	1	312	106	13	0	-AG
barcode61_consensus_vsearch	738	C	*/+G	430	12	2.69%	2	1	93	93	2.263534081363424E-4	1	1	324	106	12	0	+G
barcode61_consensus_vsearch	739	A	*/-G	405	12	2.68%	2	1	93	93	2.2531482582750418E-4	1	1	302	103	12	0	-G
barcode61_consensus_vsearch	743	A	*/+C	375	7	1.58%	2	1	93	93	0.007598887968539548	1	1	277	98	7	0	+C
barcode61_consensus_vsearch	743	A	*/+T	375	9	2.03%	2	1	93	93	0.001862705653908663	1	1	277	98	9	0	+T
barcode61_consensus_vsearch	743	A	*/-T	375	40	9.01%	2	2	93	93	3.389190688248127E-13	1	1	277	98	35	5	-T
barcode61_consensus_vsearch	749	G	*/+C	422	8	1.79%	2	1	93	93	0.003780033413733114	1	1	318	104	8	0	+C
barcode61_consensus_vsearch	749	G	*/-C	422	16	3.57%	2	2	93	93	1.327250199574337E-5	1	1	318	104	14	2	-C
barcode61_consensus_vsearch	751	C	*/-G	431	8	1.79%	2	2	93	93	0.003782601599602771	1	1	328	103	4	4	-G
barcode61_consensus_vsearch	769	A	*/+G	437	7	1.56%	2	1	93	93	0.007628580447648388	1	1	332	105	7	0	+G
barcode61_consensus_vsearch	775	A	*/-CA	431	11	2.47%	2	1	93	93	4.584838174083158E-4	1	1	324	107	11	0	-CA
barcode61_consensus_vsearch	797	G	*/-TTG	433	13	2.91%	2	1	93	93	1.1171014262094148E-4	1	1	327	106	13	0	-TTG
barcode61_consensus_vsearch	827	C	*/+A	430	7	1.57%	2	1	93	93	0.007625648020175149	1	1	325	105	7	0	+A
barcode61_consensus_vsearch	828	A	*/+G	390	10	2.24%	2	2	93	93	9.225221739189795E-4	1	1	306	84	2	8	+G
barcode61_consensus_vsearch	828	A	*/-G	390	33	7.4%	2	2	93	93	6.082156133210519E-11	1	1	306	84	26	7	-G
barcode61_consensus_vsearch	835	C	*/+T	427	12	2.69%	2	1	93	93	2.2623486621516718E-4	1	1	337	90	0	12	+T
barcode61_consensus_vsearch	836	T	*/+C	408	11	2.47%	2	1	93	93	4.5688172943049915E-4	1	1	328	80	11	0	+C
barcode61_consensus_vsearch	836	T	*/-C	408	18	4.04%	2	2	93	93	3.1756255130045852E-6	1	1	328	80	2	16	-C
barcode61_consensus_vsearch	837	C	*/-G	382	19	4.49%	2	2	93	93	1.5333310267608091E-6	1	1	321	61	5	14	-G
barcode61_consensus_vsearch	851	C	*/-T	428	12	2.7%	2	1	93	93	2.2627455527610537E-4	1	1	338	90	0	12	-T
barcode61_consensus_vsearch	860	T	*/+A	430	9	2.01%	2	1	93	93	0.0018739095280781474	1	1	326	104	9	0	+A
barcode61_consensus_vsearch	861	A	*/+G	333	10	2.24%	2	2	93	93	9.137141362428344E-4	1	1	251	82	8	2	+G
barcode61_consensus_vsearch	861	A	*/-G	333	91	20.4%	2	2	93	93	1.790128205790256E-30	1	1	251	82	77	14	-G
barcode61_consensus_vsearch	871	T	*/-C	425	11	2.48%	2	2	93	93	4.5808185020506666E-4	1	1	330	95	8	3	-C
barcode61_consensus_vsearch	873	C	*/-T	438	7	1.56%	2	2	93	93	0.007628991869306366	1	1	337	101	3	4	-T
barcode61_consensus_vsearch	875	G	*/+C	424	8	1.79%	2	1	93	93	0.0037806132981311326	1	1	328	96	8	0	+C
barcode61_consensus_vsearch	878	A	*/-C	416	14	3.15%	2	2	93	93	5.4813912517372454E-5	1	1	324	92	6	8	-C
barcode61_consensus_vsearch	882	T	*/+C	425	8	1.8%	2	1	93	93	0.0037809012469126957	1	1	325	100	8	0	+C
barcode61_consensus_vsearch	883	C	*/-A	419	12	2.72%	2	1	93	93	2.2591089391076449E-4	1	1	321	98	12	0	-A
barcode61_consensus_vsearch	901	G	*/-A	425	7	1.6%	2	2	93	93	0.007623495521158642	1	1	321	104	6	1	-A
barcode61_consensus_vsearch	914	T	*/+G	396	14	3.14%	2	1	93	93	5.452239752130743E-5	1	1	291	105	14	0	+G
barcode61_consensus_vsearch	914	T	*/-A	396	13	2.91%	2	1	93	93	1.1080358205957155E-4	1	1	291	105	13	0	+G
barcode61_consensus_vsearch	914	T	*/-AG	396	17	3.81%	2	1	93	93	6.449431495208312E-6	1	1	291	105	17	0	-AG
barcode61_consensus_vsearch	915	A	*/-G	349	45	10.79%	2	2	93	93	7.499361108270261E-15	1	1	272	77	19	26	-G
barcode61_consensus_vsearch	916	G	*/+A	371	7	1.82%	2	1	93	93	0.0075966396580781715	1	1	290	81	7	0	+A
barcode61_consensus_vsearch	917	G	*/+A	412	15	3.36%	2	1	93	93	2.6929497109171117E-5	1	1	305	107	15	0	+A
barcode61_consensus_vsearch	939	G	*/-A	430	13	2.91%	2	2	93	93	1.1164210469075442E-4	1	1	325	105	12	1	-A
barcode61_consensus_vsearch	941	A	*/-G	431	11	2.46%	2	1	93	93	4.584838174083158E-4	1	1	324	107	11	0	-G
barcode61_consensus_vsearch	945	T	*/+G	302	12	2.69%	2	2	93	93	2.1935299970804329E-4	1	1	232	70	5	7	+G
barcode61_consensus_vsearch	945	T	*/-G	302	75	16.82%	2	2	93	93	4.4215249934760855E-25	1	1	232	70	47	28	-G
barcode61_consensus_vsearch	945	T	*/-GG	302	54	12.11%	2	2	93	93	6.303264116045586E-18	1	1	232	70	53	1	-G
barcode61_consensus_vsearch	950	G	*/-A	431	8	1.79%	2	2	93	93	0.003782601599602771	1	1	327	104	7	1	-A
barcode61_consensus_vsearch	952	G	*/+T	412	12	2.73%	2	1	93	93	2.2561765155391507E-4	1	1	331	81	0	12	+T
barcode61_consensus_vsearch	952	G	*/-CA	412	8	1.82%	2	1	93	93	0.003777051806882959	1	1	331	81	0	8	+T
barcode61_consensus_vsearch	953	C	*/+A	387	10	2.29%	2	2	93	93	9.221205845541368E-4	1	1	321	66	6	4	+A
barcode61_consensus_vsearch	953	C	*/-A	387	17	3.9%	2	2	93	93	6.424831942197338E-6	1	1	321	66	8	9	-A
barcode61_consensus_vsearch	963	T	*/+G	435	8	1.79%	2	1	93	93	0.0037837097715777354	1	1	331	104	8	0	+G
barcode61_consensus_vsearch	964	A	*/-G	430	8	1.8%	2	1	93	93	0.0037823214180042796	1	1	324	106	8	0	-G
barcode61_consensus_vsearch	973	T	*/-GT	435	9	2.01%	2	2	93	93	0.0018747919330438447	1	1	329	106	8	1	-GT
barcode61_consensus_vsearch	978	T	*/-C	420	19	4.25%	2	1	93	93	1.5632171313242003E-6	1	1	315	105	19	0	-C
barcode61_consensus_vsearch	981	C	*/-A	428	17	3.79%	2	1	93	93	6.529326572028581E-6	1	1	323	105	17	0	-A
barcode61_consensus_vsearch	992	G	*/-A	434	13	2.91%	2	1	93	93	1.1173262519439844E-4	1	1	327	107	13	0	-A
barcode61_consensus_vsearch	1009	G	*/+A	400	10	2.26%	2	1	93	93	9.238190531010586E-4	1	1	295	105	10	0	+A
barcode61_consensus_vsearch	1013	G	*/+T	408	33	7.4%	2	1	93	93	6.251900657310038E-11	1	1	338	70	0	33	+T
barcode61_consensus_vsearch	1017	G	*/-T	411	23	5.16%	2	2	93	93	8.83772209012808E-8	1	1	330	81	1	22	-T
barcode61_consensus_vsearch	1019	G	*/-CG	424	11	2.48%	2	2	93	93	4.580137992598773E-4	1	1	333	91	1	10	-CG
barcode61_consensus_vsearch	1027	C	*/-GC	431	7	1.58%	2	1	93	93	0.007626072650234986	1	1	324	107	7	0	-GC
barcode61_consensus_vsearch	1030	T	*/+C	429	8	1.8%	2	1	93	93	0.0037820399638697363	1	1	326	103	8	0	+C
barcode61_consensus_vsearch	1031	C	*/+G	406	9	2.01%	2	2	93	93	0.0018693814758962122	1	1	310	96	5	4	+G
barcode61_consensus_vsearch	1031	C	*/-G	406	18	4.03%	2	2	93	93	3.172821898030405E-6	1	1	310	96	13	5	-G
barcode61_consensus_vsearch	1034	G	*/-A	408	33	7.37%	2	1	93	93	6.251900657310038E-11	1	1	302	106	33	0	-A
barcode61_consensus_vsearch	1043	G	*/-A	424	10	2.27%	2	1	93	93	9.266914820866851E-4	1	1	319	105	10	0	-A
barcode61_consensus_vsearch	1046	A	*/-T	426	13	2.91%	2	2	93	93	1.1154998599717698E-4	1	1	326	100	10	3	-T
barcode61_consensus_vsearch	1049	A	*/+G	397	11	2.49%	2	2	93	93	4.5605303044270765E-4	1	1	304	93	2	9	+G
barcode61_consensus_vsearch	1049	A	*/-G	397	16	3.62%	2	1	93	93	1.3158789700561018E-5	1	1	304	93	16	0	-G
barcode61_consensus_vsearch	1050	G	*/-A	412	14	3.25%	2	1	93	93	5.475771402649315E-5	1	1	306	106	14	0	-A
barcode61_consensus_vsearch	1054	C	*/-T	431	10	2.24%	2	2	93	93	9.274712732448419E-4	1	1	336	95	2	8	-T
barcode61_consensus_vsearch	1057	T	*/-G	434	7	1.56%	2	1	93	93	0.007627335039353406	1	1	339	95	0	7	-G
barcode61_consensus_vsearch	1064	T	*/+G	269	98	21.88%	2	2	93	93	1.750688686969295E-33	1	1	210	59	71	27	+G
barcode61_consensus_vsearch	1064	T	*/-G	269	59	13.17%	2	2	93	93	9.85352788253021E-20	1	1	210	59	47	12	+G
barcode61_consensus_vsearch	1064	T	*/-GG	269	11	2.46%	2	2	93	93	4.417722972965338E-4	1	1	210	59	8	3	+G
barcode61_consensus_vsearch	1069	G	*/+A	407	19	4.25%	2	1	93	93	1.5535434164384367E-6	1	1	301	106	19	0	+A
barcode61_consensus_vsearch	1069	G	*/-A	407	16	3.58%	2	2	93	93	1.3205799251268877E-5	1	1	301	106	15	1	+A
barcode61_consensus_vsearch	1078	C	*/+A	428	7	1.58%	2	1	93	93	0.007624792930600719	1	1	325	103	7	0	+A
barcode61_consensus_vsearch	1080	C	*/+A	420	14	3.16%	2	1	93	93	5.486911466049066E-5	1	1	314	106	14	0	+A
barcode61_consensus_vsearch	1084	T	*/+C	437	7	1.57%	2	1	93	93	0.007628580447648388	1	1	331	106	7	0	+C
barcode61_consensus_vsearch	1091	C	*/-TT	429	9	2.01%	2	1	93	93	0.0018737306563855328	1	1	327	102	9	0	-TT
barcode61_consensus_vsearch	1093	T	*/+A	407	12	2.75%	2	2	93	93	2.2540235260924642E-4	1	1	302	105	11	1	+A
barcode61_consensus_vsearch	1093	T	*/-A	407	7	1.6%	2	2	93	93	0.007615318149966635	1	1	302	105	6	1	+A
barcode61_consensus_vsearch	1109	A	*/-G	426	11	2.46%	2	2	93	93	4.581495959366191E-4	1	1	324	102	8	3	-G
barcode61_consensus_vsearch	1110	G	*/+AG	419	11	2.53%	2	1	93	93	4.576688933102391E-4	1	1	315	104	11	0	+AG
barcode61_consensus_vsearch	1113	C	*/+A	430	9	2.01%	2	1	93	93	0.0018739095280781474	1	1	332	98	0	9	+A
barcode61_consensus_vsearch	1120	A	*/+G	429	8	1.79%	2	1	93	93	0.0037820399638697363	1	1	332	97	0	8	+G
barcode61_consensus_vsearch	1124	G	*/-TG	431	7	1.58%	2	1	93	93	0.007626072650234986	1	1	334	97	0	7	-TG
barcode61_consensus_vsearch	1137	C	*/-T	359	12	2.69%	2	2	93	93	2.230490343830887E-4	1	1	255	104	11	1	-T
barcode61_consensus_vsearch	1137	C	*/-TT	359	62	13.9%	2	1	93	93	1.917953230101955E-20	1	1	255	104	62	0	-TT
barcode61_consensus_vsearch	1137	C	*/-TTA	359	7	1.57%	2	1	93	93	0.007589601517637295	1	1	255	104	7	0	-TT
barcode61_consensus_vsearch	1139	T	*/-A	332	12	3.17%	2	2	93	93	2.214460024514316E-4	1	1	226	106	11	1	-A
barcode61_consensus_vsearch	1139	T	*/-AA	332	14	3.7%	2	1	93	93	5.3373901122053535E-5	1	1	226	106	14	0	-AA
barcode61_consensus_vsearch	1141	A	*/-T	376	50	11.63%	2	2	93	93	1.9281364397075053E-16	1	1	272	104	49	1	-T
barcode61_consensus_vsearch	1148	T	*/+C	426	9	2.02%	2	2	93	93	0.001873189162106254	1	1	331	95	4	5	+C
barcode61_consensus_vsearch	1154	C	*/+G	288	14	3.15%	2	2	93	93	5.2317453930316106E-5	1	1	190	98	13	1	+G
barcode61_consensus_vsearch	1154	C	*/-G	288	126	28.38%	2	2	93	93	1.4981852627674702E-43	1	1	190	98	118	8	-G
barcode61_consensus_vsearch	1154	C	*/-GG	288	9	2.03%	2	1	93	93	0.0018366488553743722	1	1	190	98	9	0	-G
barcode61_consensus_vsearch	1158	G	*/-A	427	18	4.03%	2	2	93	93	3.201090232328667E-6	1	1	323	104	15	3	-A
barcode61_consensus_vsearch	1164	C	*/-A	432	7	1.57%	2	1	93	93	0.0076264953547406375	1	1	329	103	7	0	-A
barcode61_consensus_vsearch	1165	A	*/-C	423	8	1.83%	2	1	93	93	0.003780324023462628	1	1	317	106	8	0	-C
barcode61_consensus_vsearch	1168	A	*/+G	425	8	1.79%	2	1	93	93	0.0037809012469126957	1	1	323	102	8	0	+G
barcode61_consensus_vsearch	1183	T	*/-A	434	8	1.79%	2	1	93	93	0.0037834345948323136	1	1	327	107	8	0	-A
barcode61_consensus_vsearch	1184	A	*/+G	401	8	1.83%	2	1	93	93	0.0037736050099275447	1	1	321	80	0	8	+G
barcode61_consensus_vsearch	1184	A	*/-G	401	18	4.13%	2	1	93	93	3.165704383176564E-6	1	1	321	80	0	18	-G
barcode61_consensus_vsearch	1192	C	*/+G	435	8	1.79%	2	1	93	93	0.0037837097715777354	1	1	331	104	8	0	+G
barcode61_consensus_vsearch	1193	A	*/-G	435	8	1.79%	2	1	93	93	0.0037837097715777354	1	1	331	104	8	0	-G
barcode61_consensus_vsearch	1206	C	*/-T	436	10	2.23%	2	2	93	93	9.280135047051926E-4	1	1	339	97	1	9	-T
barcode61_consensus_vsearch	1216	C	*/-TC	433	12	2.68%	2	1	93	93	2.2647039152581312E-4	1	1	327	106	12	0	-TC
barcode61_consensus_vsearch	1251	T	*/-G	411	29	6.52%	2	2	93	93	1.1561587537002726E-9	1	1	330	81	5	24	-G
barcode61_consensus_vsearch	1254	G	*/+A	433	7	1.56%	2	1	93	93	0.0076269161468125015	1	1	327	106	7	0	+A
barcode61_consensus_vsearch	1273	T	*/-C	435	10	2.23%	2	2	93	93	9.279060186061013E-4	1	1	332	103	8	2	-C
barcode61_consensus_vsearch	1281	C	*/+A	424	16	3.59%	2	1	93	93	1.3281070163027198E-5	1	1	317	107	16	0	+A
barcode61_consensus_vsearch	1282	G	*/-A	416	18	4.04%	2	2	93	93	3.1865999582179456E-6	1	1	311	105	17	1	-A
barcode61_consensus_vsearch	1291	C	*/+G	432	7	1.56%	2	2	93	93	0.0076264953547406375	1	1	333	99	2	5	+G
barcode61_consensus_vsearch	1295	A	*/-C	411	23	5.16%	2	2	93	93	8.83772209012808E-8	1	1	309	102	20	3	-C
barcode61_consensus_vsearch	1298	C	*/-A	405	19	4.24%	2	2	93	93	1.552006856145756E-6	1	1	310	95	18	1	-A
barcode61_consensus_vsearch	1298	C	*/-AA	405	7	1.56%	2	2	93	93	0.007614365665405034	1	1	310	95	2	5	-A
barcode61_consensus_vsearch	1314	T	*/-C	398	35	7.9%	2	2	93	93	1.422627177942685E-11	1	1	326	72	7	28	-C
barcode61_consensus_vsearch	1317	C	*/-T	424	8	1.79%	2	1	93	93	0.0037806132981311326	1	1	335	89	0	8	-T
barcode61_consensus_vsearch	1318	T	*/-C	411	11	2.54%	2	2	93	93	4.5710039589920393E-4	1	1	330	81	1	10	-C
barcode61_consensus_vsearch	1325	C	*/-T	423	10	2.24%	2	2	93	93	9.26578056881533E-4	1	1	331	92	2	8	-T
barcode61_consensus_vsearch	1325	C	*/-TT	423	9	2.01%	2	2	93	93	0.0018726402317850155	1	1	331	92	4	5	-T
barcode61_consensus_vsearch	1328	T	*/+C	421	7	1.57%	2	1	93	93	0.007621737484585097	1	1	328	93	7	0	+C
barcode61_consensus_vsearch	1328	T	*/-C	421	8	1.79%	2	2	93	93	0.0037797414596765903	1	1	328	93	2	6	-C
barcode61_consensus_vsearch	1329	C	*/-G	416	7	1.61%	2	1	93	93	0.007619493408432325	1	1	337	79	0	7	-G
barcode61_consensus_vsearch	1335	T	*/-C	431	10	2.24%	2	2	93	93	9.274712732448419E-4	1	1	335	96	1	9	-C
barcode61_consensus_vsearch	1337	G	*/-AG	425	8	1.8%	2	1	93	93	0.0037809012469126957	1	1	319	106	8	0	-AG
barcode61_consensus_vsearch	1338	A	*/-G	371	42	9.7%	2	2	93	93	7.583565295217795E-14	1	1	271	100	40	2	-G
barcode61_consensus_vsearch	1342	C	*/-GGC	427	9	2.03%	2	2	93	93	0.0018733704789343226	1	1	325	102	8	1	-GGC
barcode61_consensus_vsearch	1347	C	*/+T	351	7	1.59%	2	2	93	93	0.0075846487975676224	1	1	266	85	5	2	+T
barcode61_consensus_vsearch	1347	C	*/-T	351	65	14.81%	2	2	93	93	1.7975502414181536E-21	1	1	266	85	57	8	-T
barcode61_consensus_vsearch	1352	C	*/-T	421	15	3.4%	2	2	93	93	2.7000302846488012E-5	1	1	329	92	6	9	-T
barcode61_consensus_vsearch	1356	C	*/-GC	427	11	2.46%	2	2	93	93	4.5821703849988575E-4	1	1	321	106	10	1	-GC
barcode61_consensus_vsearch	1357	G	*/-C	419	7	1.62%	2	2	93	93	0.007620846145152445	1	1	315	104	5	2	-C
barcode61_consensus_vsearch	1359	C	*/-T	424	9	2.01%	2	2	93	93	0.0018728240442215458	1	1	330	94	4	5	-T
barcode61_consensus_vsearch	1361	T	*/-G	409	16	3.62%	2	2	93	93	1.32149501788179E-5	1	1	324	85	3	13	-G
barcode61_consensus_vsearch	1379	T	*/-A	402	40	8.93%	2	2	93	93	3.61018439595374E-13	1	1	301	101	34	6	-A
barcode61_consensus_vsearch	1380	A	*/+G	392	12	2.94%	2	1	93	93	2.2472535825225005E-4	1	1	292	100	12	0	+G
barcode61_consensus_vsearch	1381	A	*/-G	401	17	3.79%	2	2	93	93	6.4626696798029955E-6	1	1	305	96	13	4	-G
barcode61_consensus_vsearch	1382	G	*/+A	408	12	2.82%	2	1	93	93	2.2544581166138029E-4	1	1	310	98	12	0	+A
barcode61_consensus_vsearch	1383	G	*/+A	422	12	2.71%	2	1	93	93	2.2603374744065776E-4	1	1	317	105	12	0	+A
barcode61_consensus_vsearch	1389	G	*/-AG	435	7	1.56%	2	1	93	93	0.007627752045228881	1	1	328	107	7	0	-AG
barcode61_consensus_vsearch	1390	A	*/+G	415	14	3.2%	2	2	93	93	5.479995734771002E-5	1	1	310	105	13	1	+G
barcode61_consensus_vsearch	1394	G	*/-C	409	7	1.56%	2	2	93	93	0.007616261521057028	1	1	307	102	3	4	-C
barcode61_consensus_vsearch	1394	G	*/-CT	409	26	5.8%	2	1	93	93	1.0140503941896291E-8	1	1	307	102	26	0	-CT
barcode61_consensus_vsearch	1395	C	*/-T	363	39	9.44%	2	2	93	93	6.906502609758751E-13	1	1	273	90	33	6	-T
barcode61_consensus_vsearch	1400	C	*/-A	427	13	2.91%	2	2	93	93	1.1157316780867368E-4	1	1	330	97	6	7	-A
barcode61_consensus_vsearch	1429	T	*/-C	426	13	2.9%	2	2	93	93	1.1154998599717698E-4	1	1	320	106	12	1	-C
barcode61_consensus_vsearch	1443	C	*/-GCGC	430	9	2.02%	2	1	93	93	0.0018739095280781474	1	1	327	103	9	0	-GCGC
barcode61_consensus_vsearch	1445	C	*/-G	337	7	1.61%	2	2	93	93	0.0075754305431544305	1	1	257	80	5	2	-G
barcode61_consensus_vsearch	1445	C	*/-GC	337	80	18.39%	2	2	93	93	1.2453935450236844E-26	1	1	257	80	62	18	-GC
barcode61_consensus_vsearch	1480	T	*/+C	428	9	2.02%	2	1	93	93	0.0018735509751739627	1	1	321	107	9	0	+C
barcode61_consensus_vsearch	1480	T	*/-C	428	7	1.57%	2	1	93	93	0.007624792930600719	1	1	321	107	7	0	+C
barcode61_consensus_vsearch	1482	C	*/+G	424	12	2.68%	2	2	93	93	2.2611473442214893E-4	1	1	326	98	7	5	+G
barcode61_consensus_vsearch	1484	A	*/-G	417	20	4.51%	2	1	93	93	7.63528734201053E-7	1	1	312	105	20	0	-G
barcode61_consensus_vsearch	1485	G	*/+A	394	8	1.87%	2	1	93	93	0.0037713141940397903	1	1	293	101	8	0	+A
barcode61_consensus_vsearch	1485	G	*/-A	394	7	1.64%	2	2	93	93	0.007608958034696689	1	1	293	101	6	1	+A
barcode61_consensus_vsearch	1485	G	*/-AG	394	14	3.27%	2	2	93	93	5.4491738001769014E-5	1	1	293	101	11	3	-AG
barcode61_consensus_vsearch	1486	A	*/+G	384	16	3.77%	2	1	93	93	1.309436672524504E-5	1	1	283	101	16	0	+G
barcode61_consensus_vsearch	1486	A	*/-G	384	18	4.25%	2	2	93	93	3.140282000063732E-6	1	1	283	101	16	2	-G
barcode61_consensus_vsearch	1488	G	*/+A	418	20	4.49%	2	1	93	93	7.639253725032686E-7	1	1	311	107	20	0	+A
barcode61_consensus_vsearch	1493	G	*/+AG	422	9	2.02%	2	1	93	93	0.0018724555760242295	1	1	321	101	9	0	+AG
barcode61_consensus_vsearch	1498	T	*/-C	431	11	2.47%	2	2	93	93	4.584838174083158E-4	1	1	328	103	10	1	-C
barcode61_consensus_vsearch	1512	A	*/-T	438	8	1.79%	2	1	93	93	0.0037845279531252564	1	1	339	99	0	8	-T
barcode61_consensus_vsearch	1519	T	*/-G	348	82	18.64%	2	2	93	93	2.8806279907209827E-27	1	1	257	91	68	14	-G
barcode61_consensus_vsearch	1526	C	*/+A	423	9	2.03%	2	1	93	93	0.0018726402317850155	1	1	322	101	9	0	+A
barcode61_consensus_vsearch	1527	G	*/-A	427	11	2.48%	2	1	93	93	4.5821703849988575E-4	1	1	322	105	11	0	-A
barcode61_consensus_vsearch	1533	T	*/-G	430	11	2.46%	2	1	93	93	4.584175673957473E-4	1	1	337	93	0	11	-G
barcode61_consensus_vsearch	1553	T	*/+G	410	7	1.57%	2	1	93	93	0.007616729829810889	1	1	307	103	7	0	+G
barcode61_consensus_vsearch	1553	T	*/-G	410	9	2.02%	2	2	93	93	0.0018701717553889113	1	1	307	103	8	1	-G
barcode61_consensus_vsearch	1555	G	*/+A	428	7	1.57%	2	1	93	93	0.007624792930600719	1	1	325	103	7	0	+A
barcode61_consensus_vsearch	1555	G	*/-A	428	9	2.01%	2	2	93	93	0.0018735509751739627	1	1	325	103	6	3	-A
barcode61_consensus_vsearch	1556	A	*/+G	419	12	2.74%	2	1	93	93	2.2591089391076449E-4	1	1	317	102	12	0	+G
barcode61_consensus_vsearch	1561	C	*/+T	433	9	2.01%	2	1	93	93	0.001874441340367089	1	1	340	93	0	9	+T
barcode61_consensus_vsearch	1572	G	*/-A	431	11	2.47%	2	1	93	93	4.584838174083158E-4	1	1	326	105	11	0	-A
barcode61_consensus_vsearch	1584	C	*/-AC	435	9	2.01%	2	1	93	93	0.0018747919330438447	1	1	329	106	9	0	-AC
barcode61_consensus_vsearch	1590	G	*/-A	432	7	1.59%	2	1	93	93	0.0076264953547406375	1	1	325	107	7	0	-A
barcode61_consensus_vsearch	1596	G	*/+A	418	7	1.58%	2	1	93	93	0.007620397344640596	1	1	311	107	7	0	+A
barcode61_consensus_vsearch	1597	T	*/+C	343	9	2.01%	2	1	93	93	0.001854598209137381	1	1	236	107	9	0	+C
barcode61_consensus_vsearch	1597	T	*/-C	343	89	19.91%	2	1	93	93	1.0245030507884609E-29	1	1	236	107	89	0	-C
barcode61_consensus_vsearch	1600	C	*/-T	429	12	2.68%	2	2	93	93	2.2631406886309665E-4	1	1	325	104	10	2	-T
barcode61_consensus_vsearch	1602	G	*/-C	414	12	2.69%	2	2	93	93	2.2570239286811238E-4	1	1	313	101	9	3	-C
barcode61_consensus_vsearch	1605	C	*/-T	384	50	11.16%	2	2	93	93	1.9866489570765057E-16	1	1	327	57	3	47	-T
barcode61_consensus_vsearch	1614	C	*/-AC	409	33	7.37%	2	2	93	93	6.261040989486667E-11	1	1	307	102	29	4	-AC
barcode61_consensus_vsearch	1618	G	*/-C	438	8	1.79%	2	1	93	93	0.0037845279531252564	1	1	332	106	8	0	-C
barcode61_consensus_vsearch	1636	T	*/+C	433	13	2.9%	2	1	93	93	1.1171014262094148E-4	1	1	327	106	13	0	+C
barcode61_consensus_vsearch	1637	C	*/+A	438	8	1.79%	2	1	93	93	0.0037845279531252564	1	1	331	107	8	0	+A
barcode61_consensus_vsearch	1638	G	*/-A	441	7	1.56%	2	1	93	93	0.0076302151642897355	1	1	334	107	7	0	-A
barcode61_consensus_vsearch	1645	T	*/+C	431	9	2.02%	2	1	93	93	0.0018740875957096264	1	1	330	101	9	0	+C
barcode61_consensus_vsearch	1658	A	*/-G	399	29	6.58%	2	2	93	93	1.1402714240395733E-9	1	1	321	78	11	18	-G
barcode61_consensus_vsearch	1662	G	*/-C	409	9	2.04%	2	2	93	93	0.0018699755869600776	1	1	314	95	1	8	-C
barcode61_consensus_vsearch	1663	C	*/-A	418	8	1.84%	2	2	93	93	0.003778857437644956	1	1	327	91	7	1	-A
barcode61_consensus_vsearch	1665	A	*/-C	426	9	2.01%	2	2	93	93	0.001873189162106254	1	1	329	97	6	3	-C
barcode61_consensus_vsearch	1670	C	*/-GCGC	418	19	4.3%	2	1	93	93	1.5617633199588545E-6	1	1	313	105	19	0	-GCGC
barcode61_consensus_vsearch	1672	C	*/-GC	339	82	19.34%	2	2	93	93	2.602492817564578E-27	1	1	244	95	70	12	-GC
barcode61_consensus_vsearch	1674	C	*/+GC	326	10	2.93%	2	2	93	93	9.124305210040607E-4	1	1	234	92	8	2	+GC
barcode61_consensus_vsearch	1690	G	*/-A	436	9	2.01%	2	1	93	93	0.0018749660605302289	1	1	330	106	9	0	-A
barcode61_consensus_vsearch	1693	G	*/+C	420	13	2.91%	2	1	93	93	1.1140871758939428E-4	1	1	315	105	13	0	+C
barcode61_consensus_vsearch	1696	G	*/-A	430	18	4.02%	2	1	93	93	3.2049271265272453E-6	1	1	323	107	18	0	-A
barcode61_consensus_vsearch	1699	C	*/+A	416	17	3.8%	2	1	93	93	6.500663914761803E-6	1	1	312	104	17	0	+A
barcode61_consensus_vsearch	1700	G	*/-A	424	20	4.49%	2	1	93	93	7.662710322710678E-7	1	1	318	106	20	0	-A
barcode61_consensus_vsearch	1706	C	*/-T	428	8	1.8%	2	2	93	93	0.0037817572285023734	1	1	332	96	1	7	-T
barcode61_consensus_vsearch	1709	C	*/+A	429	7	1.57%	2	1	93	93	0.007625221451403564	1	1	327	102	7	0	+A
barcode61_consensus_vsearch	1710	G	*/-A	434	7	1.57%	2	1	93	93	0.007627335039353406	1	1	328	106	7	0	-A
barcode61_consensus_vsearch	1723	T	*/+A	413	14	3.12%	2	1	93	93	5.4771858527024145E-5	1	1	308	105	14	0	+A
barcode61_consensus_vsearch	1726	A	*/+G	399	8	1.84%	2	2	93	93	0.003772958466097373	1	1	297	102	6	2	+G
barcode61_consensus_vsearch	1726	A	*/-G	399	12	2.76%	2	2	93	93	2.2504727237570137E-4	1	1	297	102	9	3	-G
barcode61_consensus_vsearch	1728	G	*/+A	419	11	2.52%	2	1	93	93	4.576688933102391E-4	1	1	313	106	11	0	+A
barcode61_consensus_vsearch	1744	C	*/+A	426	11	2.46%	2	1	93	93	4.581495959366191E-4	1	1	323	103	11	0	+A
barcode61_consensus_vsearch	1751	T	*/+C	429	8	1.79%	2	2	93	93	0.0037820399638697363	1	1	331	98	6	2	+C
barcode61_consensus_vsearch	1751	T	*/-C	429	7	1.56%	2	2	93	93	0.007625221451403564	1	1	331	98	2	5	+C
barcode61_consensus_vsearch	1779	A	*/-GTA	419	14	3.15%	2	2	93	93	5.485540608158622E-5	1	1	318	101	11	3	-GTA
barcode61_consensus_vsearch	1800	C	*/-T	422	7	1.56%	2	2	93	93	0.007622180052576428	1	1	320	102	3	4	-T
barcode61_consensus_vsearch	1800	C	*/-TT	422	9	2.01%	2	1	93	93	0.0018724555760242295	1	1	320	102	9	0	-TT
barcode61_consensus_vsearch	1827	T	*/-A	401	37	8.3%	2	2	93	93	3.2903576466726563E-12	1	1	330	71	3	34	-A
barcode61_consensus_vsearch	1829	A	*/-G	403	31	6.97%	2	2	93	93	2.672306318115701E-10	1	1	330	73	2	29	-G
barcode61_consensus_vsearch	1831	C	*/-A	418	12	2.73%	2	2	93	93	2.2586957161051062E-4	1	1	323	95	8	4	-A
barcode61_consensus_vsearch	1835	T	*/-CT	428	8	1.8%	2	1	93	93	0.0037817572285023734	1	1	325	103	8	0	-CT
barcode61_consensus_vsearch	1840	T	*/-C	424	21	4.71%	2	1	93	93	3.745160444570394E-7	1	1	318	106	21	0	-C
barcode61_consensus_vsearch	1842	C	*/+G	427	7	1.57%	2	2	93	93	0.007624362444354587	1	1	325	102	3	4	+G
barcode61_consensus_vsearch	1843	G	*/-A	416	10	2.26%	2	1	93	93	9.257694036262042E-4	1	1	310	106	10	0	-A
barcode61_consensus_vsearch	1843	G	*/-AG	416	15	3.39%	2	1	93	93	2.6961314693497337E-5	1	1	310	106	15	0	-AG
barcode61_consensus_vsearch	1854	A	*/+C	376	8	1.79%	2	2	93	93	0.0037650433430064176	1	1	313	63	5	3	+C
barcode61_consensus_vsearch	1854	A	*/-C	376	55	12.33%	2	2	93	93	4.406274528159143E-18	1	1	313	63	15	40	-C
barcode61_consensus_vsearch	1859	T	*/+C	420	12	2.7%	2	1	93	93	2.2595202981245667E-4	1	1	323	97	12	0	+C
barcode61_consensus_vsearch	1866	G	*/-A	406	31	7%	2	1	93	93	2.682888240277408E-10	1	1	299	107	31	0	-A
barcode61_consensus_vsearch	1867	A	*/-G	392	9	2.16%	2	1	93	93	0.0018664928473143382	1	1	285	107	9	0	-G
barcode61_consensus_vsearch	1869	G	*/+C	426	10	2.23%	2	1	93	93	9.269167954843176E-4	1	1	320	106	10	0	+C
barcode61_consensus_vsearch	1875	T	*/+G	423	10	2.28%	2	1	93	93	9.26578056881533E-4	1	1	329	94	0	10	+G
barcode61_consensus_vsearch	1889	T	*/-GT	424	8	1.79%	2	2	93	93	0.0037806132981311326	1	1	331	93	5	3	-GT
barcode61_consensus_vsearch	1894	C	*/+T	417	12	2.7%	2	1	93	93	2.2582806164226E-4	1	1	337	80	0	12	+T
barcode61_consensus_vsearch	1894	C	*/-T	417	9	2.02%	2	2	93	93	0.0018715194418685113	1	1	337	80	1	8	+T
barcode61_consensus_vsearch	1895	T	*/-C	416	13	3%	2	2	93	93	1.1131241336260559E-4	1	1	333	83	5	8	-C
barcode61_consensus_vsearch	1896	C	*/+A	414	9	2.1%	2	1	93	93	0.0018709472608215796	1	1	324	90	9	0	+A
barcode61_consensus_vsearch	1898	T	*/-C	386	55	12.39%	2	1	93	93	4.606995689158521E-18	1	1	280	106	55	0	-C
barcode61_consensus_vsearch	1900	C	*/-G	358	70	15.7%	2	2	93	93	3.9140846671248973E-23	1	1	273	85	50	20	-G
barcode61_consensus_vsearch	1904	G	*/+A	437	7	1.56%	2	1	93	93	0.007628580447648388	1	1	330	107	7	0	+A
barcode61_consensus_vsearch	1908	C	*/-AC	370	70	15.66%	2	2	93	93	4.2881324488309444E-23	1	1	269	101	69	1	-AC
barcode61_consensus_vsearch	1913	T	*/-A	423	12	2.68%	2	1	93	93	2.2607433164831964E-4	1	1	319	104	12	0	-A
barcode61_consensus_vsearch	1917	G	*/-A	440	7	1.56%	2	1	93	93	0.007629809215418646	1	1	333	107	7	0	-A
barcode61_consensus_vsearch	1923	T	*/-C	436	9	2.01%	2	2	93	93	0.0018749660605302289	1	1	333	103	6	3	-C
barcode61_consensus_vsearch	1937	C	*/-T	437	7	1.57%	2	2	93	93	0.007628580447648388	1	1	335	102	3	4	-T
barcode61_consensus_vsearch	1952	T	*/-A	433	10	2.25%	2	1	93	93	9.276896125167864E-4	1	1	326	107	10	0	-A
barcode61_consensus_vsearch	1955	C	*/-A	427	11	2.47%	2	2	93	93	4.5821703849988575E-4	1	1	322	105	10	1	-A
barcode61_consensus_vsearch	1955	C	*/-AA	427	7	1.57%	2	1	93	93	0.007624362444354587	1	1	322	105	7	0	-A
barcode61_consensus_vsearch	1961	G	*/+T	426	12	2.69%	2	1	93	93	2.2619500050778872E-4	1	1	321	105	12	0	+T
barcode61_consensus_vsearch	1983	T	*/+C	380	7	1.56%	2	1	93	93	0.007601633344865528	1	1	282	98	7	0	+C
barcode61_consensus_vsearch	1983	T	*/-C	380	56	12.5%	2	2	93	93	2.1016780455073496E-18	1	1	282	98	48	8	-C
barcode61_consensus_vsearch	1986	C	*/+T	415	9	2.01%	2	1	93	93	0.0018711388771604682	1	1	332	83	0	9	+T
barcode61_consensus_vsearch	1986	C	*/-T	415	12	2.68%	2	2	93	93	2.2574447356982284E-4	1	1	332	83	6	6	-T
barcode61_consensus_vsearch	1991	C	*/-AC	406	39	8.72%	2	1	93	93	7.6166813838523E-13	1	1	300	106	39	0	-AC
barcode61_consensus_vsearch	2040	C	*/+A	429	7	1.57%	2	1	93	93	0.007625221451403564	1	1	327	102	7	0	+A
barcode61_consensus_vsearch	2046	T	*/-C	433	9	2.01%	2	2	93	93	0.001874441340367089	1	1	329	104	8	1	-C
barcode61_consensus_vsearch	2052	A	*/-CT	405	25	5.66%	2	1	93	93	2.0810726875602597E-8	1	1	299	106	25	0	-CT
barcode61_consensus_vsearch	2069	C	*/-G	434	8	1.79%	2	2	93	93	0.0037834345948323136	1	1	329	105	7	1	-G
barcode61_consensus_vsearch	2078	G	*/-A	437	7	1.57%	2	2	93	93	0.007628580447648388	1	1	332	105	6	1	-A
barcode61_consensus_vsearch	2081	C	*/-GC	418	18	4.05%	2	1	93	93	3.189285095484537E-6	1	1	318	100	18	0	-GC
barcode61_consensus_vsearch	2088	C	*/-AC	421	10	2.28%	2	1	93	93	9.263496519144309E-4	1	1	316	105	10	0	-AC
barcode61_consensus_vsearch	2093	C	*/-GC	434	7	1.57%	2	2	93	93	0.007627335039353406	1	1	328	106	6	1	-GC
barcode61_consensus_vsearch	2094	G	*/+C	353	28	6.39%	2	2	93	93	2.226406722969495E-9	1	1	254	99	23	5	+C
barcode61_consensus_vsearch	2094	G	*/-C	353	55	12.56%	2	1	93	93	3.941932293960777E-18	1	1	254	99	55	0	-C
barcode61_consensus_vsearch	2115	G	*/+C	368	10	2.26%	2	2	93	93	9.194317755037062E-4	1	1	288	80	6	4	+C
barcode61_consensus_vsearch	2115	G	*/-C	368	35	7.9%	2	2	93	93	1.3455501358855463E-11	1	1	288	80	14	21	-C
barcode61_consensus_vsearch	2115	G	*/-CC	368	19	4.29%	2	1	93	93	1.520974801320885E-6	1	1	288	80	19	0	-C
barcode61_consensus_vsearch	2119	C	*/+T	379	11	2.46%	2	2	93	93	4.5459840602315744E-4	1	1	311	68	4	7	+T
barcode61_consensus_vsearch	2119	C	*/-T	379	45	10.04%	2	2	93	93	8.284726757731458E-15	1	1	311	68	13	32	-T
barcode61_consensus_vsearch	2119	C	*/-TT	379	7	1.56%	2	1	93	93	0.007601089929303789	1	1	311	68	7	0	-T
barcode61_consensus_vsearch	2124	A	*/+G	423	7	1.58%	2	1	93	93	0.007622620571895094	1	1	316	107	7	0	+G
barcode61_consensus_vsearch	2136	T	*/+C	362	10	2.25%	2	2	93	93	9.185266415574814E-4	1	1	280	82	7	3	+C
barcode61_consensus_vsearch	2136	T	*/-C	362	68	15.28%	2	2	93	93	1.9058566260589806E-22	1	1	280	82	51	17	-C
barcode61_consensus_vsearch	2139	C	*/-T	435	9	2.01%	2	2	93	93	0.0018747919330438447	1	1	335	100	2	7	-T
barcode61_consensus_vsearch	2141	T	*/+C	432	11	2.46%	2	1	93	93	4.5854977422456113E-4	1	1	325	107	11	0	+C
barcode61_consensus_vsearch	2142	C	*/+A	66	24	5.38%	2	1	93	93	1.0150152563666223E-8	1	1	64	2	24	0	+A
barcode61_consensus_vsearch	2142	C	*/+G	66	326	73.09%	2	2	93	93	1.9079057449756885E-154	1	1	64	2	227	99	+G
barcode61_consensus_vsearch	2142	C	*/+GG	66	12	2.69%	2	2	93	93	1.545503652061316E-4	1	1	64	2	11	1	+G
barcode61_consensus_vsearch	2142	C	*/-G	66	10	2.24%	2	2	93	93	7.119584131435621E-4	1	1	64	2	6	4	+G
barcode61_consensus_vsearch	2150	C	*/+T	261	8	1.83%	2	1	93	93	0.003705416747963619	1	1	193	68	8	0	+T
barcode61_consensus_vsearch	2150	C	*/-T	261	121	27.63%	2	2	93	93	4.431972759734164E-42	1	1	193	68	103	18	-T
barcode61_consensus_vsearch	2150	C	*/-TT	261	37	8.45%	2	2	93	93	2.2108615047248607E-12	1	1	193	68	33	4	-T
barcode61_consensus_vsearch	2150	C	*/-TTT	261	10	2.28%	2	1	93	93	8.974229918180157E-4	1	1	193	68	0	10	-T
barcode61_consensus_vsearch	2156	C	*/+A	403	32	7.17%	2	1	93	93	1.2884883167903275E-10	1	1	297	106	32	0	+A
barcode61_consensus_vsearch	2159	G	*/-A	428	10	2.26%	2	1	93	93	9.271400825692105E-4	1	1	322	106	10	0	-A
barcode61_consensus_vsearch	2160	A	*/-GA	423	8	1.83%	2	2	93	93	0.003780324023462628	1	1	317	106	7	1	-GA
barcode61_consensus_vsearch	2165	C	*/+G	422	10	2.23%	2	2	93	93	9.264641146701706E-4	1	1	336	86	1	9	+G
barcode61_consensus_vsearch	2169	T	*/+C	423	14	3.16%	2	1	93	93	5.490987823300768E-5	1	1	339	84	0	14	+C
barcode61_consensus_vsearch	2170	T	*/+C	410	18	4.03%	2	1	93	93	3.1784048153111263E-6	1	1	322	88	18	0	+C
barcode61_consensus_vsearch	2170	T	*/-C	410	18	4.03%	2	2	93	93	3.1784048153111263E-6	1	1	322	88	1	17	+C
barcode61_consensus_vsearch	2171	C	*/-G	296	124	28.9%	2	2	93	93	1.0635213078430909E-42	1	1	224	72	108	16	-G
barcode61_consensus_vsearch	2173	G	*/-A	414	22	4.92%	2	1	93	93	1.817067458098237E-7	1	1	309	105	22	0	-A
barcode61_consensus_vsearch	2176	T	*/+C	423	16	3.59%	2	2	93	93	1.3276795323882159E-5	1	1	318	105	14	2	+C
barcode61_consensus_vsearch	2179	T	*/+C	427	10	2.24%	2	1	93	93	9.270286906046182E-4	1	1	325	102	10	0	+C
barcode61_consensus_vsearch	2201	T	*/-C	432	9	2.03%	2	1	93	93	0.001874264864679625	1	1	341	91	0	9	-C
barcode61_consensus_vsearch	2202	C	*/-TC	412	12	2.75%	2	2	93	93	2.2561765155391507E-4	1	1	333	79	4	8	-TC
barcode61_consensus_vsearch	2203	T	*/+C	418	10	2.32%	2	1	93	93	9.260031044371504E-4	1	1	322	96	10	0	+C
barcode61_consensus_vsearch	2204	C	*/+G	413	14	3.22%	2	1	93	93	5.4771858527024145E-5	1	1	318	95	14	0	+G
barcode61_consensus_vsearch	2205	A	*/-G	428	13	2.91%	2	1	93	93	1.1159624774972868E-4	1	1	326	102	13	0	-G
barcode61_consensus_vsearch	2210	C	*/+AC	433	9	2.02%	2	1	93	93	0.001874441340367089	1	1	328	105	9	0	+AC
barcode61_consensus_vsearch	2215	C	*/-GC	434	8	1.79%	2	2	93	93	0.0037834345948323136	1	1	332	102	7	1	-GC
barcode61_consensus_vsearch	2225	C	*/-T	435	8	1.79%	2	2	93	93	0.0037837097715777354	1	1	333	102	3	5	-T
barcode61_consensus_vsearch	2237	T	*/+C	418	22	4.93%	2	1	93	93	1.821673684445545E-7	1	1	315	103	22	0	+C
barcode61_consensus_vsearch	2246	T	*/+G	432	7	1.57%	2	1	93	93	0.0076264953547406375	1	1	336	96	0	7	+G
barcode61_consensus_vsearch	2247	G	*/-A	431	11	2.47%	2	1	93	93	4.584838174083158E-4	1	1	325	106	11	0	-A
barcode61_consensus_vsearch	2251	G	*/-CG	437	7	1.57%	2	2	93	93	0.007628580447648388	1	1	332	105	5	2	-CG
barcode61_consensus_vsearch	2252	C	*/-G	405	27	6.14%	2	2	93	93	4.899424238601493E-9	1	1	306	99	25	2	-G
barcode61_consensus_vsearch	2254	G	*/-A	425	20	4.46%	2	1	93	93	7.666563733598089E-7	1	1	319	106	20	0	-A
barcode61_consensus_vsearch	2257	T	*/-C	405	38	8.48%	2	2	93	93	1.588257879200269E-12	1	1	299	106	37	1	-C
barcode61_consensus_vsearch	2268	G	*/-C	435	9	2.01%	2	1	93	93	0.0018747919330438447	1	1	330	105	9	0	-C
barcode61_consensus_vsearch	2272	A	*/-G	426	9	2.02%	2	1	93	93	0.001873189162106254	1	1	323	103	9	0	-G
barcode61_consensus_vsearch	2277	C	*/-GC	392	51	11.43%	2	2	93	93	9.645371381600787E-17	1	1	292	100	44	7	-GC
barcode61_consensus_vsearch	2279	C	*/+GC	384	7	1.77%	2	1	93	93	0.007603779356567615	1	1	285	99	7	0	+GC
barcode61_consensus_vsearch	2280	T	*/-G	426	9	2.01%	2	1	93	93	0.001873189162106254	1	1	334	92	0	9	-G
barcode61_consensus_vsearch	2283	A	*/-C	429	14	3.12%	2	2	93	93	5.498981101612605E-5	1	1	323	106	13	1	-C
barcode61_consensus_vsearch	2285	C	*/-G	411	18	4.02%	2	2	93	93	3.1797854475104E-6	1	1	312	99	17	1	-G
barcode61_consensus_vsearch	2286	G	*/+A	360	7	1.65%	2	1	93	93	0.007590205510476451	1	1	261	99	7	0	+A
barcode61_consensus_vsearch	2295	G	*/-C	429	14	3.13%	2	2	93	93	5.498981101612605E-5	1	1	326	103	13	1	-C
barcode61_consensus_vsearch	2304	C	*/-G	431	9	2.02%	2	2	93	93	0.0018740875957096264	1	1	327	104	8	1	-G
barcode61_consensus_vsearch	2305	G	*/-C	421	9	2.05%	2	2	93	93	0.0018722700711233777	1	1	316	105	8	1	-C
barcode61_consensus_vsearch	2307	C	*/+A	399	17	3.82%	2	2	93	93	6.4574101240949084E-6	1	1	297	102	14	3	+A
barcode61_consensus_vsearch	2307	C	*/-A	399	7	1.57%	2	1	93	93	0.007611452190916357	1	1	297	102	7	0	+A
barcode61_consensus_vsearch	2308	A	*/+G	411	10	2.3%	2	1	93	93	9.251755912194793E-4	1	1	308	103	10	0	+G
barcode61_consensus_vsearch	2309	A	*/-G	431	7	1.58%	2	1	93	93	0.007626072650234986	1	1	327	104	7	0	-G
barcode61_consensus_vsearch	2311	T	*/-C	348	87	19.51%	2	1	93	93	5.401568386500419E-29	1	1	243	105	87	0	-C
barcode61_consensus_vsearch	2314	G	*/-A	432	11	2.46%	2	1	93	93	4.5854977422456113E-4	1	1	327	105	11	0	-A
barcode61_consensus_vsearch	2319	G	*/-C	422	21	4.72%	2	2	93	93	3.740981261298434E-7	1	1	333	89	4	17	-C
barcode61_consensus_vsearch	2339	C	*/-T	430	7	1.57%	2	2	93	93	0.007625648020175149	1	1	326	104	6	1	-T
barcode61_consensus_vsearch	2347	A	*/-CA	420	17	3.85%	2	2	93	93	6.510382301474924E-6	1	1	320	100	11	6	-CA
barcode61_consensus_vsearch	2354	C	*/-TC	438	8	1.79%	2	2	93	93	0.0037845279531252564	1	1	337	101	2	6	-TC
barcode61_consensus_vsearch	2359	T	*/+G	390	7	1.56%	2	2	93	93	0.007606917708857565	1	1	321	69	5	2	+G
barcode61_consensus_vsearch	2359	T	*/-G	390	33	7.37%	2	2	93	93	6.082156133210519E-11	1	1	321	69	8	25	-G
barcode61_consensus_vsearch	2359	T	*/-GG	390	8	1.79%	2	2	93	93	0.0037699692796093966	1	1	321	69	1	7	-G
barcode61_consensus_vsearch	2364	T	*/-A	429	8	1.79%	2	2	93	93	0.0037820399638697363	1	1	331	98	5	3	-A
barcode61_consensus_vsearch	2365	A	*/+G	407	9	2.05%	2	2	93	93	0.0018695804538677086	1	1	314	93	1	8	+G
barcode61_consensus_vsearch	2371	A	*/+C	402	13	2.91%	2	1	93	93	1.1096121102660942E-4	1	1	297	105	13	0	+C
barcode61_consensus_vsearch	2371	A	*/-C	402	10	2.24%	2	2	93	93	9.240709968804184E-4	1	1	297	105	8	2	+C
barcode61_consensus_vsearch	2377	T	*/+G	425	7	1.57%	2	1	93	93	0.007623495521158642	1	1	330	95	7	0	+G
barcode61_consensus_vsearch	2378	A	*/-G	437	7	1.57%	2	1	93	93	0.007628580447648388	1	1	332	105	7	0	-G
barcode61_consensus_vsearch	2396	C	*/-AGC	430	11	2.47%	2	1	93	93	4.584175673957473E-4	1	1	326	104	11	0	-AGC
barcode61_consensus_vsearch	2402	A	*/-G	427	9	2.01%	2	1	93	93	0.0018733704789343226	1	1	322	105	9	0	-G
barcode61_consensus_vsearch	2404	G	*/+A	350	21	4.73%	2	2	93	93	3.564078576118766E-7	1	1	254	96	19	2	+A
barcode61_consensus_vsearch	2404	G	*/+AA	350	8	1.8%	2	2	93	93	0.00375488254999716	1	1	254	96	7	1	+A
barcode61_consensus_vsearch	2404	G	*/-A	350	56	12.61%	2	2	93	93	1.8089921469711078E-18	1	1	254	96	51	5	-A
barcode61_consensus_vsearch	2408	A	*/-G	415	12	2.68%	2	2	93	93	2.2574447356982284E-4	1	1	313	102	11	1	-G
barcode61_consensus_vsearch	2408	A	*/-GA	415	7	1.56%	2	1	93	93	0.007619038242851565	1	1	313	102	7	0	-G
barcode61_consensus_vsearch	2413	C	*/+T	392	20	4.49%	2	2	93	93	7.530470174873145E-7	1	1	288	104	19	1	+T
barcode61_consensus_vsearch	2413	C	*/-T	392	28	6.29%	2	2	93	93	2.3392382729302313E-9	1	1	288	104	27	1	-T
barcode61_consensus_vsearch	2416	A	*/-C	409	23	5.15%	2	1	93	93	8.825156056877416E-8	1	1	303	106	23	0	-C
barcode61_consensus_vsearch	2418	C	*/-A	432	9	2.02%	2	1	93	93	0.001874264864679625	1	1	325	107	9	0	-A
barcode61_consensus_vsearch	2419	A	*/-G	403	16	3.67%	2	2	93	93	1.3187249802108927E-5	1	1	313	90	4	12	-G
barcode61_consensus_vsearch	2421	G	*/-A	423	23	5.15%	2	1	93	93	8.911043930919515E-8	1	1	316	107	23	0	-A
barcode61_consensus_vsearch	2424	T	*/+C	411	9	2.01%	2	2	93	93	0.0018703670005234343	1	1	328	83	3	6	+C
barcode61_consensus_vsearch	2424	T	*/-C	411	25	5.58%	2	2	93	93	2.0916845630462182E-8	1	1	328	83	9	16	-C
barcode61_consensus_vsearch	2427	C	*/-T	437	7	1.56%	2	1	93	93	0.007628580447648388	1	1	341	96	0	7	-T
barcode61_consensus_vsearch	2438	C	*/-G	429	9	2.01%	2	2	93	93	0.0018737306563855328	1	1	324	105	8	1	-G
barcode61_consensus_vsearch	2441	G	*/-T	436	9	2.01%	2	1	93	93	0.0018749660605302289	1	1	340	96	0	9	-T
barcode61_consensus_vsearch	2446	G	*/-CG	426	11	2.47%	2	1	93	93	4.581495959366191E-4	1	1	333	93	0	11	-CG
barcode61_consensus_vsearch	2447	C	*/+G	400	11	2.53%	2	2	93	93	4.5628334474193127E-4	1	1	329	71	5	6	+G
barcode61_consensus_vsearch	2447	C	*/-G	400	13	3%	2	2	93	93	1.1090916003185617E-4	1	1	329	71	3	10	-G
barcode61_consensus_vsearch	2464	G	*/-TG	423	17	3.8%	2	2	93	93	6.517562209625466E-6	1	1	331	92	5	12	-TG
barcode61_consensus_vsearch	2476	C	*/+A	392	18	4.04%	2	1	93	93	3.152488292761702E-6	1	1	302	90	18	0	+A
barcode61_consensus_vsearch	2476	C	*/+G	392	11	2.47%	2	2	93	93	4.5566171886911473E-4	1	1	302	90	9	2	+A
barcode61_consensus_vsearch	2476	C	*/-G	392	14	3.15%	2	2	93	93	5.446078876839059E-5	1	1	302	90	9	5	-G
barcode61_consensus_vsearch	2477	G	*/+AA	367	7	1.64%	2	1	93	93	0.0075943435189384555	1	1	275	92	7	0	+AA
barcode61_consensus_vsearch	2481	T	*/+A	409	9	2.04%	2	1	93	93	0.0018699755869600776	1	1	313	96	9	0	+A
barcode61_consensus_vsearch	2481	T	*/-A	409	9	2.04%	2	2	93	93	0.0018699755869600776	1	1	313	96	4	5	+A
barcode61_consensus_vsearch	2487	T	*/+C	420	13	2.95%	2	1	93	93	1.1140871758939428E-4	1	1	320	100	13	0	+C
barcode61_consensus_vsearch	2488	C	*/-GG	426	7	1.58%	2	1	93	93	0.007623929979105209	1	1	330	96	0	7	-GG
barcode61_consensus_vsearch	2492	T	*/-C	432	10	2.24%	2	1	93	93	9.275806861447792E-4	1	1	325	107	10	0	-C
barcode61_consensus_vsearch	2501	T	*/-GC	430	7	1.57%	2	2	93	93	0.007625648020175149	1	1	329	101	6	1	-GC
barcode61_consensus_vsearch	2505	C	*/-T	434	7	1.57%	2	2	93	93	0.007627335039353406	1	1	334	100	4	3	-T
barcode61_consensus_vsearch	2529	T	*/+A	403	9	2.02%	2	1	93	93	0.0018687788150290171	1	1	300	103	9	0	+A
barcode61_consensus_vsearch	2529	T	*/-A	403	22	4.93%	2	2	93	93	1.8040052925584687E-7	1	1	300	103	20	2	-A
barcode61_consensus_vsearch	2538	T	*/-G	422	13	2.91%	2	2	93	93	1.1145622644220473E-4	1	1	325	97	9	4	-G
barcode61_consensus_vsearch	2544	T	*/-C	430	14	3.12%	2	1	93	93	5.500293094702783E-5	1	1	323	107	14	0	-C
barcode61_consensus_vsearch	2554	C	*/-AC	433	7	1.56%	2	1	93	93	0.0076269161468125015	1	1	326	107	7	0	-AC
barcode61_consensus_vsearch	2560	A	*/+C	404	11	2.48%	2	2	93	93	4.5658536003316156E-4	1	1	310	94	8	3	+C
barcode61_consensus_vsearch	2560	A	*/-C	404	24	5.41%	2	2	93	93	4.2783737626049086E-8	1	1	310	94	16	8	-C
barcode61_consensus_vsearch	2567	A	*/-G	383	47	10.66%	2	2	93	93	1.8800697430726687E-15	1	1	278	105	45	2	-G
barcode61_consensus_vsearch	2574	T	*/+G	429	8	1.8%	2	1	93	93	0.0037820399638697363	1	1	326	103	8	0	+G
barcode61_consensus_vsearch	2577	T	*/-C	429	11	2.47%	2	2	93	93	4.5835102222652706E-4	1	1	326	103	10	1	-C
barcode61_consensus_vsearch	2588	C	*/-T	434	7	1.58%	2	2	93	93	0.007627335039353406	1	1	334	100	2	5	-T
barcode61_consensus_vsearch	2590	G	*/-CCTG	426	14	3.12%	2	1	93	93	5.495010686777893E-5	1	1	319	107	14	0	-CCTG
barcode61_consensus_vsearch	2597	C	*/-T	432	7	1.59%	2	1	93	93	0.0076264953547406375	1	1	332	100	0	7	-T
barcode61_consensus_vsearch	2598	T	*/-C	428	7	1.6%	2	2	93	93	0.007624792930600719	1	1	334	94	2	5	-C
barcode61_consensus_vsearch	2604	C	*/-A	415	28	6.25%	2	2	93	93	2.398315875980072E-9	1	1	337	78	1	27	-A
barcode61_consensus_vsearch	2607	T	*/+C	415	13	2.92%	2	1	93	93	1.1128806504032547E-4	1	1	336	79	0	13	+C
barcode61_consensus_vsearch	2616	C	*/-T	419	12	2.68%	2	1	93	93	2.2591089391076449E-4	1	1	336	83	0	12	-T
barcode61_consensus_vsearch	2616	C	*/-TC	419	10	2.24%	2	1	93	93	9.261191504201837E-4	1	1	336	83	0	10	-T
barcode61_consensus_vsearch	2623	A	*/+G	427	12	2.71%	2	1	93	93	2.2623486621516718E-4	1	1	321	106	12	0	+G
barcode61_consensus_vsearch	2632	G	*/+T	388	33	7.38%	2	1	93	93	6.062665397875952E-11	1	1	286	102	33	0	+T
barcode61_consensus_vsearch	2632	G	*/-T	388	22	4.92%	2	2	93	93	1.7851999439113114E-7	1	1	286	102	18	4	+T
barcode61_consensus_vsearch	2653	T	*/-G	422	11	2.48%	2	2	93	93	4.57876773436784E-4	1	1	329	93	6	5	-G
barcode61_consensus_vsearch	2656	G	*/-AG	426	13	2.91%	2	1	93	93	1.1154998599717698E-4	1	1	321	105	13	0	-AG
barcode61_consensus_vsearch	2657	A	*/-G	410	8	1.86%	2	1	93	93	0.003776438502445107	1	1	306	104	8	0	-G
barcode61_consensus_vsearch	2660	T	*/+A	427	7	1.58%	2	2	93	93	0.007624362444354587	1	1	324	103	6	1	+A
barcode61_consensus_vsearch	2665	A	*/-C	428	8	1.8%	2	2	93	93	0.0037817572285023734	1	1	325	103	6	2	-C
barcode61_consensus_vsearch	2667	C	*/-T	437	7	1.57%	2	2	93	93	0.007628580447648388	1	1	338	99	2	5	-T
barcode61_consensus_vsearch	2669	T	*/+C	423	13	2.91%	2	1	93	93	1.1147982255220776E-4	1	1	318	105	13	0	+C
barcode61_consensus_vsearch	2670	C	*/-T	436	9	2.01%	2	2	93	93	0.0018749660605302289	1	1	338	98	2	7	-T
barcode61_consensus_vsearch	2671	T	*/-A	414	14	3.19%	2	2	93	93	5.478593949196498E-5	1	1	319	95	12	2	-A
barcode61_consensus_vsearch	2677	T	*/-A	435	7	1.56%	2	2	93	93	0.007627752045228881	1	1	336	99	2	5	-A
barcode61_consensus_vsearch	2704	A	*/-CA	426	11	2.46%	2	2	93	93	4.581495959366191E-4	1	1	331	95	2	9	-CA
barcode61_consensus_vsearch	2715	G	*/-A	429	8	1.8%	2	1	93	93	0.0037820399638697363	1	1	323	106	8	0	-A
barcode61_consensus_vsearch	2716	A	*/+G	302	37	8.43%	2	2	93	93	2.5749330668027314E-12	1	1	204	98	33	4	+G
barcode61_consensus_vsearch	2716	A	*/-G	302	78	17.77%	2	2	93	93	4.0238139278151514E-26	1	1	204	98	73	5	-G
barcode61_consensus_vsearch	2716	A	*/-GG	302	12	2.73%	2	1	93	93	2.1935299970804329E-4	1	1	204	98	12	0	-G
barcode61_consensus_vsearch	2719	G	*/-A	386	53	11.88%	2	2	93	93	2.0890893920311016E-17	1	1	281	105	51	2	-A
barcode61_consensus_vsearch	2726	G	*/+A	418	18	4.02%	2	2	93	93	3.189285095484537E-6	1	1	331	87	4	14	+A
barcode61_consensus_vsearch	2726	G	*/-A	418	11	2.46%	2	2	93	93	4.575989670126341E-4	1	1	331	87	6	5	+A
barcode61_consensus_vsearch	2739	G	*/+A	388	9	2.01%	2	2	93	93	0.0018656305641170923	1	1	318	70	4	5	+A
barcode61_consensus_vsearch	2739	G	*/-A	388	42	9.4%	2	2	93	93	7.937788874664411E-14	1	1	318	70	15	27	-A
barcode61_consensus_vsearch	2771	A	*/-C	437	7	1.57%	2	2	93	93	0.007628580447648388	1	1	334	103	4	3	-C
barcode61_consensus_vsearch	2778	T	*/-A	435	7	1.57%	2	2	93	93	0.007627752045228881	1	1	331	104	6	1	-A
barcode61_consensus_vsearch	2780	A	*/-G	425	9	2.01%	2	2	93	93	0.0018730070190884252	1	1	330	95	8	1	-G
barcode61_consensus_vsearch	2788	C	*/-G	433	8	1.8%	2	2	93	93	0.003783158179516694	1	1	331	102	7	1	-G
barcode61_consensus_vsearch	2795	T	*/-G	434	9	2.01%	2	2	93	93	0.0018746170280654298	1	1	331	103	6	3	-G
barcode61_consensus_vsearch	2802	T	*/-A	436	9	2.01%	2	1	93	93	0.0018749660605302289	1	1	332	104	9	0	-A
barcode61_consensus_vsearch	2810	G	*/-TG	430	11	2.46%	2	2	93	93	4.584175673957473E-4	1	1	333	97	2	9	-TG
barcode61_consensus_vsearch	2813	C	*/+T	415	8	1.79%	2	2	93	93	0.003777960974854116	1	1	322	93	4	4	+T
barcode61_consensus_vsearch	2813	C	*/-T	415	10	2.24%	2	2	93	93	9.256517413502841E-4	1	1	322	93	6	4	-T
barcode61_consensus_vsearch	2813	C	*/-TT	415	9	2.02%	2	2	93	93	0.0018711388771604682	1	1	322	93	7	2	-T
barcode61_consensus_vsearch	2816	T	*/+G	427	8	1.79%	2	1	93	93	0.0037814732031268648	1	1	322	105	8	0	+G
barcode61_consensus_vsearch	2817	A	*/-G	416	7	1.57%	2	2	93	93	0.007619493408432325	1	1	318	98	3	4	-G
barcode61_consensus_vsearch	2823	A	*/+C	411	7	1.59%	2	2	93	93	0.007617195908814076	1	1	313	98	2	5	+C
barcode61_consensus_vsearch	2823	A	*/-C	411	7	1.59%	2	2	93	93	0.007617195908814076	1	1	313	98	3	4	+C
barcode61_consensus_vsearch	2826	C	*/+T	410	7	1.56%	2	2	93	93	0.007616729829810889	1	1	325	85	5	2	+T
barcode61_consensus_vsearch	2826	C	*/-T	410	21	4.69%	2	2	93	93	3.7151754522449287E-7	1	1	325	85	3	18	-T
barcode61_consensus_vsearch	2826	C	*/-TT	410	7	1.56%	2	2	93	93	0.007616729829810889	1	1	325	85	6	1	-T
barcode61_consensus_vsearch	2829	T	*/+G	427	9	2.02%	2	2	93	93	0.0018733704789343226	1	1	334	93	1	8	+G
barcode61_consensus_vsearch	2836	G	*/-C	410	21	4.71%	2	1	93	93	3.7151754522449287E-7	1	1	304	106	21	0	-C
barcode61_consensus_vsearch	2843	C	*/+G	407	11	2.53%	2	2	93	93	4.568081577093064E-4	1	1	320	87	6	5	+G
barcode61_consensus_vsearch	2843	C	*/-G	407	10	2.3%	2	2	93	93	9.246904525720687E-4	1	1	320	87	5	5	+G
barcode61_consensus_vsearch	2851	C	*/+T	417	9	2.02%	2	1	93	93	0.0018715194418685113	1	1	324	93	9	0	+T
barcode61_consensus_vsearch	2851	C	*/-T	417	12	2.69%	2	2	93	93	2.2582806164226E-4	1	1	324	93	2	10	-T
barcode61_consensus_vsearch	2854	T	*/-G	420	15	3.36%	2	2	93	93	2.6992573667884224E-5	1	1	329	91	2	13	-G
barcode61_consensus_vsearch	2862	T	*/+G	434	8	1.79%	2	2	93	93	0.0037834345948323136	1	1	329	105	6	2	+G
barcode61_consensus_vsearch	2868	C	*/-GC	430	12	2.68%	2	2	93	93	2.263534081363424E-4	1	1	332	98	6	6	-GC
barcode61_consensus_vsearch	2874	A	*/+G	365	45	10.23%	2	2	93	93	7.923687102030988E-15	1	1	272	93	33	12	+G
barcode61_consensus_vsearch	2874	A	*/-G	365	24	5.45%	2	1	93	93	4.1341604032394113E-8	1	1	272	93	24	0	+G
barcode61_consensus_vsearch	2876	G	*/-A	428	9	2.01%	2	1	93	93	0.0018735509751739627	1	1	322	106	9	0	-A
barcode61_consensus_vsearch	2880	T	*/+C	395	28	6.25%	2	1	93	93	2.347234095007423E-9	1	1	299	96	28	0	+C
barcode61_consensus_vsearch	2880	T	*/-C	395	12	2.68%	2	2	93	93	2.24864640361563E-4	1	1	299	96	3	9	+C
barcode61_consensus_vsearch	2889	T	*/-C	422	18	4.04%	2	2	93	93	3.1945872707708225E-6	1	1	321	101	16	2	-C
barcode61_consensus_vsearch	2895	C	*/+G	417	27	6.03%	2	1	93	93	4.956991198275763E-9	1	1	312	105	27	0	+G
barcode61_consensus_vsearch	2896	A	*/-G	404	24	5.39%	2	1	93	93	4.2783737626049086E-8	1	1	302	102	24	0	-G
barcode61_consensus_vsearch	2907	C	*/-T	431	10	2.23%	2	1	93	93	9.274712732448419E-4	1	1	335	96	0	10	-T
barcode61_consensus_vsearch	2920	T	*/+C	430	10	2.24%	2	2	93	93	9.273613705492817E-4	1	1	328	102	7	3	+C
barcode61_consensus_vsearch	2936	T	*/-GT	408	27	6.04%	2	2	93	93	4.914059374679081E-9	1	1	331	77	1	26	-GT
barcode61_consensus_vsearch	2965	G	*/+C	424	7	1.57%	2	1	93	93	0.007623059056742502	1	1	317	107	7	0	+C
barcode61_consensus_vsearch	2965	G	*/-C	424	13	2.91%	2	1	93	93	1.115033140535145E-4	1	1	317	107	13	0	-C
barcode61_consensus_vsearch	2973	T	*/+G	432	9	2.01%	2	2	93	93	0.001874264864679625	1	1	327	105	8	1	+G
barcode61_consensus_vsearch	2983	A	*/-C	433	10	2.23%	2	1	93	93	9.276896125167864E-4	1	1	328	105	10	0	-C
barcode61_consensus_vsearch	2985	C	*/-A	417	19	4.24%	2	1	93	93	1.561031814887791E-6	1	1	310	107	19	0	-A
barcode61_consensus_vsearch	2987	A	*/-G	425	7	1.57%	2	1	93	93	0.007623495521158642	1	1	321	104	7	0	-G
barcode61_consensus_vsearch	2989	G	*/-A	398	13	2.95%	2	1	93	93	1.1085661935515201E-4	1	1	291	107	13	0	-A
barcode61_consensus_vsearch	2989	G	*/-AG	398	18	4.08%	2	1	93	93	3.1613578398884575E-6	1	1	291	107	18	0	-AG
barcode61_consensus_vsearch	2997	C	*/-T	430	8	1.79%	2	2	93	93	0.0037823214180042796	1	1	334	96	2	6	-T
barcode61_consensus_vsearch	3011	G	*/-A	433	8	1.8%	2	1	93	93	0.003783158179516694	1	1	327	106	8	0	-A
barcode61_consensus_vsearch	3013	A	*/-G	381	55	12.36%	2	2	93	93	4.506747934853726E-18	1	1	279	102	52	3	-G
barcode61_consensus_vsearch	3016	G	*/-A	417	10	2.23%	2	1	93	93	9.258865234089794E-4	1	1	311	106	10	0	-A
barcode61_consensus_vsearch	3016	G	*/-AT	417	20	4.46%	2	1	93	93	7.63528734201053E-7	1	1	311	106	20	0	-AT
barcode61_consensus_vsearch	3021	G	*/+A	422	10	2.24%	2	1	93	93	9.264641146701706E-4	1	1	334	88	0	10	+A
barcode61_consensus_vsearch	3021	G	*/-A	422	10	2.24%	2	2	93	93	9.264641146701706E-4	1	1	334	88	4	6	+A
barcode61_consensus_vsearch	3024	A	*/-C	418	16	3.57%	2	2	93	93	1.3255141377280018E-5	1	1	317	101	11	5	-C
barcode61_consensus_vsearch	3050	T	*/+G	389	11	2.47%	2	1	93	93	4.554223390235558E-4	1	1	289	100	11	0	+G
barcode61_consensus_vsearch	3050	T	*/-G	389	34	7.62%	2	2	93	93	2.917639473495372E-11	1	1	289	100	28	6	-G
barcode61_consensus_vsearch	3060	C	*/+G	434	8	1.8%	2	1	93	93	0.0037834345948323136	1	1	328	106	8	0	+G
barcode61_consensus_vsearch	3061	C	*/+T	417	8	1.79%	2	2	93	93	0.003778560011928581	1	1	328	89	6	2	+T
barcode61_consensus_vsearch	3061	C	*/-T	417	19	4.24%	2	2	93	93	1.561031814887791E-6	1	1	328	89	5	14	-T
barcode61_consensus_vsearch	3064	G	*/-TG	427	7	1.58%	2	1	93	93	0.007624362444354587	1	1	326	101	7	0	-TG
barcode61_consensus_vsearch	3065	T	*/-G	418	10	2.28%	2	2	93	93	9.260031044371504E-4	1	1	322	96	8	2	-G
barcode61_consensus_vsearch	3067	G	*/-C	434	10	2.23%	2	2	93	93	9.277980556005647E-4	1	1	329	105	9	1	-C
barcode61_consensus_vsearch	3068	C	*/+G	399	25	5.71%	2	1	93	93	2.070207618622798E-8	1	1	297	102	25	0	+G
barcode61_consensus_vsearch	3069	A	*/-G	400	34	7.66%	2	1	93	93	2.971279450777966E-11	1	1	297	103	34	0	-G
barcode61_consensus_vsearch	3073	A	*/-C	406	28	6.28%	2	2	93	93	2.375795646033013E-9	1	1	301	105	26	2	-C
barcode61_consensus_vsearch	3079	A	*/-C	408	26	5.83%	2	2	93	93	1.0131239849581719E-8	1	1	302	106	25	1	-C
barcode61_consensus_vsearch	3092	G	*/-AG	429	7	1.57%	2	1	93	93	0.007625221451403564	1	1	322	107	7	0	-AG
barcode61_consensus_vsearch	3096	T	*/+A	421	13	2.91%	2	1	93	93	1.1143252502300736E-4	1	1	316	105	13	0	+A
barcode61_consensus_vsearch	3114	A	*/-C	417	7	1.58%	2	2	93	93	0.007619946437356769	1	1	314	103	4	3	-C
barcode61_consensus_vsearch	3114	A	*/-CC	417	7	1.58%	2	1	93	93	0.007619946437356769	1	1	314	103	7	0	-C
barcode61_consensus_vsearch	3118	G	*/-A	403	35	7.9%	2	1	93	93	1.4347865239032197E-11	1	1	299	104	35	0	-A
barcode61_consensus_vsearch	3135	G	*/-C	419	10	2.24%	2	2	93	93	9.261191504201837E-4	1	1	315	104	8	2	-C
barcode61_consensus_vsearch	3135	G	*/-CC	419	15	3.36%	2	1	93	93	2.6984810488819573E-5	1	1	315	104	15	0	-CC
barcode61_consensus_vsearch	3138	C	*/-G	430	9	2.01%	2	2	93	93	0.0018739095280781474	1	1	334	96	5	4	-G
barcode61_consensus_vsearch	3142	T	*/+A	351	26	5.84%	2	1	93	93	9.537449228459915E-9	1	1	253	98	26	0	+A
barcode61_consensus_vsearch	3142	T	*/-A	351	57	12.81%	2	2	93	93	8.468924875824206E-19	1	1	253	98	55	2	-A
barcode61_consensus_vsearch	3144	A	*/-G	433	8	1.79%	2	1	93	93	0.003783158179516694	1	1	329	104	8	0	-G
barcode61_consensus_vsearch	3145	G	*/+A	426	8	1.82%	2	1	93	93	0.0037811878789100195	1	1	320	106	8	0	+A
barcode61_consensus_vsearch	3156	T	*/-G	430	8	1.81%	2	2	93	93	0.0037823214180042796	1	1	332	98	6	2	-G
barcode61_consensus_vsearch	3191	G	*/+A	432	9	2.01%	2	1	93	93	0.001874264864679625	1	1	329	103	9	0	+A
barcode61_consensus_vsearch	3214	G	*/+A	432	7	1.58%	2	1	93	93	0.0076264953547406375	1	1	334	98	7	0	+A
barcode61_consensus_vsearch	3218	T	*/-A	428	11	2.46%	2	2	93	93	4.5828417992626897E-4	1	1	322	106	10	1	-A
barcode61_consensus_vsearch	3219	A	*/+G	373	13	2.98%	2	1	93	93	1.1015555261551726E-4	1	1	285	88	13	0	+G
barcode61_consensus_vsearch	3219	A	*/-G	373	30	6.88%	2	2	93	93	5.317987248030449E-10	1	1	285	88	15	15	-G
barcode61_consensus_vsearch	3225	G	*/+A	375	20	4.52%	2	1	93	93	7.452374517509915E-7	1	1	269	106	20	0	+A
barcode61_consensus_vsearch	3225	G	*/-A	375	40	9.05%	2	2	93	93	3.389190688248127E-13	1	1	269	106	39	1	-A
barcode61_consensus_vsearch	3227	A	*/+G	415	20	4.54%	2	1	93	93	7.62730484821208E-7	1	1	309	106	20	0	+G
barcode61_consensus_vsearch	3228	A	*/-G	410	21	4.69%	2	1	93	93	3.7151754522449287E-7	1	1	303	107	21	0	-G
barcode61_consensus_vsearch	3228	A	*/-GA	410	13	2.9%	2	1	93	93	1.111646524937665E-4	1	1	303	107	13	0	-G
barcode61_consensus_vsearch	3229	G	*/+A	400	11	2.66%	2	1	93	93	4.5628334474193127E-4	1	1	293	107	11	0	+A
barcode61_consensus_vsearch	3230	A	*/+C	403	21	4.84%	2	1	93	93	3.699518099962941E-7	1	1	297	106	21	0	+C
barcode61_consensus_vsearch	3236	C	*/+A	428	17	3.81%	2	1	93	93	6.529326572028581E-6	1	1	323	105	17	0	+A
barcode61_consensus_vsearch	3237	G	*/-A	429	18	4.02%	2	1	93	93	3.2036534900985633E-6	1	1	322	107	18	0	-A
barcode61_consensus_vsearch	3239	A	*/-C	431	10	2.23%	2	1	93	93	9.274712732448419E-4	1	1	324	107	10	0	-C
barcode61_consensus_vsearch	3243	T	*/+C	435	8	1.79%	2	1	93	93	0.0037837097715777354	1	1	329	106	8	0	+C
barcode61_consensus_vsearch	3256	T	*/+C	374	7	1.57%	2	2	93	93	0.007598330292913895	1	1	283	91	4	3	+C
barcode61_consensus_vsearch	3256	T	*/-C	374	58	12.98%	2	2	93	93	4.460425997837194E-19	1	1	283	91	49	9	-C
barcode61_consensus_vsearch	3260	T	*/-C	339	100	22.57%	2	1	93	93	1.3428395351754657E-33	1	1	236	103	100	0	-C
barcode61_consensus_vsearch	3262	C	*/+G	412	9	2.01%	2	2	93	93	0.001870561328848028	1	1	315	97	1	8	+G
barcode61_consensus_vsearch	3262	C	*/-GA	412	14	3.12%	2	1	93	93	5.475771402649315E-5	1	1	315	97	14	0	-GA
barcode61_consensus_vsearch	3266	G	*/+T	429	8	1.8%	2	1	93	93	0.0037820399638697363	1	1	322	107	8	0	+T
barcode61_consensus_vsearch	3269	T	+C/+C	75	346	77.23%	2	2	93	93	1.988962978962595E-162	1	1	38	37	289	57	+C
barcode61_consensus_vsearch	3269	T	*/+CC	75	10	2.23%	2	2	93	93	7.37675601871001E-4	1	1	38	37	6	4	+C
barcode61_consensus_vsearch	3272	T	*/+C	414	14	3.17%	2	2	93	93	5.478593949196498E-5	1	1	321	93	13	1	+C
barcode61_consensus_vsearch	3286	T	*/+GT	433	8	1.79%	2	1	93	93	0.003783158179516694	1	1	338	95	0	8	+GT
barcode61_consensus_vsearch	3287	T	*/-C	433	9	2.01%	2	2	93	93	0.001874441340367089	1	1	333	100	4	5	-C
barcode61_consensus_vsearch	3295	A	*/+G	421	14	3.14%	2	1	93	93	5.4882762612112586E-5	1	1	315	106	14	0	+G
barcode61_consensus_vsearch	3296	G	*/-AG	417	22	4.98%	2	2	93	93	1.8205291089323654E-7	1	1	311	106	21	1	-AG
barcode61_consensus_vsearch	3317	A	*/+G	428	7	1.58%	2	1	93	93	0.007624792930600719	1	1	322	106	7	0	+G
barcode61_consensus_vsearch	3320	G	*/-A	437	9	2.01%	2	2	93	93	0.0018751394156906677	1	1	333	104	8	1	-A
barcode61_consensus_vsearch	3327	T	*/-A	431	7	1.56%	2	1	93	93	0.007626072650234986	1	1	327	104	7	0	-A
barcode61_consensus_vsearch	3328	A	*/-G	408	12	2.73%	2	2	93	93	2.2544581166138029E-4	1	1	319	89	2	10	-G
barcode61_consensus_vsearch	3335	T	*/+C	418	17	3.85%	2	2	93	93	6.505544070653668E-6	1	1	315	103	16	1	+C
barcode61_consensus_vsearch	3356	C	*/-T	433	8	1.79%	2	1	93	93	0.003783158179516694	1	1	327	106	8	0	-T
barcode61_consensus_vsearch	3361	T	*/+C	433	7	1.57%	2	2	93	93	0.0076269161468125015	1	1	329	104	5	2	+C
barcode61_consensus_vsearch	3368	C	*/-T	430	11	2.47%	2	1	93	93	4.584175673957473E-4	1	1	337	93	0	11	-T
barcode61_consensus_vsearch	3369	T	*/+C	408	7	1.61%	2	1	93	93	0.007615790966496023	1	1	317	91	7	0	+C
barcode61_consensus_vsearch	3369	T	*/-C	408	16	3.68%	2	2	93	93	1.3210384916673905E-5	1	1	317	91	14	2	-C
barcode61_consensus_vsearch	3371	C	*/-GA	425	11	2.47%	2	1	93	93	4.5808185020506666E-4	1	1	323	102	11	0	-GA
barcode61_consensus_vsearch	3382	C	*/+A	431	7	1.57%	2	1	93	93	0.007626072650234986	1	1	327	104	7	0	+A
barcode61_consensus_vsearch	3385	T	*/-C	406	38	8.48%	2	1	93	93	1.591358343178087E-12	1	1	302	104	38	0	-C
barcode61_consensus_vsearch	3403	G	*/-TG	427	15	3.39%	2	1	93	93	2.7045976238335243E-5	1	1	321	106	15	0	-TG
barcode61_consensus_vsearch	3407	C	*/-AC	438	8	1.79%	2	1	93	93	0.0037845279531252564	1	1	331	107	8	0	-AC
barcode61_consensus_vsearch	3416	C	*/+A	426	11	2.47%	2	2	93	93	4.581495959366191E-4	1	1	331	95	2	9	+A
barcode61_consensus_vsearch	3424	A	*/-G	410	8	1.8%	2	2	93	93	0.003776438502445107	1	1	310	100	2	6	-G
barcode61_consensus_vsearch	3430	C	*/+A	424	8	1.79%	2	1	93	93	0.0037806132981311326	1	1	320	104	8	0	+A
barcode61_consensus_vsearch	3441	G	*/+T	363	11	2.46%	2	2	93	93	4.5319061514943347E-4	1	1	266	97	10	1	+T
barcode61_consensus_vsearch	3441	G	*/-T	363	60	13.39%	2	2	93	93	9.117938401141949E-20	1	1	266	97	53	7	-T
barcode61_consensus_vsearch	3445	T	*/-G	425	13	2.91%	2	1	93	93	1.115267016392494E-4	1	1	334	91	0	13	-G
barcode61_consensus_vsearch	3448	T	*/+A	401	10	2.25%	2	2	93	93	9.239453265076358E-4	1	1	325	76	4	6	+A
barcode61_consensus_vsearch	3448	T	*/-A	401	10	2.25%	2	2	93	93	9.239453265076358E-4	1	1	325	76	4	6	+A
barcode61_consensus_vsearch	3465	G	*/-CG	428	11	2.46%	2	2	93	93	4.5828417992626897E-4	1	1	325	103	9	2	-CG
barcode61_consensus_vsearch	3466	C	*/-G	411	10	2.31%	2	2	93	93	9.251755912194793E-4	1	1	319	92	4	6	-G
barcode61_consensus_vsearch	3469	G	*/-A	437	8	1.79%	2	1	93	93	0.00378425644253265	1	1	330	107	8	0	-A
barcode61_consensus_vsearch	3471	T	*/+C	428	11	2.46%	2	1	93	93	4.5828417992626897E-4	1	1	322	106	11	0	+C
barcode61_consensus_vsearch	3476	C	*/+A	432	7	1.56%	2	1	93	93	0.0076264953547406375	1	1	327	105	7	0	+A
barcode61_consensus_vsearch	3488	T	*/+A	394	24	5.41%	2	1	93	93	4.243586888565942E-8	1	1	292	102	24	0	+A
barcode61_consensus_vsearch	3488	T	*/+AA	394	7	1.58%	2	1	93	93	0.007608958034696689	1	1	292	102	7	0	+A
barcode61_consensus_vsearch	3488	T	*/-A	394	13	2.93%	2	2	93	93	1.1075004107573398E-4	1	1	292	102	11	2	-A
barcode61_consensus_vsearch	3490	A	*/-G	429	7	1.56%	2	1	93	93	0.007625221451403564	1	1	326	103	7	0	-G
barcode61_consensus_vsearch	3494	G	*/+C	402	13	2.95%	2	1	93	93	1.1096121102660942E-4	1	1	295	107	13	0	+C
barcode61_consensus_vsearch	3494	G	*/-C	402	21	4.77%	2	1	93	93	3.697243479765959E-7	1	1	295	107	21	0	-C
barcode61_consensus_vsearch	3504	A	*/-G	418	14	3.15%	2	2	93	93	5.4841636470744183E-5	1	1	324	94	3	11	-G
barcode61_consensus_vsearch	3518	T	*/+A	324	16	3.6%	2	2	93	93	1.2737526784110147E-5	1	1	244	80	11	5	+A
barcode61_consensus_vsearch	3518	T	*/-A	324	80	17.98%	2	2	93	93	1.071553407180598E-26	1	1	244	80	65	15	-A
barcode61_consensus_vsearch	3518	T	*/-AA	324	16	3.6%	2	2	93	93	1.2737526784110147E-5	1	1	244	80	15	1	-A
barcode61_consensus_vsearch	3528	T	*/+C	430	13	2.9%	2	1	93	93	1.1164210469075442E-4	1	1	324	106	13	0	+C
barcode61_consensus_vsearch	3559	T	*/-G	421	17	3.81%	2	2	93	93	6.5127858630373285E-6	1	1	319	102	14	3	-G
barcode61_consensus_vsearch	3576	T	*/-A	421	9	2.02%	2	1	93	93	0.0018722700711233777	1	1	315	106	9	0	-A
barcode61_consensus_vsearch	3578	A	*/-GA	413	23	5.19%	2	1	93	93	8.850187384154793E-8	1	1	306	107	23	0	-GA
barcode61_consensus_vsearch	3579	G	*/-A	398	10	2.38%	2	1	93	93	9.235646797394348E-4	1	1	292	106	10	0	-A
barcode61_consensus_vsearch	3579	G	*/-AAG	398	8	1.9%	2	1	93	93	0.003772632825065396	1	1	292	106	8	0	-A
barcode61_consensus_vsearch	3585	T	*/-GT	409	24	5.41%	2	1	93	93	4.295249364101211E-8	1	1	331	78	0	24	-GT
barcode61_consensus_vsearch	3593	C	*/-T	425	8	1.79%	2	1	93	93	0.0037809012469126957	1	1	327	98	0	8	-T
barcode61_consensus_vsearch	3593	C	*/-TT	425	12	2.69%	2	1	93	93	2.2615495697455397E-4	1	1	327	98	12	0	-TT
barcode61_consensus_vsearch	3596	A	*/-C	427	7	1.57%	2	1	93	93	0.007624362444354587	1	1	321	106	7	0	-C
barcode61_consensus_vsearch	3598	C	*/-T	428	11	2.48%	2	2	93	93	4.5828417992626897E-4	1	1	327	101	8	3	-T
barcode61_consensus_vsearch	3600	G	*/-C	434	7	1.57%	2	1	93	93	0.007627335039353406	1	1	328	106	7	0	-C
barcode61_consensus_vsearch	3602	C	*/+A	422	14	3.14%	2	1	93	93	5.489635033716498E-5	1	1	319	103	14	0	+A
barcode61_consensus_vsearch	3603	G	*/-A	422	20	4.49%	2	1	93	93	7.654955875708403E-7	1	1	316	106	20	0	-A
barcode61_consensus_vsearch	3607	C	*/+A	437	7	1.57%	2	1	93	93	0.007628580447648388	1	1	330	107	7	0	+A
barcode61_consensus_vsearch	3613	G	*/+C	420	8	1.79%	2	2	93	93	0.003779448151948946	1	1	316	104	7	1	+C
barcode61_consensus_vsearch	3613	G	*/-C	420	14	3.12%	2	2	93	93	5.486911466049066E-5	1	1	316	104	13	1	-C
barcode61_consensus_vsearch	3618	G	*/+A	412	10	2.24%	2	1	93	93	9.25295461603329E-4	1	1	329	83	0	10	+A
barcode61_consensus_vsearch	3618	G	*/-A	412	20	4.48%	2	2	93	93	7.615205227908607E-7	1	1	329	83	10	10	-A
barcode61_consensus_vsearch	3632	C	*/-TT	428	8	1.8%	2	1	93	93	0.0037817572285023734	1	1	326	102	8	0	-TT
barcode61_consensus_vsearch	3637	G	*/+C	428	8	1.8%	2	1	93	93	0.0037817572285023734	1	1	322	106	8	0	+C
barcode61_consensus_vsearch	3640	T	*/+A	416	9	2.03%	2	1	93	93	0.001871329602106588	1	1	315	101	9	0	+A
barcode61_consensus_vsearch	3640	T	*/+G	416	10	2.25%	2	1	93	93	9.257694036262042E-4	1	1	315	101	10	0	+G
barcode61_consensus_vsearch	3641	A	*/+G	418	9	2.01%	2	1	93	93	0.0018717084025872061	1	1	313	105	9	0	+G
barcode61_consensus_vsearch	3646	C	*/+G	435	7	1.56%	2	1	93	93	0.007627752045228881	1	1	336	99	0	7	+G
barcode61_consensus_vsearch	3647	G	*/-A	437	7	1.57%	2	1	93	93	0.007628580447648388	1	1	331	106	7	0	-A
barcode61_consensus_vsearch	3662	T	*/-C	422	22	4.92%	2	1	93	93	1.826206185051853E-7	1	1	315	107	22	0	-C
barcode61_consensus_vsearch	3677	T	*/+G	427	8	1.8%	2	2	93	93	0.0037814732031268648	1	1	327	100	5	3	+G
barcode61_consensus_vsearch	3679	G	*/-A	426	18	4.02%	2	1	93	93	3.199800544200983E-6	1	1	319	107	18	0	-A
barcode61_consensus_vsearch	3682	T	*/+A	423	18	4.04%	2	1	93	93	3.195898836048293E-6	1	1	319	104	18	0	+A
barcode61_consensus_vsearch	3683	A	*/-G	420	13	2.9%	2	2	93	93	1.1140871758939428E-4	1	1	321	99	8	5	-G
barcode61_consensus_vsearch	3685	G	*/-AGG	433	11	2.46%	2	1	93	93	4.5861543978572406E-4	1	1	326	107	11	0	-AGG
barcode61_consensus_vsearch	3686	A	*/+G	376	21	4.84%	2	2	93	93	3.6345306648054725E-7	1	1	274	102	19	2	+G
barcode61_consensus_vsearch	3686	A	*/-G	376	26	5.99%	2	2	93	93	9.814836483041649E-9	1	1	274	102	24	2	-G
barcode61_consensus_vsearch	3688	G	*/+A	376	44	10.19%	2	1	93	93	1.7322629352324477E-14	1	1	270	106	44	0	+A
barcode61_consensus_vsearch	3695	A	*/+G	423	9	2.03%	2	2	93	93	0.0018726402317850155	1	1	318	105	8	1	+G
barcode61_consensus_vsearch	3707	T	*/+G	426	13	2.91%	2	2	93	93	1.1154998599717698E-4	1	1	336	90	1	12	+G
barcode61_consensus_vsearch	3709	A	*/+G	393	9	2.01%	2	2	93	93	0.0018667057694086889	1	1	289	104	8	1	+G
barcode61_consensus_vsearch	3709	A	*/-GA	393	41	9.17%	2	2	93	93	1.6874857216023365E-13	1	1	289	104	40	1	-GA
barcode61_consensus_vsearch	3710	G	*/+A	383	7	1.73%	2	1	93	93	0.007603246958909687	1	1	277	106	7	0	+A
barcode61_consensus_vsearch	3710	G	*/-A	383	12	2.97%	2	1	93	93	2.2429517467312504E-4	1	1	277	106	12	0	-A
barcode61_consensus_vsearch	3712	A	*/-G	434	10	2.24%	2	2	93	93	9.277980556005647E-4	1	1	329	105	9	1	-G
barcode61_consensus_vsearch	3723	G	*/-CG	424	19	4.28%	2	2	93	93	1.5660884922200917E-6	1	1	319	105	18	1	-CG
barcode61_consensus_vsearch	3725	G	*/-A	409	12	2.82%	2	1	93	93	2.2548906969822708E-4	1	1	305	104	12	0	-A
barcode61_consensus_vsearch	3734	T	*/-G	427	11	2.47%	2	1	93	93	4.5821703849988575E-4	1	1	332	95	0	11	-G
barcode61_consensus_vsearch	3736	G	*/-A	435	10	2.23%	2	1	93	93	9.279060186061013E-4	1	1	328	107	10	0	-A
barcode61_consensus_vsearch	3746	T	*/+G	411	19	4.35%	2	2	93	93	1.556577160279619E-6	1	1	311	100	18	1	+G
barcode61_consensus_vsearch	3758	T	*/-G	435	8	1.79%	2	1	93	93	0.0037837097715777354	1	1	339	96	0	8	-G
barcode61_consensus_vsearch	3770	C	*/-A	413	20	4.46%	2	2	93	93	7.619255358760037E-7	1	1	329	84	1	19	-A
barcode61_consensus_vsearch	3784	C	*/+A	425	8	1.79%	2	1	93	93	0.0037809012469126957	1	1	323	102	8	0	+A
barcode61_consensus_vsearch	3784	C	*/-G	425	7	1.57%	2	1	93	93	0.007623495521158642	1	1	323	102	7	0	+A
barcode61_consensus_vsearch	3785	G	*/-A	428	7	1.59%	2	1	93	93	0.007624792930600719	1	1	321	107	7	0	-A
barcode61_consensus_vsearch	3789	C	*/-G	418	18	4.02%	2	2	93	93	3.189285095484537E-6	1	1	321	97	13	5	-G
barcode61_consensus_vsearch	3792	G	*/-A	435	11	2.46%	2	2	93	93	4.587459048221758E-4	1	1	330	105	10	1	-A
barcode61_consensus_vsearch	3798	T	*/+G	438	7	1.57%	2	1	93	93	0.007628991869306366	1	1	339	99	0	7	+G
barcode61_consensus_vsearch	3807	G	*/+A	387	14	3.15%	2	1	93	93	5.438212094947901E-5	1	1	282	105	14	0	+A
barcode61_consensus_vsearch	3807	G	*/-A	387	42	9.46%	2	1	93	93	7.91733585994769E-14	1	1	282	105	42	0	-A
barcode61_consensus_vsearch	3814	T	*/-C	401	43	9.6%	2	2	93	93	3.905577543376249E-14	1	1	300	101	39	4	-C
barcode61_consensus_vsearch	3836	C	*/+G	408	11	2.46%	2	1	93	93	4.5688172943049915E-4	1	1	308	100	11	0	+G
barcode61_consensus_vsearch	3836	C	*/-G	408	15	3.35%	2	2	93	93	2.6897105828015778E-5	1	1	308	100	13	2	-G
barcode61_consensus_vsearch	3849	T	*/+C	372	16	3.6%	2	2	93	93	1.3031296605383876E-5	1	1	274	98	15	1	+C
barcode61_consensus_vsearch	3849	T	*/-C	372	51	11.49%	2	2	93	93	8.931615640784975E-17	1	1	274	98	48	3	-C
barcode61_consensus_vsearch	3851	C	*/-T	434	7	1.56%	2	1	93	93	0.007627335039353406	1	1	339	95	0	7	-T
barcode61_consensus_vsearch	3861	G	*/+C	389	47	10.51%	2	1	93	93	1.9167991537158067E-15	1	1	282	107	47	0	+C
barcode61_consensus_vsearch	3861	G	*/-C	389	10	2.24%	2	1	93	93	9.223889705434762E-4	1	1	282	107	10	0	+C
barcode61_consensus_vsearch	3870	C	*/-T	375	25	5.58%	2	2	93	93	2.0240285265845466E-8	1	1	269	106	24	1	-T
barcode61_consensus_vsearch	3870	C	*/-TT	375	46	10.27%	2	1	93	93	3.872359474716372E-15	1	1	269	106	46	0	-TT
barcode61_consensus_vsearch	3873	G	*/-A	424	23	5.15%	2	2	93	93	8.916998245724882E-8	1	1	319	105	22	1	-A
barcode61_consensus_vsearch	3875	A	*/-T	439	7	1.56%	2	2	93	93	0.00762940145447119	1	1	338	101	2	5	-T
barcode61_consensus_vsearch	3878	T	*/+C	430	10	2.25%	2	1	93	93	9.273613705492817E-4	1	1	327	103	10	0	+C
barcode61_consensus_vsearch	3880	G	*/+A	423	8	1.81%	2	1	93	93	0.003780324023462628	1	1	316	107	8	0	+A
barcode61_consensus_vsearch	3881	A	*/+G	421	9	2.04%	2	2	93	93	0.0018722700711233777	1	1	318	103	7	2	+G
barcode61_consensus_vsearch	3881	A	*/-G	421	8	1.81%	2	2	93	93	0.0037797414596765903	1	1	318	103	6	2	+G
barcode61_consensus_vsearch	3882	G	*/+A	428	8	1.82%	2	2	93	93	0.0037817572285023734	1	1	324	104	7	1	+A
barcode61_consensus_vsearch	3888	T	*/-CT	417	21	4.72%	2	1	93	93	3.7303832442405505E-7	1	1	313	104	21	0	-CT
barcode61_consensus_vsearch	3893	G	*/-CG	426	12	2.69%	2	2	93	93	2.2619500050778872E-4	1	1	323	103	10	2	-CG
barcode61_consensus_vsearch	3896	T	*/-C	430	10	2.25%	2	2	93	93	9.273613705492817E-4	1	1	326	104	9	1	-C
barcode61_consensus_vsearch	3908	G	*/+A	390	18	4.03%	2	2	93	93	3.149478194108059E-6	1	1	285	105	17	1	+A
barcode61_consensus_vsearch	3908	G	*/-A	390	16	3.58%	2	1	93	93	1.3124583755675277E-5	1	1	285	105	16	0	+A
barcode61_consensus_vsearch	3908	G	*/-AA	390	13	2.91%	2	2	93	93	1.1064141909323187E-4	1	1	285	105	12	1	+A
barcode61_consensus_vsearch	3911	A	*/+G	302	10	2.24%	2	2	93	93	9.076016973983641E-4	1	1	206	96	9	1	+G
barcode61_consensus_vsearch	3911	A	*/-G	302	128	28.64%	2	2	93	93	4.2120270207901384E-44	1	1	206	96	120	8	-G
barcode61_consensus_vsearch	3914	G	*/-A	418	20	4.49%	2	2	93	93	7.639253725032686E-7	1	1	315	103	19	1	-A
barcode61_consensus_vsearch	3923	T	*/+A	379	8	1.79%	2	1	93	93	0.0037661286454389806	1	1	283	96	8	0	+A
barcode61_consensus_vsearch	3923	T	*/-A	379	38	8.52%	2	1	93	93	1.504545528452968E-12	1	1	283	96	38	0	-A
barcode61_consensus_vsearch	3930	C	*/-G	440	8	1.79%	2	1	93	93	0.0037850673649748043	1	1	341	99	0	8	-G
barcode61_consensus_vsearch	3943	A	*/+G	409	9	2.03%	2	2	93	93	0.0018699755869600776	1	1	306	103	6	3	+G
barcode61_consensus_vsearch	3945	G	*/+A	423	18	4.02%	2	1	93	93	3.195898836048293E-6	1	1	318	105	18	0	+A
barcode61_consensus_vsearch	3949	A	*/+T	423	7	1.57%	2	1	93	93	0.007622620571895094	1	1	324	99	0	7	+T
barcode61_consensus_vsearch	3949	A	*/-C	423	9	2.02%	2	1	93	93	0.0018726402317850155	1	1	324	99	9	0	-C
barcode61_consensus_vsearch	3950	C	*/-T	427	9	2.05%	2	1	93	93	0.0018733704789343226	1	1	330	97	0	9	-T
barcode61_consensus_vsearch	3963	C	*/-GC	435	7	1.57%	2	1	93	93	0.007627752045228881	1	1	329	106	7	0	-GC
barcode61_consensus_vsearch	3966	C	*/-G	319	7	1.57%	2	2	93	93	0.007562422442723779	1	1	231	88	6	1	-G
barcode61_consensus_vsearch	3969	C	*/-T	420	16	3.58%	2	2	93	93	1.3263859391341419E-5	1	1	314	106	15	1	-T
barcode61_consensus_vsearch	3970	T	*/-G	396	20	4.64%	2	1	93	93	7.548006848953901E-7	1	1	294	102	20	0	-G
barcode61_consensus_vsearch	3971	G	*/-A	401	8	1.88%	2	1	93	93	0.0037736050099275447	1	1	294	107	8	0	-A
barcode61_consensus_vsearch	3972	A	*/-C	364	21	4.88%	2	2	93	93	3.6030592207122044E-7	1	1	259	105	20	1	-C
barcode61_consensus_vsearch	3972	A	*/-CC	364	9	2.09%	2	1	93	93	0.0018600735687751945	1	1	259	105	9	0	-C
barcode61_consensus_vsearch	3975	C	*/-A	385	12	2.69%	2	1	93	93	2.2439240943114192E-4	1	1	284	101	12	0	-A
barcode61_consensus_vsearch	3977	A	*/-G	385	39	8.76%	2	2	93	93	7.280076019775759E-13	1	1	301	84	24	15	-G
barcode61_consensus_vsearch	3989	T	*/+C	432	8	1.79%	2	1	93	93	0.0037828805172695963	1	1	326	106	8	0	+C
barcode61_consensus_vsearch	3991	A	*/-G	409	10	2.24%	2	1	93	93	9.249341612898154E-4	1	1	312	97	0	10	-G
barcode61_consensus_vsearch	3997	G	*/-AG	435	8	1.79%	2	2	93	93	0.0037837097715777354	1	1	330	105	7	1	-AG
barcode61_consensus_vsearch	3998	A	*/+G	424	7	1.6%	2	2	93	93	0.007623059056742502	1	1	320	104	6	1	+G
barcode61_consensus_vsearch	4002	C	*/+A	424	8	1.79%	2	2	93	93	0.0037806132981311326	1	1	324	100	6	2	+A
barcode61_consensus_vsearch	4002	C	*/-A	424	9	2.01%	2	2	93	93	0.0018728240442215458	1	1	324	100	5	4	-A
barcode61_consensus_vsearch	4010	C	*/-T	424	11	2.5%	2	2	93	93	4.580137992598773E-4	1	1	333	91	5	6	-T
barcode61_consensus_vsearch	4016	G	*/-TTG	421	13	2.92%	2	2	93	93	1.1143252502300736E-4	1	1	323	98	11	2	-TTG
barcode61_consensus_vsearch	4020	C	*/-A	434	7	1.57%	2	2	93	93	0.007627335039353406	1	1	339	95	2	5	-A
barcode61_consensus_vsearch	4033	G	*/+C	402	12	2.68%	2	2	93	93	2.2518199251181446E-4	1	1	297	105	11	1	+C
barcode61_consensus_vsearch	4033	G	*/+CC	402	17	3.79%	2	1	93	93	6.465281837282248E-6	1	1	297	105	17	0	+CC
barcode61_consensus_vsearch	4036	T	*/+C	427	7	1.58%	2	1	93	93	0.007624362444354587	1	1	326	101	7	0	+C
barcode61_consensus_vsearch	4037	C	*/-G	364	67	15.09%	2	2	93	93	4.192855438071938E-22	1	1	266	98	61	6	-G
barcode61_consensus_vsearch	4039	G	*/-A	402	31	6.95%	2	2	93	93	2.668754608500739E-10	1	1	300	102	29	2	-A
barcode61_consensus_vsearch	4055	A	*/+G	427	10	2.28%	2	1	93	93	9.270286906046182E-4	1	1	320	107	10	0	+G
barcode61_consensus_vsearch	4056	G	*/-A	362	31	7.01%	2	2	93	93	2.5159108889943904E-10	1	1	263	99	26	5	-A
barcode61_consensus_vsearch	4056	G	*/-AG	362	22	4.98%	2	2	93	93	1.7495716271328224E-7	1	1	263	99	21	1	-A
barcode61_consensus_vsearch	4056	G	*/-AGG	362	23	5.2%	2	1	93	93	8.497594313845702E-8	1	1	263	99	23	0	-AGG
barcode61_consensus_vsearch	4057	A	*/+G	95	154	42.19%	2	2	93	93	1.7967424012132256E-62	1	1	71	24	86	68	+G
barcode61_consensus_vsearch	4057	A	*/+GG	95	18	4.93%	2	2	93	93	1.8297682095236049E-6	1	1	71	24	16	2	+G
barcode61_consensus_vsearch	4057	A	*/-G	95	84	23.01%	2	2	93	93	1.2877495794408917E-31	1	1	71	24	81	3	-G
barcode61_consensus_vsearch	4072	G	*/+A	425	12	2.68%	2	1	93	93	2.2615495697455397E-4	1	1	318	107	12	0	+A
barcode61_consensus_vsearch	4073	A	*/-G	388	20	4.55%	2	1	93	93	7.512623101509373E-7	1	1	282	106	20	0	-G
barcode61_consensus_vsearch	4073	A	*/-GGA	388	25	5.68%	2	1	93	93	2.049600503276462E-8	1	1	282	106	25	0	-GGA
barcode61_consensus_vsearch	4075	G	*/+A	346	18	4.3%	2	1	93	93	3.075594896654672E-6	1	1	239	107	18	0	+A
barcode61_consensus_vsearch	4075	G	*/-A	346	21	5.01%	2	1	93	93	3.5524615734633334E-7	1	1	239	107	21	0	-A
barcode61_consensus_vsearch	4075	G	*/-AG	346	20	4.77%	2	1	93	93	7.304219728889915E-7	1	1	239	107	20	0	-A
barcode61_consensus_vsearch	4076	A	*/+G	349	9	2.39%	2	1	93	93	0.0018562272492925029	1	1	243	106	9	0	+G
barcode61_consensus_vsearch	4078	C	*/-GCC	416	8	1.83%	2	2	93	93	0.003778261194268045	1	1	314	102	7	1	-GCC
barcode61_consensus_vsearch	4079	G	*/+C	324	12	2.82%	2	2	93	93	2.2092319542467036E-4	1	1	221	103	11	1	+C
barcode61_consensus_vsearch	4079	G	*/-C	324	68	16%	2	1	93	93	1.4032653724400573E-22	1	1	221	103	68	0	-C
barcode61_consensus_vsearch	4079	G	*/-CC	324	10	2.35%	2	1	93	93	9.120540902472859E-4	1	1	221	103	10	0	-C
barcode61_consensus_vsearch	4082	C	*/-T	422	11	2.46%	2	2	93	93	4.57876773436784E-4	1	1	321	101	7	4	-T
barcode61_consensus_vsearch	4107	G	*/-C	383	46	10.43%	2	2	93	93	3.972890305775893E-15	1	1	304	79	25	21	-C
barcode61_consensus_vsearch	4111	C	*/-T	429	10	2.23%	2	2	93	93	9.272509747675099E-4	1	1	333	96	4	6	-T
barcode61_consensus_vsearch	4114	G	*/-A	424	16	3.57%	2	2	93	93	1.3281070163027198E-5	1	1	329	95	10	6	-A
barcode61_consensus_vsearch	4121	T	*/+C	431	9	2.02%	2	1	93	93	0.0018740875957096264	1	1	328	103	9	0	+C
barcode61_consensus_vsearch	4138	G	*/-C	425	19	4.25%	2	1	93	93	1.566798887158905E-6	1	1	318	107	19	0	-C
barcode61_consensus_vsearch	4161	G	*/+A	433	8	1.79%	2	2	93	93	0.003783158179516694	1	1	334	99	2	6	+A
barcode61_consensus_vsearch	4164	A	*/-C	432	7	1.56%	2	1	93	93	0.0076264953547406375	1	1	325	107	7	0	-C
barcode61_consensus_vsearch	4177	T	*/+C	389	13	2.9%	2	1	93	93	1.1061393736967548E-4	1	1	283	106	13	0	+C
barcode61_consensus_vsearch	4177	T	*/-C	389	42	9.38%	2	1	93	93	7.958194501597955E-14	1	1	283	106	42	0	-C
barcode61_consensus_vsearch	4180	T	*/+G	413	22	4.93%	2	1	93	93	1.8159041723423873E-7	1	1	309	104	22	0	+G
barcode61_consensus_vsearch	4181	A	*/-G	405	22	4.95%	2	1	93	93	1.806424477541293E-7	1	1	304	101	22	0	-G
barcode61_consensus_vsearch	4184	C	*/+A	426	7	1.57%	2	1	93	93	0.007623929979105209	1	1	323	103	7	0	+A
barcode61_consensus_vsearch	4185	G	*/-A	425	11	2.47%	2	1	93	93	4.5808185020506666E-4	1	1	321	104	11	0	-A
barcode61_consensus_vsearch	4186	A	*/-G	424	8	1.83%	2	1	93	93	0.0037806132981311326	1	1	317	107	8	0	-G
barcode61_consensus_vsearch	4195	T	*/+G	422	9	2.04%	2	1	93	93	0.0018724555760242295	1	1	322	100	9	0	+G
barcode61_consensus_vsearch	4215	G	*/+A	436	8	1.79%	2	1	93	93	0.003783983718069795	1	1	331	105	8	0	+A
barcode61_consensus_vsearch	4217	T	*/+A	405	15	3.36%	2	1	93	93	2.6872426494871398E-5	1	1	306	99	15	0	+A
barcode61_consensus_vsearch	4217	T	*/-A	405	20	4.47%	2	2	93	93	7.586370380473516E-7	1	1	306	99	17	3	-A
barcode61_consensus_vsearch	4219	A	*/+G	303	28	6.28%	2	2	93	93	2.052818811734648E-9	1	1	211	92	25	3	+G
barcode61_consensus_vsearch	4219	A	*/-G	303	95	21.3%	2	2	93	93	4.260644243606723E-32	1	1	211	92	87	8	-G
barcode61_consensus_vsearch	4219	A	*/-GG	303	8	1.79%	2	1	93	93	0.0037322498843562575	1	1	211	92	8	0	-G
barcode61_consensus_vsearch	4222	G	*/-A	433	8	1.8%	2	2	93	93	0.003783158179516694	1	1	333	100	6	2	-A
barcode61_consensus_vsearch	4230	C	*/-A	422	7	1.58%	2	2	93	93	0.007622180052576428	1	1	319	103	6	1	-A
barcode61_consensus_vsearch	4238	C	*/-T	436	7	1.57%	2	1	93	93	0.007628167177128368	1	1	339	97	0	7	-T
barcode61_consensus_vsearch	4249	A	*/-G	417	14	3.14%	2	2	93	93	5.4827805419876506E-5	1	1	325	92	6	8	-G
barcode61_consensus_vsearch	4254	T	*/-A	385	54	12.05%	2	2	93	93	9.774406125133643E-18	1	1	282	103	51	3	-A
barcode61_consensus_vsearch	4256	A	*/+G	365	8	1.79%	2	2	93	93	0.0037609158733080306	1	1	276	89	4	4	+G
barcode61_consensus_vsearch	4256	A	*/-G	365	49	10.99%	2	2	93	93	3.925587653047793E-16	1	1	276	89	41	8	-G
barcode61_consensus_vsearch	4256	A	*/-GG	365	8	1.79%	2	2	93	93	0.0037609158733080306	1	1	276	89	2	6	-G
barcode61_consensus_vsearch	4265	T	*/+C	427	12	2.7%	2	1	93	93	2.2623486621516718E-4	1	1	328	99	12	0	+C
barcode61_consensus_vsearch	4266	C	*/-T	437	7	1.57%	2	2	93	93	0.007628580447648388	1	1	336	101	3	4	-T
barcode61_consensus_vsearch	4269	A	*/+G	396	22	4.93%	2	2	93	93	1.79537745702876E-7	1	1	294	102	20	2	+G
barcode61_consensus_vsearch	4269	A	*/-G	396	23	5.16%	2	2	93	93	8.740935648000307E-8	1	1	294	102	22	1	-G
barcode61_consensus_vsearch	4289	C	*/+G	404	10	2.23%	2	2	93	93	9.24320545706363E-4	1	1	316	88	8	2	+G
barcode61_consensus_vsearch	4289	C	*/-G	404	24	5.36%	2	2	93	93	4.2783737626049086E-8	1	1	316	88	10	14	-G
barcode61_consensus_vsearch	4311	C	*/+T	391	9	2.02%	2	1	93	93	0.0018662788735768444	1	1	297	94	9	0	+T
barcode61_consensus_vsearch	4311	C	*/-G	391	7	1.57%	2	1	93	93	0.007607431615374521	1	1	297	94	0	7	+T
barcode61_consensus_vsearch	4313	G	*/-C	377	21	4.73%	2	1	93	93	3.637077255535154E-7	1	1	273	104	21	0	-C
barcode61_consensus_vsearch	4324	C	*/+G	422	11	2.47%	2	2	93	93	4.57876773436784E-4	1	1	320	102	10	1	+G
barcode61_consensus_vsearch	4324	C	*/-G	422	10	2.24%	2	2	93	93	9.264641146701706E-4	1	1	320	102	7	3	+G
barcode61_consensus_vsearch	4332	G	*/-TG	422	8	1.79%	2	2	93	93	0.003780033413733114	1	1	319	103	7	1	-TG
barcode61_consensus_vsearch	4335	C	*/-T	409	19	4.27%	2	2	93	93	1.5550667950843015E-6	1	1	307	102	18	1	-T
barcode61_consensus_vsearch	4343	C	*/-T	431	10	2.24%	2	2	93	93	9.274712732448419E-4	1	1	336	95	1	9	-T
barcode61_consensus_vsearch	4345	C	*/-T	431	8	1.8%	2	2	93	93	0.003782601599602771	1	1	332	99	4	4	-T
barcode61_consensus_vsearch	4363	A	*/-GCA	402	14	3.14%	2	2	93	93	5.4612677869951636E-5	1	1	305	97	11	3	-GCA
barcode61_consensus_vsearch	4376	G	*/-C	393	9	2.04%	2	1	93	93	0.0018667057694086889	1	1	288	105	9	0	-C
barcode61_consensus_vsearch	4382	T	*/+C	427	9	2.03%	2	2	93	93	0.0018733704789343226	1	1	328	99	8	1	+C
barcode61_consensus_vsearch	4383	C	*/+A	422	15	3.37%	2	1	93	93	2.7007998247201884E-5	1	1	318	104	15	0	+A
barcode61_consensus_vsearch	4392	C	*/-AC	434	7	1.57%	2	1	93	93	0.007627335039353406	1	1	330	104	7	0	-AC
barcode61_consensus_vsearch	4400	T	*/+G	349	9	2.02%	2	2	93	93	0.0018562272492925029	1	1	249	100	8	1	+G
barcode61_consensus_vsearch	4400	T	*/-G	349	70	15.73%	2	2	93	93	3.641417681770536E-23	1	1	249	100	66	4	-G
barcode61_consensus_vsearch	4407	T	*/+C	435	7	1.57%	2	1	93	93	0.007627752045228881	1	1	331	104	7	0	+C
