Chrom	Position	Ref	Cons	Reads1	Reads2	VarFreq	Strands1	Strands2	Qual1	Qual2	Pvalue	MapQual1	MapQual2	Reads1Plus	Reads1Minus	Reads2Plus	Reads2Minus	VarAllele
barcode16_consensus_vsearch	45	T	G	4	111	95.69%	1	2	93	93	8.757063310188475E-62	1	1	4	0	43	68	G
barcode16_consensus_vsearch	214	T	Y	186	8	4.1%	2	2	93	93	0.0036291041675517713	1	1	121	65	2	6	C
barcode16_consensus_vsearch	235	A	R	180	7	3.61%	2	1	93	93	0.007378565932456183	1	1	109	71	7	0	G
barcode16_consensus_vsearch	236	T	Y	183	8	4.12%	2	1	93	93	0.003624827265843605	1	1	113	70	8	0	C
barcode16_consensus_vsearch	261	T	Y	169	14	7.61%	2	2	93	93	4.7145165258180184E-5	1	1	116	53	2	12	C
barcode16_consensus_vsearch	338	G	R	112	70	38.25%	2	1	93	93	2.151466626851368E-25	1	1	49	63	70	0	A
barcode16_consensus_vsearch	351	T	K	175	10	5.32%	2	1	93	93	8.619505923183497E-4	1	1	104	71	10	0	G
barcode16_consensus_vsearch	492	T	K	177	15	7.77%	2	1	93	93	2.2967098326715997E-5	1	1	105	72	15	0	G
barcode16_consensus_vsearch	502	C	Y	181	8	4.1%	2	1	93	93	0.0036219019328410066	1	1	119	62	0	8	T
barcode16_consensus_vsearch	548	T	Y	187	8	4.1%	2	2	93	93	0.0036305010705765203	1	1	121	66	2	6	C
barcode16_consensus_vsearch	662	C	Y	184	8	4.12%	2	2	93	93	0.0036262674855563662	1	1	121	63	1	7	T
barcode16_consensus_vsearch	671	G	R	180	13	6.67%	2	1	93	93	9.905976001490834E-5	1	1	108	72	13	0	A
barcode16_consensus_vsearch	846	A	R	186	7	3.61%	2	1	93	93	0.007391912172859777	1	1	114	72	7	0	G
barcode16_consensus_vsearch	1010	G	R	184	8	4.12%	2	1	93	93	0.0036262674855563662	1	1	112	72	8	0	A
barcode16_consensus_vsearch	1017	T	W	187	7	3.59%	2	1	93	93	0.007394057154213738	1	1	122	65	0	7	A
barcode16_consensus_vsearch	1144	T	K	184	9	4.62%	2	1	93	93	0.0017754582364345615	1	1	112	72	9	0	G
barcode16_consensus_vsearch	1156	G	R	137	12	8%	2	2	93	93	1.93895008358888E-4	1	1	73	64	11	1	A
barcode16_consensus_vsearch	1174	A	R	182	10	5.18%	2	1	93	93	8.659835374014541E-4	1	1	112	70	10	0	G
barcode16_consensus_vsearch	1246	A	R	184	7	3.63%	2	1	93	93	0.007387555568979833	1	1	116	68	7	0	G
barcode16_consensus_vsearch	1363	G	R	173	7	3.78%	2	2	93	93	0.007361883903780164	1	1	109	64	6	1	A
barcode16_consensus_vsearch	1377	G	R	185	7	3.65%	2	1	93	93	0.007389745092191117	1	1	114	71	7	0	A
barcode16_consensus_vsearch	1382	A	R	176	7	3.61%	2	1	93	93	0.007369187819667051	1	1	109	67	7	0	-G
barcode16_consensus_vsearch	1399	G	R	175	17	8.85%	2	2	93	93	5.268874801705308E-6	1	1	104	71	16	1	A
barcode16_consensus_vsearch	1408	A	R	185	8	4.1%	2	2	93	93	0.003627693045256358	1	1	115	70	6	2	G
barcode16_consensus_vsearch	1483	C	Y	175	9	4.62%	2	1	93	93	0.0017669987142516655	1	1	118	57	0	9	T
barcode16_consensus_vsearch	1523	G	R	180	11	5.64%	2	1	93	93	4.2108036879098717E-4	1	1	108	72	11	0	A
barcode16_consensus_vsearch	1602	T	Y	183	7	3.68%	2	1	93	93	0.007385343252869138	1	1	120	63	0	7	C
barcode16_consensus_vsearch	1622	C	Y	185	9	4.62%	2	1	93	93	0.0017763509872760243	1	1	122	63	0	9	T
barcode16_consensus_vsearch	1663	G	R	183	7	3.61%	2	1	93	93	0.007385343252869138	1	1	114	69	7	0	A
barcode16_consensus_vsearch	1828	C	Y	104	87	45.55%	2	2	93	93	1.701941824319928E-32	1	1	68	36	54	33	T
barcode16_consensus_vsearch	1839	T	Y	106	88	45.13%	2	2	93	93	7.8712908219436E-33	1	1	69	37	53	35	C
barcode16_consensus_vsearch	2012	C	Y	188	7	3.59%	2	2	93	93	0.007396180372504935	1	1	122	66	1	6	T
barcode16_consensus_vsearch	2100	G	R	183	9	4.66%	2	2	93	93	0.0017745564291022078	1	1	116	67	7	2	A
barcode16_consensus_vsearch	2133	G	R	153	15	8.82%	2	1	93	93	2.2012244605339464E-5	1	1	93	60	15	0	A
barcode16_consensus_vsearch	2154	C	Y	183	10	5.13%	2	2	93	93	8.665366458993966E-4	1	1	122	61	1	9	T
barcode16_consensus_vsearch	2161	G	R	131	8	5.56%	2	1	93	93	0.003522084373855766	1	1	75	56	8	0	A
barcode16_consensus_vsearch	2164	G	R	168	21	11.05%	2	1	93	93	2.649235938143043E-7	1	1	97	71	21	0	A
barcode16_consensus_vsearch	2215	C	Y	181	8	4.17%	2	2	93	93	0.0036219019328410066	1	1	115	66	5	3	T
barcode16_consensus_vsearch	2275	C	Y	179	9	4.64%	2	1	93	93	0.0017708558237889195	1	1	121	58	0	9	T
barcode16_consensus_vsearch	2399	G	R	178	11	5.79%	2	1	93	93	4.204021120137521E-4	1	1	111	67	11	0	A
barcode16_consensus_vsearch	2456	G	R	174	15	7.81%	2	1	93	93	2.285953945782884E-5	1	1	103	71	15	0	A
barcode16_consensus_vsearch	2468	G	R	182	10	5.15%	2	1	93	93	8.659835374014541E-4	1	1	112	70	10	0	A
barcode16_consensus_vsearch	2568	T	Y	181	13	6.7%	2	2	93	93	9.917006682722331E-5	1	1	121	60	2	11	C
barcode16_consensus_vsearch	2586	T	Y	173	10	5.15%	2	2	93	93	8.60743791896823E-4	1	1	119	54	1	9	C
barcode16_consensus_vsearch	2713	A	R	184	8	4.12%	2	2	93	93	0.0036262674855563662	1	1	113	71	7	1	G
barcode16_consensus_vsearch	2814	G	R	173	21	10.82%	2	1	93	93	2.691990296855178E-7	1	1	101	72	21	0	A
barcode16_consensus_vsearch	2879	T	Y	186	7	3.63%	2	1	93	93	0.007391912172859777	1	1	122	64	0	7	C
barcode16_consensus_vsearch	2882	T	Y	175	15	7.81%	2	2	93	93	2.2895728702355452E-5	1	1	115	60	7	8	C
barcode16_consensus_vsearch	2890	G	R	184	9	4.62%	2	1	93	93	0.0017754582364345615	1	1	113	71	9	0	A
barcode16_consensus_vsearch	3003	A	R	186	7	3.59%	2	2	93	93	0.007391912172859777	1	1	118	68	5	2	G
barcode16_consensus_vsearch	3264	C	S	185	7	3.59%	2	1	93	93	0.007389745092191117	1	1	121	64	0	7	G
barcode16_consensus_vsearch	3317	G	R	165	26	13.47%	2	1	93	93	5.983593554065575E-9	1	1	95	70	26	0	A
barcode16_consensus_vsearch	3355	T	K	181	12	6.22%	2	1	93	93	2.0468701793138264E-4	1	1	111	70	12	0	G
barcode16_consensus_vsearch	3357	G	R	186	7	3.59%	2	1	93	93	0.007391912172859777	1	1	116	70	7	0	A
barcode16_consensus_vsearch	3404	A	R	185	9	4.62%	2	1	93	93	0.0017763509872760243	1	1	114	71	9	0	G
barcode16_consensus_vsearch	3419	T	Y	184	7	3.63%	2	2	93	93	0.007387555568979833	1	1	113	71	6	1	C
barcode16_consensus_vsearch	3426	G	R	174	8	4.35%	2	1	93	93	0.003611166483247444	1	1	113	61	8	0	A
barcode16_consensus_vsearch	3447	G	R	166	19	10.27%	2	2	93	93	1.1723425682321694E-6	1	1	101	65	18	1	A
barcode16_consensus_vsearch	3509	G	R	182	7	3.63%	2	1	93	93	0.007383107786177688	1	1	112	70	7	0	A
barcode16_consensus_vsearch	3513	G	R	182	7	3.68%	2	1	93	93	0.007383107786177688	1	1	114	68	7	0	A
barcode16_consensus_vsearch	3525	A	R	183	7	3.65%	2	1	93	93	0.007385343252869138	1	1	114	69	7	0	G
barcode16_consensus_vsearch	3620	A	R	185	7	3.61%	2	1	93	93	0.007389745092191117	1	1	113	72	7	0	G
barcode16_consensus_vsearch	3726	A	R	161	26	13.61%	2	1	93	93	5.859353678517802E-9	1	1	92	69	26	0	G
barcode16_consensus_vsearch	3744	A	R	162	29	15.1%	2	2	93	93	5.899237340980533E-10	1	1	95	67	27	2	G
barcode16_consensus_vsearch	3769	G	R	180	8	4.23%	2	1	93	93	0.00362041635085765	1	1	114	66	8	0	A
barcode16_consensus_vsearch	3885	C	Y	185	7	3.61%	2	2	93	93	0.007389745092191117	1	1	121	64	1	6	T
barcode16_consensus_vsearch	3922	A	R	176	11	5.64%	2	1	93	93	4.1971005075956745E-4	1	1	106	70	11	0	G
barcode16_consensus_vsearch	4023	G	R	182	8	4.12%	2	2	93	93	0.003623372158916335	1	1	114	68	6	2	A
barcode16_consensus_vsearch	4053	G	R	161	12	6.7%	2	1	93	93	2.0041627973286082E-4	1	1	91	70	12	0	A
barcode16_consensus_vsearch	4054	G	S	147	15	7.85%	2	1	93	93	2.17349769556443E-5	1	1	75	72	15	0	+A
barcode16_consensus_vsearch	4055	A	M	152	12	6.45%	2	1	93	93	1.9817852873331993E-4	1	1	80	72	12	0	C
barcode16_consensus_vsearch	4058	C	M	158	14	7.65%	2	1	93	93	4.6341308469083375E-5	1	1	88	70	14	0	A
barcode16_consensus_vsearch	4058	C	S	158	10	5.46%	2	2	93	93	8.508146096123988E-4	1	1	88	70	9	1	A
barcode16_consensus_vsearch	4159	A	R	178	7	3.63%	2	1	93	93	0.007373926992228167	1	1	109	69	7	0	G
barcode16_consensus_vsearch	4233	A	R	176	7	3.8%	2	2	93	93	0.007369187819667051	1	1	108	68	5	2	G
barcode16_consensus_vsearch	4279	G	R	187	7	3.61%	2	1	93	93	0.007394057154213738	1	1	122	65	0	7	A
barcode16_consensus_vsearch	4305	G	R	175	11	5.85%	2	2	93	93	4.1935871135675344E-4	1	1	112	63	10	1	A
barcode16_consensus_vsearch	4343	A	R	182	7	3.63%	2	1	93	93	0.007383107786177688	1	1	113	69	7	0	G
barcode16_consensus_vsearch	4389	T	Y	166	25	13.09%	2	2	93	93	1.2868330715678943E-8	1	1	101	65	18	7	C
