Chrom	Position	Ref	Cons	Reads1	Reads2	VarFreq	Strands1	Strands2	Qual1	Qual2	Pvalue	MapQual1	MapQual2	Reads1Plus	Reads1Minus	Reads2Plus	Reads2Minus	VarAllele
C5_BC29_consensus_vsearch	23	T	*/+C	28	47	59.49%	2	2	93	93	1.410392259495041E-19	1	1	11	17	39	8	+C
C5_BC29_consensus_vsearch	30	T	*/-C	71	7	8.86%	2	1	93	93	0.006788393631324507	1	1	46	25	7	0	-C
C5_BC29_consensus_vsearch	80	T	*/+A	55	8	10.26%	2	2	93	93	0.003083723632569312	1	1	36	19	5	3	+A
C5_BC29_consensus_vsearch	80	T	*/-A	55	11	14.1%	2	2	93	93	3.103375397885081E-4	1	1	36	19	9	2	-A
C5_BC29_consensus_vsearch	98	C	*/-A	60	14	17.95%	2	1	93	93	3.099235301415825E-5	1	1	36	24	14	0	-A
C5_BC29_consensus_vsearch	109	G	*/-C	68	8	10%	2	2	93	93	0.0032178770069028195	1	1	48	20	4	4	-C
C5_BC29_consensus_vsearch	148	C	*/-GC	70	7	8.75%	2	1	93	93	0.006775464530447864	1	1	45	25	7	0	-GC
C5_BC29_consensus_vsearch	206	T	*/+C	18	42	56%	2	2	93	93	2.2001415667263425E-18	1	1	11	7	28	14	+C
C5_BC29_consensus_vsearch	211	A	*/-C	68	8	10.13%	2	1	93	93	0.0032178770069028195	1	1	42	26	8	0	-C
C5_BC29_consensus_vsearch	308	G	*/-A	71	7	8.75%	2	1	93	93	0.006788393631324507	1	1	45	26	7	0	-A
C5_BC29_consensus_vsearch	311	G	*/-T	65	10	12.5%	2	2	93	93	7.087581206061954E-4	1	1	42	23	7	3	-T
C5_BC29_consensus_vsearch	375	T	*/-CTCT	70	8	10.26%	2	1	93	93	0.0032347379048596157	1	1	54	16	0	8	-CTCT
C5_BC29_consensus_vsearch	377	T	*/-CT	53	12	17.39%	2	2	93	93	1.3975857884287053E-4	1	1	44	9	6	6	-CT
C5_BC29_consensus_vsearch	392	T	*/-C	61	18	22.5%	2	2	93	93	1.2802768896784143E-6	1	1	44	17	10	8	-C
C5_BC29_consensus_vsearch	430	G	*/-C	70	7	8.75%	2	2	93	93	0.006775464530447864	1	1	47	23	6	1	-C
C5_BC29_consensus_vsearch	438	T	*/-C	59	19	24.05%	2	1	93	93	5.478891716541393E-7	1	1	33	26	19	0	-C
C5_BC29_consensus_vsearch	446	C	*/-AC	69	9	11.39%	2	1	93	93	0.001529943603649897	1	1	43	26	9	0	-AC
C5_BC29_consensus_vsearch	451	T	*/-C	56	23	29.11%	2	2	93	93	1.8266630946525813E-8	1	1	48	8	6	17	-C
C5_BC29_consensus_vsearch	478	T	*/-G	69	9	11.25%	2	1	93	93	0.001529943603649897	1	1	52	17	0	9	-G
C5_BC29_consensus_vsearch	484	C	*/-T	70	8	10.26%	2	1	93	93	0.0032347379048596157	1	1	53	17	0	8	-T
C5_BC29_consensus_vsearch	499	C	*/+A	56	12	16.22%	2	1	93	93	1.4357787204525497E-4	1	1	32	24	12	0	+A
C5_BC29_consensus_vsearch	500	G	*/-A	65	12	15.19%	2	1	93	93	1.5355965773680656E-4	1	1	39	26	12	0	-A
C5_BC29_consensus_vsearch	516	T	*/-C	57	18	22.5%	2	2	93	93	1.1981552701371513E-6	1	1	42	15	9	9	-C
C5_BC29_consensus_vsearch	530	C	*/-A	64	14	17.5%	2	2	93	93	3.219799275127145E-5	1	1	42	22	12	2	-A
C5_BC29_consensus_vsearch	560	G	*/-A	66	8	10.13%	2	1	93	93	0.0032001503021311726	1	1	40	26	8	0	-A
C5_BC29_consensus_vsearch	569	T	*/+C	24	46	63.01%	2	2	93	93	1.5594275002015296E-19	1	1	22	2	28	18	+C
C5_BC29_consensus_vsearch	587	A	*/-C	67	9	11.69%	2	1	93	93	0.00151955303103788	1	1	41	26	9	0	-C
C5_BC29_consensus_vsearch	617	C	*/-T	69	8	10%	2	2	93	93	0.0032264116811655053	1	1	53	16	1	7	-T
C5_BC29_consensus_vsearch	622	T	*/-C	71	8	10.13%	2	1	93	93	0.0032428631996773124	1	1	46	25	8	0	-C
C5_BC29_consensus_vsearch	654	A	*/-T	59	10	12.99%	2	2	93	93	6.878224352374522E-4	1	1	37	22	9	1	-T
C5_BC29_consensus_vsearch	691	T	*/-C	65	11	13.92%	2	1	93	93	3.30910248362529E-4	1	1	41	24	11	0	-C
C5_BC29_consensus_vsearch	734	G	*/+C	62	9	11.54%	2	2	93	93	0.0014912126829053666	1	1	41	21	8	1	+C
C5_BC29_consensus_vsearch	742	C	*/-AC	69	8	10.13%	2	1	93	93	0.0032264116811655053	1	1	45	24	8	0	-AC
C5_BC29_consensus_vsearch	789	C	*/-TT	65	8	10.13%	2	1	93	93	0.0031909412365132518	1	1	40	25	8	0	-TT
C5_BC29_consensus_vsearch	830	T	*/-A	70	9	11.25%	2	1	93	93	0.0015349552478475465	1	1	45	25	9	0	-A
C5_BC29_consensus_vsearch	842	C	*/+AC	24	37	48.05%	2	2	93	93	2.3337958537882514E-15	1	1	23	1	24	13	+AC
C5_BC29_consensus_vsearch	900	C	*/-T	61	11	13.75%	2	2	93	93	3.2326988230820273E-4	1	1	45	16	5	6	-T
C5_BC29_consensus_vsearch	955	T	*/-C	71	8	10%	2	2	93	93	0.0032428631996773124	1	1	46	25	7	1	-C
C5_BC29_consensus_vsearch	976	T	*/-A	64	13	16.46%	2	1	93	93	7.029139262599611E-5	1	1	39	25	13	0	-A
C5_BC29_consensus_vsearch	1039	C	*/-G	63	7	8.97%	2	2	93	93	0.006674952009195826	1	1	40	23	6	1	-G
C5_BC29_consensus_vsearch	1044	A	*/-CA	61	7	9.46%	2	2	93	93	0.006642560599974168	1	1	38	23	6	1	-CA
C5_BC29_consensus_vsearch	1091	A	*/-C	66	9	11.69%	2	1	93	93	0.0015141650758406918	1	1	42	24	9	0	-C
C5_BC29_consensus_vsearch	1145	A	*/+G	32	31	38.75%	2	2	93	93	3.2810903569513216E-12	1	1	26	6	12	19	+G
C5_BC29_consensus_vsearch	1154	C	*/+G	42	11	14.86%	2	2	93	93	2.7419184573992066E-4	1	1	32	10	8	3	+G
C5_BC29_consensus_vsearch	1154	C	*/-G	42	7	9.46%	2	2	93	93	0.006209196086325277	1	1	32	10	2	5	+G
C5_BC29_consensus_vsearch	1187	C	*/-T	70	7	8.75%	2	2	93	93	0.006775464530447864	1	1	53	17	1	6	-T
C5_BC29_consensus_vsearch	1192	G	*/-C	64	15	18.75%	2	2	93	93	1.4663417080995707E-5	1	1	39	25	14	1	-C
C5_BC29_consensus_vsearch	1210	C	*/-AC	70	8	10%	2	1	93	93	0.0032347379048596157	1	1	45	25	8	0	-AC
C5_BC29_consensus_vsearch	1271	C	*/-T	67	7	8.75%	2	2	93	93	0.006734644665677596	1	1	51	16	2	5	-T
C5_BC29_consensus_vsearch	1294	C	*/-T	70	8	10%	2	1	93	93	0.0032347379048596157	1	1	53	17	0	8	-T
C5_BC29_consensus_vsearch	1353	A	*/-G	63	13	16.67%	2	2	93	93	6.973589833777482E-5	1	1	38	25	12	1	-G
C5_BC29_consensus_vsearch	1383	T	*/-C	66	8	10.13%	2	1	93	93	0.0032001503021311726	1	1	41	25	8	0	-C
C5_BC29_consensus_vsearch	1396	T	*/-C	63	15	18.99%	2	2	93	93	1.451177138085664E-5	1	1	42	21	11	4	-C
C5_BC29_consensus_vsearch	1466	C	*/-A	71	7	8.75%	2	1	93	93	0.006788393631324507	1	1	47	24	7	0	-A
C5_BC29_consensus_vsearch	1469	T	*/+C	68	7	8.86%	2	1	93	93	0.006748603167255938	1	1	47	21	7	0	+C
C5_BC29_consensus_vsearch	1476	T	*/-C	57	23	28.75%	2	1	93	93	1.87765567580072E-8	1	1	31	26	23	0	-C
C5_BC29_consensus_vsearch	1481	A	*/-G	64	12	15.58%	2	2	93	93	1.5254727761391995E-4	1	1	42	22	11	1	-G
C5_BC29_consensus_vsearch	1496	A	*/-C	69	8	10.26%	2	2	93	93	0.0032264116811655053	1	1	46	23	6	2	-C
C5_BC29_consensus_vsearch	1512	T	*/-G	68	11	13.75%	2	1	93	93	3.3619779825426704E-4	1	1	53	15	0	11	-G
C5_BC29_consensus_vsearch	1520	T	*/-C	60	19	24.05%	2	1	93	93	5.578349305026512E-7	1	1	34	26	19	0	-C
C5_BC29_consensus_vsearch	1526	C	*/-G	64	7	8.75%	2	1	93	93	0.006690485474642467	1	1	42	22	7	0	-G
C5_BC29_consensus_vsearch	1531	T	*/-CC	66	9	11.39%	2	1	93	93	0.0015141650758406918	1	1	42	24	9	0	-CC
C5_BC29_consensus_vsearch	1535	G	+A/+A	13	60	76.92%	2	2	93	93	1.480140494323451E-28	1	1	11	2	36	24	+A
C5_BC29_consensus_vsearch	1546	T	*/-C	57	15	18.99%	2	2	93	93	1.354210309031423E-5	1	1	41	16	7	8	-C
C5_BC29_consensus_vsearch	1552	T	*/-C	72	8	10%	2	1	93	93	0.0032507947309133797	1	1	46	26	8	0	-C
C5_BC29_consensus_vsearch	1566	C	*/-GC	67	11	13.92%	2	2	93	93	3.3447467096847986E-4	1	1	50	17	4	7	-GC
C5_BC29_consensus_vsearch	1602	C	*/+A	44	12	15.19%	2	1	93	93	1.2641959630932279E-4	1	1	20	24	12	0	+A
C5_BC29_consensus_vsearch	1602	C	*/+AT	44	8	10.13%	2	1	93	93	0.0029216213584122254	1	1	20	24	8	0	+A
C5_BC29_consensus_vsearch	1602	C	*/+G	44	9	11.39%	2	1	93	93	0.001349510817933241	1	1	20	24	9	0	+G
C5_BC29_consensus_vsearch	1603	G	*/+A	18	29	38.16%	1	2	93	93	3.0639450528060697E-12	1	1	18	0	7	22	+A
C5_BC29_consensus_vsearch	1613	T	*/-C	57	12	15%	2	1	93	93	1.4479136155159058E-4	1	1	32	25	12	0	-C
C5_BC29_consensus_vsearch	1672	C	*/-T	68	9	11.69%	2	2	93	93	0.001524811000003712	1	1	45	23	8	1	-T
C5_BC29_consensus_vsearch	1683	T	*/-C	55	11	13.75%	2	2	93	93	3.103375397885081E-4	1	1	46	9	4	7	-C
C5_BC29_consensus_vsearch	1700	G	*/-TG	70	9	11.25%	2	2	93	93	0.0015349552478475465	1	1	46	24	7	2	-TG
C5_BC29_consensus_vsearch	1728	C	*/-T	71	8	10%	2	2	93	93	0.0032428631996773124	1	1	51	20	3	5	-T
C5_BC29_consensus_vsearch	1766	C	*/-A	63	8	10.39%	2	2	93	93	0.003171785706497264	1	1	46	17	2	6	-A
C5_BC29_consensus_vsearch	1803	C	*/-A	54	18	23.08%	2	2	93	93	1.133726470720369E-6	1	1	31	23	17	1	-A
C5_BC29_consensus_vsearch	1834	A	*/-C	67	12	15.19%	2	2	93	93	1.555200699407391E-4	1	1	51	16	3	9	-C
C5_BC29_consensus_vsearch	1864	T	*/-C	65	9	11.25%	2	1	93	93	0.0015086422852906565	1	1	39	26	9	0	-C
C5_BC29_consensus_vsearch	1919	A	*/-G	67	7	8.75%	2	2	93	93	0.006734644665677596	1	1	42	25	6	1	-G
C5_BC29_consensus_vsearch	1927	T	*/-C	67	9	11.39%	2	1	93	93	0.00151955303103788	1	1	44	23	9	0	-C
C5_BC29_consensus_vsearch	1944	C	*/+G	58	10	13.7%	2	1	93	93	6.840143631919109E-4	1	1	34	24	10	0	+G
C5_BC29_consensus_vsearch	1945	A	*/-T	59	10	14.29%	2	1	93	93	6.878224352374522E-4	1	1	35	24	10	0	-T
C5_BC29_consensus_vsearch	1952	T	+A/+A	6	69	86.25%	2	2	93	93	3.496218432176615E-36	1	1	3	3	50	19	+A
C5_BC29_consensus_vsearch	1954	T	*/-C	50	26	32.5%	2	2	93	93	1.1214577089869528E-9	1	1	36	14	15	11	-C
C5_BC29_consensus_vsearch	1976	A	*/+G	38	33	42.31%	2	2	93	93	8.710647287085913E-13	1	1	29	9	16	17	+G
C5_BC29_consensus_vsearch	2036	T	*/-C	65	12	15.38%	2	1	93	93	1.5355965773680656E-4	1	1	39	26	12	0	-C
C5_BC29_consensus_vsearch	2039	C	*/+A	43	25	31.65%	2	2	93	93	1.9778090442323843E-9	1	1	30	13	19	6	+A
C5_BC29_consensus_vsearch	2047	G	*/-AG	59	18	23.08%	2	2	93	93	1.2397492205316574E-6	1	1	35	24	17	1	-AG
C5_BC29_consensus_vsearch	2057	G	*/-TG	54	22	27.5%	2	2	93	93	4.0279725728783544E-8	1	1	35	19	15	7	-TG
C5_BC29_consensus_vsearch	2074	T	*/-C	66	7	9.21%	2	1	93	93	0.006720315634474235	1	1	45	21	7	0	-C
C5_BC29_consensus_vsearch	2111	G	*/-A	68	9	11.69%	2	1	93	93	0.001524811000003712	1	1	43	25	9	0	-A
C5_BC29_consensus_vsearch	2120	C	*/-AC	69	9	11.25%	2	1	93	93	0.001529943603649897	1	1	44	25	9	0	-AC
C5_BC29_consensus_vsearch	2140	A	*/-C	68	7	9.21%	2	1	93	93	0.006748603167255938	1	1	50	18	0	7	-C
C5_BC29_consensus_vsearch	2191	T	*/-A	61	9	11.69%	2	2	93	93	0.001485096978122699	1	1	42	19	4	5	-A
C5_BC29_consensus_vsearch	2223	A	*/-C	66	7	8.75%	2	1	93	93	0.006720315634474235	1	1	40	26	7	0	-C
C5_BC29_consensus_vsearch	2234	T	*/-C	68	11	13.75%	2	1	93	93	3.3619779825426704E-4	1	1	42	26	11	0	-C
C5_BC29_consensus_vsearch	2298	T	*/-A	71	7	8.75%	2	1	93	93	0.006788393631324507	1	1	46	25	7	0	-A
C5_BC29_consensus_vsearch	2348	T	*/-G	71	7	8.75%	2	1	93	93	0.006788393631324507	1	1	54	17	0	7	-G
C5_BC29_consensus_vsearch	2376	A	*/-T	62	12	15.38%	2	2	93	93	1.504546804177171E-4	1	1	39	23	10	2	-T
C5_BC29_consensus_vsearch	2409	A	*/-G	63	11	13.75%	2	2	93	93	3.2717922567031043E-4	1	1	43	20	7	4	-G
C5_BC29_consensus_vsearch	2414	T	*/-C	66	14	17.5%	2	1	93	93	3.276680718877326E-5	1	1	40	26	14	0	-C
C5_BC29_consensus_vsearch	2448	C	*/-A	70	8	10.13%	2	2	93	93	0.0032347379048596157	1	1	52	18	1	7	-A
C5_BC29_consensus_vsearch	2460	G	*/-TG	70	7	8.86%	2	2	93	93	0.006775464530447864	1	1	51	19	1	6	-TG
C5_BC29_consensus_vsearch	2470	C	*/-A	70	7	8.86%	2	2	93	93	0.006775464530447864	1	1	46	24	6	1	-A
C5_BC29_consensus_vsearch	2475	G	*/+T	47	31	38.75%	2	2	93	93	1.1034090888899382E-11	1	1	33	14	20	11	+T
C5_BC29_consensus_vsearch	2479	T	*/+GT	53	26	32.5%	2	2	93	93	1.262736467631406E-9	1	1	34	19	19	7	+GT
C5_BC29_consensus_vsearch	2485	T	*/-C	61	15	18.99%	2	1	93	93	1.420020951451421E-5	1	1	36	25	15	0	-C
C5_BC29_consensus_vsearch	2487	C	*/-G	68	11	13.75%	2	2	93	93	3.3619779825426704E-4	1	1	50	18	3	8	-G
C5_BC29_consensus_vsearch	2506	C	*/-G	70	7	8.75%	2	2	93	93	0.006775464530447864	1	1	47	23	5	2	-G
C5_BC29_consensus_vsearch	2509	G	*/+A	71	7	8.75%	2	1	93	93	0.006788393631324507	1	1	45	26	7	0	+A
C5_BC29_consensus_vsearch	2520	T	*/-C	56	23	29.11%	2	2	93	93	1.8266630946525813E-8	1	1	32	24	22	1	-C
C5_BC29_consensus_vsearch	2530	G	*/-TG	71	8	10.13%	2	2	93	93	0.0032428631996773124	1	1	49	22	5	3	-TG
C5_BC29_consensus_vsearch	2547	G	*/-A	70	10	12.5%	2	1	93	93	7.24035494267502E-4	1	1	44	26	10	0	-A
C5_BC29_consensus_vsearch	2549	A	*/-G	71	7	8.75%	2	2	93	93	0.006788393631324507	1	1	46	25	6	1	-G
C5_BC29_consensus_vsearch	2552	C	*/+G	72	7	8.75%	2	1	93	93	0.006801004765989798	1	1	47	25	7	0	+G
C5_BC29_consensus_vsearch	2638	G	*/-A	70	7	8.75%	2	2	93	93	0.006775464530447864	1	1	47	23	6	1	-A
C5_BC29_consensus_vsearch	2652	C	*/-A	65	14	17.5%	2	1	93	93	3.2485108610198266E-5	1	1	40	25	14	0	-A
C5_BC29_consensus_vsearch	2676	T	*/+C	65	10	12.5%	2	1	93	93	7.087581206061954E-4	1	1	40	25	10	0	+C
C5_BC29_consensus_vsearch	2738	C	*/-A	60	18	22.78%	2	1	93	93	1.2601450948046846E-6	1	1	34	26	18	0	-A
C5_BC29_consensus_vsearch	2746	A	*/-G	59	11	14.1%	2	2	93	93	3.191694034015893E-4	1	1	47	12	2	9	-G
C5_BC29_consensus_vsearch	2783	C	*/+A	71	8	10%	2	1	93	93	0.0032428631996773124	1	1	45	26	8	0	+A
C5_BC29_consensus_vsearch	2810	T	*/-C	64	11	13.92%	2	2	93	93	3.2906627028144115E-4	1	1	44	20	9	2	-C
C5_BC29_consensus_vsearch	2822	T	*/-C	61	14	17.72%	2	2	93	93	3.1302651630535304E-5	1	1	38	23	12	2	-C
C5_BC29_consensus_vsearch	2861	C	*/-TC	65	9	11.39%	2	2	93	93	0.0015086422852906565	1	1	48	17	5	4	-TC
C5_BC29_consensus_vsearch	2875	G	*/+A	68	7	8.97%	2	1	93	93	0.006748603167255938	1	1	46	22	7	0	+A
C5_BC29_consensus_vsearch	2902	G	*/-CG	60	19	24.05%	2	2	93	93	5.578349305026512E-7	1	1	41	19	13	6	-CG
C5_BC29_consensus_vsearch	2941	T	*/-A	67	10	12.5%	2	1	93	93	7.15083779311783E-4	1	1	42	25	10	0	-A
C5_BC29_consensus_vsearch	2961	T	*/-C	72	7	8.75%	2	1	93	93	0.006801004765989798	1	1	46	26	7	0	-C
C5_BC29_consensus_vsearch	2979	T	*/+C	64	13	16.46%	2	1	93	93	7.029139262599611E-5	1	1	38	26	13	0	+C
C5_BC29_consensus_vsearch	2987	G	*/-AG	67	8	10.26%	2	1	93	93	0.003209125981632621	1	1	41	26	8	0	-AG
C5_BC29_consensus_vsearch	2996	T	*/-C	62	16	20%	2	2	93	93	6.483982957402572E-6	1	1	49	13	4	12	-C
C5_BC29_consensus_vsearch	3021	G	*/-AG	60	9	12%	2	1	93	93	0.0014788182357604385	1	1	37	23	9	0	-AG
C5_BC29_consensus_vsearch	3022	A	*/-G	49	12	17.91%	2	2	93	93	1.342080026189366E-4	1	1	28	21	9	3	-G
C5_BC29_consensus_vsearch	3040	T	*/-C	61	19	23.75%	2	2	93	93	5.676699416497621E-7	1	1	36	25	18	1	-C
C5_BC29_consensus_vsearch	3180	T	*/-C	56	21	26.25%	2	2	93	93	9.82904287636758E-8	1	1	44	12	10	11	-C
C5_BC29_consensus_vsearch	3199	T	*/-AA	70	8	10%	2	1	93	93	0.0032347379048596157	1	1	54	16	0	8	-AA
C5_BC29_consensus_vsearch	3213	C	*/-AC	70	8	10%	2	1	93	93	0.0032347379048596157	1	1	44	26	8	0	-AC
C5_BC29_consensus_vsearch	3223	T	*/+A	72	7	8.86%	2	1	93	93	0.006801004765989798	1	1	46	26	7	0	+A
C5_BC29_consensus_vsearch	3269	T	*/+C	48	11	13.92%	2	2	93	93	2.9249865769560363E-4	1	1	30	18	10	1	+C
C5_BC29_consensus_vsearch	3269	T	*/-C	48	16	20.25%	2	2	93	93	5.233673935046541E-6	1	1	30	18	11	5	-C
C5_BC29_consensus_vsearch	3281	C	*/-A	69	9	11.25%	2	1	93	93	0.001529943603649897	1	1	44	25	9	0	-A
C5_BC29_consensus_vsearch	3295	T	+CT/+CT	9	67	83.75%	2	2	93	93	1.1162236894029215E-33	1	1	7	2	44	23	+CT
C5_BC29_consensus_vsearch	3300	G	*/+C	29	49	61.25%	2	2	93	93	2.1026361941269294E-20	1	1	18	11	36	13	+C
C5_BC29_consensus_vsearch	3385	T	*/-C	49	22	27.85%	2	2	93	93	3.4700434893344096E-8	1	1	36	13	17	5	-C
C5_BC29_consensus_vsearch	3452	T	*/-G	49	25	32.05%	2	2	93	93	2.583889093137667E-9	1	1	35	14	15	10	-G
C5_BC29_consensus_vsearch	3462	A	*/-G	66	9	11.54%	2	1	93	93	0.0015141650758406918	1	1	41	25	9	0	-G
C5_BC29_consensus_vsearch	3483	G	*/-A	67	8	10.13%	2	1	93	93	0.003209125981632621	1	1	41	26	8	0	-A
C5_BC29_consensus_vsearch	3498	C	*/+G	29	41	51.25%	2	2	93	93	9.392038874532623E-17	1	1	28	1	20	21	+G
C5_BC29_consensus_vsearch	3502	A	*/-C	57	15	18.75%	2	2	93	93	1.354210309031423E-5	1	1	33	24	13	2	-C
C5_BC29_consensus_vsearch	3610	C	*/-GC	66	12	15%	2	2	93	93	1.545503652061316E-4	1	1	42	24	10	2	-GC
C5_BC29_consensus_vsearch	3633	A	*/-C	69	8	10%	2	1	93	93	0.0032264116811655053	1	1	44	25	8	0	-C
C5_BC29_consensus_vsearch	3651	G	*/-A	57	15	20%	2	1	93	93	1.354210309031423E-5	1	1	32	25	15	0	-A
C5_BC29_consensus_vsearch	3652	A	*/+G	17	7	11.29%	2	2	93	93	0.004700643245917777	1	1	16	1	5	2	+G
C5_BC29_consensus_vsearch	3652	A	*/+GG	17	24	38.71%	2	2	93	93	4.6505616217573394E-10	1	1	16	1	4	20	+GG
C5_BC29_consensus_vsearch	3653	G	*/+A	21	32	45.07%	1	2	93	93	2.4145704551777203E-13	1	1	21	0	8	24	+A
C5_BC29_consensus_vsearch	3676	C	*/+G	62	13	16.46%	2	1	93	93	6.916876247391385E-5	1	1	38	24	13	0	+G
C5_BC29_consensus_vsearch	3677	A	*/-G	62	13	16.67%	2	1	93	93	6.916876247391385E-5	1	1	38	24	13	0	-G
C5_BC29_consensus_vsearch	3688	T	*/+A	58	14	17.72%	2	2	93	93	3.0352989685187766E-5	1	1	36	22	13	1	+A
C5_BC29_consensus_vsearch	3690	A	*/-G	60	9	11.69%	2	2	93	93	0.0014788182357604385	1	1	46	14	3	6	-G
C5_BC29_consensus_vsearch	3690	A	*/-GG	60	7	9.09%	2	2	93	93	0.00662566455193586	1	1	46	14	3	4	-G
C5_BC29_consensus_vsearch	3709	G	*/-C	66	8	10.13%	2	1	93	93	0.0032001503021311726	1	1	41	25	8	0	-C
C5_BC29_consensus_vsearch	3720	A	*/-G	66	12	15.19%	2	2	93	93	1.545503652061316E-4	1	1	44	22	9	3	-G
C5_BC29_consensus_vsearch	3730	T	*/+C	72	7	8.75%	2	1	93	93	0.006801004765989798	1	1	47	25	7	0	+C
C5_BC29_consensus_vsearch	3743	A	*/-C	51	20	25.97%	2	2	93	93	2.0088149799826468E-7	1	1	43	8	7	13	-C
C5_BC29_consensus_vsearch	3749	C	+A/+A	6	70	87.5%	2	2	93	93	9.493043425114606E-37	1	1	4	2	46	24	+A
C5_BC29_consensus_vsearch	3775	C	*/+A	73	7	8.75%	2	2	93	93	0.006813309504518076	1	1	53	20	1	6	+A
C5_BC29_consensus_vsearch	3797	T	*/-G	70	9	11.25%	2	2	93	93	0.0015349552478475465	1	1	53	17	1	8	-G
C5_BC29_consensus_vsearch	3838	T	*/+C	30	44	56.41%	1	2	93	93	5.024238724858156E-18	1	1	30	0	22	22	+C
C5_BC29_consensus_vsearch	3864	G	*/+T	29	19	23.75%	2	2	93	93	2.0554899573963374E-7	1	1	21	8	5	14	+T
C5_BC29_consensus_vsearch	3864	G	*/-T	29	24	30%	2	1	93	93	2.0050310696233306E-9	1	1	21	8	24	0	-T
C5_BC29_consensus_vsearch	3956	C	*/-GC	71	8	10.13%	2	2	93	93	0.0032428631996773124	1	1	49	22	5	3	-GC
C5_BC29_consensus_vsearch	3968	T	*/-C	72	7	8.75%	2	2	93	93	0.006801004765989798	1	1	48	24	5	2	-C
C5_BC29_consensus_vsearch	3998	C	*/-T	71	8	10%	2	1	93	93	0.0032428631996773124	1	1	54	17	0	8	-T
C5_BC29_consensus_vsearch	4003	T	*/-C	64	12	15.58%	2	1	93	93	1.5254727761391995E-4	1	1	38	26	12	0	-C
C5_BC29_consensus_vsearch	4005	C	*/-G	73	7	8.75%	2	1	93	93	0.006813309504518076	1	1	54	19	0	7	-G
C5_BC29_consensus_vsearch	4016	T	*/+C	72	7	8.86%	2	1	93	93	0.006801004765989798	1	1	46	26	7	0	+C
C5_BC29_consensus_vsearch	4022	T	*/-C	55	20	25.32%	2	2	93	93	2.2117231218352156E-7	1	1	39	16	13	7	-C
C5_BC29_consensus_vsearch	4030	A	*/-C	68	7	9.09%	2	1	93	93	0.006748603167255938	1	1	42	26	7	0	-C
C5_BC29_consensus_vsearch	4050	T	*/-C	60	19	24.05%	2	1	93	93	5.578349305026512E-7	1	1	34	26	19	0	-C
C5_BC29_consensus_vsearch	4136	C	*/+T	72	7	8.75%	2	1	93	93	0.006801004765989798	1	1	54	18	0	7	+T
C5_BC29_consensus_vsearch	4160	A	*/-G	66	9	11.39%	2	1	93	93	0.0015141650758406918	1	1	40	26	9	0	-G
C5_BC29_consensus_vsearch	4165	T	*/-G	71	7	8.75%	2	1	93	93	0.006788393631324507	1	1	52	19	0	7	-G
C5_BC29_consensus_vsearch	4218	T	*/-C	64	13	16.46%	2	1	93	93	7.029139262599611E-5	1	1	40	24	13	0	-C
