Chrom	Position	Ref	Cons	Reads1	Reads2	VarFreq	Strands1	Strands2	Qual1	Qual2	Pvalue	MapQual1	MapQual2	Reads1Plus	Reads1Minus	Reads2Plus	Reads2Minus	VarAllele
G3_BC75_consensus_vsearch	3	G	*/+T	99	7	4.79%	2	1	93	93	0.007053464356056319	1	1	82	17	7	0	+T
G3_BC75_consensus_vsearch	3	G	*/-T	99	40	27.4%	2	1	93	93	3.4033612431945333E-14	1	1	82	17	40	0	-T
G3_BC75_consensus_vsearch	24	T	*/-C	191	28	12.5%	2	2	93	93	1.4823492013779318E-9	1	1	120	71	6	22	-C
G3_BC75_consensus_vsearch	45	T	*/+G	203	14	6.28%	2	2	93	93	4.915625783020227E-5	1	1	120	83	6	8	+G
G3_BC75_consensus_vsearch	56	C	*/+G	204	12	5.36%	2	1	93	93	2.0867313373012331E-4	1	1	113	91	12	0	+G
G3_BC75_consensus_vsearch	57	A	*/-G	206	15	6.7%	2	2	93	93	2.3870469071571428E-5	1	1	114	92	14	1	-G
G3_BC75_consensus_vsearch	77	G	*/+A	203	13	5.78%	2	1	93	93	1.0135552209744578E-4	1	1	110	93	13	0	+A
G3_BC75_consensus_vsearch	84	G	*/-A	198	19	8.56%	2	2	93	93	1.2636778396454046E-6	1	1	105	93	18	1	-A
G3_BC75_consensus_vsearch	85	A	*/-G	192	7	3.41%	2	1	93	93	0.007404462106241813	1	1	100	92	7	0	-G
G3_BC75_consensus_vsearch	89	A	*/-GCA	206	11	4.91%	2	2	93	93	4.288076047440095E-4	1	1	126	80	1	10	-GCA
G3_BC75_consensus_vsearch	101	A	*/-C	196	17	7.62%	2	2	93	93	5.472889986979232E-6	1	1	103	93	16	1	-C
G3_BC75_consensus_vsearch	108	C	*/+G	189	9	3.98%	2	1	93	93	0.00177983409863699	1	1	112	77	0	9	+G
G3_BC75_consensus_vsearch	108	C	*/-GAA	189	9	3.98%	2	1	93	93	0.00177983409863699	1	1	112	77	9	0	+G
G3_BC75_consensus_vsearch	109	G	*/+A	196	9	4.19%	2	2	93	93	0.001785610469261078	1	1	105	91	8	1	+A
G3_BC75_consensus_vsearch	124	C	*/+A	207	9	4%	2	1	93	93	0.001793948723227531	1	1	116	91	9	0	+A
G3_BC75_consensus_vsearch	137	T	*/-C	167	51	22.57%	2	2	93	93	1.6104746458363567E-17	1	1	108	59	19	32	-C
G3_BC75_consensus_vsearch	158	G	*/-C	203	14	6.22%	2	2	93	93	4.915625783020227E-5	1	1	123	80	4	10	-C
G3_BC75_consensus_vsearch	170	A	*/+C	167	16	7.14%	2	2	93	93	1.0833863733569022E-5	1	1	106	61	6	10	+C
G3_BC75_consensus_vsearch	170	A	*/-C	167	31	13.84%	2	2	93	93	1.302884511496378E-10	1	1	106	61	10	21	-C
G3_BC75_consensus_vsearch	174	C	*/-T	203	16	7.08%	2	2	93	93	1.1485308764863282E-5	1	1	125	78	4	12	-T
G3_BC75_consensus_vsearch	178	T	*/-C	196	25	11.21%	2	2	93	93	1.4521229368552077E-8	1	1	105	91	24	1	-C
G3_BC75_consensus_vsearch	191	G	*/-A	209	14	6.19%	2	1	93	93	4.9452447660699634E-5	1	1	115	94	14	0	-A
G3_BC75_consensus_vsearch	198	C	*/-T	213	7	3.11%	2	2	93	93	0.007443047448823043	1	1	124	89	3	4	-T
G3_BC75_consensus_vsearch	206	C	*/-T	210	7	3.14%	2	2	93	93	0.007437988084800957	1	1	120	90	3	4	-T
G3_BC75_consensus_vsearch	208	T	*/-C	159	40	18.18%	2	2	93	93	1.0279515672471388E-13	1	1	106	53	12	28	-C
G3_BC75_consensus_vsearch	208	T	*/-CC	159	8	3.64%	2	2	93	93	0.0035851936379921044	1	1	106	53	2	6	-C
G3_BC75_consensus_vsearch	211	C	*/-T	190	18	8.04%	2	2	93	93	2.598147628391323E-6	1	1	122	68	1	17	-T
G3_BC75_consensus_vsearch	214	A	*/-C	203	13	5.78%	2	2	93	93	1.0135552209744578E-4	1	1	110	93	12	1	-C
G3_BC75_consensus_vsearch	215	C	*/+T	200	9	4.29%	2	1	93	93	0.0017887416879729845	1	1	115	85	0	9	+T
G3_BC75_consensus_vsearch	218	A	*/-CA	213	7	3.17%	2	1	93	93	0.007443047448823043	1	1	120	93	7	0	-CA
G3_BC75_consensus_vsearch	237	G	*/-A	211	15	6.64%	2	1	93	93	2.4004930780571747E-5	1	1	116	95	15	0	-A
G3_BC75_consensus_vsearch	240	G	*/+T	215	7	3.1%	2	1	93	93	0.007446345105805389	1	1	120	95	7	0	+T
G3_BC75_consensus_vsearch	247	G	*/+C	207	11	4.87%	2	1	93	93	4.2906952287648286E-4	1	1	114	93	11	0	+C
G3_BC75_consensus_vsearch	251	A	*/-G	188	30	13.39%	2	2	93	93	3.1911630279193985E-10	1	1	120	68	6	24	-G
G3_BC75_consensus_vsearch	266	G	*/+T	216	7	3.11%	2	1	93	93	0.007447971960236055	1	1	122	94	7	0	+T
G3_BC75_consensus_vsearch	271	G	*/-A	200	13	5.91%	2	2	93	93	1.0108231417166703E-4	1	1	107	93	11	2	-A
G3_BC75_consensus_vsearch	309	G	*/+A	206	8	3.54%	2	1	93	93	0.0036546013500883302	1	1	112	94	8	0	+A
G3_BC75_consensus_vsearch	309	G	*/-A	206	11	4.87%	2	2	93	93	4.288076047440095E-4	1	1	112	94	10	1	-A
G3_BC75_consensus_vsearch	312	G	*/+T	184	14	6.19%	2	1	93	93	4.811012196880537E-5	1	1	101	83	14	0	+T
G3_BC75_consensus_vsearch	312	G	*/-T	184	28	12.39%	2	2	93	93	1.4348194500451993E-9	1	1	101	83	16	12	-T
G3_BC75_consensus_vsearch	317	C	*/-A	206	10	4.5%	2	1	93	93	8.778898007284436E-4	1	1	115	91	10	0	-A
G3_BC75_consensus_vsearch	319	A	*/-G	180	34	15.18%	2	2	93	93	1.4016741138930937E-11	1	1	97	83	29	5	-G
G3_BC75_consensus_vsearch	331	G	*/-A	206	14	6.33%	2	2	93	93	4.930621480362649E-5	1	1	113	93	12	2	-A
G3_BC75_consensus_vsearch	342	C	*/-GC	209	11	4.89%	2	1	93	93	4.2958650804029443E-4	1	1	115	94	11	0	-GC
G3_BC75_consensus_vsearch	348	A	*/-G	169	33	15.14%	2	2	93	93	2.805266330491728E-11	1	1	119	50	3	30	-G
G3_BC75_consensus_vsearch	354	C	*/+T	196	10	4.67%	2	1	93	93	8.7325475503958E-4	1	1	125	71	0	10	+T
G3_BC75_consensus_vsearch	355	T	*/-C	178	17	7.69%	2	2	93	93	5.300321947348008E-6	1	1	119	59	3	14	-C
G3_BC75_consensus_vsearch	355	T	*/-CCT	178	16	7.24%	2	2	93	93	1.1055363203854364E-5	1	1	119	59	3	13	-C
G3_BC75_consensus_vsearch	367	A	*/-G	211	8	3.59%	2	2	93	93	0.0036602593149509337	1	1	121	90	7	1	-G
G3_BC75_consensus_vsearch	369	G	*/-C	115	60	26.67%	2	2	93	93	1.8761144290552156E-21	1	1	76	39	48	12	-C
G3_BC75_consensus_vsearch	369	G	*/-CC	115	30	13.33%	2	2	93	93	1.7471565051258392E-10	1	1	76	39	1	29	-C
G3_BC75_consensus_vsearch	369	G	*/-CCC	115	13	5.78%	2	1	93	93	8.859978307544659E-5	1	1	76	39	0	13	-C
G3_BC75_consensus_vsearch	374	C	*/-T	207	17	7.56%	2	2	93	93	5.56642225097613E-6	1	1	129	78	1	16	-T
G3_BC75_consensus_vsearch	377	T	*/-CT	196	26	11.61%	2	2	93	93	6.850873449275763E-9	1	1	118	78	11	15	-CT
G3_BC75_consensus_vsearch	392	T	*/-C	192	26	11.5%	2	2	93	93	6.747777093771561E-9	1	1	111	81	16	10	-C
G3_BC75_consensus_vsearch	394	C	*/-G	206	7	3.11%	2	1	93	93	0.007431022745174962	1	1	119	87	7	0	-G
G3_BC75_consensus_vsearch	408	G	*/-A	211	15	6.64%	2	1	93	93	2.4004930780571747E-5	1	1	116	95	15	0	-A
G3_BC75_consensus_vsearch	427	C	*/-T	210	9	4%	2	2	93	93	0.0017960807336148846	1	1	118	92	7	2	-T
G3_BC75_consensus_vsearch	431	T	*/-C	214	9	4.02%	2	2	93	93	0.0017988361772468277	1	1	125	89	3	6	-C
G3_BC75_consensus_vsearch	438	T	*/-C	198	26	11.5%	2	1	93	93	6.901521790089107E-9	1	1	105	93	26	0	-C
G3_BC75_consensus_vsearch	441	T	*/-G	202	12	5.43%	2	2	93	93	2.0835870377678545E-4	1	1	122	80	1	11	-G
G3_BC75_consensus_vsearch	451	T	*/-C	184	35	15.56%	2	2	93	93	6.649044898355569E-12	1	1	98	86	28	7	-C
G3_BC75_consensus_vsearch	454	C	*/-T	204	11	4.87%	2	2	93	93	4.2827676494109035E-4	1	1	127	77	1	10	-T
G3_BC75_consensus_vsearch	462	A	*/-G	211	8	3.54%	2	2	93	93	0.0036602593149509337	1	1	120	91	7	1	-G
G3_BC75_consensus_vsearch	467	G	*/-CG	211	9	4.04%	2	1	93	93	0.0017967787753331713	1	1	128	83	0	9	-CG
G3_BC75_consensus_vsearch	485	A	*/+C	199	13	5.83%	2	2	93	93	1.0098964132434686E-4	1	1	108	91	12	1	+C
G3_BC75_consensus_vsearch	486	C	*/+T	209	9	4.11%	2	1	93	93	0.0017953764342624938	1	1	127	82	0	9	+T
G3_BC75_consensus_vsearch	502	G	*/-A	215	7	3.14%	2	2	93	93	0.007446345105805389	1	1	123	92	6	1	-A
G3_BC75_consensus_vsearch	506	C	*/-T	209	13	5.78%	2	2	93	93	1.0188120004185222E-4	1	1	127	82	2	11	-T
G3_BC75_consensus_vsearch	514	C	*/-T	202	8	3.54%	2	2	93	93	0.0036498841327700354	1	1	120	82	1	7	-T
G3_BC75_consensus_vsearch	517	T	*/+C	162	7	3.11%	2	2	93	93	0.007332911989892741	1	1	99	63	3	4	+C
G3_BC75_consensus_vsearch	517	T	*/-C	162	47	20.89%	2	2	93	93	3.841946439843115E-16	1	1	99	63	25	22	-C
G3_BC75_consensus_vsearch	520	C	*/-T	207	8	3.54%	2	1	93	93	0.003655753662936563	1	1	129	78	0	8	-T
G3_BC75_consensus_vsearch	527	C	*/+T	209	10	4.44%	2	1	93	93	8.792003591123169E-4	1	1	118	91	10	0	+T
G3_BC75_consensus_vsearch	531	C	*/-A	170	48	21.24%	2	2	93	93	1.9339221142501194E-16	1	1	79	91	45	3	-A
G3_BC75_consensus_vsearch	539	C	*/-GC	191	19	8.48%	2	2	93	93	1.2456546324351246E-6	1	1	105	86	13	6	-GC
G3_BC75_consensus_vsearch	544	A	*/-G	182	31	14.09%	2	1	93	93	1.4353309721310144E-10	1	1	90	92	31	0	-G
G3_BC75_consensus_vsearch	547	C	*/-GC	203	7	3.17%	2	1	93	93	0.007425626339083171	1	1	109	94	7	0	-GC
G3_BC75_consensus_vsearch	548	G	*/-C	188	11	5.21%	2	1	93	93	4.2366328040616125E-4	1	1	96	92	11	0	-C
G3_BC75_consensus_vsearch	550	C	*/+T	179	8	3.64%	2	1	93	93	0.0036189151712300786	1	1	96	83	0	8	+T
G3_BC75_consensus_vsearch	550	C	*/-T	179	8	3.64%	2	2	93	93	0.0036189151712300786	1	1	96	83	6	2	+T
G3_BC75_consensus_vsearch	550	C	*/-TT	179	9	4.09%	2	1	93	93	0.0017708558237889195	1	1	96	83	9	0	-TT
G3_BC75_consensus_vsearch	551	T	*/+A	180	11	5.34%	2	1	93	93	4.2108036879098717E-4	1	1	87	93	11	0	+A
G3_BC75_consensus_vsearch	556	A	*/-T	210	9	4%	2	1	93	93	0.0017960807336148846	1	1	129	81	0	9	-T
G3_BC75_consensus_vsearch	558	T	*/-CAA	209	9	4.04%	2	1	93	93	0.0017953764342624938	1	1	131	78	0	9	-CAA
G3_BC75_consensus_vsearch	559	C	*/-A	181	11	5.16%	2	2	93	93	4.214144486820526E-4	1	1	128	53	2	9	-A
G3_BC75_consensus_vsearch	559	C	*/-AA	181	20	9.39%	2	1	93	93	5.802016995088745E-7	1	1	128	53	0	20	-AA
G3_BC75_consensus_vsearch	568	A	*/+G	202	8	3.56%	2	1	93	93	0.0036498841327700354	1	1	119	83	0	8	+G
G3_BC75_consensus_vsearch	575	C	*/-GC	211	8	3.56%	2	1	93	93	0.0036602593149509337	1	1	118	93	8	0	-GC
G3_BC75_consensus_vsearch	577	C	*/-T	202	9	4.15%	2	2	93	93	0.0017902638323438202	1	1	109	93	8	1	-T
G3_BC75_consensus_vsearch	580	A	*/-G	177	38	16.81%	2	2	93	93	6.050852009968977E-13	1	1	121	56	4	34	-G
G3_BC75_consensus_vsearch	589	T	*/-C	208	8	3.6%	2	2	93	93	0.0036568954742723925	1	1	125	83	1	7	-C
G3_BC75_consensus_vsearch	591	A	*/-C	193	12	5.45%	2	2	93	93	2.0687207786004562E-4	1	1	114	79	5	7	-C
G3_BC75_consensus_vsearch	614	C	*/-A	210	9	3.98%	2	2	93	93	0.0017960807336148846	1	1	117	93	7	2	-A
G3_BC75_consensus_vsearch	615	A	*/-G	167	31	14.42%	2	2	93	93	1.302884511496378E-10	1	1	100	67	5	26	-G
G3_BC75_consensus_vsearch	621	C	*/+T	197	10	4.42%	2	2	93	93	8.737377439902802E-4	1	1	118	79	3	7	+T
G3_BC75_consensus_vsearch	621	C	*/-T	197	14	6.19%	2	2	93	93	4.8844590491071155E-5	1	1	118	79	5	9	-T
G3_BC75_consensus_vsearch	626	T	*/-C	205	11	4.91%	2	2	93	93	4.285433624407098E-4	1	1	112	93	10	1	-C
G3_BC75_consensus_vsearch	632	T	*/+C	215	7	3.11%	2	1	93	93	0.007446345105805389	1	1	121	94	7	0	+C
G3_BC75_consensus_vsearch	639	T	*/-C	202	11	4.89%	2	2	93	93	4.2773637746469634E-4	1	1	110	92	9	2	-C
G3_BC75_consensus_vsearch	639	T	*/-CC	202	8	3.56%	2	1	93	93	0.0036498841327700354	1	1	110	92	8	0	-C
G3_BC75_consensus_vsearch	649	C	*/+TT	203	8	3.57%	2	1	93	93	0.0036510799339400076	1	1	113	90	8	0	+TT
G3_BC75_consensus_vsearch	658	A	*/+T	210	7	3.11%	2	2	93	93	0.007437988084800957	1	1	119	91	3	4	+T
G3_BC75_consensus_vsearch	666	C	*/-T	217	7	3.12%	2	2	93	93	0.007449584424390529	1	1	126	91	3	4	-T
G3_BC75_consensus_vsearch	671	A	*/-C	209	7	3.17%	2	2	93	93	0.007436270701269745	1	1	117	92	5	2	-C
G3_BC75_consensus_vsearch	683	A	*/+C	212	8	3.56%	2	1	93	93	0.003661360523321731	1	1	128	84	0	8	+C
G3_BC75_consensus_vsearch	685	T	*/+C	178	8	3.57%	2	1	93	93	0.0036173981471315664	1	1	120	58	0	8	+C
G3_BC75_consensus_vsearch	685	T	*/-A	178	9	4.02%	2	2	93	93	0.0017699066001378024	1	1	120	58	8	1	-A
G3_BC75_consensus_vsearch	695	T	*/-C	192	26	11.66%	2	1	93	93	6.747777093771561E-9	1	1	102	90	26	0	-C
G3_BC75_consensus_vsearch	701	C	*/-AC	213	8	3.56%	2	2	93	93	0.0036624519192641563	1	1	124	89	6	2	-AC
G3_BC75_consensus_vsearch	710	G	*/-CG	217	8	3.54%	2	2	93	93	0.0036667219549938834	1	1	127	90	4	4	-CG
G3_BC75_consensus_vsearch	713	T	*/-C	200	21	9.33%	2	1	93	93	2.896747146375421E-7	1	1	107	93	21	0	-C
G3_BC75_consensus_vsearch	722	C	*/-TC	200	19	8.6%	2	1	93	93	1.268651398690971E-6	1	1	128	72	0	19	-TC
G3_BC75_consensus_vsearch	723	T	*/+C	182	25	12.08%	2	1	93	93	1.3788857992806407E-8	1	1	106	76	25	0	+C
G3_BC75_consensus_vsearch	727	C	*/-A	214	7	3.1%	2	2	93	93	0.007444703667648697	1	1	124	90	5	2	-A
G3_BC75_consensus_vsearch	734	A	*/-C	211	8	3.54%	2	2	93	93	0.0036602593149509337	1	1	124	87	1	7	-C
G3_BC75_consensus_vsearch	739	C	*/-AC	208	12	5.33%	2	1	93	93	2.0928573468617033E-4	1	1	114	94	12	0	-AC
G3_BC75_consensus_vsearch	742	G	*/+C	190	8	3.57%	2	2	93	93	0.003634608580377523	1	1	122	68	4	4	+C
G3_BC75_consensus_vsearch	742	G	*/-C	190	20	8.93%	2	2	93	93	5.933167950001205E-7	1	1	122	68	3	17	-C
G3_BC75_consensus_vsearch	743	C	*/+T	186	15	7.35%	2	1	93	93	2.3272499024923496E-5	1	1	127	59	0	15	+T
G3_BC75_consensus_vsearch	746	T	*/+C	185	10	4.5%	2	2	93	93	8.676264462271394E-4	1	1	105	80	7	3	+C
G3_BC75_consensus_vsearch	746	T	*/-C	185	13	5.86%	2	2	93	93	9.960095521111045E-5	1	1	105	80	9	4	-C
G3_BC75_consensus_vsearch	748	C	*/+T	202	15	6.79%	2	1	93	93	2.375885795125084E-5	1	1	131	71	0	15	+T
G3_BC75_consensus_vsearch	751	C	*/-T	199	21	9.42%	2	2	93	93	2.8898665118248697E-7	1	1	125	74	3	18	-T
G3_BC75_consensus_vsearch	757	G	*/+C	210	10	4.44%	2	1	93	93	8.796295164637225E-4	1	1	117	93	10	0	+C
G3_BC75_consensus_vsearch	767	C	*/-G	215	8	3.54%	2	1	93	93	0.0036646057936482192	1	1	130	85	0	8	-G
G3_BC75_consensus_vsearch	779	A	*/-T	212	7	3.15%	2	2	93	93	0.00744137624879223	1	1	118	94	6	1	-T
G3_BC75_consensus_vsearch	781	G	*/+C	205	8	3.6%	2	1	93	93	0.0036534383902297935	1	1	116	89	8	0	+C
G3_BC75_consensus_vsearch	783	A	*/-T	211	8	3.56%	2	1	93	93	0.0036602593149509337	1	1	126	85	0	8	-T
G3_BC75_consensus_vsearch	791	T	*/+G	197	9	4.02%	2	1	93	93	0.0017864043973660122	1	1	112	85	9	0	+G
G3_BC75_consensus_vsearch	792	A	*/-G	196	13	5.94%	2	2	93	93	1.0070666248340834E-4	1	1	113	83	6	7	-G
G3_BC75_consensus_vsearch	797	T	*/-A	186	26	11.76%	2	2	93	93	6.588494101249739E-9	1	1	98	88	24	2	-A
G3_BC75_consensus_vsearch	809	A	*/-T	206	11	4.87%	2	2	93	93	4.288076047440095E-4	1	1	114	92	9	2	-T
G3_BC75_consensus_vsearch	815	A	*/-G	200	10	4.42%	2	2	93	93	8.751600144021374E-4	1	1	120	80	2	8	-G
G3_BC75_consensus_vsearch	836	T	*/-A	197	11	4.95%	2	1	93	93	4.263419112240475E-4	1	1	117	80	11	0	-A
G3_BC75_consensus_vsearch	836	T	*/-AA	197	10	4.5%	2	2	93	93	8.737377439902802E-4	1	1	117	80	1	9	-A
G3_BC75_consensus_vsearch	848	C	*/+A	70	16	7.17%	2	1	93	93	7.079003966829815E-6	1	1	64	6	0	16	+A
G3_BC75_consensus_vsearch	848	C	*/+AC	70	121	54.26%	2	2	93	93	1.123183599185836E-49	1	1	64	6	58	63	+AC
G3_BC75_consensus_vsearch	850	T	*/-C	202	10	4.46%	2	1	93	93	8.760865562530377E-4	1	1	128	74	0	10	-C
G3_BC75_consensus_vsearch	866	C	*/-T	207	8	3.6%	2	2	93	93	0.003655753662936563	1	1	119	88	6	2	-T
G3_BC75_consensus_vsearch	868	T	*/-C	187	23	10.36%	2	2	93	93	6.305854379020566E-8	1	1	114	73	4	19	-C
G3_BC75_consensus_vsearch	906	C	*/+T	134	14	6.22%	2	2	93	93	4.422121277582909E-5	1	1	92	42	7	7	+T
G3_BC75_consensus_vsearch	906	C	*/-T	134	58	25.78%	2	2	93	93	2.138045675164982E-20	1	1	92	42	24	34	-T
G3_BC75_consensus_vsearch	906	C	*/-TT	134	15	6.67%	2	2	93	93	2.1068355581752277E-5	1	1	92	42	5	10	-T
G3_BC75_consensus_vsearch	922	G	*/-C	211	12	5.31%	2	1	93	93	2.0973150235371546E-4	1	1	117	94	12	0	-C
G3_BC75_consensus_vsearch	926	A	*/-G	216	7	3.1%	2	2	93	93	0.007447971960236055	1	1	123	93	6	1	-G
G3_BC75_consensus_vsearch	932	A	*/-G	195	13	5.83%	2	2	93	93	1.0061064586351875E-4	1	1	114	81	2	11	-G
G3_BC75_consensus_vsearch	959	T	*/-C	180	36	16.14%	2	1	93	93	2.9644544439831586E-12	1	1	91	89	36	0	-C
G3_BC75_consensus_vsearch	978	C	*/-T	190	19	8.64%	2	1	93	93	1.2429986855259503E-6	1	1	102	88	19	0	-T
G3_BC75_consensus_vsearch	980	T	*/-A	197	19	8.48%	2	2	93	93	1.261162399210312E-6	1	1	104	93	18	1	-A
G3_BC75_consensus_vsearch	981	A	*/-C	185	10	4.9%	2	2	93	93	8.676264462271394E-4	1	1	93	92	9	1	-C
G3_BC75_consensus_vsearch	983	C	*/+A	176	13	5.88%	2	2	93	93	9.860774066125673E-5	1	1	110	66	7	6	+A
G3_BC75_consensus_vsearch	983	C	*/-A	176	24	10.86%	2	2	93	93	2.8622426530999085E-8	1	1	110	66	6	18	-A
G3_BC75_consensus_vsearch	991	G	*/-C	207	7	3.14%	2	1	93	93	0.007432788253078562	1	1	113	94	7	0	-C
G3_BC75_consensus_vsearch	996	C	*/+T	200	7	3.21%	2	1	93	93	0.007420075094973923	1	1	116	84	0	7	+T
G3_BC75_consensus_vsearch	1002	T	*/-C	215	9	3.98%	2	2	93	93	0.0017995100038167202	1	1	123	92	8	1	-C
G3_BC75_consensus_vsearch	1009	A	*/+T	180	32	14.22%	2	2	93	93	6.571054618738405E-11	1	1	90	90	31	1	+T
G3_BC75_consensus_vsearch	1009	A	*/-T	180	7	3.11%	2	2	93	93	0.007378565932456183	1	1	90	90	5	2	+T
G3_BC75_consensus_vsearch	1025	A	*/-CA	203	7	3.21%	2	1	93	93	0.007425626339083171	1	1	121	82	0	7	-CA
G3_BC75_consensus_vsearch	1026	C	*/-A	198	11	5.07%	2	2	93	93	4.2662591196418204E-4	1	1	116	82	9	2	-A
G3_BC75_consensus_vsearch	1039	C	*/-G	201	16	7.14%	2	2	93	93	1.1454151088665753E-5	1	1	122	79	4	12	-G
G3_BC75_consensus_vsearch	1056	C	*/-G	197	20	9.09%	2	2	93	93	6.029113548186886E-7	1	1	125	72	1	19	-G
G3_BC75_consensus_vsearch	1058	G	*/-A	191	28	12.56%	2	1	93	93	1.4823492013779318E-9	1	1	99	92	28	0	-A
G3_BC75_consensus_vsearch	1060	G	*/-T	210	13	5.8%	2	1	93	93	1.0196623731956113E-4	1	1	116	94	13	0	-T
G3_BC75_consensus_vsearch	1070	G	*/-A	216	7	3.11%	2	2	93	93	0.007447971960236055	1	1	123	93	6	1	-A
G3_BC75_consensus_vsearch	1072	G	*/-C	212	10	4.46%	2	2	93	93	8.804765900705064E-4	1	1	125	87	5	5	-C
G3_BC75_consensus_vsearch	1087	G	*/-C	211	11	4.91%	2	2	93	93	4.300945555177922E-4	1	1	120	91	7	4	-C
G3_BC75_consensus_vsearch	1091	C	*/+G	173	9	3.98%	2	1	93	93	0.001765008337317725	1	1	118	55	0	9	+G
G3_BC75_consensus_vsearch	1092	G	*/-A	216	7	3.14%	2	1	93	93	0.007447971960236055	1	1	122	94	7	0	-A
G3_BC75_consensus_vsearch	1097	G	*/-C	188	24	10.86%	2	1	93	93	2.9910218982788557E-8	1	1	95	93	24	0	-C
G3_BC75_consensus_vsearch	1109	G	*/+C	210	11	4.91%	2	1	93	93	4.298416344617859E-4	1	1	129	81	0	11	+C
G3_BC75_consensus_vsearch	1138	A	*/-G	202	15	6.73%	2	2	93	93	2.375885795125084E-5	1	1	112	90	12	3	-G
G3_BC75_consensus_vsearch	1143	C	*/+AC	211	9	3.98%	2	1	93	93	0.0017967787753331713	1	1	116	95	9	0	+AC
G3_BC75_consensus_vsearch	1151	T	*/-C	204	19	8.41%	2	1	93	93	1.2783751095611703E-6	1	1	110	94	19	0	-C
G3_BC75_consensus_vsearch	1156	A	*/+GGA	41	46	20.35%	2	2	93	93	3.781376030045468E-18	1	1	30	11	37	9	+GGA
G3_BC75_consensus_vsearch	1156	A	*/+GGG	41	11	4.87%	2	2	93	93	2.708143426008769E-4	1	1	30	11	4	7	+GGA
G3_BC75_consensus_vsearch	1156	A	*/+GGGA	41	96	42.48%	2	2	93	93	2.5435574934287004E-41	1	1	30	11	41	55	+GGGA
G3_BC75_consensus_vsearch	1156	A	*/+GGGGA	41	11	4.87%	2	2	93	93	2.708143426008769E-4	1	1	30	11	10	1	+GGGA
G3_BC75_consensus_vsearch	1159	C	*/-T	207	13	5.78%	2	2	93	93	1.0170895517465024E-4	1	1	127	80	1	12	-T
G3_BC75_consensus_vsearch	1161	T	*/+C	191	17	7.59%	2	1	93	93	5.427543998578852E-6	1	1	106	85	17	0	+C
G3_BC75_consensus_vsearch	1161	T	*/-C	191	7	3.12%	2	1	93	93	0.007402422710817429	1	1	106	85	0	7	+C
G3_BC75_consensus_vsearch	1162	C	*/-G	180	30	13.76%	2	1	93	93	3.0538992631883624E-10	1	1	131	49	0	30	-G
G3_BC75_consensus_vsearch	1165	A	*/-G	158	54	24.32%	2	2	93	93	1.1510890454179998E-18	1	1	82	76	38	16	-G
G3_BC75_consensus_vsearch	1186	T	*/+C	217	8	3.56%	2	1	93	93	0.0036667219549938834	1	1	131	86	0	8	+C
G3_BC75_consensus_vsearch	1187	T	*/-C	215	8	3.54%	2	1	93	93	0.0036646057936482192	1	1	128	87	0	8	-C
G3_BC75_consensus_vsearch	1194	G	*/+T	211	11	4.87%	2	1	93	93	4.300945555177922E-4	1	1	129	82	0	11	+T
G3_BC75_consensus_vsearch	1195	T	*/-CTT	214	7	3.14%	2	1	93	93	0.007444703667648697	1	1	130	84	0	7	-CTT
G3_BC75_consensus_vsearch	1196	C	*/-T	184	22	10.14%	2	2	93	93	1.3191799458892727E-7	1	1	128	56	1	21	-T
G3_BC75_consensus_vsearch	1201	G	*/-C	170	47	20.98%	2	2	93	93	4.336371751026813E-16	1	1	89	81	35	12	-C
G3_BC75_consensus_vsearch	1208	T	*/-AC	213	9	3.98%	2	1	93	93	0.0017981564163397133	1	1	119	94	9	0	-AC
G3_BC75_consensus_vsearch	1210	C	*/+T	198	10	4.76%	2	2	93	93	8.74216242207188E-4	1	1	116	82	2	8	+T
G3_BC75_consensus_vsearch	1220	G	*/-CG	216	9	3.98%	2	1	93	93	0.0018001779733764346	1	1	130	86	0	9	-CG
G3_BC75_consensus_vsearch	1226	G	*/-A	206	16	7.11%	2	1	93	93	1.1531106955580906E-5	1	1	111	95	16	0	-A
G3_BC75_consensus_vsearch	1227	A	*/-T	187	13	6.28%	2	1	93	93	9.981039688765196E-5	1	1	97	90	13	0	-T
G3_BC75_consensus_vsearch	1232	C	*/-AC	209	12	5.36%	2	1	93	93	2.0943559915765036E-4	1	1	116	93	12	0	-AC
G3_BC75_consensus_vsearch	1274	C	*/-T	214	7	3.11%	2	1	93	93	0.007444703667648697	1	1	120	94	7	0	-T
G3_BC75_consensus_vsearch	1276	T	*/-C	209	9	4%	2	2	93	93	0.0017953764342624938	1	1	117	92	7	2	-C
G3_BC75_consensus_vsearch	1280	C	*/-T	200	12	5.33%	2	1	93	93	2.0803866112796158E-4	1	1	128	72	0	12	-T
G3_BC75_consensus_vsearch	1282	T	*/-AC	212	9	4.04%	2	1	93	93	0.00179747064240055	1	1	118	94	9	0	-AC
G3_BC75_consensus_vsearch	1283	A	*/-C	201	7	3.29%	2	1	93	93	0.007421943123229272	1	1	107	94	7	0	-C
G3_BC75_consensus_vsearch	1303	C	*/-T	207	15	6.67%	2	2	93	93	2.3897801371672697E-5	1	1	129	78	1	14	-T
G3_BC75_consensus_vsearch	1342	C	*/-G	219	7	3.1%	2	2	93	93	0.007452766938834958	1	1	130	89	1	6	-G
G3_BC75_consensus_vsearch	1348	C	*/-G	200	13	5.88%	2	2	93	93	1.0108231417166703E-4	1	1	122	78	4	9	-G
G3_BC75_consensus_vsearch	1353	G	*/+T	199	23	10.31%	2	2	93	93	6.53893261033232E-8	1	1	129	70	1	22	+T
G3_BC75_consensus_vsearch	1355	C	*/-T	199	23	10.22%	2	1	93	93	6.53893261033232E-8	1	1	129	70	0	23	-T
G3_BC75_consensus_vsearch	1361	C	*/-A	170	27	12.56%	2	2	93	93	2.8644104832553384E-9	1	1	90	80	26	1	-A
G3_BC75_consensus_vsearch	1370	T	*/-C	189	30	13.27%	2	2	93	93	3.207970213967378E-10	1	1	121	68	7	23	-C
G3_BC75_consensus_vsearch	1395	T	*/-C	183	34	15.32%	2	1	93	93	1.4319646666294611E-11	1	1	94	89	34	0	-C
G3_BC75_consensus_vsearch	1398	A	*/-G	190	8	3.57%	2	1	93	93	0.003634608580377523	1	1	97	93	8	0	-G
G3_BC75_consensus_vsearch	1400	G	*/+T	206	10	4.42%	2	1	93	93	8.778898007284436E-4	1	1	112	94	10	0	+T
G3_BC75_consensus_vsearch	1400	G	*/-T	206	9	3.98%	2	2	93	93	0.001793225137980622	1	1	112	94	8	1	+T
G3_BC75_consensus_vsearch	1404	C	*/-A	188	32	14.35%	2	2	93	93	6.905539526646406E-11	1	1	126	62	3	29	-A
G3_BC75_consensus_vsearch	1406	A	*/-T	196	9	4%	2	1	93	93	0.001785610469261078	1	1	130	66	0	9	-T
G3_BC75_consensus_vsearch	1406	A	*/-TT	196	10	4.44%	2	1	93	93	8.7325475503958E-4	1	1	130	66	0	10	-TT
G3_BC75_consensus_vsearch	1406	A	*/-TTC	196	9	4%	2	1	93	93	0.001785610469261078	1	1	130	66	0	9	-TT
G3_BC75_consensus_vsearch	1408	T	*/-C	142	51	24.64%	2	2	93	93	9.7889621505517E-18	1	1	100	42	28	23	-C
G3_BC75_consensus_vsearch	1411	C	*/-T	215	7	3.1%	2	1	93	93	0.007446345105805389	1	1	130	85	0	7	-T
G3_BC75_consensus_vsearch	1425	C	*/+A	188	7	3.18%	2	1	93	93	0.007396180372504935	1	1	103	85	7	0	+A
G3_BC75_consensus_vsearch	1425	C	*/-A	188	22	10%	2	2	93	93	1.3349627887501208E-7	1	1	103	85	17	5	-A
G3_BC75_consensus_vsearch	1427	A	*/-G	210	7	3.17%	2	2	93	93	0.007437988084800957	1	1	128	82	2	5	-G
G3_BC75_consensus_vsearch	1432	C	*/-A	208	8	3.6%	2	1	93	93	0.0036568954742723925	1	1	120	88	8	0	-A
G3_BC75_consensus_vsearch	1435	T	*/-C	196	11	5.05%	2	2	93	93	4.260552860545617E-4	1	1	126	70	3	8	-C
G3_BC75_consensus_vsearch	1437	C	*/-T	196	17	7.76%	2	2	93	93	5.472889986979232E-6	1	1	126	70	4	13	-T
G3_BC75_consensus_vsearch	1450	T	*/+C	216	8	3.56%	2	2	93	93	0.003665668526289429	1	1	124	92	6	2	+C
G3_BC75_consensus_vsearch	1471	C	*/-A	205	13	5.78%	2	2	93	93	1.0153375468649412E-4	1	1	113	92	12	1	-A
G3_BC75_consensus_vsearch	1473	C	*/-A	195	7	3.14%	2	2	93	93	0.007410460397262536	1	1	104	91	6	1	-A
G3_BC75_consensus_vsearch	1477	A	*/-C	204	15	6.73%	2	1	93	93	2.3815125527116474E-5	1	1	111	93	15	0	-C
G3_BC75_consensus_vsearch	1489	A	*/-CA	211	10	4.46%	2	2	93	93	8.800549103686053E-4	1	1	125	86	3	7	-CA
G3_BC75_consensus_vsearch	1490	C	*/+A	195	12	5.63%	2	2	93	93	2.0721299272133376E-4	1	1	110	85	11	1	+A
G3_BC75_consensus_vsearch	1499	A	*/+G	208	7	3.14%	2	2	93	93	0.007434537497224064	1	1	119	89	3	4	+G
G3_BC75_consensus_vsearch	1506	T	*/+C	215	8	3.56%	2	1	93	93	0.0036646057936482192	1	1	122	93	8	0	+C
G3_BC75_consensus_vsearch	1515	G	*/-A	208	14	6.25%	2	2	93	93	4.9404108604884E-5	1	1	116	92	13	1	-A
G3_BC75_consensus_vsearch	1517	A	*/-G	209	9	3.98%	2	2	93	93	0.0017953764342624938	1	1	118	91	8	1	-G
G3_BC75_consensus_vsearch	1521	T	*/+G	205	11	4.91%	2	1	93	93	4.285433624407098E-4	1	1	130	75	0	11	+G
G3_BC75_consensus_vsearch	1530	G	*/-C	214	9	4.02%	2	2	93	93	0.0017988361772468277	1	1	122	92	8	1	-C
G3_BC75_consensus_vsearch	1536	A	*/-GA	214	9	4%	2	1	93	93	0.0017988361772468277	1	1	119	95	9	0	-GA
G3_BC75_consensus_vsearch	1544	G	*/-A	213	7	3.15%	2	2	93	93	0.007443047448823043	1	1	123	90	3	4	-A
G3_BC75_consensus_vsearch	1548	T	*/-C	201	20	8.89%	2	2	93	93	6.081727839654859E-7	1	1	109	92	18	2	-C
G3_BC75_consensus_vsearch	1557	G	*/-CG	201	23	10.18%	2	2	93	93	6.575986122662666E-8	1	1	115	86	14	9	-CG
G3_BC75_consensus_vsearch	1560	T	*/+C	204	20	8.89%	2	2	93	93	6.120185088270156E-7	1	1	112	92	19	1	+C
G3_BC75_consensus_vsearch	1566	G	*/-C	180	22	9.95%	2	2	93	93	1.3029343376067508E-7	1	1	90	90	19	3	-C
G3_BC75_consensus_vsearch	1566	G	*/-CC	180	10	4.52%	2	1	93	93	8.648604879212406E-4	1	1	90	90	10	0	-C
G3_BC75_consensus_vsearch	1578	A	*/-C	211	10	4.42%	2	2	93	93	8.800549103686053E-4	1	1	117	94	9	1	-C
G3_BC75_consensus_vsearch	1579	C	*/+T	203	10	4.67%	2	1	93	93	8.765435124402236E-4	1	1	120	83	0	10	+T
G3_BC75_consensus_vsearch	1584	G	*/-CG	201	13	5.86%	2	2	93	93	1.0117417827629507E-4	1	1	108	93	11	2	-CG
G3_BC75_consensus_vsearch	1594	T	*/+C	56	144	65.16%	2	2	93	93	1.4859382612757078E-62	1	1	50	6	80	64	+C
G3_BC75_consensus_vsearch	1595	C	*/+A	206	15	6.64%	2	2	93	93	2.3870469071571428E-5	1	1	117	89	14	1	+A
G3_BC75_consensus_vsearch	1597	A	*/-G	203	11	4.89%	2	2	93	93	4.280077806644155E-4	1	1	118	85	10	1	-G
G3_BC75_consensus_vsearch	1607	T	*/+A	197	7	3.2%	2	1	93	93	0.007414362253072604	1	1	116	81	7	0	+A
G3_BC75_consensus_vsearch	1608	A	*/+GC	203	13	5.83%	2	2	93	93	1.0135552209744578E-4	1	1	126	77	1	12	+GC
G3_BC75_consensus_vsearch	1609	A	*/+C	191	17	7.62%	2	2	93	93	5.427543998578852E-6	1	1	121	70	3	14	+C
G3_BC75_consensus_vsearch	1610	A	*/+G	44	42	18.67%	2	1	93	93	2.761141133628292E-16	1	1	19	25	42	0	+G
G3_BC75_consensus_vsearch	1610	A	*/+GCA	44	10	4.44%	2	2	93	93	6.18000281109571E-4	1	1	19	25	9	1	+G
G3_BC75_consensus_vsearch	1610	A	*/+GCACA	44	112	49.78%	2	2	93	93	1.0544681791405827E-48	1	1	19	25	51	61	+GCACA
G3_BC75_consensus_vsearch	1611	C	*/+A	195	20	8.89%	2	2	93	93	6.002214170441375E-7	1	1	106	89	17	3	+A
G3_BC75_consensus_vsearch	1613	C	*/-A	211	7	3.11%	2	1	93	93	0.007439689863414905	1	1	120	91	7	0	-A
G3_BC75_consensus_vsearch	1614	A	*/+CCC	167	29	13.3%	2	1	93	93	6.089215027612298E-10	1	1	75	92	29	0	+CCC
G3_BC75_consensus_vsearch	1617	G	*/-A	213	10	4.48%	2	1	93	93	8.808946039600796E-4	1	1	119	94	10	0	-A
G3_BC75_consensus_vsearch	1619	G	*/-C	206	7	3.15%	2	1	93	93	0.007431022745174962	1	1	115	91	7	0	-C
G3_BC75_consensus_vsearch	1635	G	*/-C	199	8	3.6%	2	2	93	93	0.0036462285478980633	1	1	106	93	7	1	-C
G3_BC75_consensus_vsearch	1642	T	*/-C	188	30	13.39%	2	2	93	93	3.1911630279193985E-10	1	1	101	87	24	6	-C
G3_BC75_consensus_vsearch	1645	C	*/-G	195	14	6.19%	2	2	93	93	4.873705147345955E-5	1	1	121	74	2	12	-G
G3_BC75_consensus_vsearch	1650	G	*/-C	210	8	3.62%	2	2	93	93	0.0036591481612605	1	1	122	88	2	6	-C
G3_BC75_consensus_vsearch	1651	C	*/-G	203	7	3.21%	2	1	93	93	0.007425626339083171	1	1	118	85	7	0	-G
G3_BC75_consensus_vsearch	1664	G	*/-T	211	7	3.1%	2	1	93	93	0.007439689863414905	1	1	118	93	7	0	-T
G3_BC75_consensus_vsearch	1670	A	*/-C	206	11	4.87%	2	2	93	93	4.288076047440095E-4	1	1	115	91	7	4	-C
G3_BC75_consensus_vsearch	1674	A	*/-T	121	96	42.48%	2	2	93	93	1.480732312065776E-35	1	1	39	82	85	11	-T
G3_BC75_consensus_vsearch	1688	C	*/+T	200	8	3.59%	2	1	93	93	0.003647458600901869	1	1	116	84	8	0	+T
G3_BC75_consensus_vsearch	1688	C	*/-T	200	13	5.83%	2	2	93	93	1.0108231417166703E-4	1	1	116	84	6	7	-T
G3_BC75_consensus_vsearch	1696	C	*/-T	209	16	7.08%	2	2	93	93	1.1575814598307718E-5	1	1	128	81	3	13	-T
G3_BC75_consensus_vsearch	1699	T	*/+C	141	19	8.44%	2	2	93	93	1.081333865480413E-6	1	1	104	37	5	14	+C
G3_BC75_consensus_vsearch	1699	T	*/-C	141	50	22.22%	2	2	93	93	2.200437213782793E-17	1	1	104	37	18	32	-C
G3_BC75_consensus_vsearch	1699	T	*/-CC	141	8	3.56%	2	1	93	93	0.0035472828472051087	1	1	104	37	0	8	-C
G3_BC75_consensus_vsearch	1716	G	*/-TG	195	25	11.06%	2	2	93	93	1.4471003755089968E-8	1	1	104	91	22	3	-TG
G3_BC75_consensus_vsearch	1727	C	*/-AC	210	9	4.04%	2	1	93	93	0.0017960807336148846	1	1	115	95	9	0	-AC
G3_BC75_consensus_vsearch	1747	T	*/-A	210	7	3.12%	2	1	93	93	0.007437988084800957	1	1	118	92	7	0	-A
G3_BC75_consensus_vsearch	1749	G	*/-A	200	19	8.52%	2	2	93	93	1.268651398690971E-6	1	1	107	93	18	1	-A
G3_BC75_consensus_vsearch	1762	T	*/+C	194	7	3.2%	2	2	93	93	0.007408480654387502	1	1	105	89	5	2	+C
G3_BC75_consensus_vsearch	1762	T	*/-C	194	12	5.48%	2	2	93	93	2.070433166935576E-4	1	1	105	89	10	2	-C
G3_BC75_consensus_vsearch	1782	C	*/+A	200	13	5.86%	2	1	93	93	1.0108231417166703E-4	1	1	124	76	0	13	+A
G3_BC75_consensus_vsearch	1782	C	*/-A	200	8	3.6%	2	2	93	93	0.003647458600901869	1	1	124	76	3	5	+A
G3_BC75_consensus_vsearch	1801	G	*/-A	172	35	15.84%	2	1	93	93	6.054814953339141E-12	1	1	78	94	35	0	-A
G3_BC75_consensus_vsearch	1801	G	*/-AG	172	14	6.33%	2	1	93	93	4.734944773282747E-5	1	1	78	94	14	0	-A
G3_BC75_consensus_vsearch	1806	C	*/+T	207	7	3.15%	2	2	93	93	0.007432788253078562	1	1	121	86	1	6	+T
G3_BC75_consensus_vsearch	1811	C	*/+G	161	25	11.16%	2	1	93	93	1.2560568517753154E-8	1	1	67	94	25	0	+G
G3_BC75_consensus_vsearch	1811	C	*/-A	161	36	16.07%	2	1	93	93	2.5030780282275763E-12	1	1	67	94	36	0	-A
G3_BC75_consensus_vsearch	1812	A	*/-T	153	29	15.34%	2	2	93	93	5.545529420668417E-10	1	1	60	93	28	1	-T
G3_BC75_consensus_vsearch	1842	A	*/-C	202	15	6.7%	2	1	93	93	2.375885795125084E-5	1	1	126	76	0	15	-C
G3_BC75_consensus_vsearch	1848	A	*/-C	195	26	11.56%	2	2	93	93	6.825326034146069E-9	1	1	122	73	7	19	-C
G3_BC75_consensus_vsearch	1852	T	*/-CT	209	9	4.04%	2	2	93	93	0.0017953764342624938	1	1	127	82	1	8	-CT
G3_BC75_consensus_vsearch	1855	G	*/-AG	211	9	4%	2	1	93	93	0.0017967787753331713	1	1	118	93	9	0	-AG
G3_BC75_consensus_vsearch	1856	A	*/-G	200	9	4.21%	2	2	93	93	0.0017887416879729845	1	1	108	92	8	1	-G
G3_BC75_consensus_vsearch	1876	C	*/-T	213	11	4.91%	2	2	93	93	4.305938947768699E-4	1	1	121	92	9	2	-T
G3_BC75_consensus_vsearch	1878	T	*/-CC	209	9	3.98%	2	1	93	93	0.0017953764342624938	1	1	116	93	9	0	-CC
G3_BC75_consensus_vsearch	1901	C	*/+A	198	18	7.96%	2	1	93	93	2.63697592562017E-6	1	1	103	95	18	0	+A
G3_BC75_consensus_vsearch	1924	C	*/-G	212	10	4.44%	2	1	93	93	8.804765900705064E-4	1	1	129	83	0	10	-G
G3_BC75_consensus_vsearch	1933	G	*/+T	203	13	5.75%	2	2	93	93	1.0135552209744578E-4	1	1	111	92	12	1	+T
G3_BC75_consensus_vsearch	1937	A	*/-C	177	31	14.16%	2	2	93	93	1.3920861453897108E-10	1	1	99	78	20	11	-C
G3_BC75_consensus_vsearch	1941	C	*/-A	191	7	3.14%	2	2	93	93	0.007402422710817429	1	1	117	74	5	2	-A
G3_BC75_consensus_vsearch	1955	A	*/-CA	193	30	13.27%	2	2	93	93	3.2744322909612674E-10	1	1	114	79	16	14	-CA
G3_BC75_consensus_vsearch	1967	T	*/-C	178	36	15.93%	2	2	93	93	2.916646643006454E-12	1	1	88	90	32	4	-C
G3_BC75_consensus_vsearch	1967	T	*/-CC	178	9	3.98%	2	1	93	93	0.0017699066001378024	1	1	88	90	9	0	-C
G3_BC75_consensus_vsearch	1970	C	*/-GC	178	28	12.44%	2	1	93	93	1.3926549242027516E-9	1	1	101	77	28	0	-GC
G3_BC75_consensus_vsearch	1975	C	*/-A	213	8	3.56%	2	1	93	93	0.0036624519192641563	1	1	121	92	8	0	-A
G3_BC75_consensus_vsearch	1978	T	*/-C	211	8	3.54%	2	1	93	93	0.0036602593149509337	1	1	127	84	0	8	-C
G3_BC75_consensus_vsearch	1989	A	*/+G	120	95	42.41%	2	2	93	93	3.4946300185742E-35	1	1	89	31	36	59	+G
G3_BC75_consensus_vsearch	1995	T	*/-C	210	12	5.38%	2	2	93	93	2.0958418294317403E-4	1	1	120	90	10	2	-C
G3_BC75_consensus_vsearch	1998	T	*/-G	208	13	5.83%	2	1	93	93	1.0179544238135389E-4	1	1	131	77	0	13	-G
G3_BC75_consensus_vsearch	2008	C	*/+T	193	9	3.98%	2	2	93	93	0.0017831826885241658	1	1	124	69	1	8	+T
G3_BC75_consensus_vsearch	2008	C	*/-T	193	22	9.73%	2	2	93	93	1.3540685912566394E-7	1	1	124	69	6	16	-T
G3_BC75_consensus_vsearch	2012	T	*/-C	214	8	3.54%	2	1	93	93	0.003663533633296164	1	1	131	83	0	8	-C
G3_BC75_consensus_vsearch	2037	T	*/+C	211	9	3.98%	2	1	93	93	0.0017967787753331713	1	1	118	93	9	0	+C
G3_BC75_consensus_vsearch	2038	C	*/-T	215	9	3.98%	2	2	93	93	0.0017995100038167202	1	1	127	88	2	7	-T
G3_BC75_consensus_vsearch	2042	C	*/+G	203	9	4%	2	1	93	93	0.0017910143883990014	1	1	122	81	0	9	+G
G3_BC75_consensus_vsearch	2045	G	*/+T	209	8	3.54%	2	1	93	93	0.003658026926953576	1	1	114	95	8	0	+T
G3_BC75_consensus_vsearch	2049	T	*/+C	207	7	3.11%	2	1	93	93	0.007432788253078562	1	1	115	92	7	0	+C
G3_BC75_consensus_vsearch	2049	T	*/-C	207	8	3.56%	2	1	93	93	0.003655753662936563	1	1	115	92	8	0	-C
G3_BC75_consensus_vsearch	2053	A	*/-C	187	19	8.52%	2	2	93	93	1.2349038260840205E-6	1	1	98	89	18	1	-C
G3_BC75_consensus_vsearch	2069	G	*/-CG	208	14	6.25%	2	1	93	93	4.9404108604884E-5	1	1	129	79	0	14	-CG
G3_BC75_consensus_vsearch	2086	T	*/-C	166	59	26.22%	2	1	93	93	2.1581379738309003E-20	1	1	71	95	59	0	-C
G3_BC75_consensus_vsearch	2088	C	*/-A	187	31	13.72%	2	2	93	93	1.477681402091444E-10	1	1	98	89	28	3	-A
G3_BC75_consensus_vsearch	2102	C	*/-TT	206	9	4.02%	2	2	93	93	0.001793225137980622	1	1	121	85	7	2	-TT
G3_BC75_consensus_vsearch	2104	T	*/-G	197	15	6.94%	2	2	93	93	2.361399232959602E-5	1	1	118	79	3	12	-G
G3_BC75_consensus_vsearch	2112	C	*/+A	193	11	4.95%	2	1	93	93	4.251792957023273E-4	1	1	104	89	11	0	+A
G3_BC75_consensus_vsearch	2113	G	*/-A	198	11	5.09%	2	1	93	93	4.2662591196418204E-4	1	1	107	91	11	0	-A
G3_BC75_consensus_vsearch	2129	C	*/-A	207	15	6.67%	2	2	93	93	2.3897801371672697E-5	1	1	118	89	10	5	-A
G3_BC75_consensus_vsearch	2134	G	*/-CG	202	20	8.93%	2	2	93	93	6.094640790165047E-7	1	1	128	74	1	19	-CG
G3_BC75_consensus_vsearch	2137	T	*/-C	213	12	5.31%	2	1	93	93	2.1002241192895544E-4	1	1	131	82	0	12	-C
G3_BC75_consensus_vsearch	2146	C	*/-GA	210	7	3.14%	2	1	93	93	0.007437988084800957	1	1	119	91	7	0	-GA
G3_BC75_consensus_vsearch	2147	G	*/-A	206	7	3.21%	2	1	93	93	0.007431022745174962	1	1	114	92	7	0	-A
G3_BC75_consensus_vsearch	2149	A	*/-G	171	51	22.67%	2	2	93	93	1.7234718595681516E-17	1	1	101	70	28	23	-G
G3_BC75_consensus_vsearch	2150	G	*/+A	167	8	4.57%	2	1	93	93	0.003599589021589525	1	1	95	72	8	0	+A
G3_BC75_consensus_vsearch	2154	C	*/-T	213	10	4.44%	2	2	93	93	8.808946039600796E-4	1	1	130	83	1	9	-T
G3_BC75_consensus_vsearch	2155	T	*/-C	200	12	5.56%	2	2	93	93	2.0803866112796158E-4	1	1	124	76	5	7	-C
G3_BC75_consensus_vsearch	2162	T	*/+C	210	11	4.93%	2	1	93	93	4.298416344617859E-4	1	1	120	90	11	0	+C
G3_BC75_consensus_vsearch	2170	T	*/-A	211	7	3.1%	2	2	93	93	0.007439689863414905	1	1	124	87	1	6	-A
G3_BC75_consensus_vsearch	2176	A	*/-C	210	9	4%	2	2	93	93	0.0017960807336148846	1	1	125	85	2	7	-C
G3_BC75_consensus_vsearch	2189	T	*/+C	214	7	3.11%	2	1	93	93	0.007444703667648697	1	1	120	94	7	0	+C
G3_BC75_consensus_vsearch	2204	T	*/+G	210	8	3.6%	2	2	93	93	0.0036591481612605	1	1	127	83	2	6	+G
G3_BC75_consensus_vsearch	2206	A	*/-G	199	20	8.97%	2	1	93	93	6.055615268214013E-7	1	1	106	93	20	0	-G
G3_BC75_consensus_vsearch	2207	G	*/-A	193	8	3.9%	2	2	93	93	0.003638595561901328	1	1	99	94	7	1	-A
G3_BC75_consensus_vsearch	2209	G	*/-A	212	8	3.62%	2	1	93	93	0.003661360523321731	1	1	119	93	8	0	-A
G3_BC75_consensus_vsearch	2212	C	*/-AC	217	7	3.11%	2	1	93	93	0.007449584424390529	1	1	123	94	7	0	-AC
G3_BC75_consensus_vsearch	2217	T	*/-C	184	41	18.14%	2	1	93	93	6.11925966932949E-14	1	1	90	94	41	0	-C
G3_BC75_consensus_vsearch	2219	C	*/-A	184	24	10.62%	2	1	93	93	2.949230559036448E-8	1	1	101	83	24	0	-A
G3_BC75_consensus_vsearch	2219	C	*/-AA	184	12	5.31%	2	2	93	93	2.052568958466569E-4	1	1	101	83	1	11	-A
G3_BC75_consensus_vsearch	2223	G	*/+C	206	16	7.21%	2	1	93	93	1.1531106955580906E-5	1	1	130	76	0	16	+C
G3_BC75_consensus_vsearch	2229	A	*/+G	206	7	3.18%	2	1	93	93	0.007431022745174962	1	1	123	83	0	7	+G
G3_BC75_consensus_vsearch	2234	T	*/-C	184	34	15.18%	2	2	93	93	1.4420013005370066E-11	1	1	103	81	25	9	-C
G3_BC75_consensus_vsearch	2236	C	*/+A	189	9	4.02%	2	2	93	93	0.00177983409863699	1	1	119	70	8	1	+A
G3_BC75_consensus_vsearch	2236	C	*/+G	189	7	3.12%	2	1	93	93	0.007398282157210082	1	1	119	70	0	7	+A
G3_BC75_consensus_vsearch	2237	G	*/-A	213	11	4.91%	2	1	93	93	4.305938947768699E-4	1	1	118	95	11	0	-A
G3_BC75_consensus_vsearch	2241	T	*/+C	211	8	3.57%	2	1	93	93	0.0036602593149509337	1	1	122	89	8	0	+C
G3_BC75_consensus_vsearch	2244	G	*/+A	202	19	8.41%	2	1	93	93	1.273549938699874E-6	1	1	111	91	19	0	+A
G3_BC75_consensus_vsearch	2247	C	*/+T	208	8	3.54%	2	2	93	93	0.0036568954742723925	1	1	130	78	1	7	+T
G3_BC75_consensus_vsearch	2247	C	*/-T	208	7	3.1%	2	1	93	93	0.007434537497224064	1	1	130	78	0	7	+T
G3_BC75_consensus_vsearch	2254	C	*/-A	165	37	16.59%	2	1	93	93	1.1845266230872804E-12	1	1	74	91	37	0	-A
G3_BC75_consensus_vsearch	2254	C	*/-AA	165	13	5.83%	2	2	93	93	9.726832470999452E-5	1	1	74	91	10	3	-A
G3_BC75_consensus_vsearch	2256	A	*/-G	186	11	5.26%	2	2	93	93	4.2303631514374124E-4	1	1	100	86	9	2	-G
G3_BC75_consensus_vsearch	2258	G	*/+A	195	18	8%	2	2	93	93	2.622705226031456E-6	1	1	103	92	17	1	+A
G3_BC75_consensus_vsearch	2265	T	*/-C	174	14	6.28%	2	2	93	93	4.7482349176863256E-5	1	1	104	70	4	10	-C
G3_BC75_consensus_vsearch	2265	T	*/-CC	174	23	10.31%	2	2	93	93	6.030664444199731E-8	1	1	104	70	19	4	-CC
G3_BC75_consensus_vsearch	2269	G	*/-A	218	7	3.11%	2	2	93	93	0.007451182688346346	1	1	125	93	6	1	-A
G3_BC75_consensus_vsearch	2271	A	*/-G	213	7	3.1%	2	1	93	93	0.007443047448823043	1	1	119	94	7	0	-G
G3_BC75_consensus_vsearch	2288	C	*/+A	105	103	45.98%	2	2	93	93	3.813904817694885E-39	1	1	88	17	41	62	+A
G3_BC75_consensus_vsearch	2288	C	*/-A	105	8	3.57%	2	1	93	93	0.0034363401311798517	1	1	88	17	0	8	+A
G3_BC75_consensus_vsearch	2290	A	*/+G	171	9	4.04%	2	2	93	93	0.0017629749665283802	1	1	98	73	8	1	+G
G3_BC75_consensus_vsearch	2290	A	*/-G	171	35	15.7%	2	2	93	93	6.004520878187821E-12	1	1	98	73	21	14	-G
G3_BC75_consensus_vsearch	2312	A	*/+G	175	10	4.48%	2	2	93	93	8.619505923183497E-4	1	1	124	51	1	9	+G
G3_BC75_consensus_vsearch	2312	A	*/-G	175	36	16.14%	2	2	93	93	2.844573692919743E-12	1	1	124	51	3	33	-G
G3_BC75_consensus_vsearch	2373	T	*/+C	207	15	6.64%	2	1	93	93	2.3897801371672697E-5	1	1	114	93	15	0	+C
G3_BC75_consensus_vsearch	2375	A	*/-CA	201	12	5.36%	2	1	93	93	2.081993933684706E-4	1	1	108	93	12	0	-CA
G3_BC75_consensus_vsearch	2387	C	*/+A	213	9	4%	2	1	93	93	0.0017981564163397133	1	1	118	95	9	0	+A
G3_BC75_consensus_vsearch	2417	G	*/-TG	204	19	8.44%	2	1	93	93	1.2783751095611703E-6	1	1	131	73	0	19	-TG
G3_BC75_consensus_vsearch	2421	C	*/+A	190	21	9.38%	2	1	93	93	2.825653619894269E-7	1	1	101	89	21	0	+A
G3_BC75_consensus_vsearch	2421	C	*/-A	190	8	3.57%	2	2	93	93	0.003634608580377523	1	1	101	89	4	4	+A
G3_BC75_consensus_vsearch	2423	A	*/-G	177	38	16.96%	2	2	93	93	6.050852009968977E-13	1	1	117	60	12	26	-G
G3_BC75_consensus_vsearch	2428	T	*/-C	208	11	4.91%	2	1	93	93	4.293291473235971E-4	1	1	113	95	11	0	-C
G3_BC75_consensus_vsearch	2445	T	*/-A	207	8	3.56%	2	1	93	93	0.003655753662936563	1	1	115	92	8	0	-A
G3_BC75_consensus_vsearch	2469	T	*/-C	212	8	3.57%	2	2	93	93	0.003661360523321731	1	1	127	85	3	5	-C
G3_BC75_consensus_vsearch	2486	C	*/-T	212	9	3.98%	2	2	93	93	0.00179747064240055	1	1	128	84	1	8	-T
G3_BC75_consensus_vsearch	2495	G	*/-TG	203	10	4.5%	2	2	93	93	8.765435124402236E-4	1	1	123	80	2	8	-TG
G3_BC75_consensus_vsearch	2500	T	*/-C	177	21	9.42%	2	2	93	93	2.7250139618908064E-7	1	1	119	58	11	10	-C
G3_BC75_consensus_vsearch	2500	T	*/-CC	177	23	10.31%	2	1	93	93	6.096415142482513E-8	1	1	119	58	0	23	-CC
G3_BC75_consensus_vsearch	2503	G	*/-AG	213	7	3.15%	2	1	93	93	0.007443047448823043	1	1	118	95	7	0	-AG
G3_BC75_consensus_vsearch	2506	G	*/-AG	204	8	3.59%	2	1	93	93	0.0036522646351654408	1	1	109	95	8	0	-AG
G3_BC75_consensus_vsearch	2506	G	*/-AGG	204	8	3.59%	2	1	93	93	0.0036522646351654408	1	1	109	95	8	0	-AG
G3_BC75_consensus_vsearch	2507	A	*/-G	195	8	3.86%	2	1	93	93	0.003641189182853133	1	1	102	93	8	0	-G
G3_BC75_consensus_vsearch	2510	T	*/+A	212	7	3.11%	2	1	93	93	0.00744137624879223	1	1	129	83	0	7	+A
G3_BC75_consensus_vsearch	2533	A	*/-C	195	27	11.95%	2	1	93	93	3.212371282433204E-9	1	1	128	67	0	27	-C
G3_BC75_consensus_vsearch	2544	A	*/+G	112	9	4.04%	2	2	93	93	0.0016740097929115023	1	1	34	78	5	4	+G
G3_BC75_consensus_vsearch	2544	A	*/-G	112	98	43.95%	2	2	93	93	9.935767726050068E-37	1	1	34	78	85	13	-G
G3_BC75_consensus_vsearch	2551	G	*/+T	204	7	3.12%	2	2	93	93	0.007427442022474603	1	1	114	90	6	1	+T
G3_BC75_consensus_vsearch	2551	G	*/-T	204	9	4.02%	2	2	93	93	0.0017917580621936403	1	1	114	90	8	1	-T
G3_BC75_consensus_vsearch	2562	A	*/-C	214	8	3.56%	2	1	93	93	0.003663533633296164	1	1	120	94	8	0	-C
G3_BC75_consensus_vsearch	2572	C	*/-T	215	7	3.1%	2	2	93	93	0.007446345105805389	1	1	128	87	2	5	-T
G3_BC75_consensus_vsearch	2579	T	*/-C	156	9	4.02%	2	2	93	93	0.001746201408139757	1	1	64	92	8	1	-C
G3_BC75_consensus_vsearch	2579	T	*/-CC	156	58	25.89%	2	1	93	93	3.9335879405778374E-20	1	1	64	92	58	0	-CC
G3_BC75_consensus_vsearch	2582	C	*/+G	209	9	3.98%	2	1	93	93	0.0017953764342624938	1	1	129	80	0	9	+G
G3_BC75_consensus_vsearch	2594	A	*/-G	212	11	4.89%	2	1	93	93	4.303452996410444E-4	1	1	119	93	11	0	-G
G3_BC75_consensus_vsearch	2605	C	*/-A	207	10	4.5%	2	2	93	93	8.783305527122537E-4	1	1	114	93	9	1	-A
G3_BC75_consensus_vsearch	2612	G	*/-A	214	9	4.02%	2	1	93	93	0.0017988361772468277	1	1	120	94	9	0	-A
G3_BC75_consensus_vsearch	2643	C	*/-G	211	7	3.14%	2	2	93	93	0.007439689863414905	1	1	121	90	6	1	-G
G3_BC75_consensus_vsearch	2652	T	*/+A	212	9	4%	2	2	93	93	0.00179747064240055	1	1	120	92	8	1	+A
G3_BC75_consensus_vsearch	2663	G	*/-TA	209	7	3.18%	2	1	93	93	0.007436270701269745	1	1	118	91	7	0	-TA
G3_BC75_consensus_vsearch	2666	C	*/+T	202	8	3.57%	2	1	93	93	0.0036498841327700354	1	1	130	72	0	8	+T
G3_BC75_consensus_vsearch	2668	T	*/-C	204	10	4.46%	2	2	93	93	8.769963348909129E-4	1	1	124	80	2	8	-C
G3_BC75_consensus_vsearch	2671	T	*/+C	212	8	3.56%	2	1	93	93	0.003661360523321731	1	1	122	90	8	0	+C
G3_BC75_consensus_vsearch	2673	T	*/+A	210	7	3.17%	2	1	93	93	0.007437988084800957	1	1	125	85	0	7	+A
G3_BC75_consensus_vsearch	2688	G	*/-A	204	8	3.67%	2	2	93	93	0.0036522646351654408	1	1	116	88	6	2	-A
G3_BC75_consensus_vsearch	2690	A	*/-G	209	9	4.05%	2	2	93	93	0.0017953764342624938	1	1	121	88	8	1	-G
G3_BC75_consensus_vsearch	2696	T	*/-C	204	11	4.89%	2	2	93	93	4.2827676494109035E-4	1	1	125	79	2	9	-C
G3_BC75_consensus_vsearch	2698	G	*/-C	175	33	14.73%	2	2	93	93	2.933324377785555E-11	1	1	94	81	27	6	-C
G3_BC75_consensus_vsearch	2699	C	*/+T	176	11	5.76%	2	1	93	93	4.1971005075956745E-4	1	1	103	73	0	11	+T
G3_BC75_consensus_vsearch	2705	A	*/-T	210	13	5.78%	2	1	93	93	1.0196623731956113E-4	1	1	128	82	0	13	-T
G3_BC75_consensus_vsearch	2727	G	*/-CG	215	7	3.11%	2	2	93	93	0.007446345105805389	1	1	127	88	1	6	-CG
G3_BC75_consensus_vsearch	2729	G	*/+C	51	39	18.31%	2	2	93	93	9.049996640726251E-15	1	1	23	28	35	4	+C
G3_BC75_consensus_vsearch	2729	G	*/+CG	51	105	49.3%	2	2	93	93	2.656151462814242E-44	1	1	23	28	53	52	+CG
G3_BC75_consensus_vsearch	2734	T	*/-C	204	12	5.45%	2	1	93	93	2.0867313373012331E-4	1	1	114	90	12	0	-C
G3_BC75_consensus_vsearch	2738	A	*/-C	74	98	44.55%	2	2	93	93	7.794309818944946E-39	1	1	51	23	63	35	-C
G3_BC75_consensus_vsearch	2738	A	*/-CC	74	34	15.45%	2	2	93	93	2.644739305896653E-12	1	1	51	23	4	30	-C
G3_BC75_consensus_vsearch	2755	T	*/+C	216	8	3.56%	2	1	93	93	0.003665668526289429	1	1	129	87	0	8	+C
G3_BC75_consensus_vsearch	2756	T	*/-C	218	7	3.11%	2	1	93	93	0.007451182688346346	1	1	130	88	0	7	-C
G3_BC75_consensus_vsearch	2760	T	*/+C	195	16	7.17%	2	1	93	93	1.1357537987418757E-5	1	1	103	92	16	0	+C
G3_BC75_consensus_vsearch	2760	T	*/+CC	195	12	5.38%	2	1	93	93	2.0721299272133376E-4	1	1	103	92	12	0	+C
G3_BC75_consensus_vsearch	2761	C	*/-G	213	7	3.1%	2	2	93	93	0.007443047448823043	1	1	123	90	4	3	-G
G3_BC75_consensus_vsearch	2783	G	*/+TA	67	114	50.89%	2	2	93	93	9.947266833777763E-47	1	1	63	4	44	70	+TA
G3_BC75_consensus_vsearch	2784	C	*/-A	138	12	5.33%	2	1	93	93	1.9420515014914618E-4	1	1	51	87	12	0	-A
G3_BC75_consensus_vsearch	2785	A	*/+C	148	63	29.44%	2	2	93	93	4.610630610469647E-22	1	1	56	92	61	2	+C
G3_BC75_consensus_vsearch	2787	A	*/-G	213	11	4.87%	2	2	93	93	4.305938947768699E-4	1	1	123	90	6	5	-G
G3_BC75_consensus_vsearch	2788	G	*/+A	202	7	3.26%	2	1	93	93	0.007423793454516522	1	1	114	88	7	0	+A
G3_BC75_consensus_vsearch	2789	G	*/+A	214	7	3.1%	2	1	93	93	0.007444703667648697	1	1	120	94	7	0	+A
G3_BC75_consensus_vsearch	2792	A	*/+G	154	9	4.09%	2	2	93	93	0.0017437389109563706	1	1	107	47	3	6	+G
G3_BC75_consensus_vsearch	2792	A	*/-G	154	49	22.27%	2	2	93	93	6.553940076551876E-17	1	1	107	47	11	38	-G
G3_BC75_consensus_vsearch	2829	C	*/-A	214	8	3.57%	2	2	93	93	0.003663533633296164	1	1	125	89	5	3	-A
G3_BC75_consensus_vsearch	2831	A	*/-G	210	11	4.87%	2	2	93	93	4.298416344617859E-4	1	1	120	90	8	3	-G
G3_BC75_consensus_vsearch	2837	T	*/-C	208	9	3.98%	2	2	93	93	0.0017946657928001688	1	1	124	84	5	4	-C
G3_BC75_consensus_vsearch	2845	C	*/-A	210	7	3.11%	2	1	93	93	0.007437988084800957	1	1	119	91	7	0	-A
G3_BC75_consensus_vsearch	2849	A	*/-G	210	8	3.6%	2	1	93	93	0.0036591481612605	1	1	116	94	8	0	-G
G3_BC75_consensus_vsearch	2857	T	*/-C	192	31	13.72%	2	2	93	93	1.519147673450775E-10	1	1	98	94	30	1	-C
G3_BC75_consensus_vsearch	2869	T	*/+C	168	8	3.56%	2	2	93	93	0.0036012982281518587	1	1	98	70	4	4	+C
G3_BC75_consensus_vsearch	2869	T	*/-C	168	47	20.89%	2	2	93	93	4.211114663089133E-16	1	1	98	70	26	21	-C
G3_BC75_consensus_vsearch	2879	G	*/-A	217	8	3.56%	2	1	93	93	0.0036667219549938834	1	1	122	95	8	0	-A
G3_BC75_consensus_vsearch	2889	C	*/-A	214	7	3.12%	2	1	93	93	0.007444703667648697	1	1	123	91	7	0	-A
G3_BC75_consensus_vsearch	2892	A	*/+G	192	7	3.17%	2	2	93	93	0.007404462106241813	1	1	110	82	2	5	+G
G3_BC75_consensus_vsearch	2892	A	*/-G	192	7	3.17%	2	2	93	93	0.007404462106241813	1	1	110	82	2	5	+G
G3_BC75_consensus_vsearch	2903	G	*/+C	199	8	3.56%	2	2	93	93	0.0036462285478980633	1	1	126	73	1	7	+C
G3_BC75_consensus_vsearch	2903	G	*/-C	199	14	6.22%	2	2	93	93	4.8950273206615416E-5	1	1	126	73	1	13	-C
G3_BC75_consensus_vsearch	2904	C	*/+T	195	13	6.16%	2	1	93	93	1.0061064586351875E-4	1	1	129	66	0	13	+T
G3_BC75_consensus_vsearch	2907	T	*/-C	210	10	4.52%	2	1	93	93	8.796295164637225E-4	1	1	130	80	0	10	-C
G3_BC75_consensus_vsearch	2908	C	*/-TC	201	7	3.26%	2	2	93	93	0.007421943123229272	1	1	126	75	4	3	-TC
G3_BC75_consensus_vsearch	2909	T	*/+C	196	10	4.69%	2	2	93	93	8.7325475503958E-4	1	1	113	83	9	1	+C
G3_BC75_consensus_vsearch	2910	C	*/-GG	198	7	3.24%	2	1	93	93	0.007416284922397948	1	1	123	75	0	7	-GG
G3_BC75_consensus_vsearch	2950	G	*/-CG	148	58	26.48%	2	2	93	93	3.207868724650712E-20	1	1	86	62	30	28	-CG
G3_BC75_consensus_vsearch	2952	G	*/+A	135	14	8.75%	2	1	93	93	4.432157766826186E-5	1	1	77	58	14	0	+A
G3_BC75_consensus_vsearch	2957	G	*/-C	207	7	3.11%	2	2	93	93	0.007432788253078562	1	1	113	94	6	1	-C
G3_BC75_consensus_vsearch	2969	T	*/+A	210	9	4%	2	1	93	93	0.0017960807336148846	1	1	118	92	9	0	+A
G3_BC75_consensus_vsearch	2971	A	*/-G	209	7	3.1%	2	2	93	93	0.007436270701269745	1	1	121	88	4	3	-G
G3_BC75_consensus_vsearch	2987	G	*/-T	209	9	4%	2	2	93	93	0.0017953764342624938	1	1	118	91	8	1	-T
G3_BC75_consensus_vsearch	2989	T	*/-A	191	18	8.07%	2	2	93	93	2.6031386084308115E-6	1	1	102	89	17	1	-A
G3_BC75_consensus_vsearch	2989	T	*/-ATT	191	7	3.14%	2	1	93	93	0.007402422710817429	1	1	102	89	7	0	-A
G3_BC75_consensus_vsearch	2993	G	*/-C	203	15	6.7%	2	2	93	93	2.37871086741396E-5	1	1	125	78	2	13	-C
G3_BC75_consensus_vsearch	2995	C	*/-A	187	12	5.36%	2	2	93	93	2.0581058583041666E-4	1	1	118	69	6	6	-A
G3_BC75_consensus_vsearch	2997	A	*/-G	201	12	5.41%	2	2	93	93	2.081993933684706E-4	1	1	128	73	2	10	-G
G3_BC75_consensus_vsearch	3005	C	*/-AC	213	10	4.44%	2	1	93	93	8.808946039600796E-4	1	1	120	93	10	0	-AC
G3_BC75_consensus_vsearch	3008	G	*/-C	212	8	3.54%	2	2	93	93	0.003661360523321731	1	1	123	89	6	2	-C
G3_BC75_consensus_vsearch	3009	C	*/+T	208	10	4.59%	2	1	93	93	8.787673881990181E-4	1	1	125	83	0	10	+T
G3_BC75_consensus_vsearch	3010	C	*/+T	214	8	3.54%	2	1	93	93	0.003663533633296164	1	1	131	83	0	8	+T
G3_BC75_consensus_vsearch	3011	C	*/-T	197	14	6.19%	2	2	93	93	4.8844590491071155E-5	1	1	128	69	2	12	-T
G3_BC75_consensus_vsearch	3017	C	*/-GG	209	7	3.1%	2	1	93	93	0.007436270701269745	1	1	128	81	0	7	-GG
G3_BC75_consensus_vsearch	3027	T	*/-C	163	41	18.39%	2	2	93	93	4.8614205752330815E-14	1	1	81	82	32	9	-C
G3_BC75_consensus_vsearch	3027	T	*/-CC	163	10	4.48%	2	1	93	93	8.543079772296276E-4	1	1	81	82	10	0	-C
G3_BC75_consensus_vsearch	3031	C	*/-A	178	14	6.19%	2	2	93	93	4.774059764537521E-5	1	1	105	73	5	9	-A
G3_BC75_consensus_vsearch	3038	C	*/-A	196	7	3.24%	2	1	93	93	0.007412420836520295	1	1	117	79	7	0	-A
G3_BC75_consensus_vsearch	3041	G	*/-A	206	10	4.42%	2	2	93	93	8.778898007284436E-4	1	1	114	92	9	1	-A
G3_BC75_consensus_vsearch	3044	G	*/-A	210	10	4.46%	2	2	93	93	8.796295164637225E-4	1	1	116	94	9	1	-A
G3_BC75_consensus_vsearch	3045	A	*/+G	204	7	3.26%	2	1	93	93	0.007427442022474603	1	1	110	94	7	0	+G
G3_BC75_consensus_vsearch	3050	C	*/-GCC	210	7	3.11%	2	2	93	93	0.007437988084800957	1	1	127	83	1	6	-GCC
G3_BC75_consensus_vsearch	3051	G	*/-C	201	11	5.12%	2	2	93	93	4.274625226161483E-4	1	1	123	78	3	8	-C
G3_BC75_consensus_vsearch	3057	G	*/-A	201	8	3.7%	2	2	93	93	0.003648677074969142	1	1	108	93	7	1	-A
G3_BC75_consensus_vsearch	3060	G	*/+C	170	7	3.27%	2	1	93	93	0.007354335343249384	1	1	76	94	7	0	+C
G3_BC75_consensus_vsearch	3060	G	*/-C	170	7	3.27%	2	1	93	93	0.007354335343249384	1	1	76	94	7	0	+C
G3_BC75_consensus_vsearch	3060	G	*/-CC	170	9	4.21%	2	1	93	93	0.001761941721127389	1	1	76	94	9	0	-CC
G3_BC75_consensus_vsearch	3063	C	*/-GAA	196	13	5.75%	2	2	93	93	1.0070666248340834E-4	1	1	108	88	11	2	-GAA
G3_BC75_consensus_vsearch	3064	G	*/-A	196	8	3.81%	2	1	93	93	0.0036424672415343016	1	1	106	90	8	0	-A
G3_BC75_consensus_vsearch	3070	A	*/-CA	213	8	3.54%	2	2	93	93	0.0036624519192641563	1	1	128	85	2	6	-CA
G3_BC75_consensus_vsearch	3074	G	*/+A	80	125	57.6%	2	2	93	93	1.5026980163211609E-50	1	1	66	14	49	76	+A
G3_BC75_consensus_vsearch	3074	G	*/+AG	80	9	4.15%	2	2	93	93	0.0015792567536216308	1	1	66	14	7	2	+A
G3_BC75_consensus_vsearch	3084	C	*/-G	210	9	3.98%	2	1	93	93	0.0017960807336148846	1	1	119	91	9	0	-G
G3_BC75_consensus_vsearch	3089	A	*/-C	209	7	3.1%	2	1	93	93	0.007436270701269745	1	1	115	94	7	0	-C
G3_BC75_consensus_vsearch	3091	C	*/-TT	198	17	7.52%	2	1	93	93	5.490515091509853E-6	1	1	114	84	17	0	-TT
G3_BC75_consensus_vsearch	3093	T	*/-G	197	7	3.35%	2	2	93	93	0.007414362253072604	1	1	109	88	1	6	-G
G3_BC75_consensus_vsearch	3109	T	*/-C	215	9	4%	2	2	93	93	0.0017995100038167202	1	1	130	85	1	8	-C
G3_BC75_consensus_vsearch	3136	A	*/-C	183	31	13.96%	2	2	93	93	1.4438723128112539E-10	1	1	98	85	27	4	-C
G3_BC75_consensus_vsearch	3137	C	*/+T	182	8	4.17%	2	2	93	93	0.003623372158916335	1	1	100	82	1	7	+T
G3_BC75_consensus_vsearch	3143	G	*/-A	218	8	3.54%	2	2	93	93	0.003667766201363899	1	1	124	94	7	1	-A
G3_BC75_consensus_vsearch	3155	G	*/-C	210	7	3.11%	2	1	93	93	0.007437988084800957	1	1	116	94	7	0	-C
G3_BC75_consensus_vsearch	3161	C	*/-AC	213	7	3.15%	2	1	93	93	0.007443047448823043	1	1	120	93	7	0	-AC
G3_BC75_consensus_vsearch	3168	A	*/-C	208	8	3.65%	2	2	93	93	0.0036568954742723925	1	1	119	89	5	3	-C
G3_BC75_consensus_vsearch	3175	A	*/-GA	210	7	3.11%	2	1	93	93	0.007437988084800957	1	1	125	85	0	7	-GA
G3_BC75_consensus_vsearch	3182	G	*/-A	194	26	11.5%	2	2	93	93	6.799628270460232E-9	1	1	101	93	25	1	-A
G3_BC75_consensus_vsearch	3190	T	*/+G	209	8	3.57%	2	2	93	93	0.003658026926953576	1	1	126	83	1	7	+G
G3_BC75_consensus_vsearch	3205	T	*/+C	184	16	7.24%	2	1	93	93	1.1167168327289302E-5	1	1	94	90	16	0	+C
G3_BC75_consensus_vsearch	3205	T	*/-C	184	19	8.6%	2	1	93	93	1.226613196470832E-6	1	1	94	90	19	0	-C
G3_BC75_consensus_vsearch	3220	G	*/-C	206	15	6.64%	2	1	93	93	2.3870469071571428E-5	1	1	115	91	15	0	-C
G3_BC75_consensus_vsearch	3224	T	*/+G	212	7	3.12%	2	2	93	93	0.00744137624879223	1	1	127	85	2	5	+G
G3_BC75_consensus_vsearch	3227	T	*/+A	214	8	3.57%	2	1	93	93	0.003663533633296164	1	1	122	92	8	0	+A
G3_BC75_consensus_vsearch	3228	G	*/-A	217	7	3.11%	2	1	93	93	0.007449584424390529	1	1	123	94	7	0	-A
G3_BC75_consensus_vsearch	3233	T	*/-C	153	64	28.32%	2	2	93	93	2.286932969424268E-22	1	1	102	51	24	40	-C
G3_BC75_consensus_vsearch	3242	T	*/+G	212	7	3.1%	2	2	93	93	0.00744137624879223	1	1	124	88	2	5	+G
G3_BC75_consensus_vsearch	3247	C	*/-A	196	19	8.44%	2	2	93	93	1.258627563292186E-6	1	1	121	75	6	13	-A
G3_BC75_consensus_vsearch	3247	C	*/-AA	196	8	3.56%	2	2	93	93	0.0036424672415343016	1	1	121	75	1	7	-A
G3_BC75_consensus_vsearch	3252	T	*/-AA	174	42	18.58%	2	2	93	93	2.4967233552494553E-14	1	1	126	48	1	41	-AA
G3_BC75_consensus_vsearch	3266	C	*/-AC	198	24	10.62%	2	1	93	93	3.090849381129373E-8	1	1	103	95	24	0	-AC
G3_BC75_consensus_vsearch	3276	T	*/+A	203	17	7.56%	2	1	93	93	5.533354906074952E-6	1	1	111	92	17	0	+A
G3_BC75_consensus_vsearch	3279	G	*/+C	205	8	3.56%	2	2	93	93	0.0036534383902297935	1	1	121	84	1	7	+C
G3_BC75_consensus_vsearch	3279	G	*/-C	205	9	4%	2	2	93	93	0.0017924949478988227	1	1	121	84	7	2	-C
G3_BC75_consensus_vsearch	3304	T	*/+C	217	7	3.1%	2	2	93	93	0.007449584424390529	1	1	129	88	1	6	+C
G3_BC75_consensus_vsearch	3312	G	*/-CG	211	8	3.6%	2	2	93	93	0.0036602593149509337	1	1	121	90	6	2	-CG
G3_BC75_consensus_vsearch	3320	A	*/-C	208	9	4%	2	2	93	93	0.0017946657928001688	1	1	127	81	2	7	-C
G3_BC75_consensus_vsearch	3321	C	*/+T	190	13	5.99%	2	2	93	93	1.0011736432355593E-4	1	1	121	69	2	11	+T
G3_BC75_consensus_vsearch	3322	T	*/+C	142	23	10.36%	2	2	93	93	5.23202381209429E-8	1	1	80	62	18	5	+C
G3_BC75_consensus_vsearch	3322	T	*/-C	142	38	17.12%	2	2	93	93	4.092825706867427E-13	1	1	80	62	22	16	-C
G3_BC75_consensus_vsearch	3322	T	*/-CC	142	9	4.05%	2	2	93	93	0.0017276400371805214	1	1	80	62	5	4	-C
G3_BC75_consensus_vsearch	3329	G	*/-A	217	7	3.11%	2	1	93	93	0.007449584424390529	1	1	122	95	7	0	-A
G3_BC75_consensus_vsearch	3332	T	*/-C	208	17	7.52%	2	1	93	93	5.574528228215115E-6	1	1	113	95	17	0	-C
G3_BC75_consensus_vsearch	3334	C	*/-A	209	14	6.19%	2	2	93	93	4.9452447660699634E-5	1	1	115	94	13	1	-A
G3_BC75_consensus_vsearch	3341	T	*/+C	188	16	7.24%	2	1	93	93	1.1238487264411091E-5	1	1	110	78	16	0	+C
G3_BC75_consensus_vsearch	3341	T	*/-C	188	12	5.43%	2	1	93	93	2.059916701724999E-4	1	1	110	78	0	12	+C
G3_BC75_consensus_vsearch	3343	T	*/+G	179	13	5.96%	2	1	93	93	9.894838953322904E-5	1	1	111	68	13	0	+G
G3_BC75_consensus_vsearch	3343	T	*/-A	179	15	6.88%	2	2	93	93	2.3037153491826006E-5	1	1	111	68	1	14	-A
G3_BC75_consensus_vsearch	3345	A	*/-T	204	11	4.89%	2	2	93	93	4.2827676494109035E-4	1	1	123	81	3	8	-T
G3_BC75_consensus_vsearch	3356	C	*/-T	210	10	4.46%	2	2	93	93	8.796295164637225E-4	1	1	127	83	2	8	-T
G3_BC75_consensus_vsearch	3357	T	*/+C	180	12	5.69%	2	2	93	93	2.0449333836859826E-4	1	1	111	69	8	4	+C
G3_BC75_consensus_vsearch	3357	T	*/-C	180	8	3.79%	2	2	93	93	0.00362041635085765	1	1	111	69	3	5	+C
G3_BC75_consensus_vsearch	3373	C	*/-A	209	10	4.44%	2	1	93	93	8.792003591123169E-4	1	1	116	93	10	0	-A
G3_BC75_consensus_vsearch	3377	G	*/+A	207	11	5%	2	1	93	93	4.2906952287648286E-4	1	1	113	94	11	0	+A
G3_BC75_consensus_vsearch	3380	A	*/+C	200	8	3.57%	2	1	93	93	0.003647458600901869	1	1	113	87	8	0	+C
G3_BC75_consensus_vsearch	3380	A	*/-C	200	11	4.91%	2	2	93	93	4.27186182801716E-4	1	1	113	87	5	6	-C
G3_BC75_consensus_vsearch	3389	C	*/+A	215	8	3.57%	2	1	93	93	0.0036646057936482192	1	1	122	93	8	0	+A
G3_BC75_consensus_vsearch	3410	T	*/-G	208	10	4.44%	2	1	93	93	8.787673881990181E-4	1	1	131	77	0	10	-G
G3_BC75_consensus_vsearch	3435	C	*/+T	193	12	5.38%	2	2	93	93	2.0687207786004562E-4	1	1	108	85	11	1	+T
G3_BC75_consensus_vsearch	3435	C	*/-T	193	16	7.17%	2	2	93	93	1.132424303638399E-5	1	1	108	85	10	6	-T
G3_BC75_consensus_vsearch	3438	T	*/+A	182	27	11.95%	2	1	93	93	3.0375645825338665E-9	1	1	89	93	27	0	+A
G3_BC75_consensus_vsearch	3439	G	*/-C	148	30	13.76%	2	2	93	93	2.452991043408916E-10	1	1	85	63	2	28	-C
G3_BC75_consensus_vsearch	3440	C	*/+T	80	102	53.68%	2	2	93	93	3.5213091772296464E-40	1	1	49	31	70	32	+T
G3_BC75_consensus_vsearch	3446	A	*/-C	207	10	4.44%	2	2	93	93	8.783305527122537E-4	1	1	127	80	1	9	-C
G3_BC75_consensus_vsearch	3449	C	*/-T	217	7	3.1%	2	2	93	93	0.007449584424390529	1	1	130	87	1	6	-T
G3_BC75_consensus_vsearch	3455	G	*/-CT	212	11	4.89%	2	1	93	93	4.303452996410444E-4	1	1	117	95	11	0	-CT
G3_BC75_consensus_vsearch	3472	A	*/+C	110	103	45.98%	2	2	93	93	6.589365136017135E-39	1	1	72	38	56	47	+C
G3_BC75_consensus_vsearch	3473	C	*/+TC	196	13	5.8%	2	1	93	93	1.0070666248340834E-4	1	1	129	67	0	13	+TC
G3_BC75_consensus_vsearch	3489	C	*/+T	212	7	3.12%	2	1	93	93	0.00744137624879223	1	1	129	83	0	7	+T
G3_BC75_consensus_vsearch	3495	A	*/+G	207	9	4%	2	2	93	93	0.001793948723227531	1	1	125	82	1	8	+G
G3_BC75_consensus_vsearch	3502	C	*/-T	214	10	4.46%	2	1	93	93	8.813089995913842E-4	1	1	131	83	0	10	-T
G3_BC75_consensus_vsearch	3505	C	*/-T	214	7	3.11%	2	1	93	93	0.007444703667648697	1	1	127	87	0	7	-T
G3_BC75_consensus_vsearch	3508	A	*/-G	177	38	17.04%	2	2	93	93	6.050852009968977E-13	1	1	85	92	36	2	-G
G3_BC75_consensus_vsearch	3513	C	+A/+A	19	193	87.33%	1	2	93	93	1.8551535164063307E-99	1	1	19	0	105	88	+A
G3_BC75_consensus_vsearch	3517	G	*/-A	213	11	4.87%	2	1	93	93	4.305938947768699E-4	1	1	118	95	11	0	-A
G3_BC75_consensus_vsearch	3523	A	*/-C	122	71	31.84%	2	2	93	93	1.5036906660052216E-25	1	1	71	51	34	37	-C
G3_BC75_consensus_vsearch	3523	A	*/-CCC	122	20	8.97%	2	1	93	93	4.646742464658006E-7	1	1	71	51	20	0	-C
G3_BC75_consensus_vsearch	3530	G	*/-C	209	9	4%	2	2	93	93	0.0017953764342624938	1	1	118	91	7	2	-C
G3_BC75_consensus_vsearch	3536	G	*/-A	192	26	11.61%	2	1	93	93	6.747777093771561E-9	1	1	97	95	26	0	-A
G3_BC75_consensus_vsearch	3545	T	*/-G	209	9	4%	2	2	93	93	0.0017953764342624938	1	1	120	89	7	2	-G
G3_BC75_consensus_vsearch	3547	G	*/-C	196	11	4.98%	2	2	93	93	4.260552860545617E-4	1	1	111	85	10	1	-C
G3_BC75_consensus_vsearch	3550	C	*/+T	199	10	4.42%	2	1	93	93	8.746903119674215E-4	1	1	117	82	0	10	+T
G3_BC75_consensus_vsearch	3551	C	*/+G	63	117	51.77%	2	2	93	93	1.4666057471523206E-48	1	1	60	3	49	68	+G
G3_BC75_consensus_vsearch	3555	A	*/-C	151	52	23.21%	2	2	93	93	5.2024946073774895E-18	1	1	83	68	27	25	-C
G3_BC75_consensus_vsearch	3555	A	*/-CC	151	7	3.12%	2	1	93	93	0.0072999599354883	1	1	83	68	7	0	-C
G3_BC75_consensus_vsearch	3572	C	*/-TG	208	12	5.41%	2	1	93	93	2.0928573468617033E-4	1	1	116	92	12	0	-TG
G3_BC75_consensus_vsearch	3607	T	*/-C	214	8	3.54%	2	1	93	93	0.003663533633296164	1	1	120	94	8	0	-C
G3_BC75_consensus_vsearch	3613	T	*/-GT	206	10	4.46%	2	2	93	93	8.778898007284436E-4	1	1	117	89	7	3	-GT
G3_BC75_consensus_vsearch	3636	C	*/-G	209	9	4%	2	2	93	93	0.0017953764342624938	1	1	128	81	1	8	-G
G3_BC75_consensus_vsearch	3661	C	*/-T	216	7	3.12%	2	1	93	93	0.007447971960236055	1	1	131	85	0	7	-T
G3_BC75_consensus_vsearch	3663	C	*/-TC	206	12	5.38%	2	2	93	93	2.089820970245861E-4	1	1	126	80	2	10	-TC
G3_BC75_consensus_vsearch	3666	A	*/+T	209	11	4.95%	2	1	93	93	4.2958650804029443E-4	1	1	114	95	11	0	+T
G3_BC75_consensus_vsearch	3673	C	*/-G	207	12	5.31%	2	1	93	93	2.091345729349345E-4	1	1	118	89	12	0	-G
G3_BC75_consensus_vsearch	3675	A	*/-G	199	13	5.99%	2	2	93	93	1.0098964132434686E-4	1	1	107	92	12	1	-G
G3_BC75_consensus_vsearch	3688	C	*/-G	203	18	7.96%	2	2	93	93	2.660025487728775E-6	1	1	126	77	4	14	-G
G3_BC75_consensus_vsearch	3690	G	*/-A	200	24	10.62%	2	1	93	93	3.1100546133066265E-8	1	1	107	93	24	0	-A
G3_BC75_consensus_vsearch	3694	C	*/+A	191	12	5.33%	2	1	93	93	2.0652482483515445E-4	1	1	100	91	12	0	+A
G3_BC75_consensus_vsearch	3694	C	*/-G	191	9	4%	2	1	93	93	0.0017815247172920585	1	1	100	91	9	0	+A
G3_BC75_consensus_vsearch	3701	C	*/-AC	212	8	3.54%	2	1	93	93	0.003661360523321731	1	1	121	91	8	0	-AC
G3_BC75_consensus_vsearch	3711	A	*/+G	156	8	3.74%	2	1	93	93	0.0035794408926960136	1	1	117	39	0	8	+G
G3_BC75_consensus_vsearch	3711	A	*/-G	156	36	16.82%	2	1	93	93	2.3793804006439792E-12	1	1	117	39	0	36	-G
G3_BC75_consensus_vsearch	3725	C	*/+G	207	8	3.6%	2	1	93	93	0.003655753662936563	1	1	117	90	8	0	+G
G3_BC75_consensus_vsearch	3726	A	*/-G	201	9	4.02%	2	2	93	93	0.0017895062981052791	1	1	111	90	8	1	-G
G3_BC75_consensus_vsearch	3727	G	*/+A	197	11	5.09%	2	1	93	93	4.263419112240475E-4	1	1	106	91	11	0	+A
G3_BC75_consensus_vsearch	3728	T	*/-C	203	10	4.46%	2	1	93	93	8.765435124402236E-4	1	1	109	94	10	0	-C
G3_BC75_consensus_vsearch	3731	A	*/+C	190	13	5.88%	2	2	93	93	1.0011736432355593E-4	1	1	101	89	11	2	+C
G3_BC75_consensus_vsearch	3731	A	*/-C	190	12	5.43%	2	2	93	93	2.0634876616312749E-4	1	1	101	89	10	2	+C
G3_BC75_consensus_vsearch	3736	G	*/-A	208	10	4.44%	2	2	93	93	8.787673881990181E-4	1	1	115	93	9	1	-A
G3_BC75_consensus_vsearch	3744	C	*/-T	205	9	4.02%	2	2	93	93	0.0017924949478988227	1	1	126	79	2	7	-T
G3_BC75_consensus_vsearch	3750	A	*/-TA	216	7	3.1%	2	2	93	93	0.007447971960236055	1	1	126	90	2	5	-TA
G3_BC75_consensus_vsearch	3759	G	*/-C	171	38	16.81%	2	2	93	93	5.717007676029115E-13	1	1	98	73	19	19	-C
G3_BC75_consensus_vsearch	3764	T	*/+G	206	9	4.09%	2	2	93	93	0.001793225137980622	1	1	126	80	1	8	+G
G3_BC75_consensus_vsearch	3779	C	*/-AC	214	7	3.15%	2	1	93	93	0.007444703667648697	1	1	120	94	7	0	-AC
G3_BC75_consensus_vsearch	3782	G	*/-T	196	24	10.67%	2	2	93	93	3.071396715362743E-8	1	1	104	92	21	3	-T
G3_BC75_consensus_vsearch	3786	T	*/-A	214	9	3.98%	2	2	93	93	0.0017988361772468277	1	1	121	93	8	1	-A
G3_BC75_consensus_vsearch	3792	C	*/+A	214	8	3.59%	2	1	93	93	0.003663533633296164	1	1	129	85	0	8	+A
G3_BC75_consensus_vsearch	3801	A	*/-CA	210	7	3.11%	2	2	93	93	0.007437988084800957	1	1	124	86	3	4	-CA
G3_BC75_consensus_vsearch	3805	A	*/-TA	209	11	4.93%	2	2	93	93	4.2958650804029443E-4	1	1	119	90	8	3	-TA
G3_BC75_consensus_vsearch	3841	C	*/-A	196	20	8.97%	2	2	93	93	6.015714107611032E-7	1	1	105	91	19	1	-A
G3_BC75_consensus_vsearch	3851	G	*/-C	200	16	7.21%	2	2	93	93	1.1438379994950568E-5	1	1	116	84	10	6	-C
G3_BC75_consensus_vsearch	3852	C	*/+T	176	24	11.59%	2	1	93	93	2.8622426530999085E-8	1	1	118	58	0	24	+T
G3_BC75_consensus_vsearch	3855	T	*/-C	146	77	34.07%	2	1	93	93	2.2730172954188508E-27	1	1	52	94	77	0	-C
G3_BC75_consensus_vsearch	3868	C	*/-A	212	12	5.33%	2	2	93	93	2.0987757342671282E-4	1	1	119	93	11	1	-A
G3_BC75_consensus_vsearch	3870	C	*/-T	200	19	8.44%	2	2	93	93	1.268651398690971E-6	1	1	124	76	1	18	-T
G3_BC75_consensus_vsearch	3871	T	*/+C	194	7	3.45%	2	2	93	93	0.007408480654387502	1	1	121	73	5	2	+C
G3_BC75_consensus_vsearch	3874	G	*/-A	209	15	6.64%	2	1	93	93	2.3951800712612044E-5	1	1	115	94	15	0	-A
G3_BC75_consensus_vsearch	3877	C	*/-T	209	8	3.54%	2	2	93	93	0.003658026926953576	1	1	124	85	1	7	-T
G3_BC75_consensus_vsearch	3881	A	*/+G	212	7	3.12%	2	1	93	93	0.00744137624879223	1	1	125	87	0	7	+G
G3_BC75_consensus_vsearch	3885	T	*/+G	198	20	8.85%	2	2	93	93	6.042413578071823E-7	1	1	106	92	18	2	+G
G3_BC75_consensus_vsearch	3886	A	*/-G	192	22	9.91%	2	2	93	93	1.3503013098022896E-7	1	1	111	81	12	10	-G
G3_BC75_consensus_vsearch	3894	T	*/+C	96	127	56.44%	2	2	93	93	3.889460206204382E-50	1	1	70	26	59	68	+C
G3_BC75_consensus_vsearch	3900	A	*/+G	203	11	4.98%	2	1	93	93	4.280077806644155E-4	1	1	123	80	0	11	+G
G3_BC75_consensus_vsearch	3913	C	*/+A	209	10	4.48%	2	2	93	93	8.792003591123169E-4	1	1	122	87	8	2	+A
G3_BC75_consensus_vsearch	3918	G	*/+C	204	7	3.14%	2	1	93	93	0.007427442022474603	1	1	113	91	7	0	+C
G3_BC75_consensus_vsearch	3918	G	*/-C	204	10	4.48%	2	2	93	93	8.769963348909129E-4	1	1	113	91	9	1	-C
G3_BC75_consensus_vsearch	3943	C	*/+T	214	9	4.02%	2	1	93	93	0.0017988361772468277	1	1	129	85	0	9	+T
G3_BC75_consensus_vsearch	3944	C	*/+TC	102	108	48%	2	2	93	93	1.960989672922573E-41	1	1	49	53	74	34	+TC
G3_BC75_consensus_vsearch	3944	C	*/+TCAC	102	7	3.11%	2	2	93	93	0.007073951586487618	1	1	49	53	6	1	+TC
G3_BC75_consensus_vsearch	3948	C	*/-AC	211	13	5.75%	2	2	93	93	1.0205056322589528E-4	1	1	119	92	11	2	-AC
G3_BC75_consensus_vsearch	3954	T	*/-GT	211	13	5.78%	2	2	93	93	1.0205056322589528E-4	1	1	130	81	1	12	-GT
G3_BC75_consensus_vsearch	3965	A	*/-T	180	43	19.03%	2	2	93	93	1.2077896720994002E-14	1	1	89	91	42	1	-T
G3_BC75_consensus_vsearch	3972	C	*/-GC	199	25	11.06%	2	2	93	93	1.4670068930690744E-8	1	1	111	88	18	7	-GC
G3_BC75_consensus_vsearch	3980	G	*/-C	205	12	5.38%	2	2	93	93	2.0882828978061456E-4	1	1	112	93	10	2	-C
G3_BC75_consensus_vsearch	3981	C	*/+G	201	8	3.79%	2	1	93	93	0.003648677074969142	1	1	110	91	8	0	+G
G3_BC75_consensus_vsearch	3982	C	*/+T	215	7	3.1%	2	2	93	93	0.007446345105805389	1	1	128	87	2	5	+T
G3_BC75_consensus_vsearch	3984	T	*/-C	205	12	5.36%	2	2	93	93	2.0882828978061456E-4	1	1	115	90	10	2	-C
G3_BC75_consensus_vsearch	3985	C	*/+G	193	12	5.66%	2	1	93	93	2.0687207786004562E-4	1	1	102	91	12	0	+G
G3_BC75_consensus_vsearch	3986	C	*/-T	203	13	5.8%	2	2	93	93	1.0135552209744578E-4	1	1	116	87	6	7	-T
G3_BC75_consensus_vsearch	3988	T	*/-G	203	10	4.57%	2	1	93	93	8.765435124402236E-4	1	1	120	83	0	10	-G
G3_BC75_consensus_vsearch	3994	T	*/-A	190	24	10.76%	2	1	93	93	3.011509434593919E-8	1	1	101	89	24	0	-A
G3_BC75_consensus_vsearch	3997	G	*/-A	209	17	7.52%	2	2	93	93	5.582571341748222E-6	1	1	115	94	16	1	-A
G3_BC75_consensus_vsearch	3999	G	*/-C	215	7	3.12%	2	2	93	93	0.007446345105805389	1	1	126	89	3	4	-C
G3_BC75_consensus_vsearch	4014	C	*/-T	180	39	17.33%	2	1	93	93	2.838197923670167E-13	1	1	127	53	0	39	-T
G3_BC75_consensus_vsearch	4019	T	*/-C	187	33	14.67%	2	1	93	93	3.1819642916895646E-11	1	1	93	94	33	0	-C
G3_BC75_consensus_vsearch	4021	C	*/-G	190	35	15.49%	2	2	93	93	6.939381010839833E-12	1	1	127	63	3	32	-G
G3_BC75_consensus_vsearch	4032	T	*/-C	210	7	3.14%	2	1	93	93	0.007437988084800957	1	1	125	85	0	7	-C
G3_BC75_consensus_vsearch	4034	T	*/-A	195	20	9.01%	2	2	93	93	6.002214170441375E-7	1	1	124	71	3	17	-A
G3_BC75_consensus_vsearch	4038	T	*/-C	157	47	20.89%	2	2	93	93	3.542495362077904E-16	1	1	105	52	21	26	-C
G3_BC75_consensus_vsearch	4038	T	*/-CC	157	11	4.89%	2	2	93	93	4.1235800097779135E-4	1	1	105	52	1	10	-C
G3_BC75_consensus_vsearch	4045	T	*/-A	212	9	4%	2	1	93	93	0.00179747064240055	1	1	122	90	9	0	-A
G3_BC75_consensus_vsearch	4046	A	*/-C	194	15	6.98%	2	2	93	93	2.3524071874557613E-5	1	1	104	90	13	2	-C
G3_BC75_consensus_vsearch	4054	T	*/-C	217	7	3.1%	2	1	93	93	0.007449584424390529	1	1	122	95	7	0	-C
G3_BC75_consensus_vsearch	4066	T	*/-C	156	63	28.12%	2	2	93	93	5.831419491416403E-22	1	1	67	89	62	1	-C
G3_BC75_consensus_vsearch	4068	C	*/-A	215	8	3.54%	2	2	93	93	0.0036646057936482192	1	1	122	93	7	1	-A
G3_BC75_consensus_vsearch	4091	A	*/-G	202	12	5.36%	2	2	93	93	2.0835870377678545E-4	1	1	118	84	3	9	-G
G3_BC75_consensus_vsearch	4107	T	*/+G	207	7	3.1%	2	1	93	93	0.007432788253078562	1	1	129	78	0	7	+G
G3_BC75_consensus_vsearch	4123	T	*/-G	187	12	5.45%	2	1	93	93	2.0581058583041666E-4	1	1	97	90	12	0	-G
G3_BC75_consensus_vsearch	4124	G	*/-A	161	39	18.75%	2	1	93	93	2.3330715306772195E-13	1	1	67	94	39	0	-A
G3_BC75_consensus_vsearch	4127	G	*/+C	176	30	13.7%	2	1	93	93	2.9833677411014105E-10	1	1	81	95	30	0	+C
G3_BC75_consensus_vsearch	4127	G	*/-C	176	7	3.2%	2	1	93	93	0.007369187819667051	1	1	81	95	7	0	+C
G3_BC75_consensus_vsearch	4137	T	*/-C	180	44	19.56%	2	1	93	93	5.4580204421525216E-15	1	1	86	94	44	0	-C
G3_BC75_consensus_vsearch	4139	C	*/+G	206	11	4.87%	2	2	93	93	4.288076047440095E-4	1	1	123	83	2	9	+G
G3_BC75_consensus_vsearch	4140	G	*/-A	216	7	3.1%	2	2	93	93	0.007447971960236055	1	1	122	94	6	1	-A
G3_BC75_consensus_vsearch	4160	C	*/-T	208	8	3.59%	2	2	93	93	0.0036568954742723925	1	1	125	83	1	7	-T
G3_BC75_consensus_vsearch	4179	A	*/-G	191	19	8.6%	2	1	93	93	1.2456546324351246E-6	1	1	98	93	19	0	-G
G3_BC75_consensus_vsearch	4184	T	*/-G	196	27	11.95%	2	1	93	93	3.2252988485898974E-9	1	1	129	67	0	27	-G
G3_BC75_consensus_vsearch	4197	C	*/-AC	201	18	8%	2	2	93	93	2.6509133703959145E-6	1	1	110	91	17	1	-AC
G3_BC75_consensus_vsearch	4201	T	*/-C	211	14	6.19%	2	1	93	93	4.9547934929218304E-5	1	1	117	94	14	0	-C
G3_BC75_consensus_vsearch	4207	C	*/-T	197	19	8.64%	2	1	93	93	1.261162399210312E-6	1	1	128	69	0	19	-T
G3_BC75_consensus_vsearch	4209	T	*/+G	211	8	3.56%	2	1	93	93	0.0036602593149509337	1	1	129	82	0	8	+G
G3_BC75_consensus_vsearch	4238	T	*/+C	193	14	6.22%	2	1	93	93	4.862760706844154E-5	1	1	113	80	0	14	+C
G3_BC75_consensus_vsearch	4238	T	*/-C	193	18	8%	2	1	93	93	2.613000438265718E-6	1	1	113	80	18	0	-C
G3_BC75_consensus_vsearch	4252	C	*/-G	203	11	5%	2	2	93	93	4.280077806644155E-4	1	1	116	87	8	3	-G
G3_BC75_consensus_vsearch	4266	C	*/+A	182	7	3.11%	2	2	93	93	0.007383107786177688	1	1	95	87	5	2	+A
G3_BC75_consensus_vsearch	4266	C	*/-A	182	31	13.78%	2	2	93	93	1.4353309721310144E-10	1	1	95	87	26	5	-A
G3_BC75_consensus_vsearch	4272	T	*/-C	213	9	4%	2	2	93	93	0.0017981564163397133	1	1	128	85	1	8	-C
G3_BC75_consensus_vsearch	4305	G	*/-A	214	7	3.1%	2	2	93	93	0.007444703667648697	1	1	124	90	4	3	-A
G3_BC75_consensus_vsearch	4311	T	*/+C	214	10	4.42%	2	1	93	93	8.813089995913842E-4	1	1	129	85	0	10	+C
G3_BC75_consensus_vsearch	4312	T	*/-C	214	10	4.42%	2	1	93	93	8.813089995913842E-4	1	1	129	85	0	10	-C
G3_BC75_consensus_vsearch	4336	T	*/+C	208	9	4%	2	1	93	93	0.0017946657928001688	1	1	119	89	9	0	+C
G3_BC75_consensus_vsearch	4337	C	*/+T	208	7	3.17%	2	1	93	93	0.007434537497224064	1	1	126	82	0	7	+T
G3_BC75_consensus_vsearch	4344	C	*/-TC	153	67	29.65%	2	2	93	93	1.763412502776814E-23	1	1	127	26	4	63	-TC
G3_BC75_consensus_vsearch	4364	C	*/+G	211	7	3.11%	2	1	93	93	0.007439689863414905	1	1	127	84	0	7	+G
