Chrom	Position	Ref	Cons	Reads1	Reads2	VarFreq	Strands1	Strands2	Qual1	Qual2	Pvalue	MapQual1	MapQual2	Reads1Plus	Reads1Minus	Reads2Plus	Reads2Minus	VarAllele
G3_BC75_consensus_vsearch	20	A	R	167	46	20.81%	2	2	93	93	9.299602692355662E-16	1	1	105	62	24	22	G
G3_BC75_consensus_vsearch	37	G	R	209	10	4.48%	2	2	93	93	8.792003591123169E-4	1	1	118	91	9	1	A
G3_BC75_consensus_vsearch	47	A	R	204	11	4.95%	2	1	93	93	4.2827676494109035E-4	1	1	110	94	11	0	G
G3_BC75_consensus_vsearch	53	C	Y	206	10	4.55%	2	2	93	93	8.778898007284436E-4	1	1	127	79	1	9	T
G3_BC75_consensus_vsearch	66	T	Y	201	15	6.94%	2	2	93	93	2.373037043728608E-5	1	1	122	79	2	13	C
G3_BC75_consensus_vsearch	69	C	Y	194	23	10.31%	2	2	93	93	6.444107300416681E-8	1	1	126	68	1	22	T
G3_BC75_consensus_vsearch	104	C	Y	186	30	13.27%	2	1	93	93	3.1573165354568655E-10	1	1	124	62	0	30	T
G3_BC75_consensus_vsearch	108	C	Y	189	11	4.87%	2	2	93	93	4.239722735294379E-4	1	1	112	77	3	8	T
G3_BC75_consensus_vsearch	119	C	Y	214	9	3.98%	2	2	93	93	0.0017988361772468277	1	1	129	85	1	8	T
G3_BC75_consensus_vsearch	127	G	K	205	10	4.46%	2	1	93	93	8.774450793915666E-4	1	1	115	90	10	0	T
G3_BC75_consensus_vsearch	128	T	Y	208	7	3.15%	2	1	93	93	0.007434537497224064	1	1	123	85	0	7	C
G3_BC75_consensus_vsearch	132	G	R	217	9	3.98%	2	2	93	93	0.0018008401619304512	1	1	124	93	7	2	A
G3_BC75_consensus_vsearch	140	C	Y	212	8	3.59%	2	1	93	93	0.003661360523321731	1	1	129	83	0	8	T
G3_BC75_consensus_vsearch	141	C	Y	206	8	3.54%	2	2	93	93	0.0036546013500883302	1	1	127	79	1	7	T
G3_BC75_consensus_vsearch	149	A	R	197	19	8.48%	2	2	93	93	1.261162399210312E-6	1	1	108	89	18	1	G
G3_BC75_consensus_vsearch	176	T	Y	213	8	3.6%	2	2	93	93	0.0036624519192641563	1	1	128	85	1	7	C
G3_BC75_consensus_vsearch	188	A	R	211	10	4.46%	2	1	93	93	8.800549103686053E-4	1	1	117	94	10	0	G
G3_BC75_consensus_vsearch	203	C	Y	201	18	8%	2	1	93	93	2.6509133703959145E-6	1	1	127	74	0	18	T
G3_BC75_consensus_vsearch	212	T	W	186	12	5.85%	2	1	93	93	2.056277785002741E-4	1	1	114	72	12	0	A
G3_BC75_consensus_vsearch	264	C	Y	209	7	3.2%	2	1	93	93	0.007436270701269745	1	1	126	83	0	7	T
G3_BC75_consensus_vsearch	276	C	Y	217	8	3.54%	2	1	93	93	0.0036667219549938834	1	1	130	87	0	8	T
G3_BC75_consensus_vsearch	281	A	R	215	7	3.1%	2	1	93	93	0.007446345105805389	1	1	122	93	7	0	G
G3_BC75_consensus_vsearch	290	G	R	212	7	3.17%	2	1	93	93	0.00744137624879223	1	1	121	91	7	0	A
G3_BC75_consensus_vsearch	298	T	Y	215	7	3.11%	2	1	93	93	0.007446345105805389	1	1	129	86	0	7	C
G3_BC75_consensus_vsearch	301	T	Y	202	9	4.05%	2	2	93	93	0.0017902638323438202	1	1	123	79	6	3	C
G3_BC75_consensus_vsearch	308	C	Y	211	9	4%	2	2	93	93	0.0017967787753331713	1	1	125	86	1	8	T
G3_BC75_consensus_vsearch	357	C	Y	189	10	4.88%	2	1	93	93	8.697426073947409E-4	1	1	127	62	0	10	T
G3_BC75_consensus_vsearch	388	C	Y	210	9	4.07%	2	2	93	93	0.0017960807336148846	1	1	129	81	1	8	T
G3_BC75_consensus_vsearch	410	T	K	211	13	5.78%	2	1	93	93	1.0205056322589528E-4	1	1	117	94	13	0	G
G3_BC75_consensus_vsearch	412	G	R	217	7	3.11%	2	1	93	93	0.007449584424390529	1	1	122	95	7	0	A
G3_BC75_consensus_vsearch	457	G	R	205	7	3.29%	2	1	93	93	0.0074292407456773525	1	1	124	81	7	0	A
G3_BC75_consensus_vsearch	466	A	R	213	9	4%	2	2	93	93	0.0017981564163397133	1	1	122	91	8	1	G
G3_BC75_consensus_vsearch	474	C	Y	210	16	7.08%	2	1	93	93	1.1590481452408359E-5	1	1	131	79	0	16	T
G3_BC75_consensus_vsearch	480	T	Y	213	7	3.1%	2	2	93	93	0.007443047448823043	1	1	125	88	2	5	C
G3_BC75_consensus_vsearch	508	T	Y	213	7	3.11%	2	2	93	93	0.007443047448823043	1	1	123	90	3	4	C
G3_BC75_consensus_vsearch	509	A	R	213	8	3.6%	2	2	93	93	0.0036624519192641563	1	1	120	93	7	1	G
G3_BC75_consensus_vsearch	526	G	R	211	13	5.78%	2	1	93	93	1.0205056322589528E-4	1	1	116	95	13	0	A
G3_BC75_consensus_vsearch	528	G	R	208	9	4.07%	2	1	93	93	0.0017946657928001688	1	1	118	90	9	0	A
G3_BC75_consensus_vsearch	529	G	R	199	20	8.89%	2	1	93	93	6.055615268214013E-7	1	1	105	94	20	0	A
G3_BC75_consensus_vsearch	550	C	M	179	11	5%	2	1	93	93	4.2074294006989865E-4	1	1	96	83	11	0	A
G3_BC75_consensus_vsearch	551	T	W	180	7	3.4%	2	1	93	93	0.007378565932456183	1	1	87	93	7	0	+A
G3_BC75_consensus_vsearch	552	T	W	198	7	3.27%	2	1	93	93	0.007416284922397948	1	1	106	92	7	0	A
G3_BC75_consensus_vsearch	561	A	W	184	8	4.06%	2	1	93	93	0.0036262674855563662	1	1	128	56	0	8	T
G3_BC75_consensus_vsearch	568	A	R	202	11	4.89%	2	2	93	93	4.2773637746469634E-4	1	1	119	83	10	1	G
G3_BC75_consensus_vsearch	578	T	W	199	7	3.32%	2	1	93	93	0.007418189114685095	1	1	105	94	7	0	A
G3_BC75_consensus_vsearch	615	A	R	167	13	6.05%	2	1	93	93	9.752306273366467E-5	1	1	100	67	13	0	-G
G3_BC75_consensus_vsearch	642	C	Y	212	14	6.19%	2	2	93	93	4.9595092839070994E-5	1	1	130	82	1	13	T
G3_BC75_consensus_vsearch	650	A	W	205	11	5.02%	2	1	93	93	4.285433624407098E-4	1	1	112	93	11	0	T
G3_BC75_consensus_vsearch	651	C	Y	204	14	6.36%	2	2	93	93	4.920666598282105E-5	1	1	113	91	11	3	T
G3_BC75_consensus_vsearch	667	T	Y	196	20	9.22%	2	2	93	93	6.015714107611032E-7	1	1	122	74	3	17	C
G3_BC75_consensus_vsearch	685	T	Y	178	26	11.61%	2	2	93	93	6.3670555946337175E-9	1	1	120	58	1	25	C
G3_BC75_consensus_vsearch	691	C	Y	210	12	5.33%	2	2	93	93	2.0958418294317403E-4	1	1	126	84	1	11	T
G3_BC75_consensus_vsearch	717	G	R	203	18	8.07%	2	2	93	93	2.660025487728775E-6	1	1	111	92	17	1	A
G3_BC75_consensus_vsearch	726	G	R	209	14	6.22%	2	1	93	93	4.9452447660699634E-5	1	1	114	95	14	0	A
G3_BC75_consensus_vsearch	744	C	Y	209	7	3.12%	2	1	93	93	0.007436270701269745	1	1	127	82	0	7	T
G3_BC75_consensus_vsearch	749	T	Y	208	7	3.18%	2	1	93	93	0.007434537497224064	1	1	128	80	0	7	C
G3_BC75_consensus_vsearch	750	A	R	209	9	4.04%	2	1	93	93	0.0017953764342624938	1	1	118	91	9	0	G
G3_BC75_consensus_vsearch	765	G	R	198	14	6.28%	2	1	93	93	4.8897660884513865E-5	1	1	108	90	14	0	A
G3_BC75_consensus_vsearch	786	G	R	210	9	4.05%	2	1	93	93	0.0017960807336148846	1	1	117	93	9	0	A
G3_BC75_consensus_vsearch	791	T	Y	197	8	3.57%	2	2	93	93	0.003643733038795537	1	1	112	85	1	7	+G
G3_BC75_consensus_vsearch	815	A	R	200	11	4.87%	2	2	93	93	4.27186182801716E-4	1	1	120	80	9	2	G
G3_BC75_consensus_vsearch	824	C	Y	215	7	3.11%	2	2	93	93	0.007446345105805389	1	1	130	85	1	6	T
G3_BC75_consensus_vsearch	833	A	R	197	19	8.56%	2	1	93	93	1.261162399210312E-6	1	1	109	88	19	0	G
G3_BC75_consensus_vsearch	849	T	Y	197	20	9.13%	2	1	93	93	6.029113548186886E-7	1	1	128	69	0	20	C
G3_BC75_consensus_vsearch	872	T	Y	212	7	3.11%	2	2	93	93	0.00744137624879223	1	1	121	91	5	2	C
G3_BC75_consensus_vsearch	873	G	R	212	8	3.64%	2	1	93	93	0.003661360523321731	1	1	118	94	8	0	A
G3_BC75_consensus_vsearch	874	G	R	214	8	3.54%	2	1	93	93	0.003663533633296164	1	1	119	95	8	0	A
G3_BC75_consensus_vsearch	876	C	Y	216	8	3.54%	2	2	93	93	0.003665668526289429	1	1	123	93	6	2	T
G3_BC75_consensus_vsearch	884	T	Y	213	7	3.12%	2	1	93	93	0.007443047448823043	1	1	128	85	0	7	C
G3_BC75_consensus_vsearch	886	C	Y	213	7	3.15%	2	1	93	93	0.007443047448823043	1	1	127	86	0	7	T
G3_BC75_consensus_vsearch	900	C	Y	208	14	6.22%	2	2	93	93	4.9404108604884E-5	1	1	126	82	3	11	T
G3_BC75_consensus_vsearch	932	A	R	195	12	5.38%	2	2	93	93	2.0721299272133376E-4	1	1	114	81	11	1	-G
G3_BC75_consensus_vsearch	941	A	R	212	10	4.42%	2	1	93	93	8.804765900705064E-4	1	1	117	95	10	0	G
G3_BC75_consensus_vsearch	946	G	R	210	11	4.93%	2	2	93	93	4.298416344617859E-4	1	1	119	91	9	2	A
G3_BC75_consensus_vsearch	962	C	Y	193	18	7.96%	2	2	93	93	2.613000438265718E-6	1	1	121	72	2	16	T
G3_BC75_consensus_vsearch	963	G	R	203	11	4.95%	2	1	93	93	4.280077806644155E-4	1	1	108	95	11	0	A
G3_BC75_consensus_vsearch	982	C	S	188	18	8.57%	2	1	93	93	2.5880431248781214E-6	1	1	97	91	18	0	G
G3_BC75_consensus_vsearch	984	A	R	188	7	3.55%	2	2	93	93	0.007396180372504935	1	1	113	75	6	1	G
G3_BC75_consensus_vsearch	1000	C	Y	217	8	3.54%	2	2	93	93	0.0036667219549938834	1	1	130	87	1	7	T
G3_BC75_consensus_vsearch	1050	G	R	206	14	6.28%	2	2	93	93	4.930621480362649E-5	1	1	113	93	13	1	A
G3_BC75_consensus_vsearch	1053	A	M	215	7	3.11%	2	2	93	93	0.007446345105805389	1	1	128	87	1	6	C
G3_BC75_consensus_vsearch	1054	T	Y	215	9	4%	2	1	93	93	0.0017995100038167202	1	1	129	86	0	9	C
G3_BC75_consensus_vsearch	1055	T	Y	209	8	3.54%	2	1	93	93	0.003658026926953576	1	1	126	83	0	8	C
G3_BC75_consensus_vsearch	1057	G	R	186	14	6.97%	2	1	93	93	4.822879642891894E-5	1	1	112	74	14	0	A
G3_BC75_consensus_vsearch	1091	C	Y	173	24	10.62%	2	2	93	93	2.8283978794910944E-8	1	1	118	55	3	21	T
G3_BC75_consensus_vsearch	1116	C	Y	208	10	4.46%	2	2	93	93	8.787673881990181E-4	1	1	122	86	1	9	T
G3_BC75_consensus_vsearch	1125	A	R	211	10	4.42%	2	2	93	93	8.800549103686053E-4	1	1	117	94	9	1	G
G3_BC75_consensus_vsearch	1144	G	R	197	8	3.59%	2	1	93	93	0.003643733038795537	1	1	102	95	8	0	A
G3_BC75_consensus_vsearch	1144	G	S	197	17	7.62%	2	1	93	93	5.481738321341071E-6	1	1	102	95	17	0	C
G3_BC75_consensus_vsearch	1211	C	S	211	11	4.93%	2	1	93	93	4.300945555177922E-4	1	1	118	93	11	0	G
G3_BC75_consensus_vsearch	1228	T	K	193	16	7.66%	2	1	93	93	1.132424303638399E-5	1	1	99	94	16	0	G
G3_BC75_consensus_vsearch	1285	C	S	213	9	4.05%	2	1	93	93	0.0017981564163397133	1	1	118	95	9	0	G
G3_BC75_consensus_vsearch	1287	G	R	205	14	6.39%	2	1	93	93	4.9256649870734555E-5	1	1	117	88	14	0	A
G3_BC75_consensus_vsearch	1308	G	R	213	9	4.02%	2	2	93	93	0.0017981564163397133	1	1	120	93	8	1	A
G3_BC75_consensus_vsearch	1311	T	Y	216	8	3.54%	2	2	93	93	0.003665668526289429	1	1	130	86	1	7	C
G3_BC75_consensus_vsearch	1317	C	Y	205	13	5.75%	2	1	93	93	1.0153375468649412E-4	1	1	126	79	0	13	T
G3_BC75_consensus_vsearch	1359	C	Y	211	7	3.11%	2	2	93	93	0.007439689863414905	1	1	123	88	2	5	T
G3_BC75_consensus_vsearch	1361	C	Y	170	7	3.26%	2	2	93	93	0.007354335343249384	1	1	90	80	1	6	-A
G3_BC75_consensus_vsearch	1382	C	Y	212	8	3.6%	2	2	93	93	0.003661360523321731	1	1	127	85	4	4	T
G3_BC75_consensus_vsearch	1390	A	R	211	8	3.57%	2	1	93	93	0.0036602593149509337	1	1	120	91	8	0	G
G3_BC75_consensus_vsearch	1398	A	R	190	25	11.16%	2	1	93	93	1.4215166911555927E-8	1	1	97	93	25	0	G
G3_BC75_consensus_vsearch	1407	T	Y	188	7	3.54%	2	2	93	93	0.007396180372504935	1	1	129	59	1	6	C
G3_BC75_consensus_vsearch	1408	T	Y	142	8	3.86%	2	1	93	93	0.003549622192432461	1	1	100	42	0	8	-C
G3_BC75_consensus_vsearch	1422	A	R	211	8	3.59%	2	2	93	93	0.0036602593149509337	1	1	124	87	3	5	G
G3_BC75_consensus_vsearch	1468	G	R	203	20	8.97%	2	1	93	93	6.107459539817822E-7	1	1	110	93	20	0	A
G3_BC75_consensus_vsearch	1473	C	Y	195	14	6.28%	2	2	93	93	4.873705147345955E-5	1	1	104	91	12	2	T
G3_BC75_consensus_vsearch	1480	C	Y	195	28	12.44%	2	2	93	93	1.508731680963363E-9	1	1	130	65	1	27	T
G3_BC75_consensus_vsearch	1512	A	R	214	10	4.42%	2	1	93	93	8.813089995913842E-4	1	1	120	94	10	0	G
G3_BC75_consensus_vsearch	1520	C	Y	206	14	6.28%	2	1	93	93	4.930621480362649E-5	1	1	129	77	0	14	T
G3_BC75_consensus_vsearch	1522	A	M	197	8	3.56%	2	1	93	93	0.003643733038795537	1	1	128	69	0	8	C
G3_BC75_consensus_vsearch	1522	A	R	197	13	5.78%	2	2	93	93	1.0080182645455998E-4	1	1	128	69	2	11	G
G3_BC75_consensus_vsearch	1570	C	Y	204	21	9.33%	2	2	93	93	2.923785526578798E-7	1	1	119	85	11	10	T
G3_BC75_consensus_vsearch	1581	C	Y	211	12	5.33%	2	2	93	93	2.0973150235371546E-4	1	1	129	82	1	11	T
G3_BC75_consensus_vsearch	1589	C	Y	208	14	6.28%	2	2	93	93	4.9404108604884E-5	1	1	128	80	1	13	T
G3_BC75_consensus_vsearch	1590	C	Y	192	30	13.27%	2	2	93	93	3.2579311551130064E-10	1	1	128	64	1	29	T
G3_BC75_consensus_vsearch	1592	T	Y	200	19	8.44%	2	1	93	93	1.268651398690971E-6	1	1	131	69	0	19	C
G3_BC75_consensus_vsearch	1594	T	Y	56	20	9.05%	2	1	93	93	2.261418887345067E-7	1	1	50	6	0	20	+C
G3_BC75_consensus_vsearch	1596	A	M	205	12	5.38%	2	2	93	93	2.0882828978061456E-4	1	1	117	88	11	1	C
G3_BC75_consensus_vsearch	1601	T	Y	211	8	3.57%	2	2	93	93	0.0036602593149509337	1	1	128	83	1	7	C
G3_BC75_consensus_vsearch	1602	A	R	211	7	3.14%	2	2	93	93	0.007439689863414905	1	1	120	91	6	1	G
G3_BC75_consensus_vsearch	1612	C	M	182	35	15.56%	2	1	93	93	6.551238349827933E-12	1	1	88	94	35	0	A
G3_BC75_consensus_vsearch	1614	A	M	167	12	5.5%	2	2	93	93	2.0179123643446653E-4	1	1	75	92	11	1	+CCC
G3_BC75_consensus_vsearch	1623	C	Y	217	7	3.11%	2	2	93	93	0.007449584424390529	1	1	126	91	4	3	T
G3_BC75_consensus_vsearch	1630	C	Y	207	11	4.89%	2	2	93	93	4.2906952287648286E-4	1	1	123	84	2	9	T
G3_BC75_consensus_vsearch	1634	A	R	200	15	6.88%	2	1	93	93	2.3701643162627867E-5	1	1	107	93	15	0	G
G3_BC75_consensus_vsearch	1639	T	W	201	9	4.05%	2	1	93	93	0.0017895062981052791	1	1	109	92	9	0	A
G3_BC75_consensus_vsearch	1670	A	R	206	7	3.1%	2	1	93	93	0.007431022745174962	1	1	115	91	7	0	-C
G3_BC75_consensus_vsearch	1706	C	Y	215	7	3.1%	2	2	93	93	0.007446345105805389	1	1	123	92	4	3	T
G3_BC75_consensus_vsearch	1738	A	R	212	7	3.18%	2	1	93	93	0.00744137624879223	1	1	118	94	7	0	G
G3_BC75_consensus_vsearch	1813	T	K	154	37	18.88%	2	1	93	93	1.054785445505795E-12	1	1	61	93	37	0	G
G3_BC75_consensus_vsearch	1826	A	R	198	22	9.95%	2	2	93	93	1.3725141667146876E-7	1	1	106	92	21	1	G
G3_BC75_consensus_vsearch	1830	A	R	186	35	15.77%	2	1	93	93	6.7463415254651095E-12	1	1	91	95	35	0	G
G3_BC75_consensus_vsearch	1839	A	R	202	12	5.38%	2	2	93	93	2.0835870377678545E-4	1	1	120	82	9	3	G
G3_BC75_consensus_vsearch	1845	G	S	202	13	5.83%	2	1	93	93	1.0126524414330837E-4	1	1	126	76	0	13	C
G3_BC75_consensus_vsearch	1846	T	W	201	13	5.94%	2	1	93	93	1.0117417827629507E-4	1	1	126	75	0	13	A
G3_BC75_consensus_vsearch	1871	A	R	215	9	4%	2	1	93	93	0.0017995100038167202	1	1	121	94	9	0	G
G3_BC75_consensus_vsearch	1886	C	Y	216	7	3.14%	2	1	93	93	0.007447971960236055	1	1	128	88	0	7	T
G3_BC75_consensus_vsearch	1905	A	R	216	8	3.54%	2	1	93	93	0.003665668526289429	1	1	122	94	8	0	G
G3_BC75_consensus_vsearch	1914	G	K	215	8	3.56%	2	1	93	93	0.0036646057936482192	1	1	120	95	8	0	T
G3_BC75_consensus_vsearch	1929	A	R	205	9	4.11%	2	1	93	93	0.0017924949478988227	1	1	110	95	9	0	G
G3_BC75_consensus_vsearch	1931	G	R	211	8	3.62%	2	1	93	93	0.0036602593149509337	1	1	120	91	8	0	A
G3_BC75_consensus_vsearch	1940	C	Y	207	8	3.59%	2	1	93	93	0.003655753662936563	1	1	126	81	0	8	T
G3_BC75_consensus_vsearch	1941	C	Y	191	17	7.62%	2	1	93	93	5.427543998578852E-6	1	1	117	74	0	17	T
G3_BC75_consensus_vsearch	1957	A	R	183	7	3.61%	2	1	93	93	0.007385343252869138	1	1	103	80	7	0	G
G3_BC75_consensus_vsearch	1965	G	R	217	8	3.54%	2	1	93	93	0.0036667219549938834	1	1	122	95	8	0	A
G3_BC75_consensus_vsearch	1969	C	M	203	9	4.17%	2	1	93	93	0.0017910143883990014	1	1	112	91	9	0	A
G3_BC75_consensus_vsearch	1970	C	Y	178	8	3.56%	2	1	93	93	0.0036173981471315664	1	1	101	77	0	8	-GC
G3_BC75_consensus_vsearch	1982	A	R	212	10	4.44%	2	2	93	93	8.804765900705064E-4	1	1	120	92	8	2	G
G3_BC75_consensus_vsearch	2003	A	R	200	15	6.82%	2	2	93	93	2.3701643162627867E-5	1	1	113	87	13	2	G
G3_BC75_consensus_vsearch	2040	A	R	187	33	14.73%	2	1	93	93	3.1819642916895646E-11	1	1	95	92	33	0	G
G3_BC75_consensus_vsearch	2045	G	K	209	8	3.54%	2	1	93	93	0.003658026926953576	1	1	114	95	8	0	+T
G3_BC75_consensus_vsearch	2057	C	Y	209	12	5.33%	2	2	93	93	2.0943559915765036E-4	1	1	123	86	6	6	T
G3_BC75_consensus_vsearch	2081	C	Y	216	9	3.98%	2	1	93	93	0.0018001779733764346	1	1	131	85	0	9	T
G3_BC75_consensus_vsearch	2096	C	Y	216	7	3.11%	2	2	93	93	0.007447971960236055	1	1	127	89	1	6	T
G3_BC75_consensus_vsearch	2107	T	Y	206	12	5.36%	2	2	93	93	2.089820970245861E-4	1	1	124	82	1	11	C
G3_BC75_consensus_vsearch	2111	G	R	210	7	3.12%	2	1	93	93	0.007437988084800957	1	1	118	92	7	0	A
G3_BC75_consensus_vsearch	2112	C	Y	193	8	3.6%	2	2	93	93	0.003638595561901328	1	1	104	89	5	3	+A
G3_BC75_consensus_vsearch	2122	G	R	212	7	3.11%	2	1	93	93	0.00744137624879223	1	1	119	93	7	0	A
G3_BC75_consensus_vsearch	2124	C	Y	207	7	3.18%	2	1	93	93	0.007432788253078562	1	1	124	83	0	7	T
G3_BC75_consensus_vsearch	2126	G	R	189	28	12.61%	2	1	93	93	1.4689480604716706E-9	1	1	98	91	28	0	A
G3_BC75_consensus_vsearch	2131	A	R	215	8	3.54%	2	2	93	93	0.0036646057936482192	1	1	125	90	5	3	G
G3_BC75_consensus_vsearch	2233	C	Y	196	25	11.11%	2	1	93	93	1.4521229368552077E-8	1	1	131	65	0	25	T
G3_BC75_consensus_vsearch	2236	C	Y	189	9	4.02%	2	1	93	93	0.00177983409863699	1	1	119	70	0	9	T
G3_BC75_consensus_vsearch	2243	G	R	174	41	18.64%	2	1	93	93	5.5183988005791116E-14	1	1	88	86	41	0	A
G3_BC75_consensus_vsearch	2253	G	R	211	9	4.02%	2	1	93	93	0.0017967787753331713	1	1	117	94	9	0	A
G3_BC75_consensus_vsearch	2268	C	Y	198	12	5.41%	2	1	93	93	2.077128545125299E-4	1	1	129	69	0	12	T
G3_BC75_consensus_vsearch	2291	G	R	151	26	14.21%	2	2	93	93	5.535048527187511E-9	1	1	83	68	22	4	A
G3_BC75_consensus_vsearch	2292	G	R	201	15	6.88%	2	2	93	93	2.373037043728608E-5	1	1	124	77	2	13	A
G3_BC75_consensus_vsearch	2358	T	Y	210	8	3.59%	2	2	93	93	0.0036591481612605	1	1	128	82	2	6	C
G3_BC75_consensus_vsearch	2380	A	R	206	11	5%	2	2	93	93	4.288076047440095E-4	1	1	113	93	10	1	G
G3_BC75_consensus_vsearch	2388	G	S	214	10	4.42%	2	1	93	93	8.813089995913842E-4	1	1	119	95	10	0	C
G3_BC75_consensus_vsearch	2395	G	R	213	7	3.14%	2	1	93	93	0.007443047448823043	1	1	119	94	7	0	A
G3_BC75_consensus_vsearch	2398	A	R	216	9	3.98%	2	1	93	93	0.0018001779733764346	1	1	122	94	9	0	G
G3_BC75_consensus_vsearch	2400	G	R	196	24	10.76%	2	1	93	93	3.071396715362743E-8	1	1	103	93	24	0	A
G3_BC75_consensus_vsearch	2432	G	R	216	9	4%	2	1	93	93	0.0018001779733764346	1	1	121	95	9	0	A
G3_BC75_consensus_vsearch	2456	A	R	212	13	5.75%	2	1	93	93	1.0213418662308634E-4	1	1	117	95	13	0	G
G3_BC75_consensus_vsearch	2512	A	R	211	11	4.89%	2	2	93	93	4.300945555177922E-4	1	1	120	91	9	2	G
G3_BC75_consensus_vsearch	2513	C	Y	202	17	7.52%	2	1	93	93	5.524923410580334E-6	1	1	126	76	0	17	T
G3_BC75_consensus_vsearch	2516	A	R	210	9	4.02%	2	2	93	93	0.0017960807336148846	1	1	121	89	7	2	G
G3_BC75_consensus_vsearch	2524	G	R	120	96	43.44%	2	2	93	93	1.362175970116924E-35	1	1	68	52	58	38	A
G3_BC75_consensus_vsearch	2549	T	Y	206	14	6.22%	2	1	93	93	4.930621480362649E-5	1	1	131	75	0	14	C
G3_BC75_consensus_vsearch	2614	T	K	213	10	4.46%	2	1	93	93	8.808946039600796E-4	1	1	119	94	10	0	G
G3_BC75_consensus_vsearch	2616	A	R	210	9	3.98%	2	1	93	93	0.0017960807336148846	1	1	118	92	9	0	G
G3_BC75_consensus_vsearch	2632	A	R	210	7	3.14%	2	1	93	93	0.007437988084800957	1	1	119	91	7	0	G
G3_BC75_consensus_vsearch	2653	G	R	201	8	3.54%	2	1	93	93	0.003648677074969142	1	1	109	92	8	0	A
G3_BC75_consensus_vsearch	2653	G	K	201	8	3.54%	2	1	93	93	0.003648677074969142	1	1	109	92	8	0	A
G3_BC75_consensus_vsearch	2657	C	Y	214	9	4%	2	2	93	93	0.0017988361772468277	1	1	127	87	4	5	T
G3_BC75_consensus_vsearch	2661	T	W	208	7	3.18%	2	1	93	93	0.007434537497224064	1	1	117	91	7	0	A
G3_BC75_consensus_vsearch	2696	T	Y	204	8	3.56%	2	2	93	93	0.0036522646351654408	1	1	125	79	4	4	-C
G3_BC75_consensus_vsearch	2700	C	Y	217	7	3.12%	2	2	93	93	0.007449584424390529	1	1	129	88	1	6	T
G3_BC75_consensus_vsearch	2719	G	R	211	11	4.89%	2	1	93	93	4.300945555177922E-4	1	1	118	93	11	0	A
G3_BC75_consensus_vsearch	2730	G	S	213	7	3.11%	2	1	93	93	0.007443047448823043	1	1	118	95	7	0	C
G3_BC75_consensus_vsearch	2731	A	R	179	34	15.32%	2	1	93	93	1.3915174486747352E-11	1	1	85	94	34	0	G
G3_BC75_consensus_vsearch	2746	A	R	213	7	3.11%	2	2	93	93	0.007443047448823043	1	1	119	94	6	1	G
G3_BC75_consensus_vsearch	2774	G	R	202	19	8.52%	2	1	93	93	1.273549938699874E-6	1	1	111	91	19	0	A
G3_BC75_consensus_vsearch	2778	G	R	207	13	5.78%	2	2	93	93	1.0170895517465024E-4	1	1	115	92	12	1	A
G3_BC75_consensus_vsearch	2783	G	R	67	32	14.29%	2	2	93	93	1.1627054562438317E-11	1	1	63	4	19	13	+TA
G3_BC75_consensus_vsearch	2784	C	Y	138	68	30.22%	2	2	93	93	4.360539117412934E-24	1	1	51	87	63	5	T
G3_BC75_consensus_vsearch	2790	G	R	212	7	3.1%	2	1	93	93	0.00744137624879223	1	1	120	92	7	0	A
G3_BC75_consensus_vsearch	2792	A	R	154	7	3.18%	2	2	93	93	0.007309387540537701	1	1	107	47	5	2	-G
G3_BC75_consensus_vsearch	2797	C	Y	212	7	3.1%	2	2	93	93	0.00744137624879223	1	1	127	85	1	6	T
G3_BC75_consensus_vsearch	2799	T	Y	204	13	5.83%	2	2	93	93	1.0144502228683225E-4	1	1	124	80	2	11	C
G3_BC75_consensus_vsearch	2833	G	R	216	7	3.1%	2	1	93	93	0.007447971960236055	1	1	122	94	7	0	A
G3_BC75_consensus_vsearch	2834	C	Y	211	8	3.57%	2	2	93	93	0.0036602593149509337	1	1	123	88	3	5	T
G3_BC75_consensus_vsearch	2847	C	Y	207	9	4.07%	2	2	93	93	0.001793948723227531	1	1	117	90	7	2	T
G3_BC75_consensus_vsearch	2854	A	R	210	11	4.95%	2	1	93	93	4.298416344617859E-4	1	1	116	94	11	0	G
G3_BC75_consensus_vsearch	2872	C	Y	197	23	10.18%	2	1	93	93	6.501382894958495E-8	1	1	125	72	0	23	T
G3_BC75_consensus_vsearch	2875	G	R	200	16	7.24%	2	1	93	93	1.1438379994950568E-5	1	1	109	91	16	0	A
G3_BC75_consensus_vsearch	2891	C	Y	211	7	3.14%	2	1	93	93	0.007439689863414905	1	1	118	93	7	0	T
G3_BC75_consensus_vsearch	2892	A	R	192	13	5.88%	2	2	93	93	1.0031736438947346E-4	1	1	110	82	12	1	G
G3_BC75_consensus_vsearch	2911	G	R	193	19	8.92%	2	1	93	93	1.2509044651274263E-6	1	1	112	81	19	0	A
G3_BC75_consensus_vsearch	2945	A	R	206	8	3.64%	2	2	93	93	0.0036546013500883302	1	1	115	91	7	1	G
G3_BC75_consensus_vsearch	2954	G	R	206	9	4.07%	2	1	93	93	0.001793225137980622	1	1	118	88	9	0	A
G3_BC75_consensus_vsearch	2956	G	R	198	14	6.48%	2	2	93	93	4.8897660884513865E-5	1	1	112	86	13	1	A
G3_BC75_consensus_vsearch	2991	T	K	188	18	8.61%	2	2	93	93	2.5880431248781214E-6	1	1	103	85	17	1	G
G3_BC75_consensus_vsearch	2995	C	Y	187	14	6.25%	2	1	93	93	4.828732418008738E-5	1	1	118	69	0	14	T
G3_BC75_consensus_vsearch	2996	A	R	186	8	3.81%	2	2	93	93	0.0036291041675517713	1	1	121	65	2	6	G
G3_BC75_consensus_vsearch	2996	A	W	186	14	6.67%	2	1	93	93	4.822879642891894E-5	1	1	121	65	0	14	T
G3_BC75_consensus_vsearch	3011	C	Y	197	8	3.54%	2	1	93	93	0.003643733038795537	1	1	128	69	0	8	-T
G3_BC75_consensus_vsearch	3012	T	W	200	7	3.35%	2	1	93	93	0.007420075094973923	1	1	120	80	7	0	A
G3_BC75_consensus_vsearch	3024	C	Y	211	7	3.11%	2	2	93	93	0.007439689863414905	1	1	126	85	1	6	T
G3_BC75_consensus_vsearch	3031	C	Y	178	26	11.5%	2	2	93	93	6.3670555946337175E-9	1	1	105	73	19	7	T
G3_BC75_consensus_vsearch	3033	A	W	207	8	3.62%	2	1	93	93	0.003655753662936563	1	1	129	78	0	8	T
G3_BC75_consensus_vsearch	3060	G	R	170	21	9.81%	2	1	93	93	2.6665394471759025E-7	1	1	76	94	21	0	A
G3_BC75_consensus_vsearch	3063	C	Y	196	8	3.54%	2	2	93	93	0.0036424672415343016	1	1	108	88	4	4	-GAA
G3_BC75_consensus_vsearch	3075	G	R	176	46	20.54%	2	2	93	93	1.0524264735767039E-15	1	1	93	83	36	10	A
G3_BC75_consensus_vsearch	3086	C	M	207	8	3.64%	2	1	93	93	0.003655753662936563	1	1	116	91	8	0	A
G3_BC75_consensus_vsearch	3087	C	Y	198	20	8.89%	2	2	93	93	6.042413578071823E-7	1	1	114	84	10	10	T
G3_BC75_consensus_vsearch	3089	A	R	209	9	3.98%	2	2	93	93	0.0017953764342624938	1	1	115	94	8	1	G
G3_BC75_consensus_vsearch	3094	G	R	200	14	6.39%	2	1	93	93	4.9002433333818565E-5	1	1	113	87	14	0	A
G3_BC75_consensus_vsearch	3124	A	R	213	7	3.1%	2	2	93	93	0.007443047448823043	1	1	120	93	6	1	G
G3_BC75_consensus_vsearch	3142	C	Y	207	8	3.62%	2	2	93	93	0.003655753662936563	1	1	117	90	4	4	T
G3_BC75_consensus_vsearch	3147	T	Y	199	14	6.33%	2	2	93	93	4.8950273206615416E-5	1	1	119	80	1	13	C
G3_BC75_consensus_vsearch	3152	A	R	219	7	3.1%	2	2	93	93	0.007452766938834958	1	1	125	94	6	1	G
G3_BC75_consensus_vsearch	3157	C	Y	206	18	8%	2	2	93	93	2.6734324964115575E-6	1	1	126	80	3	15	T
G3_BC75_consensus_vsearch	3173	T	Y	214	7	3.15%	2	2	93	93	0.007444703667648697	1	1	124	90	3	4	C
G3_BC75_consensus_vsearch	3195	T	Y	213	8	3.57%	2	2	93	93	0.0036624519192641563	1	1	128	85	1	7	C
G3_BC75_consensus_vsearch	3200	G	R	219	7	3.1%	2	1	93	93	0.007452766938834958	1	1	124	95	7	0	A
G3_BC75_consensus_vsearch	3219	T	Y	206	17	7.52%	2	2	93	93	5.5582526785826E-6	1	1	128	78	1	16	C
G3_BC75_consensus_vsearch	3241	T	Y	216	7	3.14%	2	2	93	93	0.007447971960236055	1	1	129	87	1	6	C
G3_BC75_consensus_vsearch	3251	T	Y	209	9	4.02%	2	2	93	93	0.0017953764342624938	1	1	125	84	1	8	C
G3_BC75_consensus_vsearch	3255	G	R	213	8	3.56%	2	2	93	93	0.0036624519192641563	1	1	119	94	7	1	A
G3_BC75_consensus_vsearch	3257	C	Y	204	7	3.1%	2	2	93	93	0.007427442022474603	1	1	117	87	1	6	T
G3_BC75_consensus_vsearch	3258	G	S	209	9	4.04%	2	1	93	93	0.0017953764342624938	1	1	114	95	9	0	C
G3_BC75_consensus_vsearch	3273	G	R	189	33	14.73%	2	2	93	93	3.222422571316263E-11	1	1	98	91	32	1	A
G3_BC75_consensus_vsearch	3275	T	Y	208	11	4.98%	2	2	93	93	4.293291473235971E-4	1	1	124	84	1	10	C
G3_BC75_consensus_vsearch	3277	G	K	203	17	7.59%	2	1	93	93	5.533354906074952E-6	1	1	110	93	17	0	T
G3_BC75_consensus_vsearch	3321	C	Y	190	7	3.23%	2	1	93	93	0.007400362831181816	1	1	121	69	0	7	+T
G3_BC75_consensus_vsearch	3343	T	Y	179	9	4.13%	2	2	93	93	0.0017708558237889195	1	1	111	68	5	4	-A
G3_BC75_consensus_vsearch	3344	A	M	191	8	3.86%	2	2	93	93	0.0036359507017874977	1	1	124	67	1	7	C
G3_BC75_consensus_vsearch	3346	T	Y	205	9	4.19%	2	2	93	93	0.0017924949478988227	1	1	126	79	1	8	C
G3_BC75_consensus_vsearch	3367	T	Y	209	9	4.02%	2	1	93	93	0.0017953764342624938	1	1	130	79	0	9	C
G3_BC75_consensus_vsearch	3372	A	R	215	7	3.11%	2	1	93	93	0.007446345105805389	1	1	121	94	7	0	G
G3_BC75_consensus_vsearch	3376	A	W	202	13	5.8%	2	1	93	93	1.0126524414330837E-4	1	1	109	93	13	0	T
G3_BC75_consensus_vsearch	3407	T	Y	205	7	3.14%	2	1	93	93	0.0074292407456773525	1	1	130	75	0	7	C
G3_BC75_consensus_vsearch	3410	T	Y	208	7	3.11%	2	1	93	93	0.007434537497224064	1	1	131	77	0	7	-G
G3_BC75_consensus_vsearch	3420	A	R	192	28	12.39%	2	1	93	93	1.48899698039867E-9	1	1	98	94	28	0	G
G3_BC75_consensus_vsearch	3422	G	R	199	25	11.16%	2	1	93	93	1.4670068930690744E-8	1	1	104	95	25	0	A
G3_BC75_consensus_vsearch	3428	T	Y	213	7	3.15%	2	1	93	93	0.007443047448823043	1	1	129	84	0	7	C
G3_BC75_consensus_vsearch	3439	G	R	148	30	13.76%	2	1	93	93	2.452991043408916E-10	1	1	85	63	30	0	-C
G3_BC75_consensus_vsearch	3441	C	Y	152	70	31.39%	2	2	93	93	1.2912628060830365E-24	1	1	84	68	45	25	T
G3_BC75_consensus_vsearch	3442	C	Y	193	33	14.6%	2	2	93	93	3.302493573590362E-11	1	1	127	66	4	29	T
G3_BC75_consensus_vsearch	3464	A	R	212	9	3.98%	2	2	93	93	0.00179747064240055	1	1	121	91	7	2	G
G3_BC75_consensus_vsearch	3473	C	Y	196	8	3.57%	2	1	93	93	0.0036424672415343016	1	1	129	67	0	8	+TC
G3_BC75_consensus_vsearch	3475	T	Y	198	13	5.86%	2	2	93	93	1.0089614904466718E-4	1	1	127	71	2	11	C
G3_BC75_consensus_vsearch	3481	A	R	204	15	6.64%	2	2	93	93	2.3815125527116474E-5	1	1	113	91	14	1	G
G3_BC75_consensus_vsearch	3514	C	Y	206	15	6.64%	2	1	93	93	2.3870469071571428E-5	1	1	111	95	15	0	T
G3_BC75_consensus_vsearch	3515	A	R	186	27	12.05%	2	2	93	93	3.0927166428209853E-9	1	1	96	90	26	1	G
G3_BC75_consensus_vsearch	3542	G	R	217	7	3.11%	2	2	93	93	0.007449584424390529	1	1	124	93	6	1	A
G3_BC75_consensus_vsearch	3547	G	R	196	7	3.17%	2	2	93	93	0.007412420836520295	1	1	111	85	4	3	-C
G3_BC75_consensus_vsearch	3548	C	M	203	7	3.26%	2	1	93	93	0.007425626339083171	1	1	110	93	7	0	A
G3_BC75_consensus_vsearch	3549	C	Y	212	11	4.87%	2	2	93	93	4.303452996410444E-4	1	1	122	90	9	2	T
G3_BC75_consensus_vsearch	3550	C	Y	199	15	6.64%	2	2	93	93	2.3672673108116326E-5	1	1	117	82	13	2	T
G3_BC75_consensus_vsearch	3551	C	S	63	30	13.27%	2	2	93	93	5.6848427521193126E-11	1	1	60	3	10	20	+G
G3_BC75_consensus_vsearch	3558	C	Y	212	7	3.15%	2	1	93	93	0.00744137624879223	1	1	126	86	0	7	T
G3_BC75_consensus_vsearch	3561	G	R	213	10	4.42%	2	1	93	93	8.808946039600796E-4	1	1	120	93	10	0	A
G3_BC75_consensus_vsearch	3612	G	R	208	14	6.22%	2	2	93	93	4.9404108604884E-5	1	1	115	93	13	1	A
G3_BC75_consensus_vsearch	3654	T	Y	209	7	3.15%	2	1	93	93	0.007436270701269745	1	1	125	84	0	7	C
G3_BC75_consensus_vsearch	3709	T	K	205	7	3.27%	2	2	93	93	0.0074292407456773525	1	1	120	85	6	1	G
G3_BC75_consensus_vsearch	3711	A	R	156	12	5.61%	2	2	93	93	1.9920063431870148E-4	1	1	117	39	8	4	-G
G3_BC75_consensus_vsearch	3718	C	Y	208	8	3.56%	2	1	93	93	0.0036568954742723925	1	1	125	83	0	8	T
G3_BC75_consensus_vsearch	3735	C	Y	203	12	5.31%	2	1	93	93	2.0851661109317314E-4	1	1	128	75	0	12	T
G3_BC75_consensus_vsearch	3773	A	R	214	9	3.98%	2	1	93	93	0.0017988361772468277	1	1	121	93	9	0	G
G3_BC75_consensus_vsearch	3788	A	R	214	9	4%	2	1	93	93	0.0017988361772468277	1	1	122	92	9	0	G
G3_BC75_consensus_vsearch	3790	T	Y	204	11	5%	2	2	93	93	4.2827676494109035E-4	1	1	120	84	1	10	C
G3_BC75_consensus_vsearch	3794	A	R	213	9	4%	2	1	93	93	0.0017981564163397133	1	1	120	93	9	0	G
G3_BC75_consensus_vsearch	3795	C	Y	207	10	4.46%	2	1	93	93	8.783305527122537E-4	1	1	123	84	0	10	T
G3_BC75_consensus_vsearch	3835	T	Y	214	8	3.54%	2	1	93	93	0.003663533633296164	1	1	130	84	0	8	C
G3_BC75_consensus_vsearch	3843	C	S	195	19	8.6%	2	1	93	93	1.2560731117652181E-6	1	1	102	93	19	0	G
G3_BC75_consensus_vsearch	3887	G	R	190	7	3.43%	2	1	93	93	0.007400362831181816	1	1	105	85	7	0	A
G3_BC75_consensus_vsearch	3896	A	M	202	21	9.38%	2	1	93	93	2.9103621750809095E-7	1	1	129	73	0	21	C
G3_BC75_consensus_vsearch	3898	T	Y	201	21	9.42%	2	1	93	93	2.903578867014327E-7	1	1	130	71	0	21	C
G3_BC75_consensus_vsearch	3914	G	K	213	7	3.12%	2	1	93	93	0.007443047448823043	1	1	122	91	7	0	T
G3_BC75_consensus_vsearch	3941	T	Y	215	10	4.42%	2	1	93	93	8.817198236951184E-4	1	1	131	84	0	10	C
G3_BC75_consensus_vsearch	3945	A	W	137	80	35.87%	2	2	93	93	1.0308714188504014E-28	1	1	83	54	46	34	T
G3_BC75_consensus_vsearch	3951	G	R	186	37	16.52%	2	2	93	93	1.4276707624694763E-12	1	1	121	65	8	29	A
G3_BC75_consensus_vsearch	3952	T	Y	185	38	16.96%	2	2	93	93	6.492585863549596E-13	1	1	120	65	9	29	C
G3_BC75_consensus_vsearch	3978	C	Y	208	11	4.87%	2	2	93	93	4.293291473235971E-4	1	1	125	83	1	10	T
G3_BC75_consensus_vsearch	3987	T	W	190	11	5.34%	2	1	93	93	4.2427833042722946E-4	1	1	105	85	11	0	A
G3_BC75_consensus_vsearch	4009	A	R	210	11	4.89%	2	2	93	93	4.298416344617859E-4	1	1	124	86	7	4	G
G3_BC75_consensus_vsearch	4037	T	Y	208	8	3.59%	2	1	93	93	0.0036568954742723925	1	1	130	78	0	8	C
G3_BC75_consensus_vsearch	4041	C	Y	210	12	5.36%	2	1	93	93	2.0958418294317403E-4	1	1	129	81	0	12	T
G3_BC75_consensus_vsearch	4042	C	Y	199	18	7.96%	2	1	93	93	2.641658197446781E-6	1	1	129	70	0	18	T
G3_BC75_consensus_vsearch	4047	C	S	199	9	4.33%	2	1	93	93	0.0017879699024036485	1	1	109	90	9	0	G
G3_BC75_consensus_vsearch	4049	C	Y	167	53	23.56%	2	1	93	93	3.1350625712752208E-18	1	1	128	39	0	53	T
G3_BC75_consensus_vsearch	4079	C	Y	205	16	7.08%	2	2	93	93	1.1515964001761286E-5	1	1	125	80	2	14	T
G3_BC75_consensus_vsearch	4091	A	R	202	9	4.02%	2	2	93	93	0.0017902638323438202	1	1	118	84	8	1	-G
G3_BC75_consensus_vsearch	4123	T	Y	187	7	3.18%	2	2	93	93	0.007394057154213738	1	1	97	90	3	4	-G
G3_BC75_consensus_vsearch	4126	A	R	199	16	7.21%	2	1	93	93	1.1422478632590395E-5	1	1	105	94	16	0	G
G3_BC75_consensus_vsearch	4130	T	Y	204	13	5.8%	2	1	93	93	1.0144502228683225E-4	1	1	126	78	0	13	C
G3_BC75_consensus_vsearch	4171	G	R	201	19	8.48%	2	1	93	93	1.2711099418435063E-6	1	1	109	92	19	0	A
G3_BC75_consensus_vsearch	4173	A	R	197	23	10.22%	2	1	93	93	6.501382894958495E-8	1	1	108	89	23	0	G
G3_BC75_consensus_vsearch	4179	A	R	191	9	4.07%	2	1	93	93	0.0017815247172920585	1	1	98	93	9	0	-G
G3_BC75_consensus_vsearch	4232	A	R	208	7	3.11%	2	1	93	93	0.007434537497224064	1	1	125	83	0	7	G
G3_BC75_consensus_vsearch	4265	A	R	204	11	5%	2	2	93	93	4.2827676494109035E-4	1	1	112	92	9	2	G
G3_BC75_consensus_vsearch	4309	C	Y	216	9	3.98%	2	1	93	93	0.0018001779733764346	1	1	130	86	0	9	T
