Chrom	Position	Ref	Cons	Reads1	Reads2	VarFreq	Strands1	Strands2	Qual1	Qual2	Pvalue	MapQual1	MapQual2	Reads1Plus	Reads1Minus	Reads2Plus	Reads2Minus	VarAllele
C8_BC32.191219_FM1-2_consensus_vsearch	21	G	*/+T	3	13	72.22%	1	2	93	93	1.6120971772178452E-6	1	1	0	3	4	9	+T
C8_BC32.191219_FM1-2_consensus_vsearch	23	C	*/+T	3	13	72.22%	1	2	93	93	1.6120971772178452E-6	1	1	0	3	4	9	+T
C8_BC32.191219_FM1-2_consensus_vsearch	79	T	*/+G	12	12	44.44%	1	2	93	93	3.88145957231542E-5	1	1	0	12	6	6	+G
C8_BC32.191219_FM1-2_consensus_vsearch	104	C	*/-G	18	8	30.77%	2	2	93	93	0.002076007708047738	1	1	3	15	3	5	-G
C8_BC32.191219_FM1-2_consensus_vsearch	177	G	*/+C	1	5	17.86%	1	1	93	93	0.007575757575757551	1	1	0	1	0	5	+C
C8_BC32.191219_FM1-2_consensus_vsearch	177	G	*/+CA	1	15	53.57%	1	2	93	93	2.8282406617856754E-8	1	1	0	1	4	11	+CA
C8_BC32.191219_FM1-2_consensus_vsearch	214	A	*/+C	10	14	45.16%	1	2	93	93	4.0662909805207985E-6	1	1	0	10	7	7	+C
C8_BC32.191219_FM1-2_consensus_vsearch	222	T	*/-G	19	9	27.27%	2	2	93	93	9.116854288885203E-4	1	1	2	17	4	5	-G
C8_BC32.191219_FM1-2_consensus_vsearch	239	T	*/-C	6	19	57.58%	2	2	93	93	5.824519166139266E-9	1	1	1	5	3	16	-C
C8_BC32.191219_FM1-2_consensus_vsearch	239	T	*/-CC	6	8	24.24%	2	2	93	93	9.66183574879222E-4	1	1	1	5	2	6	-C
C8_BC32.191219_FM1-2_consensus_vsearch	248	T	*/-G	25	10	28.57%	2	1	93	93	4.627610344570926E-4	1	1	7	18	0	10	-G
C8_BC32.191219_FM1-2_consensus_vsearch	287	T	*/+G	21	14	37.84%	1	2	93	93	1.2004731173689027E-5	1	1	0	21	8	6	+G
C8_BC32.191219_FM1-2_consensus_vsearch	293	C	+A/+A	1	34	91.89%	1	2	93	93	3.208948607674984E-19	1	1	0	1	8	26	+A
C8_BC32.191219_FM1-2_consensus_vsearch	396	C	*/+G	2	22	59.46%	1	2	93	93	1.0078268239519597E-11	1	1	0	2	8	14	+G
C8_BC32.191219_FM1-2_consensus_vsearch	406	C	*/-T	28	8	21.62%	2	1	93	93	0.002528222798579596	1	1	9	19	0	8	-T
C8_BC32.191219_FM1-2_consensus_vsearch	411	C	*/+G	10	24	64.86%	2	2	93	93	8.720532671909143E-11	1	1	3	7	5	19	+G
C8_BC32.191219_FM1-2_consensus_vsearch	475	C	*/+G	10	20	55.56%	1	2	93	93	7.167492725073896E-9	1	1	0	10	7	13	+G
C8_BC32.191219_FM1-2_consensus_vsearch	595	T	+A/+A	3	32	86.49%	1	2	93	93	7.519636237318471E-17	1	1	0	3	8	24	+A
C8_BC32.191219_FM1-2_consensus_vsearch	625	C	*/-G	12	9	24.32%	2	2	93	93	6.591957811470039E-4	1	1	4	8	1	8	-G
C8_BC32.191219_FM1-2_consensus_vsearch	625	C	*/-GG	12	6	16.22%	2	2	93	93	0.009530791788856087	1	1	4	8	1	5	-G
C8_BC32.191219_FM1-2_consensus_vsearch	640	A	*/-T	24	7	18.92%	2	1	93	93	0.005346879981282025	1	1	8	16	0	7	-T
C8_BC32.191219_FM1-2_consensus_vsearch	667	C	*/-T	28	7	18.92%	2	1	93	93	0.005609494334348063	1	1	9	19	0	7	-T
C8_BC32.191219_FM1-2_consensus_vsearch	691	C	+T/+T	7	29	78.38%	1	2	93	93	7.282079278440404E-14	1	1	0	7	9	20	+T
C8_BC32.191219_FM1-2_consensus_vsearch	702	A	*/-G	27	9	24.32%	2	1	93	93	0.0011060974743786064	1	1	8	19	0	9	-G
C8_BC32.191219_FM1-2_consensus_vsearch	833	T	*/+G	8	23	62.16%	2	2	93	93	1.321873658312735E-10	1	1	4	4	4	19	+G
C8_BC32.191219_FM1-2_consensus_vsearch	922	C	*/-G	25	10	27.03%	2	1	93	93	4.627610344570926E-4	1	1	8	17	0	10	-G
C8_BC32.191219_FM1-2_consensus_vsearch	1066	G	*/-TG	26	10	27.78%	2	1	93	93	4.740417747336426E-4	1	1	9	17	0	10	-TG
C8_BC32.191219_FM1-2_consensus_vsearch	1111	C	*/-G	13	18	48.65%	2	2	93	93	1.1154354063068815E-7	1	1	3	10	6	12	-G
C8_BC32.191219_FM1-2_consensus_vsearch	1122	T	*/+C	16	13	36.11%	2	2	93	93	2.150599300338356E-5	1	1	3	13	5	8	+C
C8_BC32.191219_FM1-2_consensus_vsearch	1162	C	*/-G	26	8	21.62%	2	2	93	93	0.002456193182887606	1	1	8	18	1	7	-G
C8_BC32.191219_FM1-2_consensus_vsearch	1270	C	*/-GC	26	9	25%	2	2	93	93	0.0010857085808416032	1	1	6	20	3	6	-GC
C8_BC32.191219_FM1-2_consensus_vsearch	1356	C	*/-T	23	10	27.03%	2	1	93	93	4.387183574385003E-4	1	1	8	15	0	10	-T
C8_BC32.191219_FM1-2_consensus_vsearch	1381	T	*/-G	24	12	33.33%	2	1	93	93	8.14720131086417E-5	1	1	8	16	0	12	-G
C8_BC32.191219_FM1-2_consensus_vsearch	1425	T	*/-C	25	7	20.59%	2	2	93	93	0.005418171714365526	1	1	3	22	4	3	-C
C8_BC32.191219_FM1-2_consensus_vsearch	1511	C	*/-G	14	18	50%	2	2	93	93	1.3089293033191935E-7	1	1	2	12	5	13	-G
C8_BC32.191219_FM1-2_consensus_vsearch	1613	T	*/+A	6	20	60.61%	2	2	93	93	1.8273001305535603E-9	1	1	4	2	5	15	+A
C8_BC32.191219_FM1-2_consensus_vsearch	1616	G	*/+T	17	16	44.44%	2	1	93	93	1.3640109436850739E-6	1	1	7	10	0	16	+T
C8_BC32.191219_FM1-2_consensus_vsearch	1618	C	*/-T	23	13	36.11%	2	1	93	93	3.258880524345711E-5	1	1	9	14	0	13	-T
C8_BC32.191219_FM1-2_consensus_vsearch	1655	T	*/+G	7	26	72.22%	2	2	93	93	2.5824149612947483E-12	1	1	3	4	5	21	+G
C8_BC32.191219_FM1-2_consensus_vsearch	1657	G	*/+C	22	10	27.78%	2	2	93	93	4.2589866517567145E-4	1	1	3	19	3	7	+C
C8_BC32.191219_FM1-2_consensus_vsearch	1658	C	*/+TC	24	7	19.44%	2	1	93	93	0.005346879981282025	1	1	9	15	0	7	+TC
C8_BC32.191219_FM1-2_consensus_vsearch	1677	C	*/-T	29	7	19.44%	2	1	93	93	0.005666706272678213	1	1	9	20	0	7	-T
C8_BC32.191219_FM1-2_consensus_vsearch	1717	A	*/+C	7	23	63.89%	1	2	93	93	8.705456751101868E-11	1	1	0	7	8	15	+C
C8_BC32.191219_FM1-2_consensus_vsearch	1865	T	*/-C	24	11	29.73%	2	2	93	93	1.928170976904528E-4	1	1	4	20	5	6	-C
C8_BC32.191219_FM1-2_consensus_vsearch	1915	G	*/-TG	29	7	18.92%	2	2	93	93	0.005666706272678213	1	1	5	24	3	4	-TG
C8_BC32.191219_FM1-2_consensus_vsearch	2020	G	*/+C	20	12	32.43%	2	2	93	93	6.875093756504348E-5	1	1	2	18	7	5	+C
C8_BC32.191219_FM1-2_consensus_vsearch	2084	G	*/+TGG	14	23	62.16%	2	2	93	93	7.403261825337397E-10	1	1	2	12	7	16	+TGG
C8_BC32.191219_FM1-2_consensus_vsearch	2096	C	*/+G	22	11	29.73%	2	1	93	93	1.801878968050816E-4	1	1	8	14	0	11	+G
C8_BC32.191219_FM1-2_consensus_vsearch	2383	T	*/-C	22	11	29.73%	2	2	93	93	1.801878968050816E-4	1	1	4	18	5	6	-C
C8_BC32.191219_FM1-2_consensus_vsearch	2441	C	*/-G	22	7	22.58%	2	2	93	93	0.00519093617405469	1	1	7	15	2	5	-G
C8_BC32.191219_FM1-2_consensus_vsearch	2442	G	*/+C	11	15	50%	1	2	93	93	1.7240576731772838E-6	1	1	0	11	6	9	+C
C8_BC32.191219_FM1-2_consensus_vsearch	2495	C	*/-T	28	9	24.32%	2	1	93	93	0.0011255786432032276	1	1	9	19	0	9	-T
C8_BC32.191219_FM1-2_consensus_vsearch	2561	T	*/-C	30	7	18.92%	2	1	93	93	0.005721044552005416	1	1	9	21	0	7	-C
C8_BC32.191219_FM1-2_consensus_vsearch	2578	G	*/+C	26	10	27.03%	2	1	93	93	4.740417747336426E-4	1	1	9	17	0	10	+C
C8_BC32.191219_FM1-2_consensus_vsearch	2580	T	*/-C	26	10	27.78%	2	1	93	93	4.740417747336426E-4	1	1	9	17	0	10	-C
C8_BC32.191219_FM1-2_consensus_vsearch	2700	T	*/+G	17	15	40.54%	2	2	93	93	3.5464284535815083E-6	1	1	4	13	4	11	+G
C8_BC32.191219_FM1-2_consensus_vsearch	2734	A	*/-G	24	11	29.73%	2	2	93	93	1.928170976904528E-4	1	1	4	20	5	6	-G
C8_BC32.191219_FM1-2_consensus_vsearch	2829	A	*/-G	22	8	24.24%	1	2	93	93	0.002287531195345912	1	1	0	22	5	3	-G
C8_BC32.191219_FM1-2_consensus_vsearch	2843	T	-C/-C	9	27	75%	2	2	93	93	2.0025718015712448E-12	1	1	1	8	8	19	-C
C8_BC32.191219_FM1-2_consensus_vsearch	2917	C	-T/-T	4	30	81.08%	2	2	93	93	2.59427450187488E-15	1	1	2	2	7	23	-T
C8_BC32.191219_FM1-2_consensus_vsearch	2919	T	*/-C	19	13	37.14%	2	2	93	93	2.6442668294248142E-5	1	1	5	14	2	11	-C
C8_BC32.191219_FM1-2_consensus_vsearch	3001	A	-C/-C	6	30	83.33%	2	2	93	93	1.1854547662577936E-14	1	1	1	5	7	23	-C
C8_BC32.191219_FM1-2_consensus_vsearch	3006	C	*/+T	15	21	56.76%	1	2	93	93	7.205841509994935E-9	1	1	0	15	8	13	+T
C8_BC32.191219_FM1-2_consensus_vsearch	3042	A	*/-G	14	10	28.57%	2	2	93	93	2.9985341531182507E-4	1	1	2	12	4	6	-G
C8_BC32.191219_FM1-2_consensus_vsearch	3082	T	*/-G	27	7	19.44%	2	1	93	93	0.005549177190968586	1	1	8	19	0	7	-G
C8_BC32.191219_FM1-2_consensus_vsearch	3186	A	*/-C	29	7	18.92%	2	1	93	93	0.005666706272678213	1	1	8	21	0	7	-C
C8_BC32.191219_FM1-2_consensus_vsearch	3189	C	*/-G	19	11	29.73%	2	2	93	93	1.5940262628202147E-4	1	1	7	12	2	9	-G
C8_BC32.191219_FM1-2_consensus_vsearch	3194	A	*/+T	2	12	34.29%	1	2	93	93	2.9912804175827393E-6	1	1	0	2	5	7	+T
C8_BC32.191219_FM1-2_consensus_vsearch	3195	A	*/-T	20	12	34.29%	2	2	93	93	6.875093756504348E-5	1	1	3	17	5	7	-T
C8_BC32.191219_FM1-2_consensus_vsearch	3245	T	*/+C	16	12	32.43%	2	2	93	93	5.448184894190479E-5	1	1	1	15	8	4	+C
C8_BC32.191219_FM1-2_consensus_vsearch	3344	T	*/-A	26	7	19.44%	2	1	93	93	0.005485498108449143	1	1	8	18	0	7	-A
C8_BC32.191219_FM1-2_consensus_vsearch	3416	T	*/-G	25	12	32.43%	2	1	93	93	8.441839824024235E-5	1	1	9	16	0	12	-G
C8_BC32.191219_FM1-2_consensus_vsearch	3488	T	*/-C	29	7	19.44%	2	1	93	93	0.005666706272678213	1	1	9	20	0	7	-C
C8_BC32.191219_FM1-2_consensus_vsearch	3558	T	*/-GT	23	10	29.41%	2	1	93	93	4.387183574385003E-4	1	1	9	14	0	10	-GT
C8_BC32.191219_FM1-2_consensus_vsearch	3625	T	*/+C	19	13	36.11%	1	2	93	93	2.6442668294248142E-5	1	1	0	19	6	7	+C
C8_BC32.191219_FM1-2_consensus_vsearch	3629	C	*/+T	28	9	24.32%	2	2	93	93	0.0011255786432032276	1	1	8	20	1	8	+T
C8_BC32.191219_FM1-2_consensus_vsearch	3630	C	*/+T	9	26	70.27%	2	2	93	93	6.319226573846743E-12	1	1	1	8	8	18	+T
C8_BC32.191219_FM1-2_consensus_vsearch	3631	C	*/+T	4	22	59.46%	1	2	93	93	5.52610926578708E-11	1	1	0	4	8	14	+T
C8_BC32.191219_FM1-2_consensus_vsearch	3632	C	*/-G	29	8	21.62%	2	2	93	93	0.0025616617397038444	1	1	8	21	1	7	-G
C8_BC32.191219_FM1-2_consensus_vsearch	3663	T	*/+G	1	14	41.18%	1	2	93	93	1.0314760060630275E-7	1	1	0	1	3	11	+G
C8_BC32.191219_FM1-2_consensus_vsearch	3663	T	*/+GG	1	15	44.12%	1	2	93	93	2.8282406617856754E-8	1	1	0	1	6	9	+GG
C8_BC32.191219_FM1-2_consensus_vsearch	3692	C	*/-G	8	23	63.89%	1	2	93	93	1.321873658312735E-10	1	1	0	8	9	14	-G
C8_BC32.191219_FM1-2_consensus_vsearch	3711	T	*/+AGT	13	19	52.78%	2	2	93	93	3.983697879667458E-8	1	1	4	9	3	16	+AGT
C8_BC32.191219_FM1-2_consensus_vsearch	3735	A	*/+T	6	22	59.46%	2	2	93	93	1.7583454086459297E-10	1	1	1	5	8	14	+T
C8_BC32.191219_FM1-2_consensus_vsearch	3741	C	*/-T	10	16	55.17%	1	2	93	93	5.125576866202848E-7	1	1	0	10	9	7	-T
C8_BC32.191219_FM1-2_consensus_vsearch	3760	T	*/+G	29	7	19.44%	2	2	93	93	0.005666706272678213	1	1	7	22	2	5	+G
C8_BC32.191219_FM1-2_consensus_vsearch	3806	G	*/-C	28	8	21.62%	2	1	93	93	0.002528222798579596	1	1	8	20	0	8	-C
C8_BC32.191219_FM1-2_consensus_vsearch	3808	C	*/-G	10	25	69.44%	1	2	93	93	2.843651958231016E-11	1	1	0	10	8	17	-G
C8_BC32.191219_FM1-2_consensus_vsearch	3812	T	*/+C	9	27	72.97%	2	2	93	93	2.0025718015712448E-12	1	1	4	5	4	23	+C
C8_BC32.191219_FM1-2_consensus_vsearch	3818	C	*/-G	26	8	21.62%	2	2	93	93	0.002456193182887606	1	1	6	20	2	6	-G
C8_BC32.191219_FM1-2_consensus_vsearch	3830	T	*/-C	22	9	26.47%	2	2	93	93	9.937635520765498E-4	1	1	7	15	2	7	-C
C8_BC32.191219_FM1-2_consensus_vsearch	3842	T	*/+G	5	22	64.71%	2	2	93	93	1.0343208286151812E-10	1	1	1	4	6	16	+G
C8_BC32.191219_FM1-2_consensus_vsearch	3847	G	*/+C	27	7	18.92%	2	1	93	93	0.005549177190968586	1	1	9	18	0	7	+C
C8_BC32.191219_FM1-2_consensus_vsearch	3849	T	*/-C	27	7	20%	2	1	93	93	0.005549177190968586	1	1	8	19	0	7	-C
C8_BC32.191219_FM1-2_consensus_vsearch	3958	A	*/+CGA	9	19	52.78%	1	2	93	93	1.6264695029975115E-8	1	1	0	9	5	14	+CGA
C8_BC32.191219_FM1-2_consensus_vsearch	4048	C	*/-G	20	14	37.84%	2	2	93	93	1.1295360695244261E-5	1	1	5	15	4	10	-G
C8_BC32.191219_FM1-2_consensus_vsearch	4051	T	+C/+C	9	28	75.68%	2	2	93	93	6.309472799470945E-13	1	1	2	7	7	21	+C
C8_BC32.191219_FM1-2_consensus_vsearch	4073	G	*/+A	10	24	64.86%	2	2	93	93	8.720532671909143E-11	1	1	1	9	7	17	+A
C8_BC32.191219_FM1-2_consensus_vsearch	4093	G	*/-C	25	10	27.78%	2	2	93	93	4.627610344570926E-4	1	1	7	18	2	8	-C
C8_BC32.191219_FM1-2_consensus_vsearch	4095	C	*/+T	16	18	48.65%	2	2	93	93	1.7304616449736725E-7	1	1	2	14	7	11	+T
C8_BC32.191219_FM1-2_consensus_vsearch	4203	C	+GG/+GG	4	28	77.78%	2	2	93	93	3.214243372877389E-14	1	1	1	3	6	22	+GG
C8_BC32.191219_FM1-2_consensus_vsearch	4208	A	+G/+G	5	27	75%	2	2	93	93	2.3785400959295006E-13	1	1	2	3	4	23	+G
C8_BC32.191219_FM1-2_consensus_vsearch	4211	G	*/+T	8	23	67.65%	1	2	93	93	1.321873658312735E-10	1	1	0	8	7	16	+T
C8_BC32.191219_FM1-2_consensus_vsearch	4217	T	*/+G	12	18	51.43%	2	2	93	93	9.350320054982027E-8	1	1	3	9	4	14	+G
C8_BC32.191219_FM1-2_consensus_vsearch	4248	A	*/+T	27	7	20%	2	1	93	93	0.005549177190968586	1	1	8	19	0	7	+T
C8_BC32.191219_FM1-2_consensus_vsearch	4267	C	*/-G	23	9	28.12%	2	2	93	93	0.0010184533297679728	1	1	5	18	3	6	-G
C8_BC32.191219_FM1-2_consensus_vsearch	4290	A	*/+G	5	23	67.65%	2	2	93	93	3.102962485845742E-11	1	1	1	4	4	19	+G
C8_BC32.191219_FM1-2_consensus_vsearch	4317	T	*/+C	12	21	61.76%	1	2	93	93	3.98369787966727E-9	1	1	0	12	7	14	+C
C8_BC32.191219_FM1-2_consensus_vsearch	4370	C	*/+G	7	25	73.53%	1	2	93	93	8.392848624208075E-12	1	1	0	7	7	18	+G
C8_BC32.191219_FM1-2_consensus_vsearch	4375	A	*/-G	14	15	45.45%	2	2	93	93	2.6067870307129658E-6	1	1	1	13	4	11	-G
