Chrom	Position	Ref	Cons	Reads1	Reads2	VarFreq	Strands1	Strands2	Qual1	Qual2	Pvalue	MapQual1	MapQual2	Reads1Plus	Reads1Minus	Reads2Plus	Reads2Minus	VarAllele
E7_BC55.191219_FM1-2_consensus_vsearch	12	C	*/+T	403	7	1.67%	2	2	93	93	0.007613403934674614	1	1	260	143	3	4	+T
E7_BC55.191219_FM1-2_consensus_vsearch	19	C	*/+A	360	25	5.61%	2	2	93	93	1.9927477920972333E-8	1	1	185	175	24	1	+A
E7_BC55.191219_FM1-2_consensus_vsearch	19	C	*/-A	360	45	10.09%	2	2	93	93	7.792425413290809E-15	1	1	185	175	44	1	-A
E7_BC55.191219_FM1-2_consensus_vsearch	22	A	*/-G	427	12	2.68%	2	1	93	93	2.2623486621516718E-4	1	1	248	179	12	0	-G
E7_BC55.191219_FM1-2_consensus_vsearch	26	T	*/-A	421	9	2.01%	2	2	93	93	0.0018722700711233777	1	1	260	161	3	6	-A
E7_BC55.191219_FM1-2_consensus_vsearch	26	T	*/-AA	421	12	2.68%	2	1	93	93	2.259929805737435E-4	1	1	260	161	0	12	-AA
E7_BC55.191219_FM1-2_consensus_vsearch	38	G	*/+T	431	8	1.79%	2	1	93	93	0.003782601599602771	1	1	263	168	0	8	+T
E7_BC55.191219_FM1-2_consensus_vsearch	40	C	*/-T	434	8	1.78%	2	2	93	93	0.0037834345948323136	1	1	264	170	1	7	-T
E7_BC55.191219_FM1-2_consensus_vsearch	41	T	*/-A	400	28	6.35%	2	2	93	93	2.360361847758479E-9	1	1	251	149	11	17	-A
E7_BC55.191219_FM1-2_consensus_vsearch	43	A	*/-G	423	17	3.78%	2	1	93	93	6.517562209625466E-6	1	1	263	160	0	17	-G
E7_BC55.191219_FM1-2_consensus_vsearch	44	G	*/-T	417	8	1.85%	2	2	93	93	0.003778560011928581	1	1	259	158	2	6	-T
E7_BC55.191219_FM1-2_consensus_vsearch	45	T	*/-GT	424	7	1.58%	2	1	93	93	0.007623059056742502	1	1	261	163	0	7	-GT
E7_BC55.191219_FM1-2_consensus_vsearch	47	T	*/+A	408	11	2.48%	2	2	93	93	4.5688172943049915E-4	1	1	254	154	2	9	+A
E7_BC55.191219_FM1-2_consensus_vsearch	47	T	*/-A	408	12	2.71%	2	2	93	93	2.2544581166138029E-4	1	1	254	154	5	7	-A
E7_BC55.191219_FM1-2_consensus_vsearch	51	C	*/-A	432	11	2.44%	2	2	93	93	4.5854977422456113E-4	1	1	258	174	5	6	-A
E7_BC55.191219_FM1-2_consensus_vsearch	71	C	*/+A	401	20	4.47%	2	1	93	93	7.56950332781708E-7	1	1	236	165	20	0	+A
E7_BC55.191219_FM1-2_consensus_vsearch	72	G	*/-A	415	19	4.28%	2	1	93	93	1.5595595089671119E-6	1	1	240	175	19	0	-A
E7_BC55.191219_FM1-2_consensus_vsearch	77	G	*/+C	434	11	2.44%	2	1	93	93	4.5868081601559884E-4	1	1	263	171	0	11	+C
E7_BC55.191219_FM1-2_consensus_vsearch	79	T	*/-C	429	10	2.23%	2	1	93	93	9.272509747675099E-4	1	1	263	166	0	10	-C
E7_BC55.191219_FM1-2_consensus_vsearch	87	T	*/+C	433	7	1.56%	2	1	93	93	0.0076269161468125015	1	1	255	178	7	0	+C
E7_BC55.191219_FM1-2_consensus_vsearch	96	G	*/-T	434	8	1.79%	2	2	93	93	0.0037834345948323136	1	1	256	178	7	1	-T
E7_BC55.191219_FM1-2_consensus_vsearch	99	T	*/-A	437	7	1.55%	2	2	93	93	0.007628580447648388	1	1	258	179	6	1	-A
E7_BC55.191219_FM1-2_consensus_vsearch	100	A	*/-T	421	8	1.81%	2	2	93	93	0.0037797414596765903	1	1	248	173	5	3	-T
E7_BC55.191219_FM1-2_consensus_vsearch	106	T	*/-GAT	427	20	4.44%	2	2	93	93	7.67422341324127E-7	1	1	246	181	19	1	-GAT
E7_BC55.191219_FM1-2_consensus_vsearch	112	C	*/+T	396	11	2.44%	2	2	93	93	4.5597552073400974E-4	1	1	265	131	1	10	+T
E7_BC55.191219_FM1-2_consensus_vsearch	112	C	*/-T	396	40	8.87%	2	1	93	93	3.5623861235075985E-13	1	1	265	131	0	40	-T
E7_BC55.191219_FM1-2_consensus_vsearch	116	C	*/-T	422	7	1.57%	2	2	93	93	0.007622180052576428	1	1	247	175	5	2	-T
E7_BC55.191219_FM1-2_consensus_vsearch	116	C	*/-TA	422	9	2.01%	2	2	93	93	0.0018724555760242295	1	1	247	175	8	1	-TA
E7_BC55.191219_FM1-2_consensus_vsearch	121	T	*/-G	434	7	1.56%	2	2	93	93	0.007627335039353406	1	1	259	175	4	3	-G
E7_BC55.191219_FM1-2_consensus_vsearch	138	T	*/-C	416	17	3.78%	2	1	93	93	6.500663914761803E-6	1	1	261	155	0	17	-C
E7_BC55.191219_FM1-2_consensus_vsearch	140	T	*/+A	423	11	2.47%	2	1	93	93	4.5794544103178105E-4	1	1	249	174	11	0	+A
E7_BC55.191219_FM1-2_consensus_vsearch	142	G	*/+A	417	7	1.56%	2	1	93	93	0.007619946437356769	1	1	239	178	7	0	+A
E7_BC55.191219_FM1-2_consensus_vsearch	142	G	*/-A	417	20	4.46%	2	1	93	93	7.63528734201053E-7	1	1	239	178	20	0	-A
E7_BC55.191219_FM1-2_consensus_vsearch	143	A	*/-G	415	7	1.63%	2	2	93	93	0.007619038242851565	1	1	237	178	6	1	-G
E7_BC55.191219_FM1-2_consensus_vsearch	156	C	*/+T	426	8	1.78%	2	1	93	93	0.0037811878789100195	1	1	261	165	0	8	+T
E7_BC55.191219_FM1-2_consensus_vsearch	156	C	*/-T	426	7	1.56%	2	1	93	93	0.007623929979105209	1	1	261	165	0	7	+T
E7_BC55.191219_FM1-2_consensus_vsearch	163	G	*/-C	432	8	1.78%	2	2	93	93	0.0037828805172695963	1	1	250	182	7	1	-C
E7_BC55.191219_FM1-2_consensus_vsearch	177	G	*/-TG	433	9	2%	2	2	93	93	0.001874441340367089	1	1	263	170	1	8	-TG
E7_BC55.191219_FM1-2_consensus_vsearch	181	A	*/+T	429	7	1.56%	2	2	93	93	0.007625221451403564	1	1	254	175	5	2	+T
E7_BC55.191219_FM1-2_consensus_vsearch	181	A	*/-T	429	8	1.78%	2	2	93	93	0.0037820399638697363	1	1	254	175	4	4	-T
E7_BC55.191219_FM1-2_consensus_vsearch	187	T	*/+G	428	9	2.01%	2	1	93	93	0.0018735509751739627	1	1	249	179	9	0	+G
E7_BC55.191219_FM1-2_consensus_vsearch	188	A	*/-G	433	12	2.68%	2	2	93	93	2.2647039152581312E-4	1	1	254	179	11	1	-G
E7_BC55.191219_FM1-2_consensus_vsearch	191	T	*/+A	315	7	1.56%	2	2	93	93	0.007559335514723115	1	1	232	83	6	1	+A
E7_BC55.191219_FM1-2_consensus_vsearch	191	T	*/-A	315	124	27.56%	2	2	93	93	1.8318904024689903E-42	1	1	232	83	29	95	-A
E7_BC55.191219_FM1-2_consensus_vsearch	195	A	*/+CC	411	35	7.76%	2	2	93	93	1.4538571216780888E-11	1	1	256	155	7	28	+CC
E7_BC55.191219_FM1-2_consensus_vsearch	197	A	*/+T	375	44	9.76%	2	2	93	93	1.727083829837631E-14	1	1	229	146	12	32	+T
E7_BC55.191219_FM1-2_consensus_vsearch	198	C	*/+AATG	382	12	2.67%	2	1	93	93	2.2424619755304767E-4	1	1	237	145	12	0	+AATG
E7_BC55.191219_FM1-2_consensus_vsearch	199	C	*/+A	98	289	64.08%	2	2	93	93	1.5838812386778346E-127	1	1	47	51	160	129	+A
E7_BC55.191219_FM1-2_consensus_vsearch	199	C	*/+AAT	98	18	3.99%	2	1	93	93	1.8678457231036494E-6	1	1	47	51	18	0	+A
E7_BC55.191219_FM1-2_consensus_vsearch	199	C	*/+AATGC	98	32	7.1%	2	1	93	93	2.6382931296267964E-11	1	1	47	51	32	0	+AATGC
E7_BC55.191219_FM1-2_consensus_vsearch	200	A	*/+CG	81	17	3.77%	2	1	93	93	3.5725678602860195E-6	1	1	70	11	17	0	+CG
E7_BC55.191219_FM1-2_consensus_vsearch	200	A	*/+TGCG	81	281	62.31%	2	2	93	93	6.1584870219556014E-127	1	1	70	11	156	125	+TGCG
E7_BC55.191219_FM1-2_consensus_vsearch	201	G	*/+T	413	18	3.98%	2	1	93	93	3.1825288676449396E-6	1	1	242	171	18	0	+T
E7_BC55.191219_FM1-2_consensus_vsearch	208	G	*/+C	430	8	1.77%	2	2	93	93	0.0037823214180042796	1	1	260	170	1	7	+C
E7_BC55.191219_FM1-2_consensus_vsearch	210	T	*/-C	433	8	1.79%	2	1	93	93	0.003783158179516694	1	1	267	166	0	8	-C
E7_BC55.191219_FM1-2_consensus_vsearch	215	G	*/+A	426	7	1.58%	2	1	93	93	0.007623929979105209	1	1	251	175	7	0	+A
E7_BC55.191219_FM1-2_consensus_vsearch	226	A	*/-TAA	418	26	5.78%	2	2	93	93	1.0222311992636743E-8	1	1	239	179	23	3	-TAA
E7_BC55.191219_FM1-2_consensus_vsearch	227	T	*/-A	408	8	1.89%	2	2	93	93	0.0037758193480112623	1	1	232	176	6	2	-A
E7_BC55.191219_FM1-2_consensus_vsearch	229	A	*/+T	396	8	1.89%	2	1	93	93	0.0037719767465882576	1	1	225	171	0	8	+T
E7_BC55.191219_FM1-2_consensus_vsearch	230	C	*/-T	426	10	2.22%	2	2	93	93	9.269167954843176E-4	1	1	251	175	3	7	-T
E7_BC55.191219_FM1-2_consensus_vsearch	232	T	*/-C	412	20	4.49%	2	2	93	93	7.615205227908607E-7	1	1	242	170	13	7	-C
E7_BC55.191219_FM1-2_consensus_vsearch	235	C	*/+G	374	11	2.44%	2	2	93	93	4.541707543665027E-4	1	1	256	118	2	9	+G
E7_BC55.191219_FM1-2_consensus_vsearch	235	C	*/+T	374	16	3.55%	2	1	93	93	1.3042061767525985E-5	1	1	256	118	0	16	+T
E7_BC55.191219_FM1-2_consensus_vsearch	236	G	*/-A	438	7	1.56%	2	1	93	93	0.007628991869306366	1	1	256	182	7	0	-A
E7_BC55.191219_FM1-2_consensus_vsearch	248	C	*/-T	426	14	3.1%	2	2	93	93	5.495010686777893E-5	1	1	261	165	2	12	-T
E7_BC55.191219_FM1-2_consensus_vsearch	252	C	*/-GC	432	7	1.56%	2	2	93	93	0.0076264953547406375	1	1	258	174	6	1	-GC
E7_BC55.191219_FM1-2_consensus_vsearch	259	G	*/-A	426	24	5.31%	2	1	93	93	4.3502009152175485E-8	1	1	243	183	24	0	-A
E7_BC55.191219_FM1-2_consensus_vsearch	263	C	*/-T	435	11	2.43%	2	2	93	93	4.587459048221758E-4	1	1	262	173	3	8	-T
E7_BC55.191219_FM1-2_consensus_vsearch	268	T	*/+C	439	10	2.21%	2	1	93	93	9.283331329900578E-4	1	1	266	173	0	10	+C
E7_BC55.191219_FM1-2_consensus_vsearch	269	T	*/-C	430	7	1.55%	2	2	93	93	0.007625648020175149	1	1	260	170	3	4	-C
E7_BC55.191219_FM1-2_consensus_vsearch	270	C	*/-A	430	7	1.57%	2	2	93	93	0.007625648020175149	1	1	259	171	4	3	-A
E7_BC55.191219_FM1-2_consensus_vsearch	277	C	*/-T	439	8	1.78%	2	2	93	93	0.003784798257927548	1	1	262	177	2	6	-T
E7_BC55.191219_FM1-2_consensus_vsearch	279	G	*/-C	407	31	6.9%	2	2	93	93	2.686391344617984E-10	1	1	227	180	30	1	-C
E7_BC55.191219_FM1-2_consensus_vsearch	309	C	*/-T	434	8	1.78%	2	2	93	93	0.0037834345948323136	1	1	255	179	5	3	-T
E7_BC55.191219_FM1-2_consensus_vsearch	310	T	*/-A	430	7	1.58%	2	2	93	93	0.007625648020175149	1	1	251	179	6	1	-A
E7_BC55.191219_FM1-2_consensus_vsearch	311	A	*/-C	425	10	2.26%	2	2	93	93	9.268043937944601E-4	1	1	248	177	7	3	-C
E7_BC55.191219_FM1-2_consensus_vsearch	313	C	*/-A	379	8	1.78%	2	2	93	93	0.0037661286454389806	1	1	259	120	5	3	-A
E7_BC55.191219_FM1-2_consensus_vsearch	313	C	*/-AA	379	60	13.36%	2	1	93	93	9.958943471942857E-20	1	1	259	120	0	60	-AA
E7_BC55.191219_FM1-2_consensus_vsearch	324	C	*/-G	411	29	6.47%	2	2	93	93	1.1561587537002726E-9	1	1	256	155	2	27	-G
E7_BC55.191219_FM1-2_consensus_vsearch	331	C	*/+G	320	7	1.55%	2	2	93	93	0.007563182448808609	1	1	166	154	3	4	+G
E7_BC55.191219_FM1-2_consensus_vsearch	331	C	*/-G	320	115	25.39%	2	2	93	93	3.97093099828248E-39	1	1	166	154	95	20	-G
E7_BC55.191219_FM1-2_consensus_vsearch	332	G	*/+A	279	17	5.11%	2	1	93	93	6.0234492696525666E-6	1	1	120	159	17	0	+A
E7_BC55.191219_FM1-2_consensus_vsearch	338	T	*/+A	419	7	1.54%	2	1	93	93	0.007620846145152445	1	1	248	171	7	0	+A
E7_BC55.191219_FM1-2_consensus_vsearch	338	T	*/-A	419	22	4.85%	2	2	93	93	1.8228136523728208E-7	1	1	248	171	11	11	-A
E7_BC55.191219_FM1-2_consensus_vsearch	340	A	*/+G	402	7	1.55%	2	2	93	93	0.0076129195598281015	1	1	238	164	5	2	+G
E7_BC55.191219_FM1-2_consensus_vsearch	340	A	*/-G	402	25	5.53%	2	2	93	93	2.075672356278571E-8	1	1	238	164	20	5	-G
E7_BC55.191219_FM1-2_consensus_vsearch	344	T	*/+C	432	14	3.09%	2	1	93	93	5.50290008587801E-5	1	1	265	167	0	14	+C
E7_BC55.191219_FM1-2_consensus_vsearch	345	T	*/-C	427	18	3.97%	2	1	93	93	3.201090232328667E-6	1	1	261	166	0	18	-C
E7_BC55.191219_FM1-2_consensus_vsearch	350	T	*/-C	422	24	5.31%	2	2	93	93	4.3375967580996214E-8	1	1	246	176	20	4	-C
E7_BC55.191219_FM1-2_consensus_vsearch	352	C	*/-G	439	7	1.54%	2	1	93	93	0.00762940145447119	1	1	264	175	0	7	-G
E7_BC55.191219_FM1-2_consensus_vsearch	353	G	*/+A	413	32	7.16%	2	2	93	93	1.3063797746337085E-10	1	1	265	148	2	30	+A
E7_BC55.191219_FM1-2_consensus_vsearch	355	A	*/-G	353	82	18.1%	2	2	93	93	3.041663298653247E-27	1	1	196	157	55	27	-G
E7_BC55.191219_FM1-2_consensus_vsearch	355	A	*/-GG	353	17	3.75%	2	2	93	93	6.321883427565135E-6	1	1	196	157	16	1	-G
E7_BC55.191219_FM1-2_consensus_vsearch	356	G	*/+A	104	237	66.95%	2	2	93	93	8.749274890034845E-101	1	1	67	37	122	115	+A
E7_BC55.191219_FM1-2_consensus_vsearch	361	G	*/+C	427	13	2.9%	2	2	93	93	1.1157316780867368E-4	1	1	249	178	8	5	+C
E7_BC55.191219_FM1-2_consensus_vsearch	362	C	*/+T	434	8	1.79%	2	1	93	93	0.0037834345948323136	1	1	260	174	0	8	+T
E7_BC55.191219_FM1-2_consensus_vsearch	363	C	*/-T	432	9	1.98%	2	2	93	93	0.001874264864679625	1	1	261	171	2	7	-T
E7_BC55.191219_FM1-2_consensus_vsearch	366	A	*/-GA	422	21	4.68%	2	1	93	93	3.740981261298434E-7	1	1	238	184	21	0	-GA
E7_BC55.191219_FM1-2_consensus_vsearch	367	G	*/-A	413	7	1.63%	2	2	93	93	0.007618121440992818	1	1	240	173	2	5	-A
E7_BC55.191219_FM1-2_consensus_vsearch	382	T	*/-C	411	41	9.03%	2	2	93	93	1.7587442875102587E-13	1	1	228	183	39	2	-C
E7_BC55.191219_FM1-2_consensus_vsearch	384	C	*/+A	386	9	1.98%	2	2	93	93	0.0018651929543866046	1	1	234	152	8	1	+A
E7_BC55.191219_FM1-2_consensus_vsearch	384	C	*/-A	386	45	9.91%	2	2	93	93	8.461664141189412E-15	1	1	234	152	15	30	-A
E7_BC55.191219_FM1-2_consensus_vsearch	386	A	*/-G	410	24	5.29%	2	2	93	93	4.298584353902719E-8	1	1	241	169	19	5	-G
E7_BC55.191219_FM1-2_consensus_vsearch	387	G	*/+C	378	14	3.27%	2	1	93	93	5.423567585746075E-5	1	1	241	137	0	14	+C
E7_BC55.191219_FM1-2_consensus_vsearch	388	G	*/+A	387	44	9.73%	2	1	93	93	1.788537795218229E-14	1	1	213	174	44	0	+A
E7_BC55.191219_FM1-2_consensus_vsearch	388	G	*/-A	387	8	1.77%	2	1	93	93	0.0037689428690762675	1	1	213	174	8	0	+A
E7_BC55.191219_FM1-2_consensus_vsearch	390	A	*/-G	425	13	2.9%	2	2	93	93	1.115267016392494E-4	1	1	264	161	2	11	-G
E7_BC55.191219_FM1-2_consensus_vsearch	391	G	*/+C	417	11	2.53%	2	1	93	93	4.575287206333824E-4	1	1	264	153	0	11	+C
E7_BC55.191219_FM1-2_consensus_vsearch	402	C	*/-G	394	7	1.54%	2	1	93	93	0.007608958034696689	1	1	229	165	7	0	-G
E7_BC55.191219_FM1-2_consensus_vsearch	402	C	*/-GC	394	36	7.93%	2	2	93	93	6.776001825443543E-12	1	1	229	165	25	11	-GC
E7_BC55.191219_FM1-2_consensus_vsearch	402	C	*/-GCA	394	8	1.76%	2	2	93	93	0.0037713141940397903	1	1	229	165	1	7	-GC
E7_BC55.191219_FM1-2_consensus_vsearch	404	C	*/+A	291	8	1.97%	2	2	93	93	0.003725343850254782	1	1	216	75	6	2	+A
E7_BC55.191219_FM1-2_consensus_vsearch	404	C	*/-A	291	95	23.34%	2	2	93	93	3.3932937773854476E-32	1	1	216	75	9	86	-A
E7_BC55.191219_FM1-2_consensus_vsearch	407	A	*/-T	431	9	2%	2	2	93	93	0.0018740875957096264	1	1	255	176	3	6	-T
E7_BC55.191219_FM1-2_consensus_vsearch	409	T	*/-A	400	7	1.55%	2	2	93	93	0.007611943705349879	1	1	224	176	6	1	-A
E7_BC55.191219_FM1-2_consensus_vsearch	409	T	*/-AC	400	34	7.52%	2	1	93	93	2.971279450777966E-11	1	1	224	176	34	0	-AC
E7_BC55.191219_FM1-2_consensus_vsearch	413	C	*/-A	422	11	2.44%	2	2	93	93	4.57876773436784E-4	1	1	262	160	1	10	-A
E7_BC55.191219_FM1-2_consensus_vsearch	422	C	*/-AC	429	12	2.64%	2	2	93	93	2.2631406886309665E-4	1	1	251	178	8	4	-AC
E7_BC55.191219_FM1-2_consensus_vsearch	427	C	*/-G	438	7	1.55%	2	1	93	93	0.007628991869306366	1	1	253	185	7	0	-G
E7_BC55.191219_FM1-2_consensus_vsearch	428	G	*/-AG	423	10	2.24%	2	2	93	93	9.26578056881533E-4	1	1	241	182	9	1	-AG
E7_BC55.191219_FM1-2_consensus_vsearch	429	A	*/-G	391	40	9.09%	2	2	93	93	3.521990332302632E-13	1	1	212	179	39	1	-G
E7_BC55.191219_FM1-2_consensus_vsearch	438	C	*/-AAT	425	9	1.99%	2	1	93	93	0.0018730070190884252	1	1	261	164	0	9	-AAT
E7_BC55.191219_FM1-2_consensus_vsearch	444	A	*/+CT	432	7	1.55%	2	1	93	93	0.0076264953547406375	1	1	254	178	7	0	+CT
E7_BC55.191219_FM1-2_consensus_vsearch	449	G	*/-A	430	16	3.54%	2	1	93	93	1.3306337519337772E-5	1	1	249	181	16	0	-A
E7_BC55.191219_FM1-2_consensus_vsearch	455	C	*/-G	432	13	2.88%	2	2	93	93	1.1168756210732632E-4	1	1	260	172	3	10	-G
E7_BC55.191219_FM1-2_consensus_vsearch	458	C	*/-T	430	16	3.53%	2	2	93	93	1.3306337519337772E-5	1	1	263	167	3	13	-T
E7_BC55.191219_FM1-2_consensus_vsearch	460	C	*/+T	301	20	4.44%	2	2	93	93	7.027854372179865E-7	1	1	227	74	12	8	+T
E7_BC55.191219_FM1-2_consensus_vsearch	460	C	*/-T	301	106	23.56%	2	2	93	93	4.6439118838766054E-36	1	1	227	74	28	78	-T
E7_BC55.191219_FM1-2_consensus_vsearch	460	C	*/-TT	301	17	3.78%	2	1	93	93	6.125441355430881E-6	1	1	227	74	0	17	-T
E7_BC55.191219_FM1-2_consensus_vsearch	464	T	*/-G	424	16	3.54%	2	2	93	93	1.3281070163027198E-5	1	1	261	163	4	12	-G
E7_BC55.191219_FM1-2_consensus_vsearch	469	C	*/+A	436	9	2%	2	1	93	93	0.0018749660605302289	1	1	253	183	9	0	+A
E7_BC55.191219_FM1-2_consensus_vsearch	470	G	*/+A	408	10	2.2%	2	1	93	93	9.248125937902505E-4	1	1	243	165	10	0	+A
E7_BC55.191219_FM1-2_consensus_vsearch	470	G	*/-TG	408	18	3.96%	2	1	93	93	3.1756255130045852E-6	1	1	243	165	0	18	-TG
E7_BC55.191219_FM1-2_consensus_vsearch	473	C	*/-A	426	19	4.21%	2	2	93	93	1.567506340833558E-6	1	1	259	167	6	13	-A
E7_BC55.191219_FM1-2_consensus_vsearch	475	A	*/+T	434	7	1.54%	2	2	93	93	0.007627335039353406	1	1	255	179	6	1	+T
E7_BC55.191219_FM1-2_consensus_vsearch	477	T	*/-G	405	41	9.03%	2	2	93	93	1.7353381828502486E-13	1	1	263	142	2	39	-G
E7_BC55.191219_FM1-2_consensus_vsearch	482	T	*/+A	425	8	1.78%	2	1	93	93	0.0037809012469126957	1	1	250	175	8	0	+A
E7_BC55.191219_FM1-2_consensus_vsearch	483	G	*/+A	425	10	2.23%	2	1	93	93	9.268043937944601E-4	1	1	248	177	10	0	+A
E7_BC55.191219_FM1-2_consensus_vsearch	484	A	*/-G	430	9	2.01%	2	1	93	93	0.0018739095280781474	1	1	253	177	9	0	-G
E7_BC55.191219_FM1-2_consensus_vsearch	487	T	*/+G	424	8	1.78%	2	1	93	93	0.0037806132981311326	1	1	250	174	8	0	+G
E7_BC55.191219_FM1-2_consensus_vsearch	487	T	*/-A	424	8	1.78%	2	2	93	93	0.0037806132981311326	1	1	250	174	5	3	+G
E7_BC55.191219_FM1-2_consensus_vsearch	488	A	*/-G	417	8	1.79%	2	1	93	93	0.003778560011928581	1	1	248	169	8	0	-G
E7_BC55.191219_FM1-2_consensus_vsearch	490	A	*/-T	440	7	1.56%	2	2	93	93	0.007629809215418646	1	1	264	176	1	6	-T
E7_BC55.191219_FM1-2_consensus_vsearch	493	T	*/-A	424	17	3.74%	2	2	93	93	6.519935125426091E-6	1	1	256	168	2	15	-A
E7_BC55.191219_FM1-2_consensus_vsearch	496	A	*/-T	428	18	3.96%	2	1	93	93	3.20237453644594E-6	1	1	267	161	0	18	-T
E7_BC55.191219_FM1-2_consensus_vsearch	497	T	*/-C	419	14	3.21%	2	2	93	93	5.485540608158622E-5	1	1	259	160	8	6	-C
E7_BC55.191219_FM1-2_consensus_vsearch	501	C	*/-A	423	8	1.77%	2	2	93	93	0.003780324023462628	1	1	257	166	1	7	-A
E7_BC55.191219_FM1-2_consensus_vsearch	507	A	*/-G	427	10	2.22%	2	2	93	93	9.270286906046182E-4	1	1	248	179	6	4	-G
E7_BC55.191219_FM1-2_consensus_vsearch	516	T	*/-G	344	99	21.9%	2	2	93	93	3.2791253687717045E-33	1	1	262	82	2	97	-G
E7_BC55.191219_FM1-2_consensus_vsearch	519	A	*/-G	405	33	7.32%	2	2	93	93	6.224300717447606E-11	1	1	237	168	23	10	-G
E7_BC55.191219_FM1-2_consensus_vsearch	520	G	*/+A	392	8	1.92%	2	1	93	93	0.0037706450711110975	1	1	230	162	8	0	+A
E7_BC55.191219_FM1-2_consensus_vsearch	520	G	*/+T	392	10	2.4%	2	1	93	93	9.227866256324819E-4	1	1	230	162	0	10	+T
E7_BC55.191219_FM1-2_consensus_vsearch	521	G	*/+A	423	15	3.33%	2	1	93	93	2.701566009065348E-5	1	1	241	182	15	0	+A
E7_BC55.191219_FM1-2_consensus_vsearch	523	C	*/-A	420	7	1.56%	2	2	93	93	0.007621292853586086	1	1	254	166	3	4	-A
E7_BC55.191219_FM1-2_consensus_vsearch	523	C	*/-AA	420	7	1.56%	2	1	93	93	0.007621292853586086	1	1	254	166	0	7	-A
E7_BC55.191219_FM1-2_consensus_vsearch	529	T	*/-G	393	40	8.97%	2	2	93	93	3.5382106907563276E-13	1	1	255	138	4	36	-G
E7_BC55.191219_FM1-2_consensus_vsearch	540	G	*/-C	406	16	3.59%	2	1	93	93	1.3201193045766802E-5	1	1	225	181	16	0	-C
E7_BC55.191219_FM1-2_consensus_vsearch	551	T	*/-C	423	20	4.41%	2	2	93	93	7.658841069212707E-7	1	1	246	177	17	3	-C
E7_BC55.191219_FM1-2_consensus_vsearch	556	C	*/-T	434	14	3.09%	2	1	93	93	5.5054846604229285E-5	1	1	265	169	0	14	-T
E7_BC55.191219_FM1-2_consensus_vsearch	557	T	*/-C	359	73	16.63%	2	1	93	93	3.8089860272184484E-24	1	1	191	168	73	0	-C
E7_BC55.191219_FM1-2_consensus_vsearch	572	T	*/+A	404	15	3.31%	2	2	93	93	2.6864125215700153E-5	1	1	236	168	13	2	+A
E7_BC55.191219_FM1-2_consensus_vsearch	572	T	*/+AA	404	13	2.87%	2	2	93	93	1.1101277914824134E-4	1	1	236	168	11	2	+A
E7_BC55.191219_FM1-2_consensus_vsearch	572	T	*/-A	404	11	2.43%	2	2	93	93	4.5658536003316156E-4	1	1	236	168	6	5	+A
E7_BC55.191219_FM1-2_consensus_vsearch	578	T	*/+A	429	16	3.52%	2	1	93	93	1.3302171151380651E-5	1	1	251	178	16	0	+A
E7_BC55.191219_FM1-2_consensus_vsearch	587	T	*/+A	285	22	4.92%	2	2	93	93	1.6142960508852506E-7	1	1	164	121	20	2	+A
E7_BC55.191219_FM1-2_consensus_vsearch	587	T	*/+AA	285	7	1.57%	2	2	93	93	0.007533506790877374	1	1	164	121	6	1	+A
E7_BC55.191219_FM1-2_consensus_vsearch	587	T	*/-A	285	112	25.06%	2	2	93	93	2.0485052962219344E-38	1	1	164	121	64	48	-A
E7_BC55.191219_FM1-2_consensus_vsearch	587	T	*/-AA	285	17	3.8%	2	2	93	93	6.052605744083776E-6	1	1	164	121	13	4	-A
E7_BC55.191219_FM1-2_consensus_vsearch	593	G	*/+C	438	8	1.77%	2	1	93	93	0.0037845279531252564	1	1	266	172	0	8	+C
E7_BC55.191219_FM1-2_consensus_vsearch	606	C	*/-T	410	22	4.85%	2	2	93	93	1.812385707292981E-7	1	1	258	152	8	14	-T
E7_BC55.191219_FM1-2_consensus_vsearch	606	C	*/-TT	410	16	3.52%	2	2	93	93	1.321949517328872E-5	1	1	258	152	3	13	-T
E7_BC55.191219_FM1-2_consensus_vsearch	608	T	*/+C	403	13	2.97%	2	1	93	93	1.1098705502596942E-4	1	1	242	161	13	0	+C
E7_BC55.191219_FM1-2_consensus_vsearch	608	T	*/-C	403	17	3.89%	2	2	93	93	6.4678823522925845E-6	1	1	242	161	8	9	-C
E7_BC55.191219_FM1-2_consensus_vsearch	609	C	*/-G	404	17	3.91%	2	1	93	93	6.470471302259629E-6	1	1	258	146	0	17	-G
E7_BC55.191219_FM1-2_consensus_vsearch	609	C	*/-GG	404	9	2.07%	2	1	93	93	0.0018689806633249517	1	1	258	146	0	9	-G
E7_BC55.191219_FM1-2_consensus_vsearch	612	G	*/+C	429	11	2.42%	2	1	93	93	4.5835102222652706E-4	1	1	268	161	0	11	+C
E7_BC55.191219_FM1-2_consensus_vsearch	614	T	*/+C	419	7	1.56%	2	1	93	93	0.007620846145152445	1	1	260	159	7	0	+C
E7_BC55.191219_FM1-2_consensus_vsearch	614	T	*/-C	419	21	4.68%	2	1	93	93	3.7346484366063784E-7	1	1	260	159	0	21	-C
E7_BC55.191219_FM1-2_consensus_vsearch	617	G	*/-C	434	15	3.31%	2	2	93	93	2.7097786818023924E-5	1	1	259	175	7	8	-C
E7_BC55.191219_FM1-2_consensus_vsearch	619	C	*/+T	393	7	1.55%	2	2	93	93	0.007608451759263046	1	1	247	146	1	6	+T
E7_BC55.191219_FM1-2_consensus_vsearch	619	C	*/-T	393	32	7.06%	2	2	93	93	1.269985114116753E-10	1	1	247	146	2	30	-T
E7_BC55.191219_FM1-2_consensus_vsearch	619	C	*/-TT	393	7	1.55%	2	1	93	93	0.007608451759263046	1	1	247	146	7	0	-T
E7_BC55.191219_FM1-2_consensus_vsearch	626	T	*/+C	416	9	2.01%	2	1	93	93	0.001871329602106588	1	1	251	165	9	0	+C
E7_BC55.191219_FM1-2_consensus_vsearch	626	T	*/-C	416	9	2.01%	2	2	93	93	0.001871329602106588	1	1	251	165	6	3	+C
E7_BC55.191219_FM1-2_consensus_vsearch	632	T	*/-C	423	7	1.58%	2	2	93	93	0.007622620571895094	1	1	260	163	2	5	-C
E7_BC55.191219_FM1-2_consensus_vsearch	633	C	*/+T	419	13	2.93%	2	1	93	93	1.1138480342819209E-4	1	1	258	161	0	13	+T
E7_BC55.191219_FM1-2_consensus_vsearch	640	C	*/+T	369	15	3.36%	2	1	93	93	2.6547739902969607E-5	1	1	195	174	15	0	+T
E7_BC55.191219_FM1-2_consensus_vsearch	640	C	*/-G	369	18	4.04%	2	2	93	93	3.116143495392193E-6	1	1	195	174	17	1	-G
E7_BC55.191219_FM1-2_consensus_vsearch	640	C	*/-GC	369	33	7.4%	2	2	93	93	5.870828506173398E-11	1	1	195	174	25	8	-GC
E7_BC55.191219_FM1-2_consensus_vsearch	641	G	*/+C	357	8	2.04%	2	1	93	93	0.003757759247190633	1	1	184	173	8	0	+C
E7_BC55.191219_FM1-2_consensus_vsearch	642	C	*/+T	323	21	5.08%	2	1	93	93	3.4811017857401133E-7	1	1	160	163	21	0	+T
E7_BC55.191219_FM1-2_consensus_vsearch	642	C	*/-A	323	10	2.42%	2	2	93	93	9.118642134740773E-4	1	1	160	163	8	2	+T
E7_BC55.191219_FM1-2_consensus_vsearch	642	C	*/-AC	323	34	8.23%	2	1	93	93	2.5515608609268324E-11	1	1	160	163	34	0	-AC
E7_BC55.191219_FM1-2_consensus_vsearch	646	G	*/+C	430	14	3.1%	2	1	93	93	5.500293094702783E-5	1	1	260	170	0	14	+C
E7_BC55.191219_FM1-2_consensus_vsearch	648	T	*/-C	430	12	2.67%	2	2	93	93	2.263534081363424E-4	1	1	263	167	1	11	-C
E7_BC55.191219_FM1-2_consensus_vsearch	649	C	*/-G	427	7	1.59%	2	2	93	93	0.007624362444354587	1	1	261	166	3	4	-G
E7_BC55.191219_FM1-2_consensus_vsearch	653	T	*/-G	413	18	4.02%	2	2	93	93	3.1825288676449396E-6	1	1	244	169	10	8	-G
E7_BC55.191219_FM1-2_consensus_vsearch	655	G	*/+A	416	25	5.53%	2	1	93	93	2.1003406097185295E-8	1	1	236	180	25	0	+A
E7_BC55.191219_FM1-2_consensus_vsearch	663	C	*/-TC	437	7	1.55%	2	1	93	93	0.007628580447648388	1	1	264	173	0	7	-TC
E7_BC55.191219_FM1-2_consensus_vsearch	664	T	*/-C	416	12	2.71%	2	2	93	93	2.257863627265534E-4	1	1	254	162	8	4	-C
E7_BC55.191219_FM1-2_consensus_vsearch	666	C	*/-T	421	15	3.35%	2	2	93	93	2.7000302846488012E-5	1	1	265	156	3	12	-T
E7_BC55.191219_FM1-2_consensus_vsearch	670	G	*/-TG	430	10	2.22%	2	1	93	93	9.273613705492817E-4	1	1	265	165	0	10	-TG
E7_BC55.191219_FM1-2_consensus_vsearch	671	T	*/+A	407	14	3.18%	2	2	93	93	5.468602328051435E-5	1	1	252	155	13	1	+A
E7_BC55.191219_FM1-2_consensus_vsearch	672	G	*/-A	425	10	2.27%	2	2	93	93	9.268043937944601E-4	1	1	254	171	9	1	-A
E7_BC55.191219_FM1-2_consensus_vsearch	673	A	*/-G	426	11	2.48%	2	2	93	93	4.581495959366191E-4	1	1	247	179	10	1	-G
E7_BC55.191219_FM1-2_consensus_vsearch	681	G	*/-C	414	23	5.16%	2	2	93	93	8.856382627956532E-8	1	1	246	168	15	8	-C
E7_BC55.191219_FM1-2_consensus_vsearch	684	C	*/+T	397	10	2.21%	2	2	93	93	9.234365709559712E-4	1	1	253	144	3	7	+T
E7_BC55.191219_FM1-2_consensus_vsearch	684	C	*/-T	397	28	6.18%	2	2	93	93	2.3525147178522405E-9	1	1	253	144	7	21	-T
E7_BC55.191219_FM1-2_consensus_vsearch	690	T	*/-G	418	14	3.11%	2	2	93	93	5.4841636470744183E-5	1	1	248	170	12	2	-G
E7_BC55.191219_FM1-2_consensus_vsearch	692	G	*/+A	376	25	5.58%	2	1	93	93	2.026044651898465E-8	1	1	230	146	25	0	+A
E7_BC55.191219_FM1-2_consensus_vsearch	696	T	*/-GT	387	54	11.97%	2	2	93	93	9.856827986083252E-18	1	1	247	140	20	34	-GT
E7_BC55.191219_FM1-2_consensus_vsearch	698	T	*/-C	373	8	2.01%	2	2	93	93	0.0037639410987491528	1	1	238	135	1	7	-C
E7_BC55.191219_FM1-2_consensus_vsearch	699	C	*/+A	307	24	5.39%	2	1	93	93	3.868194881666782E-8	1	1	162	145	24	0	+A
E7_BC55.191219_FM1-2_consensus_vsearch	699	C	*/+G	307	7	1.57%	2	2	93	93	0.0075529272619753235	1	1	162	145	5	2	+A
E7_BC55.191219_FM1-2_consensus_vsearch	699	C	*/-G	307	99	22.25%	2	2	93	93	1.7213350960447694E-33	1	1	162	145	73	26	-G
E7_BC55.191219_FM1-2_consensus_vsearch	703	G	*/-A	436	12	2.64%	2	2	93	93	2.2658584690234848E-4	1	1	257	179	9	3	-A
E7_BC55.191219_FM1-2_consensus_vsearch	705	A	*/-C	430	8	1.77%	2	2	93	93	0.0037823214180042796	1	1	249	181	6	2	-C
E7_BC55.191219_FM1-2_consensus_vsearch	708	A	*/-G	399	29	6.53%	2	2	93	93	1.1402714240395733E-9	1	1	234	165	10	19	-G
E7_BC55.191219_FM1-2_consensus_vsearch	713	C	*/-T	338	42	9.25%	2	2	93	93	6.855240226749158E-14	1	1	166	172	33	9	-T
E7_BC55.191219_FM1-2_consensus_vsearch	713	C	*/-TT	338	61	13.44%	2	2	93	93	3.6167602363674186E-20	1	1	166	172	59	2	-TT
E7_BC55.191219_FM1-2_consensus_vsearch	713	C	*/-TTT	338	8	1.76%	2	1	93	93	0.0037496828790229684	1	1	166	172	8	0	-TT
E7_BC55.191219_FM1-2_consensus_vsearch	717	A	*/-C	412	13	2.97%	2	2	93	93	1.11214354741109E-4	1	1	235	177	9	4	-C
E7_BC55.191219_FM1-2_consensus_vsearch	719	C	*/+T	392	11	2.47%	2	1	93	93	4.5566171886911473E-4	1	1	237	155	0	11	+T
E7_BC55.191219_FM1-2_consensus_vsearch	719	C	*/-T	392	25	5.62%	2	2	93	93	2.0571996412600835E-8	1	1	237	155	10	15	-T
E7_BC55.191219_FM1-2_consensus_vsearch	719	C	*/-TT	392	10	2.25%	2	1	93	93	9.227866256324819E-4	1	1	237	155	10	0	-T
E7_BC55.191219_FM1-2_consensus_vsearch	723	A	*/+G	403	8	1.79%	2	1	93	93	0.0037742453123195243	1	1	223	180	8	0	+G
E7_BC55.191219_FM1-2_consensus_vsearch	723	A	*/-GA	403	29	6.47%	2	2	93	93	1.1456440378899714E-9	1	1	223	180	27	2	-GA
E7_BC55.191219_FM1-2_consensus_vsearch	724	G	*/+A	404	9	2.13%	2	2	93	93	0.0018689806633249517	1	1	227	177	6	3	+A
E7_BC55.191219_FM1-2_consensus_vsearch	731	A	*/+G	413	14	3.09%	2	2	93	93	5.4771858527024145E-5	1	1	243	170	2	12	+G
E7_BC55.191219_FM1-2_consensus_vsearch	731	A	*/-G	413	19	4.19%	2	1	93	93	1.5580746773809727E-6	1	1	243	170	19	0	-G
E7_BC55.191219_FM1-2_consensus_vsearch	734	G	*/-T	423	25	5.53%	2	1	93	93	2.1121828246927912E-8	1	1	265	158	0	25	-T
E7_BC55.191219_FM1-2_consensus_vsearch	736	G	*/+A	435	7	1.56%	2	2	93	93	0.007627752045228881	1	1	264	171	1	6	+A
E7_BC55.191219_FM1-2_consensus_vsearch	739	C	*/+A	407	9	2%	2	1	93	93	0.0018695804538677086	1	1	235	172	9	0	+A
E7_BC55.191219_FM1-2_consensus_vsearch	739	C	*/-A	407	21	4.67%	2	2	93	93	3.708521351455572E-7	1	1	235	172	19	2	-A
E7_BC55.191219_FM1-2_consensus_vsearch	739	C	*/-AA	407	7	1.56%	2	2	93	93	0.007615318149966635	1	1	235	172	1	6	-A
E7_BC55.191219_FM1-2_consensus_vsearch	753	G	*/-CC	429	9	2.02%	2	1	93	93	0.0018737306563855328	1	1	246	183	9	0	-CC
E7_BC55.191219_FM1-2_consensus_vsearch	756	C	*/+G	393	16	3.53%	2	2	93	93	1.3139378685872623E-5	1	1	237	156	4	12	+G
E7_BC55.191219_FM1-2_consensus_vsearch	757	G	*/-A	437	8	1.78%	2	1	93	93	0.00378425644253265	1	1	252	185	8	0	-A
E7_BC55.191219_FM1-2_consensus_vsearch	763	A	*/-T	433	9	2%	2	2	93	93	0.001874441340367089	1	1	259	174	7	2	-T
E7_BC55.191219_FM1-2_consensus_vsearch	775	T	*/+A	431	10	2.22%	2	1	93	93	9.274712732448419E-4	1	1	266	165	0	10	+A
E7_BC55.191219_FM1-2_consensus_vsearch	778	C	*/+A	419	20	4.44%	2	2	93	93	7.643203668866705E-7	1	1	267	152	1	19	+A
E7_BC55.191219_FM1-2_consensus_vsearch	787	G	*/-TG	422	20	4.42%	2	1	93	93	7.654955875708403E-7	1	1	259	163	0	20	-TG
E7_BC55.191219_FM1-2_consensus_vsearch	789	G	*/-C	401	8	1.85%	2	1	93	93	0.0037736050099275447	1	1	252	149	0	8	-C
E7_BC55.191219_FM1-2_consensus_vsearch	793	T	*/-C	417	29	6.4%	2	1	93	93	1.1638493087196217E-9	1	1	235	182	29	0	-C
E7_BC55.191219_FM1-2_consensus_vsearch	795	C	*/-T	438	12	2.64%	2	2	93	93	2.2666198297196754E-4	1	1	267	171	1	11	-T
E7_BC55.191219_FM1-2_consensus_vsearch	797	A	*/+T	383	21	4.69%	2	2	93	93	3.652121355363276E-7	1	1	227	156	14	7	+T
E7_BC55.191219_FM1-2_consensus_vsearch	797	A	*/-T	383	32	7.14%	2	2	93	93	1.2508402692879024E-10	1	1	227	156	13	19	-T
E7_BC55.191219_FM1-2_consensus_vsearch	806	G	*/+T	434	8	1.76%	2	2	93	93	0.0037834345948323136	1	1	253	181	7	1	+T
E7_BC55.191219_FM1-2_consensus_vsearch	810	C	*/-T	414	21	4.68%	2	2	93	93	3.7239194258898957E-7	1	1	259	155	6	15	-T
E7_BC55.191219_FM1-2_consensus_vsearch	812	A	*/-G	407	20	4.51%	2	2	93	93	7.594696420327181E-7	1	1	233	174	19	1	-G
E7_BC55.191219_FM1-2_consensus_vsearch	822	T	*/-A	414	20	4.48%	2	2	93	93	7.623288530279364E-7	1	1	263	151	6	14	-A
E7_BC55.191219_FM1-2_consensus_vsearch	829	T	*/-A	437	8	1.76%	2	1	93	93	0.00378425644253265	1	1	260	177	8	0	-A
E7_BC55.191219_FM1-2_consensus_vsearch	830	A	*/+GCC	425	8	1.81%	2	1	93	93	0.0037809012469126957	1	1	249	176	8	0	+GCC
E7_BC55.191219_FM1-2_consensus_vsearch	833	A	*/+G	354	13	2.9%	2	2	93	93	1.0956125007602598E-4	1	1	247	107	1	12	+G
E7_BC55.191219_FM1-2_consensus_vsearch	833	A	*/-G	354	50	11.14%	2	2	93	93	1.7644257468808856E-16	1	1	247	107	6	44	-G
E7_BC55.191219_FM1-2_consensus_vsearch	833	A	*/-GG	354	22	4.9%	2	2	93	93	1.7377486846905932E-7	1	1	247	107	1	21	-G
E7_BC55.191219_FM1-2_consensus_vsearch	837	A	*/-C	426	7	1.56%	2	1	93	93	0.007623929979105209	1	1	259	167	0	7	-C
E7_BC55.191219_FM1-2_consensus_vsearch	842	C	*/+A	262	21	4.67%	2	1	93	93	3.244452624982964E-7	1	1	140	122	21	0	+A
E7_BC55.191219_FM1-2_consensus_vsearch	842	C	*/-G	262	148	32.89%	2	2	93	93	2.3185385280283376E-52	1	1	140	122	101	47	-G
E7_BC55.191219_FM1-2_consensus_vsearch	852	A	*/-GTA	422	7	1.57%	2	2	93	93	0.007622180052576428	1	1	251	171	5	2	-GTA
E7_BC55.191219_FM1-2_consensus_vsearch	857	T	*/+C	434	12	2.64%	2	1	93	93	2.2650904494607855E-4	1	1	255	179	12	0	+C
E7_BC55.191219_FM1-2_consensus_vsearch	857	T	*/-C	434	8	1.76%	2	2	93	93	0.0037834345948323136	1	1	255	179	2	6	+C
E7_BC55.191219_FM1-2_consensus_vsearch	865	T	*/-A	425	8	1.78%	2	2	93	93	0.0037809012469126957	1	1	254	171	5	3	-A
E7_BC55.191219_FM1-2_consensus_vsearch	866	A	*/+G	412	11	2.49%	2	2	93	93	4.571726097283556E-4	1	1	243	169	3	8	+G
E7_BC55.191219_FM1-2_consensus_vsearch	866	A	*/-G	412	12	2.72%	2	1	93	93	2.2561765155391507E-4	1	1	243	169	12	0	-G
E7_BC55.191219_FM1-2_consensus_vsearch	867	G	*/-A	412	10	2.28%	2	1	93	93	9.25295461603329E-4	1	1	229	183	10	0	-A
E7_BC55.191219_FM1-2_consensus_vsearch	867	G	*/-AG	412	8	1.83%	2	2	93	93	0.003777051806882959	1	1	229	183	7	1	-A
E7_BC55.191219_FM1-2_consensus_vsearch	868	A	*/+G	380	8	1.85%	2	1	93	93	0.003766486715388715	1	1	198	182	8	0	+G
E7_BC55.191219_FM1-2_consensus_vsearch	868	A	*/-G	380	35	8.1%	2	1	93	93	1.3772560425075862E-11	1	1	198	182	35	0	-G
E7_BC55.191219_FM1-2_consensus_vsearch	871	T	*/+A	434	7	1.56%	2	1	93	93	0.007627335039353406	1	1	255	179	7	0	+A
E7_BC55.191219_FM1-2_consensus_vsearch	872	G	*/-A	433	9	2.01%	2	2	93	93	0.001874441340367089	1	1	259	174	5	4	-A
E7_BC55.191219_FM1-2_consensus_vsearch	877	T	*/-C	414	20	4.42%	2	2	93	93	7.623288530279364E-7	1	1	263	151	1	19	-C
E7_BC55.191219_FM1-2_consensus_vsearch	878	C	*/-T	389	27	6.32%	2	1	93	93	4.818483870068246E-9	1	1	263	126	0	27	-T
E7_BC55.191219_FM1-2_consensus_vsearch	880	T	*/-G	405	31	6.95%	2	2	93	93	2.679373074076999E-10	1	1	257	148	1	30	-G
E7_BC55.191219_FM1-2_consensus_vsearch	882	G	*/-A	443	8	1.77%	2	2	93	93	0.003785867578538486	1	1	259	184	7	1	-A
E7_BC55.191219_FM1-2_consensus_vsearch	885	T	*/+G	428	12	2.66%	2	1	93	93	2.2627455527610537E-4	1	1	266	162	0	12	+G
E7_BC55.191219_FM1-2_consensus_vsearch	896	T	*/+A	411	12	2.69%	2	1	93	93	2.2557498827275595E-4	1	1	260	151	0	12	+A
E7_BC55.191219_FM1-2_consensus_vsearch	900	T	*/-ACT	348	7	1.56%	2	1	93	93	0.007582734311001454	1	1	253	95	7	0	-ACT
E7_BC55.191219_FM1-2_consensus_vsearch	901	A	*/+T	399	26	5.84%	2	1	93	93	1.0046237206982396E-8	1	1	248	151	0	26	+T
E7_BC55.191219_FM1-2_consensus_vsearch	902	C	*/+A	383	7	1.58%	2	1	93	93	0.007603246958909687	1	1	253	130	0	7	+A
E7_BC55.191219_FM1-2_consensus_vsearch	902	C	*/-T	383	27	6.08%	2	2	93	93	4.786817853052246E-9	1	1	253	130	6	21	-T
E7_BC55.191219_FM1-2_consensus_vsearch	904	G	*/-CG	422	7	1.58%	2	2	93	93	0.007622180052576428	1	1	246	176	4	3	-CG
E7_BC55.191219_FM1-2_consensus_vsearch	905	C	*/+A	337	11	2.51%	2	1	93	93	4.5063381864919106E-4	1	1	165	172	11	0	+A
E7_BC55.191219_FM1-2_consensus_vsearch	905	C	*/-G	337	9	2.05%	2	2	93	93	0.0018529134694595746	1	1	165	172	8	1	+A
E7_BC55.191219_FM1-2_consensus_vsearch	905	C	*/-GA	337	63	14.38%	2	1	93	93	7.649968459907619E-21	1	1	165	172	63	0	-GA
E7_BC55.191219_FM1-2_consensus_vsearch	906	G	*/+A	317	8	2.19%	2	2	93	93	0.0037396690155496095	1	1	144	173	7	1	+A
E7_BC55.191219_FM1-2_consensus_vsearch	906	G	*/-A	317	24	6.56%	2	1	93	93	3.919347887273906E-8	1	1	144	173	24	0	-A
E7_BC55.191219_FM1-2_consensus_vsearch	909	A	*/-G	375	75	16.56%	2	2	93	93	9.1377394921331E-25	1	1	193	182	73	2	-G
E7_BC55.191219_FM1-2_consensus_vsearch	912	A	*/-T	416	29	6.42%	2	2	93	93	1.1625789255799283E-9	1	1	239	177	25	4	-T
E7_BC55.191219_FM1-2_consensus_vsearch	916	G	*/-C	416	21	4.68%	2	1	93	93	3.7282374960453956E-7	1	1	234	182	21	0	-C
E7_BC55.191219_FM1-2_consensus_vsearch	918	C	*/-A	399	41	9.07%	2	2	93	93	1.7115871232317524E-13	1	1	228	171	31	10	-A
E7_BC55.191219_FM1-2_consensus_vsearch	925	G	*/+T	381	16	3.57%	2	2	93	93	1.307893571981294E-5	1	1	204	177	14	2	+T
E7_BC55.191219_FM1-2_consensus_vsearch	925	G	*/-T	381	32	7.14%	2	2	93	93	1.2469315497302171E-10	1	1	204	177	29	3	-T
E7_BC55.191219_FM1-2_consensus_vsearch	933	T	*/-A	441	9	1.99%	2	1	93	93	0.0018758252149176666	1	1	257	184	9	0	-A
E7_BC55.191219_FM1-2_consensus_vsearch	937	C	*/-A	415	31	6.87%	2	2	93	93	2.71398896207431E-10	1	1	236	179	28	3	-A
E7_BC55.191219_FM1-2_consensus_vsearch	944	G	*/+A	398	19	4.22%	2	1	93	93	1.5465225927437376E-6	1	1	216	182	19	0	+A
E7_BC55.191219_FM1-2_consensus_vsearch	944	G	*/-A	398	26	5.78%	2	2	93	93	1.003660801739248E-8	1	1	216	182	25	1	-A
E7_BC55.191219_FM1-2_consensus_vsearch	946	A	*/-G	425	16	3.53%	2	2	93	93	1.328532663205171E-5	1	1	246	179	13	3	-G
E7_BC55.191219_FM1-2_consensus_vsearch	947	G	*/+A	421	7	1.61%	2	1	93	93	0.007621737484585097	1	1	241	180	7	0	+A
E7_BC55.191219_FM1-2_consensus_vsearch	948	G	*/+A	412	26	5.75%	2	1	93	93	1.0168084703671111E-8	1	1	230	182	26	0	+A
E7_BC55.191219_FM1-2_consensus_vsearch	948	G	*/-T	412	7	1.55%	2	1	93	93	0.007617659773976637	1	1	230	182	7	0	+A
E7_BC55.191219_FM1-2_consensus_vsearch	950	T	*/+G	433	8	1.77%	2	1	93	93	0.003783158179516694	1	1	251	182	8	0	+G
E7_BC55.191219_FM1-2_consensus_vsearch	951	A	*/+G	130	228	50.55%	2	2	93	93	2.7874459557210952E-93	1	1	43	87	170	58	+G
E7_BC55.191219_FM1-2_consensus_vsearch	951	A	*/+GG	130	10	2.22%	2	1	93	93	8.268692705650911E-4	1	1	43	87	0	10	+G
E7_BC55.191219_FM1-2_consensus_vsearch	951	A	*/-G	130	42	9.31%	2	2	93	93	1.3083171850355307E-14	1	1	43	87	25	17	-G
E7_BC55.191219_FM1-2_consensus_vsearch	951	A	*/-GG	130	9	2%	2	1	93	93	0.0017088631591672273	1	1	43	87	0	9	-G
E7_BC55.191219_FM1-2_consensus_vsearch	957	C	*/+G	426	12	2.66%	2	1	93	93	2.2619500050778872E-4	1	1	261	165	0	12	+G
E7_BC55.191219_FM1-2_consensus_vsearch	958	G	*/-A	400	41	9.21%	2	2	93	93	1.7155698174443366E-13	1	1	257	143	7	34	-A
E7_BC55.191219_FM1-2_consensus_vsearch	967	T	*/+G	434	12	2.65%	2	1	93	93	2.2650904494607855E-4	1	1	252	182	12	0	+G
E7_BC55.191219_FM1-2_consensus_vsearch	968	A	*/-G	428	13	2.88%	2	2	93	93	1.1159624774972868E-4	1	1	250	178	12	1	-G
E7_BC55.191219_FM1-2_consensus_vsearch	982	T	*/-C	438	7	1.56%	2	2	93	93	0.007628991869306366	1	1	262	176	1	6	-C
E7_BC55.191219_FM1-2_consensus_vsearch	983	C	*/+T	435	7	1.57%	2	2	93	93	0.007627752045228881	1	1	265	170	1	6	+T
E7_BC55.191219_FM1-2_consensus_vsearch	991	T	*/-A	431	13	2.91%	2	2	93	93	1.1166488301300728E-4	1	1	261	170	7	6	-A
E7_BC55.191219_FM1-2_consensus_vsearch	1005	T	*/-C	395	45	10.07%	2	2	93	93	8.685662622888045E-15	1	1	227	168	37	8	-C
E7_BC55.191219_FM1-2_consensus_vsearch	1007	C	*/-G	427	17	3.74%	2	2	93	93	6.526993615927746E-6	1	1	267	160	1	16	-G
E7_BC55.191219_FM1-2_consensus_vsearch	1012	C	*/+A	176	89	19.69%	2	1	93	93	2.1380940634553743E-31	1	1	119	57	89	0	+A
E7_BC55.191219_FM1-2_consensus_vsearch	1012	C	*/+AG	176	9	1.99%	2	1	93	93	0.001767978203561041	1	1	119	57	9	0	+A
E7_BC55.191219_FM1-2_consensus_vsearch	1012	C	*/+G	176	130	28.76%	2	2	93	93	1.6807759425818642E-47	1	1	119	57	21	109	+G
E7_BC55.191219_FM1-2_consensus_vsearch	1012	C	*/-G	176	27	5.97%	2	2	93	93	2.9524624326486785E-9	1	1	119	57	24	3	+G
E7_BC55.191219_FM1-2_consensus_vsearch	1018	T	*/-CT	430	16	3.55%	2	1	93	93	1.3306337519337772E-5	1	1	267	163	0	16	-CT
E7_BC55.191219_FM1-2_consensus_vsearch	1019	C	-T/-T	25	406	93.12%	2	2	93	93	1.1764664223154487E-217	1	1	13	12	254	152	-T
E7_BC55.191219_FM1-2_consensus_vsearch	1020	T	*/+C	10	7	25.93%	2	2	93	93	0.0036151279199109596	1	1	7	3	2	5	+C
E7_BC55.191219_FM1-2_consensus_vsearch	1021	T	*/-C	423	14	3.12%	2	2	93	93	5.490987823300768E-5	1	1	252	171	5	9	-C
E7_BC55.191219_FM1-2_consensus_vsearch	1022	C	*/-A	430	7	1.6%	2	2	93	93	0.007625648020175149	1	1	257	173	5	2	-A
E7_BC55.191219_FM1-2_consensus_vsearch	1024	A	*/-T	442	8	1.76%	2	2	93	93	0.0037856020174325917	1	1	266	176	1	7	-T
E7_BC55.191219_FM1-2_consensus_vsearch	1026	C	*/-T	428	16	3.55%	2	2	93	93	1.3297986993183741E-5	1	1	261	167	2	14	-T
E7_BC55.191219_FM1-2_consensus_vsearch	1032	T	*/-GT	427	11	2.44%	2	2	93	93	4.5821703849988575E-4	1	1	259	168	5	6	-GT
E7_BC55.191219_FM1-2_consensus_vsearch	1034	T	*/-C	344	83	18.91%	2	2	93	93	1.2451434316651948E-27	1	1	222	122	32	51	-C
E7_BC55.191219_FM1-2_consensus_vsearch	1037	C	*/-T	431	16	3.52%	2	2	93	93	1.3310486209944137E-5	1	1	267	164	2	14	-T
E7_BC55.191219_FM1-2_consensus_vsearch	1039	C	*/-G	409	21	4.78%	2	2	93	93	3.712966667784702E-7	1	1	257	152	1	20	-G
E7_BC55.191219_FM1-2_consensus_vsearch	1041	G	*/-A	438	8	1.77%	2	2	93	93	0.0037845279531252564	1	1	258	180	7	1	-A
E7_BC55.191219_FM1-2_consensus_vsearch	1042	A	*/+G	435	7	1.58%	2	1	93	93	0.007627752045228881	1	1	251	184	7	0	+G
E7_BC55.191219_FM1-2_consensus_vsearch	1049	C	*/-G	431	8	1.79%	2	1	93	93	0.003782601599602771	1	1	256	175	8	0	-G
E7_BC55.191219_FM1-2_consensus_vsearch	1051	A	*/+G	389	11	2.44%	2	1	93	93	4.554223390235558E-4	1	1	209	180	11	0	+G
E7_BC55.191219_FM1-2_consensus_vsearch	1051	A	*/-G	389	10	2.22%	2	1	93	93	9.223889705434762E-4	1	1	209	180	10	0	+G
E7_BC55.191219_FM1-2_consensus_vsearch	1051	A	*/-GA	389	34	7.56%	2	2	93	93	2.917639473495372E-11	1	1	209	180	33	1	-GA
E7_BC55.191219_FM1-2_consensus_vsearch	1052	G	*/+A	382	8	1.97%	2	2	93	93	0.0037671973936205536	1	1	210	172	7	1	+A
E7_BC55.191219_FM1-2_consensus_vsearch	1052	G	*/-A	382	13	3.19%	2	2	93	93	1.1041780449831012E-4	1	1	210	172	3	10	-A
E7_BC55.191219_FM1-2_consensus_vsearch	1055	A	*/-T	435	7	1.55%	2	2	93	93	0.007627752045228881	1	1	261	174	1	6	-T
E7_BC55.191219_FM1-2_consensus_vsearch	1057	C	*/-A	421	19	4.21%	2	2	93	93	1.5639394759467178E-6	1	1	249	172	15	4	-A
E7_BC55.191219_FM1-2_consensus_vsearch	1063	C	*/-T	425	18	3.97%	2	2	93	93	3.198505438225124E-6	1	1	264	161	1	17	-T
E7_BC55.191219_FM1-2_consensus_vsearch	1066	T	*/-G	430	10	2.2%	2	2	93	93	9.273613705492817E-4	1	1	262	168	3	7	-G
E7_BC55.191219_FM1-2_consensus_vsearch	1073	T	*/+G	262	36	7.93%	2	2	93	93	4.7255055062786784E-12	1	1	162	100	8	28	+G
E7_BC55.191219_FM1-2_consensus_vsearch	1073	T	*/-G	262	125	27.53%	2	2	93	93	1.4352610039812366E-43	1	1	162	100	75	50	-G
E7_BC55.191219_FM1-2_consensus_vsearch	1073	T	*/-GG	262	23	5.07%	2	2	93	93	7.508723106253298E-8	1	1	162	100	18	5	-G
E7_BC55.191219_FM1-2_consensus_vsearch	1078	G	*/+A	401	18	3.96%	2	2	93	93	3.165704383176564E-6	1	1	226	175	17	1	+A
E7_BC55.191219_FM1-2_consensus_vsearch	1078	G	*/-AG	401	8	1.76%	2	2	93	93	0.0037736050099275447	1	1	226	175	2	6	+A
E7_BC55.191219_FM1-2_consensus_vsearch	1086	T	*/-C	439	8	1.76%	2	2	93	93	0.003784798257927548	1	1	261	178	3	5	-C
E7_BC55.191219_FM1-2_consensus_vsearch	1089	C	*/+A	405	15	3.33%	2	2	93	93	2.6872426494871398E-5	1	1	231	174	11	4	+A
E7_BC55.191219_FM1-2_consensus_vsearch	1089	C	*/-A	405	21	4.66%	2	2	93	93	3.704038652276923E-7	1	1	231	174	18	3	-A
E7_BC55.191219_FM1-2_consensus_vsearch	1095	T	*/+G	426	19	4.21%	2	2	93	93	1.567506340833558E-6	1	1	252	174	12	7	+G
E7_BC55.191219_FM1-2_consensus_vsearch	1096	G	*/+A	438	7	1.55%	2	1	93	93	0.007628991869306366	1	1	262	176	0	7	+A
E7_BC55.191219_FM1-2_consensus_vsearch	1100	C	*/-T	421	15	3.3%	2	2	93	93	2.7000302846488012E-5	1	1	247	174	7	8	-T
E7_BC55.191219_FM1-2_consensus_vsearch	1100	C	*/-TTA	421	9	1.98%	2	1	93	93	0.0018722700711233777	1	1	247	174	9	0	-T
E7_BC55.191219_FM1-2_consensus_vsearch	1102	T	*/+A	402	7	1.6%	2	2	93	93	0.0076129195598281015	1	1	221	181	6	1	+A
E7_BC55.191219_FM1-2_consensus_vsearch	1102	T	*/-A	402	18	4.11%	2	2	93	93	3.1671404471085125E-6	1	1	221	181	17	1	-A
E7_BC55.191219_FM1-2_consensus_vsearch	1105	A	*/-G	439	7	1.54%	2	2	93	93	0.00762940145447119	1	1	258	181	5	2	-G
E7_BC55.191219_FM1-2_consensus_vsearch	1107	G	*/-A	433	9	1.99%	2	2	93	93	0.001874441340367089	1	1	249	184	8	1	-A
E7_BC55.191219_FM1-2_consensus_vsearch	1113	A	*/+T	426	17	3.76%	2	2	93	93	6.5246507648444996E-6	1	1	262	164	2	15	+T
E7_BC55.191219_FM1-2_consensus_vsearch	1114	C	*/+G	408	11	2.44%	2	2	93	93	4.5688172943049915E-4	1	1	258	150	3	8	+G
E7_BC55.191219_FM1-2_consensus_vsearch	1116	G	*/+A	432	11	2.43%	2	2	93	93	4.5854977422456113E-4	1	1	252	180	10	1	+A
E7_BC55.191219_FM1-2_consensus_vsearch	1118	A	*/+G	420	12	2.65%	2	2	93	93	2.2595202981245667E-4	1	1	251	169	11	1	+G
E7_BC55.191219_FM1-2_consensus_vsearch	1118	A	*/-G	420	15	3.32%	2	2	93	93	2.6992573667884224E-5	1	1	251	169	3	12	-G
E7_BC55.191219_FM1-2_consensus_vsearch	1119	G	*/+A	408	9	2.06%	2	1	93	93	0.0018697784886581234	1	1	242	166	9	0	+A
E7_BC55.191219_FM1-2_consensus_vsearch	1119	G	*/+AG	408	10	2.29%	2	1	93	93	9.248125937902505E-4	1	1	242	166	10	0	+AG
E7_BC55.191219_FM1-2_consensus_vsearch	1120	G	*/+A	423	25	5.53%	2	1	93	93	2.1121828246927912E-8	1	1	238	185	25	0	+A
E7_BC55.191219_FM1-2_consensus_vsearch	1126	A	*/-CA	431	7	1.55%	2	1	93	93	0.007626072650234986	1	1	261	170	0	7	-CA
E7_BC55.191219_FM1-2_consensus_vsearch	1133	G	*/-TG	434	12	2.65%	2	1	93	93	2.2650904494607855E-4	1	1	267	167	0	12	-TG
E7_BC55.191219_FM1-2_consensus_vsearch	1136	G	*/-A	419	26	5.78%	2	1	93	93	1.0231231003831989E-8	1	1	240	179	26	0	-A
E7_BC55.191219_FM1-2_consensus_vsearch	1139	C	*/-T	429	8	1.77%	2	2	93	93	0.0037820399638697363	1	1	259	170	2	6	-T
E7_BC55.191219_FM1-2_consensus_vsearch	1141	T	*/+G	433	9	2%	2	1	93	93	0.001874441340367089	1	1	267	166	0	9	+G
E7_BC55.191219_FM1-2_consensus_vsearch	1143	C	*/+G	411	7	1.58%	2	1	93	93	0.007617195908814076	1	1	266	145	0	7	+G
E7_BC55.191219_FM1-2_consensus_vsearch	1146	C	*/-T	360	14	3.1%	2	2	93	93	5.3922580061608375E-5	1	1	195	165	7	7	-T
E7_BC55.191219_FM1-2_consensus_vsearch	1146	C	*/-TT	360	59	13.05%	2	1	93	93	1.9277861555666706E-19	1	1	195	165	59	0	-TT
E7_BC55.191219_FM1-2_consensus_vsearch	1157	T	*/+C	424	8	1.79%	2	2	93	93	0.0037806132981311326	1	1	256	168	7	1	+C
E7_BC55.191219_FM1-2_consensus_vsearch	1157	T	*/-C	424	11	2.46%	2	1	93	93	4.580137992598773E-4	1	1	256	168	0	11	-C
E7_BC55.191219_FM1-2_consensus_vsearch	1163	C	*/+G	229	15	3.34%	2	2	93	93	2.4447196886404097E-5	1	1	86	143	12	3	+G
E7_BC55.191219_FM1-2_consensus_vsearch	1163	C	*/-G	229	149	33.18%	2	2	93	93	1.526665979679838E-53	1	1	86	143	117	32	-G
E7_BC55.191219_FM1-2_consensus_vsearch	1163	C	*/-GG	229	40	8.91%	2	2	93	93	1.899109847996336E-13	1	1	86	143	38	2	-G
E7_BC55.191219_FM1-2_consensus_vsearch	1167	G	*/-A	433	12	2.64%	2	2	93	93	2.2647039152581312E-4	1	1	263	170	3	9	-A
E7_BC55.191219_FM1-2_consensus_vsearch	1170	A	*/+C	438	7	1.55%	2	1	93	93	0.007628991869306366	1	1	262	176	0	7	+C
E7_BC55.191219_FM1-2_consensus_vsearch	1174	A	*/+C	416	14	3.13%	2	1	93	93	5.4813912517372454E-5	1	1	236	180	14	0	+C
E7_BC55.191219_FM1-2_consensus_vsearch	1174	A	*/-C	416	13	2.91%	2	2	93	93	1.1131241336260559E-4	1	1	236	180	10	3	+C
E7_BC55.191219_FM1-2_consensus_vsearch	1180	T	*/-C	410	38	8.39%	2	1	93	93	1.6036749756780597E-12	1	1	226	184	38	0	-C
E7_BC55.191219_FM1-2_consensus_vsearch	1183	A	*/-G	433	11	2.43%	2	1	93	93	4.5861543978572406E-4	1	1	251	182	11	0	-G
E7_BC55.191219_FM1-2_consensus_vsearch	1192	G	*/-AG	435	8	1.78%	2	1	93	93	0.0037837097715777354	1	1	252	183	8	0	-AG
E7_BC55.191219_FM1-2_consensus_vsearch	1193	A	*/+G	405	7	1.58%	2	2	93	93	0.007614365665405034	1	1	233	172	3	4	+G
E7_BC55.191219_FM1-2_consensus_vsearch	1193	A	*/-G	405	24	5.42%	2	2	93	93	4.2817759008625E-8	1	1	233	172	20	4	-G
E7_BC55.191219_FM1-2_consensus_vsearch	1194	G	*/+A	396	9	2.14%	2	1	93	93	0.0018673383028544072	1	1	220	176	9	0	+A
E7_BC55.191219_FM1-2_consensus_vsearch	1195	G	*/-A	412	38	8.39%	2	1	93	93	1.6097825698919589E-12	1	1	229	183	38	0	-A
E7_BC55.191219_FM1-2_consensus_vsearch	1206	T	*/+G	428	8	1.77%	2	1	93	93	0.0037817572285023734	1	1	252	176	0	8	+G
E7_BC55.191219_FM1-2_consensus_vsearch	1206	T	*/-G	428	10	2.21%	2	1	93	93	9.271400825692105E-4	1	1	252	176	10	0	-G
E7_BC55.191219_FM1-2_consensus_vsearch	1207	G	*/-A	434	7	1.58%	2	1	93	93	0.007627335039353406	1	1	250	184	7	0	-A
E7_BC55.191219_FM1-2_consensus_vsearch	1208	A	*/+T	431	9	2.01%	2	1	93	93	0.0018740875957096264	1	1	248	183	9	0	+T
E7_BC55.191219_FM1-2_consensus_vsearch	1209	T	*/+A	429	9	1.99%	2	2	93	93	0.0018737306563855328	1	1	248	181	8	1	+A
E7_BC55.191219_FM1-2_consensus_vsearch	1214	C	*/+T	381	27	6.05%	2	2	93	93	4.776095970881117E-9	1	1	260	121	3	24	+T
E7_BC55.191219_FM1-2_consensus_vsearch	1214	C	*/+TT	381	9	2.02%	2	1	93	93	0.0018640795393290628	1	1	260	121	0	9	+T
E7_BC55.191219_FM1-2_consensus_vsearch	1214	C	*/-T	381	28	6.28%	2	2	93	93	2.3091284069716537E-9	1	1	260	121	2	26	-T
E7_BC55.191219_FM1-2_consensus_vsearch	1217	T	*/-C	435	7	1.55%	2	1	93	93	0.007627752045228881	1	1	265	170	0	7	-C
E7_BC55.191219_FM1-2_consensus_vsearch	1218	C	*/+T	406	11	2.48%	2	1	93	93	4.5673424053118783E-4	1	1	267	139	0	11	+T
E7_BC55.191219_FM1-2_consensus_vsearch	1218	C	*/-T	406	20	4.51%	2	2	93	93	7.590542262785938E-7	1	1	267	139	1	19	-T
E7_BC55.191219_FM1-2_consensus_vsearch	1222	A	*/-T	423	15	3.33%	2	2	93	93	2.701566009065348E-5	1	1	251	172	10	5	-T
E7_BC55.191219_FM1-2_consensus_vsearch	1228	T	*/-G	428	11	2.47%	2	2	93	93	4.5828417992626897E-4	1	1	258	170	8	3	-G
E7_BC55.191219_FM1-2_consensus_vsearch	1237	G	*/-TG	433	7	1.57%	2	1	93	93	0.0076269161468125015	1	1	261	172	0	7	-TG
E7_BC55.191219_FM1-2_consensus_vsearch	1238	T	*/-GC	423	12	2.72%	2	1	93	93	2.2607433164831964E-4	1	1	266	157	0	12	-GC
E7_BC55.191219_FM1-2_consensus_vsearch	1247	G	*/+T	415	30	6.65%	2	1	93	93	5.617106074815266E-10	1	1	236	179	30	0	+T
E7_BC55.191219_FM1-2_consensus_vsearch	1250	C	*/-T	438	8	1.79%	2	2	93	93	0.0037845279531252564	1	1	267	171	1	7	-T
E7_BC55.191219_FM1-2_consensus_vsearch	1259	T	*/-G	423	11	2.43%	2	2	93	93	4.5794544103178105E-4	1	1	257	166	10	1	-G
E7_BC55.191219_FM1-2_consensus_vsearch	1261	G	*/-A	415	28	6.19%	2	1	93	93	2.398315875980072E-9	1	1	232	183	28	0	-A
E7_BC55.191219_FM1-2_consensus_vsearch	1263	G	*/-T	425	17	3.8%	2	2	93	93	6.522297955848449E-6	1	1	263	162	1	16	-T
E7_BC55.191219_FM1-2_consensus_vsearch	1264	T	*/+G	406	11	2.53%	2	1	93	93	4.5673424053118783E-4	1	1	257	149	0	11	+G
E7_BC55.191219_FM1-2_consensus_vsearch	1266	A	*/-T	433	7	1.57%	2	2	93	93	0.0076269161468125015	1	1	256	177	2	5	-T
E7_BC55.191219_FM1-2_consensus_vsearch	1277	T	*/-A	438	8	1.77%	2	2	93	93	0.0037845279531252564	1	1	256	182	6	2	-A
E7_BC55.191219_FM1-2_consensus_vsearch	1279	A	*/-T	439	7	1.55%	2	1	93	93	0.00762940145447119	1	1	263	176	0	7	-T
E7_BC55.191219_FM1-2_consensus_vsearch	1280	T	*/+C	435	8	1.8%	2	1	93	93	0.0037837097715777354	1	1	267	168	0	8	+C
E7_BC55.191219_FM1-2_consensus_vsearch	1281	T	*/-C	423	22	4.87%	2	2	93	93	1.827327995963688E-7	1	1	255	168	9	13	-C
E7_BC55.191219_FM1-2_consensus_vsearch	1283	C	*/+G	419	12	2.65%	2	2	93	93	2.2591089391076449E-4	1	1	261	158	1	11	+G
E7_BC55.191219_FM1-2_consensus_vsearch	1293	C	*/+A	423	13	2.88%	2	2	93	93	1.1147982255220776E-4	1	1	247	176	12	1	+A
E7_BC55.191219_FM1-2_consensus_vsearch	1293	C	*/-G	423	7	1.55%	2	2	93	93	0.007622620571895094	1	1	247	176	6	1	+A
E7_BC55.191219_FM1-2_consensus_vsearch	1304	T	*/-C	440	9	2%	2	1	93	93	0.0018756548982491606	1	1	269	171	0	9	-C
E7_BC55.191219_FM1-2_consensus_vsearch	1305	C	*/-T	433	8	1.8%	2	1	93	93	0.003783158179516694	1	1	266	167	0	8	-T
E7_BC55.191219_FM1-2_consensus_vsearch	1306	T	*/+C	433	7	1.57%	2	1	93	93	0.0076269161468125015	1	1	259	174	7	0	+C
E7_BC55.191219_FM1-2_consensus_vsearch	1307	C	*/-T	437	8	1.78%	2	2	93	93	0.00378425644253265	1	1	261	176	5	3	-T
E7_BC55.191219_FM1-2_consensus_vsearch	1308	T	*/+G	418	14	3.16%	2	1	93	93	5.4841636470744183E-5	1	1	242	176	14	0	+G
E7_BC55.191219_FM1-2_consensus_vsearch	1314	A	*/-G	434	9	2%	2	1	93	93	0.0018746170280654298	1	1	250	184	9	0	-G
E7_BC55.191219_FM1-2_consensus_vsearch	1315	G	*/-AG	387	45	10.16%	2	2	93	93	8.486746548559036E-15	1	1	206	181	41	4	-AG
E7_BC55.191219_FM1-2_consensus_vsearch	1324	C	*/+T	260	16	3.58%	2	2	93	93	1.2200205814354207E-5	1	1	158	102	4	12	+T
E7_BC55.191219_FM1-2_consensus_vsearch	1324	C	*/-T	260	119	26.62%	2	2	93	93	2.4082110392853277E-41	1	1	158	102	82	37	-T
E7_BC55.191219_FM1-2_consensus_vsearch	1324	C	*/-TT	260	28	6.26%	2	2	93	93	1.8695620539695493E-9	1	1	158	102	22	6	-T
E7_BC55.191219_FM1-2_consensus_vsearch	1324	C	*/-TTT	260	12	2.68%	2	1	93	93	2.1567900632063892E-4	1	1	158	102	0	12	-T
E7_BC55.191219_FM1-2_consensus_vsearch	1334	G	*/-C	432	11	2.43%	2	1	93	93	4.5854977422456113E-4	1	1	252	180	11	0	-C
E7_BC55.191219_FM1-2_consensus_vsearch	1341	T	*/-C	421	14	3.13%	2	2	93	93	5.4882762612112586E-5	1	1	257	164	9	5	-C
E7_BC55.191219_FM1-2_consensus_vsearch	1344	T	*/-C	385	7	1.58%	2	2	93	93	0.007604309052101333	1	1	262	123	2	5	-C
E7_BC55.191219_FM1-2_consensus_vsearch	1344	T	*/-CT	385	41	9.28%	2	2	93	93	1.6547963174145619E-13	1	1	262	123	1	40	-CT
E7_BC55.191219_FM1-2_consensus_vsearch	1345	C	*/-T	391	7	1.73%	2	2	93	93	0.007607431615374521	1	1	262	129	1	6	-T
E7_BC55.191219_FM1-2_consensus_vsearch	1347	T	*/+A	435	9	2%	2	1	93	93	0.0018747919330438447	1	1	254	181	9	0	+A
E7_BC55.191219_FM1-2_consensus_vsearch	1348	A	*/+G	421	22	4.9%	2	1	93	93	1.8250798754561758E-7	1	1	263	158	0	22	+G
E7_BC55.191219_FM1-2_consensus_vsearch	1350	A	*/-G	233	209	46.76%	2	2	93	93	7.574535416660371E-78	1	1	76	157	183	26	-G
E7_BC55.191219_FM1-2_consensus_vsearch	1356	T	*/+G	386	42	9.29%	2	1	93	93	7.896835360218272E-14	1	1	249	137	0	42	+G
E7_BC55.191219_FM1-2_consensus_vsearch	1356	T	*/-G	386	8	1.77%	2	2	93	93	0.003768597288121233	1	1	249	137	7	1	+G
E7_BC55.191219_FM1-2_consensus_vsearch	1357	G	*/-A	425	12	2.7%	2	2	93	93	2.2615495697455397E-4	1	1	249	176	8	4	-A
E7_BC55.191219_FM1-2_consensus_vsearch	1360	C	*/-AC	409	28	6.25%	2	1	93	93	2.3833851009692717E-9	1	1	234	175	28	0	-AC
E7_BC55.191219_FM1-2_consensus_vsearch	1373	T	*/-G	379	54	12.05%	2	2	93	93	9.52651558106936E-18	1	1	231	148	23	31	-G
E7_BC55.191219_FM1-2_consensus_vsearch	1378	G	*/-T	422	22	4.9%	2	2	93	93	1.826206185051853E-7	1	1	243	179	19	3	-T
E7_BC55.191219_FM1-2_consensus_vsearch	1380	T	*/+C	429	22	4.87%	2	1	93	93	1.8339658693410565E-7	1	1	246	183	22	0	+C
E7_BC55.191219_FM1-2_consensus_vsearch	1381	T	*/-G	427	7	1.55%	2	2	93	93	0.007624362444354587	1	1	252	175	5	2	-G
E7_BC55.191219_FM1-2_consensus_vsearch	1383	C	*/+A	419	7	1.56%	2	2	93	93	0.007620846145152445	1	1	255	164	1	6	+A
E7_BC55.191219_FM1-2_consensus_vsearch	1383	C	*/-G	419	8	1.78%	2	2	93	93	0.0037791534811211507	1	1	255	164	1	7	-G
E7_BC55.191219_FM1-2_consensus_vsearch	1386	C	*/-A	418	17	3.79%	2	2	93	93	6.505544070653668E-6	1	1	262	156	1	16	-A
E7_BC55.191219_FM1-2_consensus_vsearch	1389	T	*/-A	416	10	2.25%	2	1	93	93	9.257694036262042E-4	1	1	256	160	10	0	-A
E7_BC55.191219_FM1-2_consensus_vsearch	1404	G	*/+C	428	8	1.77%	2	2	93	93	0.0037817572285023734	1	1	256	172	6	2	+C
E7_BC55.191219_FM1-2_consensus_vsearch	1404	G	*/-C	428	12	2.65%	2	2	93	93	2.2627455527610537E-4	1	1	256	172	6	6	-C
E7_BC55.191219_FM1-2_consensus_vsearch	1405	C	*/+T	425	9	2.04%	2	1	93	93	0.0018730070190884252	1	1	261	164	0	9	+T
E7_BC55.191219_FM1-2_consensus_vsearch	1407	C	*/+T	423	11	2.42%	2	1	93	93	4.5794544103178105E-4	1	1	261	162	0	11	+T
E7_BC55.191219_FM1-2_consensus_vsearch	1407	C	*/-T	423	7	1.54%	2	2	93	93	0.007622620571895094	1	1	261	162	1	6	+T
E7_BC55.191219_FM1-2_consensus_vsearch	1416	T	*/+C	435	10	2.2%	2	2	93	93	9.279060186061013E-4	1	1	256	179	9	1	+C
E7_BC55.191219_FM1-2_consensus_vsearch	1417	C	*/+T	433	12	2.67%	2	1	93	93	2.2647039152581312E-4	1	1	265	168	0	12	+T
E7_BC55.191219_FM1-2_consensus_vsearch	1418	T	*/-G	436	7	1.56%	2	2	93	93	0.007628167177128368	1	1	262	174	2	5	-G
E7_BC55.191219_FM1-2_consensus_vsearch	1420	G	*/+A	434	10	2.21%	2	1	93	93	9.277980556005647E-4	1	1	255	179	10	0	+A
E7_BC55.191219_FM1-2_consensus_vsearch	1421	G	+C/+C	75	343	75.55%	2	2	93	93	7.74794049867897E-161	1	1	64	11	196	147	+C
E7_BC55.191219_FM1-2_consensus_vsearch	1422	C	*/+T	381	7	1.56%	2	2	93	93	0.007602173974125566	1	1	212	169	1	6	+T
E7_BC55.191219_FM1-2_consensus_vsearch	1422	C	*/-G	381	27	6%	2	2	93	93	4.776095970881117E-9	1	1	212	169	25	2	-G
E7_BC55.191219_FM1-2_consensus_vsearch	1422	C	*/-GCA	381	25	5.56%	2	2	93	93	2.0360009198932435E-8	1	1	212	169	24	1	-G
E7_BC55.191219_FM1-2_consensus_vsearch	1428	C	*/-GCGC	435	7	1.55%	2	1	93	93	0.007627752045228881	1	1	252	183	7	0	-GCGC
E7_BC55.191219_FM1-2_consensus_vsearch	1430	C	*/-GC	295	127	28.73%	2	2	93	93	7.959274821330152E-44	1	1	156	139	86	41	-GC
E7_BC55.191219_FM1-2_consensus_vsearch	1432	C	*/-T	289	8	2.52%	2	2	93	93	0.0037241392015619126	1	1	155	134	6	2	-T
E7_BC55.191219_FM1-2_consensus_vsearch	1435	C	*/-AC	419	16	3.54%	2	1	93	93	1.3259509871934923E-5	1	1	241	178	16	0	-AC
E7_BC55.191219_FM1-2_consensus_vsearch	1437	C	*/-T	420	8	1.83%	2	2	93	93	0.003779448151948946	1	1	238	182	6	2	-T
E7_BC55.191219_FM1-2_consensus_vsearch	1442	A	*/-G	423	9	2%	2	2	93	93	0.0018726402317850155	1	1	261	162	1	8	-G
E7_BC55.191219_FM1-2_consensus_vsearch	1443	G	*/+A	427	7	1.59%	2	1	93	93	0.007624362444354587	1	1	257	170	7	0	+A
E7_BC55.191219_FM1-2_consensus_vsearch	1450	C	*/-G	415	18	4.01%	2	2	93	93	3.1852487497487506E-6	1	1	239	176	17	1	-G
E7_BC55.191219_FM1-2_consensus_vsearch	1451	G	*/-A	404	18	4.15%	2	2	93	93	3.169993651046948E-6	1	1	225	179	17	1	-A
E7_BC55.191219_FM1-2_consensus_vsearch	1455	A	*/+T	270	20	4.43%	2	2	93	93	6.794414573767185E-7	1	1	135	135	17	3	+T
E7_BC55.191219_FM1-2_consensus_vsearch	1455	A	*/-T	270	154	34.15%	2	2	93	93	1.633579577050908E-54	1	1	135	135	110	44	-T
E7_BC55.191219_FM1-2_consensus_vsearch	1460	T	*/-C	421	23	5.07%	2	2	93	93	8.899064781650921E-8	1	1	244	177	18	5	-C
E7_BC55.191219_FM1-2_consensus_vsearch	1462	C	*/-T	402	35	7.71%	2	2	93	93	1.4323696223108268E-11	1	1	255	147	6	29	-T
E7_BC55.191219_FM1-2_consensus_vsearch	1467	C	*/-A	425	10	2.23%	2	1	93	93	9.268043937944601E-4	1	1	244	181	10	0	-A
E7_BC55.191219_FM1-2_consensus_vsearch	1470	A	*/-G	411	24	5.32%	2	1	93	93	4.3019061497432856E-8	1	1	240	171	24	0	-G
E7_BC55.191219_FM1-2_consensus_vsearch	1470	A	*/-GA	411	14	3.1%	2	2	93	93	5.474350555951183E-5	1	1	240	171	1	13	-G
E7_BC55.191219_FM1-2_consensus_vsearch	1475	T	*/-C	370	77	17.04%	2	2	93	93	1.8364768281296207E-25	1	1	191	179	76	1	-C
E7_BC55.191219_FM1-2_consensus_vsearch	1477	C	*/-G	395	20	4.41%	2	2	93	93	7.543651339090008E-7	1	1	264	131	1	19	-G
E7_BC55.191219_FM1-2_consensus_vsearch	1477	C	*/-GG	395	29	6.39%	2	1	93	93	1.1348197897367633E-9	1	1	264	131	0	29	-GG
E7_BC55.191219_FM1-2_consensus_vsearch	1487	T	*/+G	432	11	2.44%	2	2	93	93	4.5854977422456113E-4	1	1	254	178	9	2	+G
E7_BC55.191219_FM1-2_consensus_vsearch	1488	G	*/-TG	427	10	2.22%	2	1	93	93	9.270286906046182E-4	1	1	250	177	10	0	-TG
E7_BC55.191219_FM1-2_consensus_vsearch	1496	C	*/+T	438	7	1.54%	2	1	93	93	0.007628991869306366	1	1	268	170	0	7	+T
E7_BC55.191219_FM1-2_consensus_vsearch	1501	G	*/-TG	428	16	3.53%	2	1	93	93	1.3297986993183741E-5	1	1	262	166	0	16	-TG
E7_BC55.191219_FM1-2_consensus_vsearch	1505	T	*/+G	420	7	1.56%	2	2	93	93	0.007621292853586086	1	1	249	171	5	2	+G
E7_BC55.191219_FM1-2_consensus_vsearch	1505	T	*/-G	420	12	2.67%	2	2	93	93	2.2595202981245667E-4	1	1	249	171	6	6	-G
E7_BC55.191219_FM1-2_consensus_vsearch	1511	T	*/+G	417	18	3.96%	2	1	93	93	3.187945394524003E-6	1	1	235	182	18	0	+G
E7_BC55.191219_FM1-2_consensus_vsearch	1511	T	*/-A	417	17	3.74%	2	2	93	93	6.503109267247564E-6	1	1	235	182	15	2	+G
E7_BC55.191219_FM1-2_consensus_vsearch	1512	A	*/-G	417	16	3.66%	2	1	93	93	1.3250753783082343E-5	1	1	235	182	16	0	-G
E7_BC55.191219_FM1-2_consensus_vsearch	1513	G	*/-A	417	12	2.74%	2	2	93	93	2.2582806164226E-4	1	1	238	179	11	1	-A
E7_BC55.191219_FM1-2_consensus_vsearch	1517	A	*/+T	431	10	2.24%	2	1	93	93	9.274712732448419E-4	1	1	251	180	10	0	+T
E7_BC55.191219_FM1-2_consensus_vsearch	1521	C	*/-A	424	21	4.67%	2	2	93	93	3.745160444570394E-7	1	1	260	164	5	16	-A
E7_BC55.191219_FM1-2_consensus_vsearch	1525	T	*/-A	423	20	4.42%	2	1	93	93	7.658841069212707E-7	1	1	243	180	20	0	-A
E7_BC55.191219_FM1-2_consensus_vsearch	1529	G	*/+C	438	10	2.21%	2	1	93	93	9.282270587880905E-4	1	1	264	174	0	10	+C
E7_BC55.191219_FM1-2_consensus_vsearch	1530	C	*/-T	437	11	2.44%	2	1	93	93	4.588752277082112E-4	1	1	264	173	0	11	-T
E7_BC55.191219_FM1-2_consensus_vsearch	1531	T	*/-C	427	9	2.04%	2	1	93	93	0.0018733704789343226	1	1	264	163	0	9	-C
E7_BC55.191219_FM1-2_consensus_vsearch	1540	A	*/-G	388	39	8.69%	2	2	93	93	7.329327232862585E-13	1	1	215	173	35	4	-G
E7_BC55.191219_FM1-2_consensus_vsearch	1540	A	*/-GGA	388	7	1.56%	2	2	93	93	0.007605882130108492	1	1	215	173	5	2	-G
E7_BC55.191219_FM1-2_consensus_vsearch	1546	G	*/+C	423	14	3.13%	2	2	93	93	5.490987823300768E-5	1	1	243	180	11	3	+C
E7_BC55.191219_FM1-2_consensus_vsearch	1552	T	*/+A	424	8	1.78%	2	1	93	93	0.0037806132981311326	1	1	260	164	0	8	+A
E7_BC55.191219_FM1-2_consensus_vsearch	1552	T	*/-A	424	7	1.56%	2	2	93	93	0.007623059056742502	1	1	260	164	5	2	+A
E7_BC55.191219_FM1-2_consensus_vsearch	1557	G	*/+CG	435	7	1.54%	2	2	93	93	0.007627752045228881	1	1	258	177	6	1	+CG
E7_BC55.191219_FM1-2_consensus_vsearch	1558	T	*/+A	416	8	1.79%	2	2	93	93	0.003778261194268045	1	1	243	173	7	1	+A
E7_BC55.191219_FM1-2_consensus_vsearch	1558	T	*/+G	416	8	1.79%	2	2	93	93	0.003778261194268045	1	1	243	173	4	4	+A
E7_BC55.191219_FM1-2_consensus_vsearch	1558	T	*/-G	416	10	2.24%	2	1	93	93	9.257694036262042E-4	1	1	243	173	10	0	-G
E7_BC55.191219_FM1-2_consensus_vsearch	1559	G	*/-A	424	11	2.5%	2	1	93	93	4.580137992598773E-4	1	1	243	181	11	0	-A
E7_BC55.191219_FM1-2_consensus_vsearch	1570	T	*/-C	435	7	1.56%	2	1	93	93	0.007627752045228881	1	1	265	170	0	7	-C
E7_BC55.191219_FM1-2_consensus_vsearch	1584	T	*/+C	332	24	5.3%	2	2	93	93	3.991628628820214E-8	1	1	165	167	20	4	+C
E7_BC55.191219_FM1-2_consensus_vsearch	1584	T	*/-C	332	89	19.65%	2	2	93	93	8.83181731990264E-30	1	1	165	167	79	10	-C
E7_BC55.191219_FM1-2_consensus_vsearch	1587	C	*/-T	432	11	2.43%	2	2	93	93	4.5854977422456113E-4	1	1	257	175	4	7	-T
E7_BC55.191219_FM1-2_consensus_vsearch	1589	G	*/+C	411	9	2.01%	2	2	93	93	0.0018703670005234343	1	1	236	175	6	3	+C
E7_BC55.191219_FM1-2_consensus_vsearch	1589	G	*/-C	411	12	2.68%	2	2	93	93	2.2557498827275595E-4	1	1	236	175	8	4	-C
E7_BC55.191219_FM1-2_consensus_vsearch	1590	C	*/+T	422	9	2.06%	2	1	93	93	0.0018724555760242295	1	1	253	169	0	9	+T
E7_BC55.191219_FM1-2_consensus_vsearch	1592	C	*/-T	371	65	14.35%	2	2	93	93	2.0567434742151078E-21	1	1	255	116	2	63	-T
E7_BC55.191219_FM1-2_consensus_vsearch	1601	C	*/-AC	384	55	12.17%	2	2	93	93	4.566925191957679E-18	1	1	232	152	33	22	-AC
E7_BC55.191219_FM1-2_consensus_vsearch	1602	A	*/+C	370	11	2.82%	2	1	93	93	4.5382073751055476E-4	1	1	228	142	0	11	+C
E7_BC55.191219_FM1-2_consensus_vsearch	1605	G	*/-C	435	9	1.99%	2	2	93	93	0.0018747919330438447	1	1	252	183	8	1	-C
E7_BC55.191219_FM1-2_consensus_vsearch	1611	C	*/-G	439	7	1.56%	2	1	93	93	0.00762940145447119	1	1	256	183	7	0	-G
E7_BC55.191219_FM1-2_consensus_vsearch	1616	C	*/-TAC	432	11	2.43%	2	2	93	93	4.5854977422456113E-4	1	1	255	177	9	2	-TAC
E7_BC55.191219_FM1-2_consensus_vsearch	1621	G	*/-A	445	7	1.55%	2	1	93	93	0.007631821078608308	1	1	261	184	7	0	-A
E7_BC55.191219_FM1-2_consensus_vsearch	1625	G	*/-A	445	7	1.54%	2	2	93	93	0.007631821078608308	1	1	263	182	4	3	-A
E7_BC55.191219_FM1-2_consensus_vsearch	1631	C	*/-T	420	16	3.53%	2	1	93	93	1.3263859391341419E-5	1	1	249	171	16	0	-T
E7_BC55.191219_FM1-2_consensus_vsearch	1633	T	*/+G	417	11	2.44%	2	2	93	93	4.575287206333824E-4	1	1	235	182	10	1	+G
E7_BC55.191219_FM1-2_consensus_vsearch	1634	A	*/-G	432	8	1.77%	2	2	93	93	0.0037828805172695963	1	1	252	180	7	1	-G
E7_BC55.191219_FM1-2_consensus_vsearch	1636	T	*/+A	415	24	5.33%	2	1	93	93	4.3150629281374106E-8	1	1	237	178	24	0	+A
E7_BC55.191219_FM1-2_consensus_vsearch	1637	G	*/-A	433	13	2.89%	2	1	93	93	1.1171014262094148E-4	1	1	248	185	13	0	-A
E7_BC55.191219_FM1-2_consensus_vsearch	1638	A	*/-G	423	9	2.04%	2	2	93	93	0.0018726402317850155	1	1	245	178	4	5	-G
E7_BC55.191219_FM1-2_consensus_vsearch	1640	G	*/-C	429	17	3.74%	2	2	93	93	6.5316496955632174E-6	1	1	262	167	2	15	-C
E7_BC55.191219_FM1-2_consensus_vsearch	1642	C	*/+T	395	20	4.42%	2	1	93	93	7.543651339090008E-7	1	1	259	136	0	20	+T
E7_BC55.191219_FM1-2_consensus_vsearch	1642	C	*/-T	395	21	4.65%	2	2	93	93	3.6810476750993E-7	1	1	259	136	7	14	-T
E7_BC55.191219_FM1-2_consensus_vsearch	1644	T	*/+C	419	19	4.19%	2	2	93	93	1.562491752356326E-6	1	1	239	180	18	1	+C
E7_BC55.191219_FM1-2_consensus_vsearch	1644	T	*/-C	419	11	2.42%	2	2	93	93	4.576688933102391E-4	1	1	239	180	9	2	+C
E7_BC55.191219_FM1-2_consensus_vsearch	1645	C	*/+T	383	8	1.81%	2	1	93	93	0.0037675500295774327	1	1	256	127	0	8	+T
E7_BC55.191219_FM1-2_consensus_vsearch	1645	C	*/-G	383	43	9.75%	2	2	93	93	3.7241796831736845E-14	1	1	256	127	1	42	-G
E7_BC55.191219_FM1-2_consensus_vsearch	1647	G	*/-A	426	26	5.73%	2	2	93	93	1.029273738521168E-8	1	1	243	183	25	1	-A
E7_BC55.191219_FM1-2_consensus_vsearch	1650	T	*/-G	431	13	2.86%	2	2	93	93	1.1166488301300728E-4	1	1	260	171	6	7	-G
E7_BC55.191219_FM1-2_consensus_vsearch	1653	C	*/-T	427	8	1.78%	2	2	93	93	0.0037814732031268648	1	1	253	174	6	2	-T
E7_BC55.191219_FM1-2_consensus_vsearch	1653	C	*/-TT	427	10	2.22%	2	2	93	93	9.270286906046182E-4	1	1	253	174	5	5	-TT
E7_BC55.191219_FM1-2_consensus_vsearch	1656	C	*/-G	372	46	10.45%	2	2	93	93	3.834292310326099E-15	1	1	234	138	12	34	-G
E7_BC55.191219_FM1-2_consensus_vsearch	1657	G	*/+A	314	10	2.5%	2	1	93	93	9.101036737212366E-4	1	1	182	132	10	0	+A
E7_BC55.191219_FM1-2_consensus_vsearch	1662	T	*/+C	151	295	65.12%	2	2	93	93	1.8067528045115711E-122	1	1	128	23	137	158	+C
E7_BC55.191219_FM1-2_consensus_vsearch	1663	C	*/-G	424	16	3.55%	2	2	93	93	1.3281070163027198E-5	1	1	245	179	15	1	-G
E7_BC55.191219_FM1-2_consensus_vsearch	1665	G	*/-A	413	29	6.44%	2	2	93	93	1.1587405680343973E-9	1	1	242	171	17	12	-A
E7_BC55.191219_FM1-2_consensus_vsearch	1673	A	*/+C	418	10	2.22%	2	2	93	93	9.260031044371504E-4	1	1	248	170	2	8	+C
E7_BC55.191219_FM1-2_consensus_vsearch	1673	A	*/-C	418	19	4.21%	2	2	93	93	1.5617633199588545E-6	1	1	248	170	14	5	-C
E7_BC55.191219_FM1-2_consensus_vsearch	1676	C	*/-T	437	14	3.08%	2	2	93	93	5.5093201188592644E-5	1	1	265	172	3	11	-T
E7_BC55.191219_FM1-2_consensus_vsearch	1685	A	*/-G	309	39	8.76%	2	2	93	93	5.889822285784529E-13	1	1	131	178	38	1	-G
E7_BC55.191219_FM1-2_consensus_vsearch	1685	A	*/-GA	309	92	20.67%	2	1	93	93	5.4880924409179125E-31	1	1	131	178	92	0	-GA
E7_BC55.191219_FM1-2_consensus_vsearch	1686	G	*/-A	299	12	3.74%	2	2	93	93	2.191222894905056E-4	1	1	116	183	11	1	-A
E7_BC55.191219_FM1-2_consensus_vsearch	1688	A	*/-G	433	12	2.67%	2	1	93	93	2.2647039152581312E-4	1	1	249	184	12	0	-G
E7_BC55.191219_FM1-2_consensus_vsearch	1689	G	*/+A	428	8	1.81%	2	1	93	93	0.0037817572285023734	1	1	244	184	8	0	+A
E7_BC55.191219_FM1-2_consensus_vsearch	1694	T	*/+C	431	14	3.08%	2	1	93	93	5.501599410545798E-5	1	1	250	181	14	0	+C
E7_BC55.191219_FM1-2_consensus_vsearch	1699	C	*/-T	433	7	1.55%	2	2	93	93	0.0076269161468125015	1	1	260	173	1	6	-T
E7_BC55.191219_FM1-2_consensus_vsearch	1699	C	*/-TT	433	8	1.77%	2	2	93	93	0.003783158179516694	1	1	260	173	6	2	-TT
E7_BC55.191219_FM1-2_consensus_vsearch	1701	T	*/-G	427	7	1.57%	2	2	93	93	0.007624362444354587	1	1	257	170	3	4	-G
E7_BC55.191219_FM1-2_consensus_vsearch	1706	A	*/+T	407	23	5.13%	2	1	93	93	8.812488070903023E-8	1	1	231	176	23	0	+T
E7_BC55.191219_FM1-2_consensus_vsearch	1706	A	*/-T	407	9	2.01%	2	2	93	93	0.0018695804538677086	1	1	231	176	6	3	+T
E7_BC55.191219_FM1-2_consensus_vsearch	1709	T	*/+A	429	15	3.3%	2	1	93	93	2.7060938566629196E-5	1	1	247	182	15	0	+A
E7_BC55.191219_FM1-2_consensus_vsearch	1710	A	*/+G	419	15	3.33%	2	1	93	93	2.6984810488819573E-5	1	1	255	164	0	15	+G
E7_BC55.191219_FM1-2_consensus_vsearch	1711	G	*/+A	425	9	2.01%	2	1	93	93	0.0018730070190884252	1	1	241	184	9	0	+A
E7_BC55.191219_FM1-2_consensus_vsearch	1711	G	*/-AG	425	7	1.57%	2	2	93	93	0.007623495521158642	1	1	241	184	6	1	+A
E7_BC55.191219_FM1-2_consensus_vsearch	1712	A	*/+G	387	7	1.58%	2	2	93	93	0.007605360418658285	1	1	207	180	5	2	+G
E7_BC55.191219_FM1-2_consensus_vsearch	1712	A	*/-G	387	37	8.37%	2	2	93	93	3.2014263687382928E-12	1	1	207	180	35	2	-G
E7_BC55.191219_FM1-2_consensus_vsearch	1714	G	*/-A	411	20	4.52%	2	1	93	93	7.611138031103958E-7	1	1	226	185	20	0	-A
E7_BC55.191219_FM1-2_consensus_vsearch	1718	T	*/+A	342	20	4.5%	2	2	93	93	7.282126575285166E-7	1	1	213	129	16	4	+A
E7_BC55.191219_FM1-2_consensus_vsearch	1718	T	*/-A	342	67	15.09%	2	2	93	93	3.561012682586598E-22	1	1	213	129	25	42	-A
E7_BC55.191219_FM1-2_consensus_vsearch	1721	A	*/+G	428	17	3.74%	2	1	93	93	6.529326572028581E-6	1	1	244	184	17	0	+G
E7_BC55.191219_FM1-2_consensus_vsearch	1722	A	*/-G	427	18	3.96%	2	2	93	93	3.201090232328667E-6	1	1	246	181	17	1	-G
E7_BC55.191219_FM1-2_consensus_vsearch	1723	G	*/+AA	400	12	2.76%	2	1	93	93	2.2509239120889853E-4	1	1	218	182	12	0	+AA
E7_BC55.191219_FM1-2_consensus_vsearch	1727	T	*/+A	422	7	1.57%	2	1	93	93	0.007622180052576428	1	1	260	162	0	7	+A
E7_BC55.191219_FM1-2_consensus_vsearch	1727	T	*/-A	422	7	1.57%	2	2	93	93	0.007622180052576428	1	1	260	162	4	3	+A
E7_BC55.191219_FM1-2_consensus_vsearch	1730	C	*/+A	369	33	7.47%	2	1	93	93	5.870828506173398E-11	1	1	212	157	33	0	+A
E7_BC55.191219_FM1-2_consensus_vsearch	1730	C	*/-A	369	9	2.04%	2	2	93	93	0.001861288716262604	1	1	212	157	7	2	+A
E7_BC55.191219_FM1-2_consensus_vsearch	1737	T	*/-C	429	19	4.19%	2	2	93	93	1.5696112350960334E-6	1	1	261	168	8	11	-C
E7_BC55.191219_FM1-2_consensus_vsearch	1739	C	*/-GT	437	8	1.77%	2	2	93	93	0.00378425644253265	1	1	265	172	1	7	-GT
E7_BC55.191219_FM1-2_consensus_vsearch	1742	A	*/-G	429	10	2.24%	2	2	93	93	9.272509747675099E-4	1	1	255	174	5	5	-G
E7_BC55.191219_FM1-2_consensus_vsearch	1753	C	*/+G	417	10	2.24%	2	1	93	93	9.258865234089794E-4	1	1	259	158	0	10	+G
E7_BC55.191219_FM1-2_consensus_vsearch	1775	C	*/+A	413	10	2.21%	2	2	93	93	9.254147741675464E-4	1	1	239	174	9	1	+A
E7_BC55.191219_FM1-2_consensus_vsearch	1775	C	*/-A	413	20	4.42%	2	2	93	93	7.619255358760037E-7	1	1	239	174	17	3	-A
E7_BC55.191219_FM1-2_consensus_vsearch	1778	A	*/-G	429	7	1.54%	2	2	93	93	0.007625221451403564	1	1	263	166	3	4	-G
E7_BC55.191219_FM1-2_consensus_vsearch	1783	G	*/-TG	414	32	7.08%	2	2	93	93	1.3081363754474417E-10	1	1	265	149	2	30	-TG
E7_BC55.191219_FM1-2_consensus_vsearch	1793	T	*/+G	436	7	1.55%	2	1	93	93	0.007628167177128368	1	1	263	173	0	7	+G
E7_BC55.191219_FM1-2_consensus_vsearch	1796	T	*/+C	436	9	2%	2	1	93	93	0.0018749660605302289	1	1	265	171	0	9	+C
E7_BC55.191219_FM1-2_consensus_vsearch	1797	T	*/-C	437	7	1.55%	2	1	93	93	0.007628580447648388	1	1	263	174	0	7	-C
E7_BC55.191219_FM1-2_consensus_vsearch	1798	C	*/-GC	422	12	2.7%	2	2	93	93	2.2603374744065776E-4	1	1	252	170	11	1	-GC
E7_BC55.191219_FM1-2_consensus_vsearch	1803	G	*/-TG	428	10	2.22%	2	2	93	93	9.271400825692105E-4	1	1	249	179	7	3	-TG
E7_BC55.191219_FM1-2_consensus_vsearch	1804	T	*/-GC	423	9	2.03%	2	2	93	93	0.0018726402317850155	1	1	251	172	6	3	-GC
E7_BC55.191219_FM1-2_consensus_vsearch	1806	C	*/-A	426	12	2.7%	2	1	93	93	2.2619500050778872E-4	1	1	247	179	12	0	-A
E7_BC55.191219_FM1-2_consensus_vsearch	1808	C	*/-T	429	10	2.24%	2	1	93	93	9.272509747675099E-4	1	1	260	169	0	10	-T
E7_BC55.191219_FM1-2_consensus_vsearch	1809	T	*/+C	380	19	4.32%	2	2	93	93	1.5316142463136337E-6	1	1	240	140	15	4	+C
E7_BC55.191219_FM1-2_consensus_vsearch	1809	T	*/-C	380	18	4.09%	2	2	93	93	3.134009125315532E-6	1	1	240	140	8	10	+C
E7_BC55.191219_FM1-2_consensus_vsearch	1809	T	*/-CC	380	8	1.82%	2	1	93	93	0.003766486715388715	1	1	240	140	0	8	+C
E7_BC55.191219_FM1-2_consensus_vsearch	1809	T	*/-CCT	380	9	2.05%	2	1	93	93	0.0018638534646934156	1	1	240	140	0	9	-CCT
E7_BC55.191219_FM1-2_consensus_vsearch	1811	C	*/+T	392	9	2.07%	2	1	93	93	0.0018664928473143382	1	1	255	137	0	9	+T
E7_BC55.191219_FM1-2_consensus_vsearch	1811	C	*/-T	392	16	3.68%	2	2	93	93	1.3134469842360711E-5	1	1	255	137	5	11	-T
E7_BC55.191219_FM1-2_consensus_vsearch	1826	C	*/-ACAC	441	9	1.99%	2	2	93	93	0.0018758252149176666	1	1	259	182	7	2	-ACAC
E7_BC55.191219_FM1-2_consensus_vsearch	1828	C	*/-AC	366	73	16.44%	2	2	93	93	4.036226757632315E-24	1	1	218	148	40	33	-AC
E7_BC55.191219_FM1-2_consensus_vsearch	1833	G	*/-TG	426	12	2.65%	2	2	93	93	2.2619500050778872E-4	1	1	251	175	11	1	-TG
E7_BC55.191219_FM1-2_consensus_vsearch	1834	T	*/+A	412	11	2.5%	2	2	93	93	4.571726097283556E-4	1	1	242	170	10	1	+A
E7_BC55.191219_FM1-2_consensus_vsearch	1835	G	*/-A	420	12	2.74%	2	1	93	93	2.2595202981245667E-4	1	1	241	179	12	0	-A
E7_BC55.191219_FM1-2_consensus_vsearch	1837	A	*/-C	428	14	3.09%	2	2	93	93	5.49766339423539E-5	1	1	257	171	6	8	-C
E7_BC55.191219_FM1-2_consensus_vsearch	1839	C	*/-T	433	15	3.3%	2	1	93	93	2.7090480075111917E-5	1	1	268	165	0	15	-T
E7_BC55.191219_FM1-2_consensus_vsearch	1841	C	*/+G	426	8	1.79%	2	1	93	93	0.0037811878789100195	1	1	257	169	0	8	+G
E7_BC55.191219_FM1-2_consensus_vsearch	1842	G	*/-A	441	7	1.55%	2	2	93	93	0.0076302151642897355	1	1	260	181	6	1	-A
E7_BC55.191219_FM1-2_consensus_vsearch	1850	T	*/+C	434	7	1.56%	2	2	93	93	0.007627335039353406	1	1	260	174	1	6	+C
E7_BC55.191219_FM1-2_consensus_vsearch	1851	C	*/+A	441	8	1.78%	2	1	93	93	0.0037853352821818676	1	1	258	183	8	0	+A
E7_BC55.191219_FM1-2_consensus_vsearch	1853	T	*/-C	403	39	8.71%	2	2	93	93	7.569741475394133E-13	1	1	226	177	38	1	-C
E7_BC55.191219_FM1-2_consensus_vsearch	1856	A	*/-G	335	71	15.85%	2	2	93	93	1.4764295354950337E-23	1	1	200	135	34	37	-G
E7_BC55.191219_FM1-2_consensus_vsearch	1856	A	*/-GG	335	35	7.81%	2	2	93	93	1.251790903318864E-11	1	1	200	135	25	10	-G
E7_BC55.191219_FM1-2_consensus_vsearch	1865	G	*/-CG	432	16	3.52%	2	2	93	93	1.3314617335401616E-5	1	1	257	175	7	9	-CG
E7_BC55.191219_FM1-2_consensus_vsearch	1867	G	*/+T	419	8	1.84%	2	1	93	93	0.0037791534811211507	1	1	250	169	8	0	+T
E7_BC55.191219_FM1-2_consensus_vsearch	1869	T	*/+C	437	10	2.21%	2	1	93	93	9.281205170584159E-4	1	1	259	178	10	0	+C
E7_BC55.191219_FM1-2_consensus_vsearch	1872	A	*/-C	422	11	2.43%	2	2	93	93	4.57876773436784E-4	1	1	243	179	8	3	-C
E7_BC55.191219_FM1-2_consensus_vsearch	1873	C	*/+G	410	21	4.76%	2	1	93	93	3.7151754522449287E-7	1	1	231	179	21	0	+G
E7_BC55.191219_FM1-2_consensus_vsearch	1874	C	*/+T	358	12	2.64%	2	2	93	93	2.2299370906875363E-4	1	1	241	117	3	9	+T
E7_BC55.191219_FM1-2_consensus_vsearch	1874	C	*/-T	358	60	13.22%	2	2	93	93	8.856725540080625E-20	1	1	241	117	3	57	-T
E7_BC55.191219_FM1-2_consensus_vsearch	1874	C	*/-TT	358	14	3.08%	2	1	93	93	5.388600494176372E-5	1	1	241	117	14	0	-T
E7_BC55.191219_FM1-2_consensus_vsearch	1879	C	*/-A	390	49	10.89%	2	2	93	93	4.3000207278381816E-16	1	1	255	135	6	43	-A
E7_BC55.191219_FM1-2_consensus_vsearch	1883	A	*/+C	430	10	2.2%	2	2	93	93	9.273613705492817E-4	1	1	248	182	9	1	+C
E7_BC55.191219_FM1-2_consensus_vsearch	1887	A	*/-T	438	7	1.55%	2	2	93	93	0.007628991869306366	1	1	257	181	6	1	-T
E7_BC55.191219_FM1-2_consensus_vsearch	1896	G	*/-A	443	10	2.2%	2	2	93	93	9.287528155311122E-4	1	1	259	184	9	1	-A
E7_BC55.191219_FM1-2_consensus_vsearch	1899	C	*/-T	424	24	5.32%	2	1	93	93	4.343923167757811E-8	1	1	268	156	0	24	-T
E7_BC55.191219_FM1-2_consensus_vsearch	1902	T	*/-G	407	38	8.44%	2	1	93	93	1.594450255287653E-12	1	1	265	142	0	38	-G
E7_BC55.191219_FM1-2_consensus_vsearch	1907	C	*/+A	437	8	1.76%	2	1	93	93	0.00378425644253265	1	1	254	183	8	0	+A
E7_BC55.191219_FM1-2_consensus_vsearch	1909	A	*/-GA	429	8	1.78%	2	1	93	93	0.0037820399638697363	1	1	254	175	0	8	-GA
E7_BC55.191219_FM1-2_consensus_vsearch	1912	C	*/-GC	438	7	1.55%	2	1	93	93	0.007628991869306366	1	1	253	185	7	0	-GC
E7_BC55.191219_FM1-2_consensus_vsearch	1915	T	*/+A	364	17	3.76%	2	2	93	93	6.357058602775765E-6	1	1	216	148	11	6	+A
E7_BC55.191219_FM1-2_consensus_vsearch	1915	T	*/-A	364	41	9.07%	2	2	93	93	1.5658875325986871E-13	1	1	216	148	29	12	-A
E7_BC55.191219_FM1-2_consensus_vsearch	1915	T	*/-AA	364	9	1.99%	2	2	93	93	0.0018600735687751945	1	1	216	148	7	2	-A
E7_BC55.191219_FM1-2_consensus_vsearch	1922	T	*/+A	399	14	3.09%	2	2	93	93	5.456785241416283E-5	1	1	251	148	7	7	+A
E7_BC55.191219_FM1-2_consensus_vsearch	1922	T	*/-A	399	32	7.06%	2	2	93	93	1.2811620811313112E-10	1	1	251	148	8	24	-A
E7_BC55.191219_FM1-2_consensus_vsearch	1935	A	*/-GCA	437	8	1.77%	2	1	93	93	0.00378425644253265	1	1	260	177	8	0	-GCA
E7_BC55.191219_FM1-2_consensus_vsearch	1940	C	*/-G	436	7	1.55%	2	1	93	93	0.007628167177128368	1	1	261	175	0	7	-G
E7_BC55.191219_FM1-2_consensus_vsearch	1947	C	*/+T	412	13	2.95%	2	1	93	93	1.11214354741109E-4	1	1	259	153	0	13	+T
E7_BC55.191219_FM1-2_consensus_vsearch	1947	C	*/-T	412	10	2.27%	2	2	93	93	9.25295461603329E-4	1	1	259	153	3	7	+T
E7_BC55.191219_FM1-2_consensus_vsearch	1948	T	*/+CT	417	7	1.62%	2	2	93	93	0.007619946437356769	1	1	251	166	4	3	+CT
E7_BC55.191219_FM1-2_consensus_vsearch	1953	A	*/+T	415	29	6.43%	2	1	93	93	1.1613040233734709E-9	1	1	235	180	29	0	+T
E7_BC55.191219_FM1-2_consensus_vsearch	1955	T	*/-C	432	18	3.99%	2	2	93	93	3.2074585795037237E-6	1	1	252	180	15	3	-C
E7_BC55.191219_FM1-2_consensus_vsearch	1965	G	*/+A	436	8	1.77%	2	1	93	93	0.003783983718069795	1	1	255	181	8	0	+A
E7_BC55.191219_FM1-2_consensus_vsearch	1975	G	*/-CGAAT	402	9	2.08%	2	1	93	93	0.001868575996146208	1	1	240	162	9	0	-CGAAT
E7_BC55.191219_FM1-2_consensus_vsearch	1976	C	*/-G	386	7	1.66%	2	1	93	93	0.0076048360660226225	1	1	229	157	7	0	-G
E7_BC55.191219_FM1-2_consensus_vsearch	1977	G	*/-A	406	7	1.65%	2	1	93	93	0.007614843055105977	1	1	227	179	7	0	-A
E7_BC55.191219_FM1-2_consensus_vsearch	1986	T	*/+A	428	8	1.78%	2	1	93	93	0.0037817572285023734	1	1	251	177	8	0	+A
E7_BC55.191219_FM1-2_consensus_vsearch	1990	T	*/-A	418	17	3.81%	2	2	93	93	6.505544070653668E-6	1	1	259	159	1	16	-A
E7_BC55.191219_FM1-2_consensus_vsearch	1994	G	*/-TG	389	46	10.18%	2	2	93	93	4.047350455486424E-15	1	1	244	145	14	32	-TG
E7_BC55.191219_FM1-2_consensus_vsearch	1995	T	*/+A	373	7	1.75%	2	2	93	93	0.007597769697997662	1	1	229	144	6	1	+A
E7_BC55.191219_FM1-2_consensus_vsearch	1995	T	*/-GA	373	9	2.25%	2	2	93	93	0.0018622382238204073	1	1	229	144	8	1	-GA
E7_BC55.191219_FM1-2_consensus_vsearch	1996	G	*/-AA	349	31	7.89%	2	1	93	93	2.461276097891965E-10	1	1	198	151	31	0	-AA
E7_BC55.191219_FM1-2_consensus_vsearch	2003	A	*/+G	423	8	1.78%	2	2	93	93	0.003780324023462628	1	1	250	173	7	1	+G
E7_BC55.191219_FM1-2_consensus_vsearch	2004	G	*/-A	435	7	1.56%	2	2	93	93	0.007627752045228881	1	1	256	179	3	4	-A
E7_BC55.191219_FM1-2_consensus_vsearch	2020	C	*/+A	432	15	3.32%	2	1	93	93	2.7083142079970986E-5	1	1	249	183	15	0	+A
E7_BC55.191219_FM1-2_consensus_vsearch	2021	G	*/-A	431	15	3.33%	2	1	93	93	2.70757726321695E-5	1	1	248	183	15	0	-A
E7_BC55.191219_FM1-2_consensus_vsearch	2025	C	*/+T	399	8	1.78%	2	2	93	93	0.003772958466097373	1	1	260	139	2	6	+T
E7_BC55.191219_FM1-2_consensus_vsearch	2025	C	*/-T	399	38	8.44%	2	2	93	93	1.5694738408221542E-12	1	1	260	139	5	33	-T
E7_BC55.191219_FM1-2_consensus_vsearch	2028	T	*/+A	428	12	2.64%	2	1	93	93	2.2627455527610537E-4	1	1	247	181	12	0	+A
E7_BC55.191219_FM1-2_consensus_vsearch	2029	G	*/-A	424	17	3.79%	2	2	93	93	6.519935125426091E-6	1	1	244	180	15	2	-A
E7_BC55.191219_FM1-2_consensus_vsearch	2032	C	*/+T	427	8	1.77%	2	1	93	93	0.0037814732031268648	1	1	247	180	8	0	+T
E7_BC55.191219_FM1-2_consensus_vsearch	2037	C	*/+T	401	25	5.52%	2	1	93	93	2.0738579890833378E-8	1	1	256	145	0	25	+T
E7_BC55.191219_FM1-2_consensus_vsearch	2037	C	*/-T	401	18	3.97%	2	2	93	93	3.165704383176564E-6	1	1	256	145	7	11	+T
E7_BC55.191219_FM1-2_consensus_vsearch	2039	T	*/-GC	433	7	1.56%	2	2	93	93	0.0076269161468125015	1	1	253	180	6	1	-GC
E7_BC55.191219_FM1-2_consensus_vsearch	2041	C	*/-AC	420	16	3.59%	2	1	93	93	1.3263859391341419E-5	1	1	244	176	16	0	-AC
E7_BC55.191219_FM1-2_consensus_vsearch	2042	A	*/-C	392	34	7.8%	2	2	93	93	2.93245681460937E-11	1	1	237	155	12	22	-C
E7_BC55.191219_FM1-2_consensus_vsearch	2046	T	*/-CT	436	10	2.23%	2	2	93	93	9.280135047051926E-4	1	1	266	170	2	8	-CT
E7_BC55.191219_FM1-2_consensus_vsearch	2054	T	*/-C	406	40	8.89%	2	2	93	93	3.6416456447980984E-13	1	1	233	173	31	9	-C
E7_BC55.191219_FM1-2_consensus_vsearch	2056	C	*/+G	430	16	3.52%	2	2	93	93	1.3306337519337772E-5	1	1	263	167	4	12	+G
E7_BC55.191219_FM1-2_consensus_vsearch	2057	G	*/+A	420	30	6.64%	2	1	93	93	5.649839880762713E-10	1	1	267	153	0	30	+A
E7_BC55.191219_FM1-2_consensus_vsearch	2058	G	*/-A	415	30	6.62%	2	1	93	93	5.617106074815266E-10	1	1	261	154	0	30	-A
E7_BC55.191219_FM1-2_consensus_vsearch	2059	A	*/+G	153	259	61.52%	2	2	93	93	2.490288218045528E-105	1	1	139	14	118	141	+G
E7_BC55.191219_FM1-2_consensus_vsearch	2061	G	*/+AG	399	44	9.71%	2	1	93	93	1.8484874833323488E-14	1	1	219	180	44	0	+AG
E7_BC55.191219_FM1-2_consensus_vsearch	2065	G	*/-C	421	17	3.77%	2	2	93	93	6.5127858630373285E-6	1	1	241	180	16	1	-C
E7_BC55.191219_FM1-2_consensus_vsearch	2070	G	*/+A	356	10	2.2%	2	1	93	93	9.175923743135597E-4	1	1	174	182	10	0	+A
E7_BC55.191219_FM1-2_consensus_vsearch	2070	G	*/-T	356	40	8.81%	2	2	93	93	3.224242806421905E-13	1	1	174	182	39	1	-T
E7_BC55.191219_FM1-2_consensus_vsearch	2072	T	*/-G	369	46	10.13%	2	1	93	93	3.796024726670625E-15	1	1	192	177	46	0	-G
E7_BC55.191219_FM1-2_consensus_vsearch	2073	G	*/+A	385	7	1.72%	2	1	93	93	0.007604309052101333	1	1	201	184	7	0	+A
E7_BC55.191219_FM1-2_consensus_vsearch	2074	A	*/-G	436	10	2.22%	2	1	93	93	9.280135047051926E-4	1	1	254	182	10	0	-G
E7_BC55.191219_FM1-2_consensus_vsearch	2075	G	*/-T	410	23	5.2%	2	1	93	93	8.831451741297899E-8	1	1	250	160	0	23	-T
E7_BC55.191219_FM1-2_consensus_vsearch	2081	T	*/+A	420	8	1.79%	2	1	93	93	0.003779448151948946	1	1	252	168	8	0	+A
E7_BC55.191219_FM1-2_consensus_vsearch	2082	G	*/-A	430	13	2.88%	2	2	93	93	1.1164210469075442E-4	1	1	251	179	12	1	-A
E7_BC55.191219_FM1-2_consensus_vsearch	2087	T	*/-C	434	7	1.54%	2	1	93	93	0.007627335039353406	1	1	259	175	0	7	-C
E7_BC55.191219_FM1-2_consensus_vsearch	2093	C	*/-T	435	11	2.45%	2	1	93	93	4.587459048221758E-4	1	1	265	170	0	11	-T
E7_BC55.191219_FM1-2_consensus_vsearch	2094	T	*/-C	374	61	13.86%	2	2	93	93	4.5129943227539416E-20	1	1	207	167	58	3	-C
E7_BC55.191219_FM1-2_consensus_vsearch	2100	G	*/+T	403	12	2.65%	2	2	93	93	2.252264779649526E-4	1	1	225	178	10	2	+T
E7_BC55.191219_FM1-2_consensus_vsearch	2100	G	*/-T	403	31	6.84%	2	2	93	93	2.672306318115701E-10	1	1	225	178	27	4	-T
E7_BC55.191219_FM1-2_consensus_vsearch	2107	T	*/+A	363	10	2.21%	2	1	93	93	9.186794830860472E-4	1	1	185	178	10	0	+A
E7_BC55.191219_FM1-2_consensus_vsearch	2107	T	*/-A	363	71	15.67%	2	2	93	93	1.8700218203134872E-23	1	1	185	178	70	1	-A
E7_BC55.191219_FM1-2_consensus_vsearch	2110	A	*/-G	419	23	5.08%	2	2	93	93	8.88699068341335E-8	1	1	243	176	21	2	-G
E7_BC55.191219_FM1-2_consensus_vsearch	2114	C	*/-T	441	7	1.55%	2	2	93	93	0.0076302151642897355	1	1	263	178	2	5	-T
E7_BC55.191219_FM1-2_consensus_vsearch	2126	T	*/-C	427	11	2.46%	2	1	93	93	4.5821703849988575E-4	1	1	247	180	11	0	-C
E7_BC55.191219_FM1-2_consensus_vsearch	2128	C	*/-T	437	12	2.65%	2	2	93	93	2.266239976305489E-4	1	1	259	178	6	6	-T
E7_BC55.191219_FM1-2_consensus_vsearch	2134	G	*/-C	415	24	5.31%	2	2	93	93	4.3150629281374106E-8	1	1	235	180	22	2	-C
E7_BC55.191219_FM1-2_consensus_vsearch	2135	C	*/+T	384	31	7.23%	2	2	93	93	2.602659831150514E-10	1	1	240	144	1	30	+T
E7_BC55.191219_FM1-2_consensus_vsearch	2136	C	*/-T	414	32	7.06%	2	1	93	93	1.3081363754474417E-10	1	1	266	148	0	32	-T
E7_BC55.191219_FM1-2_consensus_vsearch	2140	C	*/-G	413	15	3.37%	2	1	93	93	2.693750469087132E-5	1	1	233	180	15	0	-G
E7_BC55.191219_FM1-2_consensus_vsearch	2142	A	*/-G	436	8	1.79%	2	1	93	93	0.003783983718069795	1	1	251	185	8	0	-G
E7_BC55.191219_FM1-2_consensus_vsearch	2148	C	*/-TGC	426	9	2.01%	2	2	93	93	0.001873189162106254	1	1	255	171	7	2	-TGC
E7_BC55.191219_FM1-2_consensus_vsearch	2152	G	*/+TG	433	9	2.01%	2	1	93	93	0.001874441340367089	1	1	263	170	0	9	+TG
E7_BC55.191219_FM1-2_consensus_vsearch	2160	C	*/-G	422	10	2.21%	2	2	93	93	9.264641146701706E-4	1	1	255	167	9	1	-G
E7_BC55.191219_FM1-2_consensus_vsearch	2161	G	*/+A	409	8	1.8%	2	1	93	93	0.00377612966169784	1	1	237	172	8	0	+A
E7_BC55.191219_FM1-2_consensus_vsearch	2161	G	*/+TG	409	11	2.48%	2	1	93	93	4.5695495811152217E-4	1	1	237	172	0	11	+TG
E7_BC55.191219_FM1-2_consensus_vsearch	2161	G	*/-A	409	13	2.93%	2	1	93	93	1.1113963043830918E-4	1	1	237	172	13	0	-A
E7_BC55.191219_FM1-2_consensus_vsearch	2162	A	*/-G	419	12	2.73%	2	2	93	93	2.2591089391076449E-4	1	1	240	179	11	1	-G
E7_BC55.191219_FM1-2_consensus_vsearch	2166	T	*/+G	435	9	1.99%	2	2	93	93	0.0018747919330438447	1	1	259	176	6	3	+G
E7_BC55.191219_FM1-2_consensus_vsearch	2171	C	*/+T	417	9	2.02%	2	1	93	93	0.0018715194418685113	1	1	266	151	0	9	+T
E7_BC55.191219_FM1-2_consensus_vsearch	2174	T	*/-G	430	17	3.76%	2	2	93	93	6.533963048407704E-6	1	1	266	164	2	15	-G
E7_BC55.191219_FM1-2_consensus_vsearch	2176	G	*/-A	429	18	3.96%	2	1	93	93	3.2036534900985633E-6	1	1	248	181	18	0	-A
E7_BC55.191219_FM1-2_consensus_vsearch	2177	A	*/-G	422	8	1.85%	2	1	93	93	0.003780033413733114	1	1	241	181	8	0	-G
E7_BC55.191219_FM1-2_consensus_vsearch	2179	C	*/-T	423	15	3.33%	2	2	93	93	2.701566009065348E-5	1	1	255	168	4	11	-T
E7_BC55.191219_FM1-2_consensus_vsearch	2181	T	*/-G	334	105	23.39%	2	1	93	93	2.074194615752117E-35	1	1	260	74	0	105	-G
E7_BC55.191219_FM1-2_consensus_vsearch	2184	A	*/-C	432	8	1.77%	2	1	93	93	0.0037828805172695963	1	1	250	182	8	0	-C
E7_BC55.191219_FM1-2_consensus_vsearch	2185	C	*/+A	432	9	2.02%	2	1	93	93	0.001874264864679625	1	1	250	182	9	0	+A
E7_BC55.191219_FM1-2_consensus_vsearch	2188	G	*/+A	422	14	3.08%	2	1	93	93	5.489635033716498E-5	1	1	240	182	14	0	+A
E7_BC55.191219_FM1-2_consensus_vsearch	2188	G	*/-A	422	14	3.08%	2	2	93	93	5.489635033716498E-5	1	1	240	182	13	1	+A
E7_BC55.191219_FM1-2_consensus_vsearch	2191	C	*/-T	422	24	5.31%	2	1	93	93	4.3375967580996214E-8	1	1	267	155	0	24	-T
E7_BC55.191219_FM1-2_consensus_vsearch	2193	C	*/-T	440	11	2.43%	2	2	93	93	4.590671030956891E-4	1	1	260	180	8	3	-T
E7_BC55.191219_FM1-2_consensus_vsearch	2197	T	*/-G	437	7	1.55%	2	1	93	93	0.007628580447648388	1	1	263	174	0	7	-G
E7_BC55.191219_FM1-2_consensus_vsearch	2199	G	*/-C	437	9	1.99%	2	1	93	93	0.0018751394156906677	1	1	256	181	9	0	-C
E7_BC55.191219_FM1-2_consensus_vsearch	2201	C	*/-T	445	8	1.77%	2	2	93	93	0.0037863952091791225	1	1	265	180	4	4	-T
E7_BC55.191219_FM1-2_consensus_vsearch	2203	T	*/-C	424	19	4.19%	2	2	93	93	1.5660884922200917E-6	1	1	249	175	12	7	-C
E7_BC55.191219_FM1-2_consensus_vsearch	2207	A	*/-G	437	7	1.57%	2	2	93	93	0.007628580447648388	1	1	260	177	3	4	-G
E7_BC55.191219_FM1-2_consensus_vsearch	2219	T	*/+A	418	7	1.55%	2	1	93	93	0.007620397344640596	1	1	246	172	7	0	+A
E7_BC55.191219_FM1-2_consensus_vsearch	2219	T	*/-A	418	12	2.66%	2	2	93	93	2.2586957161051062E-4	1	1	246	172	11	1	-A
E7_BC55.191219_FM1-2_consensus_vsearch	2220	A	*/+G	409	9	2.04%	2	2	93	93	0.0018699755869600776	1	1	232	177	4	5	+G
E7_BC55.191219_FM1-2_consensus_vsearch	2220	A	*/-GA	409	18	4.08%	2	1	93	93	3.17701818350145E-6	1	1	232	177	18	0	-GA
E7_BC55.191219_FM1-2_consensus_vsearch	2221	G	*/-A	413	12	2.76%	2	2	93	93	2.2566011930545864E-4	1	1	240	173	5	7	-A
E7_BC55.191219_FM1-2_consensus_vsearch	2225	T	*/-G	437	8	1.77%	2	1	93	93	0.00378425644253265	1	1	254	183	8	0	-G
E7_BC55.191219_FM1-2_consensus_vsearch	2241	T	*/-C	370	69	15.23%	2	2	93	93	9.306835611186658E-23	1	1	201	169	56	13	-C
E7_BC55.191219_FM1-2_consensus_vsearch	2242	C	*/+G	370	7	1.85%	2	1	93	93	0.007596070166375128	1	1	198	172	7	0	+G
E7_BC55.191219_FM1-2_consensus_vsearch	2244	C	*/-T	381	44	9.71%	2	2	93	93	1.7580001267598153E-14	1	1	240	141	3	41	-T
E7_BC55.191219_FM1-2_consensus_vsearch	2244	C	*/-TT	381	18	3.97%	2	1	93	93	3.1355882207983647E-6	1	1	240	141	18	0	-T
E7_BC55.191219_FM1-2_consensus_vsearch	2246	T	*/-G	400	12	2.77%	2	2	93	93	2.2509239120889853E-4	1	1	233	167	4	8	-G
E7_BC55.191219_FM1-2_consensus_vsearch	2248	G	*/+A	432	8	1.79%	2	1	93	93	0.0037828805172695963	1	1	255	177	8	0	+A
E7_BC55.191219_FM1-2_consensus_vsearch	2250	T	*/-C	441	7	1.54%	2	1	93	93	0.0076302151642897355	1	1	258	183	7	0	-C
E7_BC55.191219_FM1-2_consensus_vsearch	2257	C	*/-G	437	8	1.77%	2	1	93	93	0.00378425644253265	1	1	263	174	0	8	-G
E7_BC55.191219_FM1-2_consensus_vsearch	2279	C	*/+A	342	13	2.88%	2	1	93	93	1.0915439349354801E-4	1	1	161	181	13	0	+A
E7_BC55.191219_FM1-2_consensus_vsearch	2279	C	*/-A	342	87	19.29%	2	2	93	93	5.012622700888927E-29	1	1	161	181	86	1	-A
E7_BC55.191219_FM1-2_consensus_vsearch	2288	C	*/-TC	368	66	14.77%	2	2	93	93	9.33048028845814E-22	1	1	214	154	47	19	-TC
E7_BC55.191219_FM1-2_consensus_vsearch	2288	C	*/-TCG	368	7	1.57%	2	2	93	93	0.007594922120899784	1	1	214	154	3	4	-TC
E7_BC55.191219_FM1-2_consensus_vsearch	2289	T	*/+C	348	11	2.94%	2	1	93	93	4.5175963040571215E-4	1	1	199	149	11	0	+C
E7_BC55.191219_FM1-2_consensus_vsearch	2290	C	*/-G	339	20	5.41%	2	2	93	93	7.265269601976787E-7	1	1	204	135	9	11	-G
E7_BC55.191219_FM1-2_consensus_vsearch	2290	C	*/-GG	339	7	1.89%	2	1	93	93	0.00757679283814411	1	1	204	135	0	7	-G
E7_BC55.191219_FM1-2_consensus_vsearch	2292	G	*/+A	432	7	1.57%	2	1	93	93	0.0076264953547406375	1	1	255	177	7	0	+A
E7_BC55.191219_FM1-2_consensus_vsearch	2297	G	*/+C	424	7	1.55%	2	1	93	93	0.007623059056742502	1	1	267	157	0	7	+C
E7_BC55.191219_FM1-2_consensus_vsearch	2297	G	*/+T	424	10	2.21%	2	1	93	93	9.266914820866851E-4	1	1	267	157	0	10	+T
E7_BC55.191219_FM1-2_consensus_vsearch	2298	C	*/+T	413	12	2.67%	2	1	93	93	2.2566011930545864E-4	1	1	266	147	0	12	+T
E7_BC55.191219_FM1-2_consensus_vsearch	2299	T	*/+C	420	12	2.67%	2	2	93	93	2.2595202981245667E-4	1	1	259	161	1	11	+C
E7_BC55.191219_FM1-2_consensus_vsearch	2299	T	*/-C	420	13	2.89%	2	2	93	93	1.1140871758939428E-4	1	1	259	161	3	10	-C
E7_BC55.191219_FM1-2_consensus_vsearch	2302	C	*/-T	414	23	5.1%	2	2	93	93	8.856382627956532E-8	1	1	263	151	1	22	-T
E7_BC55.191219_FM1-2_consensus_vsearch	2303	T	*/+C	300	9	2.09%	2	2	93	93	0.0018411013979868624	1	1	143	157	7	2	+C
E7_BC55.191219_FM1-2_consensus_vsearch	2303	T	*/-C	300	121	28.07%	2	2	93	93	1.5303659668496542E-41	1	1	143	157	118	3	-C
E7_BC55.191219_FM1-2_consensus_vsearch	2305	C	*/-T	441	7	1.54%	2	1	93	93	0.0076302151642897355	1	1	268	173	0	7	-T
E7_BC55.191219_FM1-2_consensus_vsearch	2306	T	*/-A	426	7	1.57%	2	2	93	93	0.007623929979105209	1	1	261	165	5	2	-A
E7_BC55.191219_FM1-2_consensus_vsearch	2313	C	*/-T	434	12	2.67%	2	2	93	93	2.2650904494607855E-4	1	1	262	172	3	9	-T
E7_BC55.191219_FM1-2_consensus_vsearch	2315	T	*/+C	410	28	6.19%	2	1	93	93	2.385896375035146E-9	1	1	234	176	28	0	+C
E7_BC55.191219_FM1-2_consensus_vsearch	2316	C	*/-G	411	20	4.49%	2	1	93	93	7.611138031103958E-7	1	1	257	154	0	20	-G
E7_BC55.191219_FM1-2_consensus_vsearch	2325	T	*/+C	427	19	4.2%	2	2	93	93	1.5682108713963469E-6	1	1	250	177	16	3	+C
E7_BC55.191219_FM1-2_consensus_vsearch	2326	C	*/-T	421	26	5.75%	2	2	93	93	1.0248968823747786E-8	1	1	245	176	20	6	-T
E7_BC55.191219_FM1-2_consensus_vsearch	2329	A	*/+G	416	8	1.77%	2	1	93	93	0.003778261194268045	1	1	233	183	8	0	+G
E7_BC55.191219_FM1-2_consensus_vsearch	2331	G	*/+T	418	15	3.31%	2	2	93	93	2.6977013084786136E-5	1	1	237	181	14	1	+T
E7_BC55.191219_FM1-2_consensus_vsearch	2331	G	*/-T	418	8	1.77%	2	2	93	93	0.003778857437644956	1	1	237	181	7	1	+T
E7_BC55.191219_FM1-2_consensus_vsearch	2336	C	*/-AC	417	24	5.32%	2	2	93	93	4.321564132228603E-8	1	1	239	178	22	2	-AC
E7_BC55.191219_FM1-2_consensus_vsearch	2337	A	*/-C	407	14	3.27%	2	2	93	93	5.468602328051435E-5	1	1	239	168	3	11	-C
E7_BC55.191219_FM1-2_consensus_vsearch	2338	C	*/+AC	385	7	1.69%	2	1	93	93	0.007604309052101333	1	1	226	159	7	0	+AC
E7_BC55.191219_FM1-2_consensus_vsearch	2343	A	*/+C	433	7	1.55%	2	1	93	93	0.0076269161468125015	1	1	261	172	0	7	+C
E7_BC55.191219_FM1-2_consensus_vsearch	2344	C	*/-T	436	9	2%	2	2	93	93	0.0018749660605302289	1	1	261	175	3	6	-T
E7_BC55.191219_FM1-2_consensus_vsearch	2345	T	*/+C	404	26	5.87%	2	2	93	93	1.009382561029543E-8	1	1	238	166	25	1	+C
E7_BC55.191219_FM1-2_consensus_vsearch	2345	T	*/-C	404	9	2.03%	2	1	93	93	0.0018689806633249517	1	1	238	166	0	9	+C
E7_BC55.191219_FM1-2_consensus_vsearch	2346	C	*/+G	382	12	2.73%	2	2	93	93	2.2424619755304767E-4	1	1	250	132	1	11	+G
E7_BC55.191219_FM1-2_consensus_vsearch	2346	C	*/-G	382	20	4.55%	2	2	93	93	7.485252334873302E-7	1	1	250	132	10	10	-G
E7_BC55.191219_FM1-2_consensus_vsearch	2346	C	*/-GG	382	15	3.41%	2	1	93	93	2.6671442214013996E-5	1	1	250	132	0	15	-G
E7_BC55.191219_FM1-2_consensus_vsearch	2351	A	*/-G	418	18	4%	2	2	93	93	3.189285095484537E-6	1	1	260	158	2	16	-G
E7_BC55.191219_FM1-2_consensus_vsearch	2355	C	*/-T	431	10	2.22%	2	2	93	93	9.274712732448419E-4	1	1	255	176	7	3	-T
E7_BC55.191219_FM1-2_consensus_vsearch	2357	A	*/+C	400	14	3.11%	2	1	93	93	5.4582863522470956E-5	1	1	229	171	14	0	+C
E7_BC55.191219_FM1-2_consensus_vsearch	2357	A	*/-C	400	26	5.78%	2	2	93	93	1.0055828943460669E-8	1	1	229	171	18	8	-C
E7_BC55.191219_FM1-2_consensus_vsearch	2367	C	*/-T	376	61	13.59%	2	2	93	93	4.5635806752264175E-20	1	1	199	177	58	3	-T
E7_BC55.191219_FM1-2_consensus_vsearch	2369	T	*/-A	414	13	2.92%	2	1	93	93	1.1126360633158358E-4	1	1	245	169	0	13	-A
E7_BC55.191219_FM1-2_consensus_vsearch	2371	A	*/-G	417	26	5.75%	2	2	93	93	1.0213359333062522E-8	1	1	247	170	14	12	-G
E7_BC55.191219_FM1-2_consensus_vsearch	2378	C	*/-A	427	20	4.42%	2	2	93	93	7.67422341324127E-7	1	1	265	162	2	18	-A
E7_BC55.191219_FM1-2_consensus_vsearch	2381	T	*/+C	415	16	3.58%	2	1	93	93	1.3241920793983298E-5	1	1	257	158	0	16	+C
E7_BC55.191219_FM1-2_consensus_vsearch	2385	C	*/+G	426	7	1.55%	2	1	93	93	0.007623929979105209	1	1	265	161	0	7	+G
E7_BC55.191219_FM1-2_consensus_vsearch	2385	C	*/-G	426	7	1.55%	2	2	93	93	0.007623929979105209	1	1	265	161	1	6	+G
E7_BC55.191219_FM1-2_consensus_vsearch	2388	A	*/-G	411	26	5.8%	2	1	93	93	1.0158926171078022E-8	1	1	228	183	26	0	-G
E7_BC55.191219_FM1-2_consensus_vsearch	2390	G	*/+A	349	32	7.1%	2	2	93	93	1.1805069326284918E-10	1	1	178	171	29	3	+A
E7_BC55.191219_FM1-2_consensus_vsearch	2390	G	*/+AA	349	14	3.1%	2	1	93	93	5.371665821516508E-5	1	1	178	171	14	0	+A
E7_BC55.191219_FM1-2_consensus_vsearch	2390	G	*/-A	349	38	8.43%	2	2	93	93	1.400040712836016E-12	1	1	178	171	27	11	-A
E7_BC55.191219_FM1-2_consensus_vsearch	2390	G	*/-AA	349	9	2%	2	1	93	93	0.0018562272492925029	1	1	178	171	9	0	-A
E7_BC55.191219_FM1-2_consensus_vsearch	2394	A	*/+G	417	8	1.76%	2	1	93	93	0.003778560011928581	1	1	235	182	8	0	+G
E7_BC55.191219_FM1-2_consensus_vsearch	2394	A	*/-G	417	10	2.2%	2	1	93	93	9.258865234089794E-4	1	1	235	182	10	0	-G
E7_BC55.191219_FM1-2_consensus_vsearch	2395	G	*/-A	407	12	2.77%	2	2	93	93	2.2540235260924642E-4	1	1	228	179	8	4	-A
E7_BC55.191219_FM1-2_consensus_vsearch	2398	A	*/+T	391	8	1.79%	2	1	93	93	0.003770308015149166	1	1	216	175	0	8	+T
E7_BC55.191219_FM1-2_consensus_vsearch	2399	C	*/-T	421	11	2.46%	2	2	93	93	4.5780779436953333E-4	1	1	250	171	1	10	-T
E7_BC55.191219_FM1-2_consensus_vsearch	2403	C	*/-A	423	7	1.58%	2	2	93	93	0.007622620571895094	1	1	242	181	6	1	-A
E7_BC55.191219_FM1-2_consensus_vsearch	2405	A	*/-G	440	9	1.99%	2	1	93	93	0.0018756548982491606	1	1	256	184	9	0	-G
E7_BC55.191219_FM1-2_consensus_vsearch	2407	G	*/-A	432	20	4.41%	2	1	93	93	7.693102036002013E-7	1	1	248	184	20	0	-A
E7_BC55.191219_FM1-2_consensus_vsearch	2410	T	*/+C	221	18	3.97%	2	2	93	93	2.7361017606407482E-6	1	1	157	64	15	3	+C
E7_BC55.191219_FM1-2_consensus_vsearch	2410	T	*/-C	221	200	44.15%	2	2	93	93	1.3115015653108894E-74	1	1	157	64	89	111	-C
E7_BC55.191219_FM1-2_consensus_vsearch	2410	T	*/-CC	221	7	1.55%	2	2	93	93	0.007455894130096957	1	1	157	64	5	2	-C
E7_BC55.191219_FM1-2_consensus_vsearch	2424	C	*/-G	423	11	2.43%	2	1	93	93	4.5794544103178105E-4	1	1	243	180	11	0	-G
E7_BC55.191219_FM1-2_consensus_vsearch	2426	A	*/+G	430	10	2.23%	2	1	93	93	9.273613705492817E-4	1	1	247	183	10	0	+G
E7_BC55.191219_FM1-2_consensus_vsearch	2427	G	*/-T	432	10	2.21%	2	1	93	93	9.275806861447792E-4	1	1	263	169	0	10	-T
E7_BC55.191219_FM1-2_consensus_vsearch	2429	G	*/-A	431	9	2.01%	2	2	93	93	0.0018740875957096264	1	1	255	176	8	1	-A
E7_BC55.191219_FM1-2_consensus_vsearch	2432	G	*/-CG	405	34	7.54%	2	1	93	93	2.9950454991493754E-11	1	1	260	145	0	34	-CG
E7_BC55.191219_FM1-2_consensus_vsearch	2433	C	*/-G	360	37	8.94%	2	2	93	93	3.019307273196661E-12	1	1	260	100	3	34	-G
E7_BC55.191219_FM1-2_consensus_vsearch	2439	G	*/-A	441	7	1.54%	2	1	93	93	0.0076302151642897355	1	1	259	182	7	0	-A
E7_BC55.191219_FM1-2_consensus_vsearch	2444	C	*/-A	428	7	1.57%	2	2	93	93	0.007624792930600719	1	1	257	171	3	4	-A
E7_BC55.191219_FM1-2_consensus_vsearch	2444	C	*/-AA	428	9	2.01%	2	2	93	93	0.0018735509751739627	1	1	257	171	4	5	-AA
E7_BC55.191219_FM1-2_consensus_vsearch	2447	A	*/+T	418	10	2.21%	2	1	93	93	9.260031044371504E-4	1	1	244	174	10	0	+T
E7_BC55.191219_FM1-2_consensus_vsearch	2447	A	*/-T	418	18	3.97%	2	2	93	93	3.189285095484537E-6	1	1	244	174	10	8	-T
E7_BC55.191219_FM1-2_consensus_vsearch	2451	T	*/+A	438	7	1.54%	2	1	93	93	0.007628991869306366	1	1	256	182	7	0	+A
E7_BC55.191219_FM1-2_consensus_vsearch	2455	T	*/+C	431	16	3.56%	2	1	93	93	1.3310486209944137E-5	1	1	250	181	16	0	+C
E7_BC55.191219_FM1-2_consensus_vsearch	2465	T	*/-C	421	18	4.03%	2	2	93	93	3.1932701494892594E-6	1	1	250	171	13	5	-C
E7_BC55.191219_FM1-2_consensus_vsearch	2467	C	*/+G	427	8	1.77%	2	1	93	93	0.0037814732031268648	1	1	261	166	0	8	+G
E7_BC55.191219_FM1-2_consensus_vsearch	2473	T	*/-C	407	44	9.69%	2	1	93	93	1.887629550114411E-14	1	1	223	184	44	0	-C
E7_BC55.191219_FM1-2_consensus_vsearch	2475	C	*/+G	425	13	2.86%	2	2	93	93	1.115267016392494E-4	1	1	249	176	6	7	+G
E7_BC55.191219_FM1-2_consensus_vsearch	2476	G	*/-A	438	7	1.56%	2	1	93	93	0.007628991869306366	1	1	253	185	7	0	-A
E7_BC55.191219_FM1-2_consensus_vsearch	2482	T	*/-A	424	9	2%	2	2	93	93	0.0018728240442215458	1	1	246	178	7	2	-A
E7_BC55.191219_FM1-2_consensus_vsearch	2485	A	*/-T	444	9	1.98%	2	2	93	93	0.0018763317016516773	1	1	264	180	4	5	-T
E7_BC55.191219_FM1-2_consensus_vsearch	2489	T	*/-A	427	15	3.34%	2	2	93	93	2.7045976238335243E-5	1	1	250	177	12	3	-A
E7_BC55.191219_FM1-2_consensus_vsearch	2491	G	*/-A	423	7	1.56%	2	2	93	93	0.007622620571895094	1	1	257	166	3	4	-A
E7_BC55.191219_FM1-2_consensus_vsearch	2491	G	*/-AAG	423	13	2.9%	2	1	93	93	1.1147982255220776E-4	1	1	257	166	0	13	-AAG
E7_BC55.191219_FM1-2_consensus_vsearch	2499	A	*/+T	436	10	2.22%	2	1	93	93	9.280135047051926E-4	1	1	267	169	0	10	+T
E7_BC55.191219_FM1-2_consensus_vsearch	2501	C	*/-T	434	14	3.11%	2	2	93	93	5.5054846604229285E-5	1	1	262	172	2	12	-T
E7_BC55.191219_FM1-2_consensus_vsearch	2505	G	*/-C	408	25	5.56%	2	2	93	93	2.0864097267404846E-8	1	1	230	178	19	6	-C
E7_BC55.191219_FM1-2_consensus_vsearch	2507	C	*/-G	431	13	2.87%	2	1	93	93	1.1166488301300728E-4	1	1	265	166	0	13	-G
E7_BC55.191219_FM1-2_consensus_vsearch	2516	C	*/+T	425	10	2.23%	2	1	93	93	9.268043937944601E-4	1	1	241	184	10	0	+T
E7_BC55.191219_FM1-2_consensus_vsearch	2516	C	*/-A	425	8	1.79%	2	1	93	93	0.0037809012469126957	1	1	241	184	8	0	+T
E7_BC55.191219_FM1-2_consensus_vsearch	2517	A	*/+G	400	7	1.58%	2	2	93	93	0.007611943705349879	1	1	234	166	1	6	+G
E7_BC55.191219_FM1-2_consensus_vsearch	2518	C	*/-A	383	12	2.73%	2	2	93	93	2.2429517467312504E-4	1	1	227	156	2	10	-A
E7_BC55.191219_FM1-2_consensus_vsearch	2518	C	*/-AA	383	10	2.28%	2	2	93	93	9.215757570452482E-4	1	1	227	156	1	9	-A
E7_BC55.191219_FM1-2_consensus_vsearch	2519	A	*/+G	388	17	4.01%	2	1	93	93	6.427615629419297E-6	1	1	230	158	17	0	+G
E7_BC55.191219_FM1-2_consensus_vsearch	2520	A	*/-G	403	23	5.24%	2	1	93	93	8.786841289852207E-8	1	1	235	168	23	0	-G
E7_BC55.191219_FM1-2_consensus_vsearch	2521	G	*/+A	419	7	1.62%	2	1	93	93	0.007620846145152445	1	1	235	184	7	0	+A
E7_BC55.191219_FM1-2_consensus_vsearch	2537	T	*/-AT	436	16	3.52%	2	2	93	93	1.3330968393872219E-5	1	1	258	178	10	6	-AT
E7_BC55.191219_FM1-2_consensus_vsearch	2539	T	*/+C	415	17	3.88%	2	1	93	93	6.498207944661731E-6	1	1	238	177	17	0	+C
E7_BC55.191219_FM1-2_consensus_vsearch	2540	C	*/-A	441	8	1.76%	2	2	93	93	0.0037853352821818676	1	1	259	182	5	3	-A
E7_BC55.191219_FM1-2_consensus_vsearch	2544	G	*/-AG	374	49	10.99%	2	2	93	93	4.0618228712785374E-16	1	1	197	177	43	6	-AG
E7_BC55.191219_FM1-2_consensus_vsearch	2544	G	*/-AGG	374	19	4.26%	2	2	93	93	1.5263684541229892E-6	1	1	197	177	18	1	-AG
E7_BC55.191219_FM1-2_consensus_vsearch	2545	A	*/+G	289	12	3.17%	2	2	93	93	2.183212783388439E-4	1	1	135	154	7	5	+G
E7_BC55.191219_FM1-2_consensus_vsearch	2545	A	*/-G	289	76	20.05%	2	2	93	93	1.6841591425548821E-25	1	1	135	154	58	18	-G
E7_BC55.191219_FM1-2_consensus_vsearch	2551	A	*/-G	422	15	3.32%	2	2	93	93	2.7007998247201884E-5	1	1	243	179	14	1	-G
E7_BC55.191219_FM1-2_consensus_vsearch	2555	T	*/-C	368	57	12.78%	2	2	93	93	9.269071714640578E-19	1	1	196	172	56	1	-C
E7_BC55.191219_FM1-2_consensus_vsearch	2555	T	*/-CC	368	17	3.81%	2	2	93	93	6.369386231588866E-6	1	1	196	172	16	1	-C
E7_BC55.191219_FM1-2_consensus_vsearch	2559	G	*/+A	433	10	2.22%	2	1	93	93	9.276896125167864E-4	1	1	257	176	10	0	+A
E7_BC55.191219_FM1-2_consensus_vsearch	2562	C	*/+T	402	11	2.44%	2	2	93	93	4.5643506815540774E-4	1	1	241	161	8	3	+T
E7_BC55.191219_FM1-2_consensus_vsearch	2562	C	*/-T	402	13	2.88%	2	2	93	93	1.1096121102660942E-4	1	1	241	161	7	6	-T
E7_BC55.191219_FM1-2_consensus_vsearch	2562	C	*/-TT	402	15	3.33%	2	2	93	93	2.68474088688777E-5	1	1	241	161	10	5	-TT
E7_BC55.191219_FM1-2_consensus_vsearch	2569	A	*/+G	424	11	2.44%	2	2	93	93	4.580137992598773E-4	1	1	256	168	2	9	+G
E7_BC55.191219_FM1-2_consensus_vsearch	2574	G	*/-C	418	12	2.67%	2	1	93	93	2.2586957161051062E-4	1	1	234	184	12	0	-C
E7_BC55.191219_FM1-2_consensus_vsearch	2574	G	*/-CC	418	12	2.67%	2	1	93	93	2.2586957161051062E-4	1	1	234	184	12	0	-C
E7_BC55.191219_FM1-2_consensus_vsearch	2584	C	*/-T	436	7	1.55%	2	2	93	93	0.007628167177128368	1	1	258	178	5	2	-T
E7_BC55.191219_FM1-2_consensus_vsearch	2585	T	*/+G	408	12	2.7%	2	1	93	93	2.2544581166138029E-4	1	1	249	159	0	12	+G
E7_BC55.191219_FM1-2_consensus_vsearch	2585	T	*/-AC	408	9	2.03%	2	2	93	93	0.0018697784886581234	1	1	249	159	8	1	+G
E7_BC55.191219_FM1-2_consensus_vsearch	2594	C	*/-T	425	16	3.57%	2	1	93	93	1.328532663205171E-5	1	1	261	164	0	16	-T
E7_BC55.191219_FM1-2_consensus_vsearch	2596	C	*/-TC	375	69	15.4%	2	2	93	93	9.64306330999644E-23	1	1	259	116	5	64	-TC
E7_BC55.191219_FM1-2_consensus_vsearch	2601	C	*/+A	428	7	1.55%	2	1	93	93	0.007624792930600719	1	1	248	180	7	0	+A
E7_BC55.191219_FM1-2_consensus_vsearch	2606	C	*/+A	425	8	1.77%	2	1	93	93	0.0037809012469126957	1	1	243	182	8	0	+A
E7_BC55.191219_FM1-2_consensus_vsearch	2606	C	*/+G	425	10	2.21%	2	1	93	93	9.268043937944601E-4	1	1	243	182	10	0	+G
E7_BC55.191219_FM1-2_consensus_vsearch	2607	G	*/+A	425	9	2.01%	2	1	93	93	0.0018730070190884252	1	1	242	183	9	0	+A
E7_BC55.191219_FM1-2_consensus_vsearch	2607	G	*/-A	425	9	2.01%	2	1	93	93	0.0018730070190884252	1	1	242	183	9	0	+A
E7_BC55.191219_FM1-2_consensus_vsearch	2612	G	*/+T	416	21	4.64%	2	2	93	93	3.7282374960453956E-7	1	1	235	181	20	1	+T
E7_BC55.191219_FM1-2_consensus_vsearch	2612	G	*/-T	416	12	2.65%	2	2	93	93	2.257863627265534E-4	1	1	235	181	11	1	+T
E7_BC55.191219_FM1-2_consensus_vsearch	2617	T	*/-G	415	8	1.78%	2	1	93	93	0.003777960974854116	1	1	252	163	8	0	-G
E7_BC55.191219_FM1-2_consensus_vsearch	2619	A	*/-T	423	20	4.44%	2	1	93	93	7.658841069212707E-7	1	1	243	180	20	0	-T
E7_BC55.191219_FM1-2_consensus_vsearch	2623	C	*/-A	441	7	1.55%	2	2	93	93	0.0076302151642897355	1	1	262	179	6	1	-A
E7_BC55.191219_FM1-2_consensus_vsearch	2626	C	*/-T	422	25	5.57%	2	1	93	93	2.110510404694971E-8	1	1	266	156	0	25	-T
E7_BC55.191219_FM1-2_consensus_vsearch	2627	T	*/-C	355	69	16.12%	2	2	93	93	8.321112972089009E-23	1	1	200	155	67	2	-C
E7_BC55.191219_FM1-2_consensus_vsearch	2633	T	*/+G	383	10	2.2%	2	2	93	93	9.215757570452482E-4	1	1	249	134	7	3	+G
E7_BC55.191219_FM1-2_consensus_vsearch	2633	T	*/-G	383	57	12.56%	2	2	93	93	9.975536255508274E-19	1	1	249	134	12	45	-G
E7_BC55.191219_FM1-2_consensus_vsearch	2636	G	*/-AG	437	12	2.65%	2	1	93	93	2.266239976305489E-4	1	1	256	181	12	0	-AG
E7_BC55.191219_FM1-2_consensus_vsearch	2637	A	*/-G	414	19	4.33%	2	2	93	93	1.5588186688080025E-6	1	1	237	177	16	3	-G
E7_BC55.191219_FM1-2_consensus_vsearch	2638	G	*/+A	394	8	1.91%	2	1	93	93	0.0037713141940397903	1	1	221	173	8	0	+A
E7_BC55.191219_FM1-2_consensus_vsearch	2640	T	*/-A	418	14	3.1%	2	2	93	93	5.4841636470744183E-5	1	1	255	163	9	5	-A
E7_BC55.191219_FM1-2_consensus_vsearch	2640	T	*/-AA	418	9	2%	2	1	93	93	0.0018717084025872061	1	1	255	163	0	9	-A
E7_BC55.191219_FM1-2_consensus_vsearch	2643	A	*/-T	431	13	2.86%	2	2	93	93	1.1166488301300728E-4	1	1	268	163	1	12	-T
E7_BC55.191219_FM1-2_consensus_vsearch	2643	A	*/-TT	431	9	1.98%	2	1	93	93	0.0018740875957096264	1	1	268	163	0	9	-T
E7_BC55.191219_FM1-2_consensus_vsearch	2645	T	*/-C	378	49	11.01%	2	2	93	93	4.121858321565859E-16	1	1	260	118	3	46	-C
E7_BC55.191219_FM1-2_consensus_vsearch	2647	C	*/+T	427	9	2.02%	2	1	93	93	0.0018733704789343226	1	1	266	161	0	9	+T
E7_BC55.191219_FM1-2_consensus_vsearch	2650	C	*/-T	425	18	4.01%	2	2	93	93	3.198505438225124E-6	1	1	261	164	2	16	-T
E7_BC55.191219_FM1-2_consensus_vsearch	2651	T	*/+A	370	11	2.55%	2	1	93	93	4.5382073751055476E-4	1	1	213	157	11	0	+A
E7_BC55.191219_FM1-2_consensus_vsearch	2651	T	*/-A	370	35	8.12%	2	2	93	93	1.350918670682252E-11	1	1	213	157	32	3	-A
E7_BC55.191219_FM1-2_consensus_vsearch	2654	A	*/-G	433	17	3.75%	2	1	93	93	6.540845093994583E-6	1	1	252	181	17	0	-G
E7_BC55.191219_FM1-2_consensus_vsearch	2664	C	*/-T	431	18	3.96%	2	2	93	93	3.2061954787653915E-6	1	1	262	169	4	14	-T
E7_BC55.191219_FM1-2_consensus_vsearch	2666	T	*/-G	400	43	9.53%	2	2	93	93	3.895687371141154E-14	1	1	258	142	2	41	-G
E7_BC55.191219_FM1-2_consensus_vsearch	2693	G	*/-TG	439	7	1.54%	2	1	93	93	0.00762940145447119	1	1	263	176	0	7	-TG
E7_BC55.191219_FM1-2_consensus_vsearch	2694	T	*/+G	427	9	2.02%	2	2	93	93	0.0018733704789343226	1	1	262	165	2	7	+G
E7_BC55.191219_FM1-2_consensus_vsearch	2695	G	*/-A	427	10	2.25%	2	1	93	93	9.270286906046182E-4	1	1	252	175	10	0	-A
E7_BC55.191219_FM1-2_consensus_vsearch	2696	A	*/+G	330	23	5.18%	2	2	93	93	8.232381324758503E-8	1	1	152	178	20	3	+G
E7_BC55.191219_FM1-2_consensus_vsearch	2696	A	*/-G	330	84	18.92%	2	2	93	93	4.738964283992109E-28	1	1	152	178	80	4	-G
E7_BC55.191219_FM1-2_consensus_vsearch	2699	G	*/+A	408	13	2.88%	2	2	93	93	1.1111449338120726E-4	1	1	231	177	12	1	+A
E7_BC55.191219_FM1-2_consensus_vsearch	2699	G	*/-A	408	21	4.66%	2	1	93	93	3.710748653386239E-7	1	1	231	177	21	0	-A
E7_BC55.191219_FM1-2_consensus_vsearch	2706	G	*/+A	324	10	2.21%	2	2	93	93	9.120540902472859E-4	1	1	163	161	8	2	+A
E7_BC55.191219_FM1-2_consensus_vsearch	2706	G	*/-A	324	108	23.89%	2	2	93	93	1.4469404833717373E-36	1	1	163	161	86	22	-A
E7_BC55.191219_FM1-2_consensus_vsearch	2714	C	*/+T	406	8	1.76%	2	2	93	93	0.0037751942594862146	1	1	253	153	1	7	+T
E7_BC55.191219_FM1-2_consensus_vsearch	2714	C	*/-T	406	22	4.85%	2	2	93	93	1.8076265748958188E-7	1	1	253	153	1	21	-T
E7_BC55.191219_FM1-2_consensus_vsearch	2714	C	*/-TT	406	15	3.3%	2	2	93	93	2.6880690187417594E-5	1	1	253	153	13	2	-T
E7_BC55.191219_FM1-2_consensus_vsearch	2717	T	*/-G	409	39	8.59%	2	2	93	93	7.663248718263112E-13	1	1	267	142	1	38	-G
E7_BC55.191219_FM1-2_consensus_vsearch	2719	G	*/-A	375	73	16.15%	2	2	93	93	4.335804965975598E-24	1	1	193	182	72	1	-A
E7_BC55.191219_FM1-2_consensus_vsearch	2725	G	*/-AG	383	57	12.72%	2	2	93	93	9.975536255508274E-19	1	1	201	182	54	3	-AG
E7_BC55.191219_FM1-2_consensus_vsearch	2739	G	*/-TG	434	7	1.56%	2	1	93	93	0.007627335039353406	1	1	263	171	0	7	-TG
E7_BC55.191219_FM1-2_consensus_vsearch	2752	T	*/+G	134	240	53.57%	2	2	93	93	1.8239834027809484E-98	1	1	103	31	103	137	+G
E7_BC55.191219_FM1-2_consensus_vsearch	2752	T	*/+GG	134	15	3.35%	2	2	93	93	2.1068355581752277E-5	1	1	103	31	11	4	+G
E7_BC55.191219_FM1-2_consensus_vsearch	2752	T	*/-G	134	29	6.47%	2	2	93	93	4.748298119894438E-10	1	1	103	31	26	3	-G
E7_BC55.191219_FM1-2_consensus_vsearch	2752	T	*/-GG	134	25	5.58%	2	2	93	93	1.071080352374038E-8	1	1	103	31	24	1	-G
E7_BC55.191219_FM1-2_consensus_vsearch	2759	C	*/+A	424	9	2%	2	1	93	93	0.0018728240442215458	1	1	243	181	9	0	+A
E7_BC55.191219_FM1-2_consensus_vsearch	2759	C	*/+G	424	13	2.88%	2	2	93	93	1.115033140535145E-4	1	1	243	181	12	1	+G
E7_BC55.191219_FM1-2_consensus_vsearch	2761	C	*/-T	417	11	2.44%	2	2	93	93	4.575287206333824E-4	1	1	245	172	7	4	-T
E7_BC55.191219_FM1-2_consensus_vsearch	2761	C	*/-TT	417	12	2.66%	2	1	93	93	2.2582806164226E-4	1	1	245	172	12	0	-TT
E7_BC55.191219_FM1-2_consensus_vsearch	2763	T	*/+G	398	16	3.66%	2	2	93	93	1.3163587130167554E-5	1	1	228	170	11	5	+G
E7_BC55.191219_FM1-2_consensus_vsearch	2764	G	*/-A	436	12	2.68%	2	2	93	93	2.2658584690234848E-4	1	1	257	179	9	3	-A
E7_BC55.191219_FM1-2_consensus_vsearch	2774	G	*/-CG	437	11	2.43%	2	2	93	93	4.588752277082112E-4	1	1	266	171	2	9	-CG
E7_BC55.191219_FM1-2_consensus_vsearch	2777	T	*/-C	438	8	1.77%	2	2	93	93	0.0037845279531252564	1	1	264	174	4	4	-C
E7_BC55.191219_FM1-2_consensus_vsearch	2780	T	*/-C	371	70	15.56%	2	2	93	93	4.319816120797377E-23	1	1	194	177	67	3	-C
E7_BC55.191219_FM1-2_consensus_vsearch	2782	C	*/-G	404	17	3.76%	2	2	93	93	6.470471302259629E-6	1	1	250	154	7	10	-G
E7_BC55.191219_FM1-2_consensus_vsearch	2782	C	*/-GG	404	14	3.1%	2	1	93	93	5.4642218239350483E-5	1	1	250	154	0	14	-G
E7_BC55.191219_FM1-2_consensus_vsearch	2785	G	*/-A	429	19	4.19%	2	1	93	93	1.5696112350960334E-6	1	1	246	183	19	0	-A
E7_BC55.191219_FM1-2_consensus_vsearch	2788	T	*/+C	437	9	1.98%	2	1	93	93	0.0018751394156906677	1	1	257	180	9	0	+C
E7_BC55.191219_FM1-2_consensus_vsearch	2791	G	*/+C	346	19	4.19%	2	2	93	93	1.4998271409615135E-6	1	1	186	160	10	9	+C
E7_BC55.191219_FM1-2_consensus_vsearch	2791	G	*/-C	346	63	13.91%	2	2	93	93	8.149986291259221E-21	1	1	186	160	49	14	-C
E7_BC55.191219_FM1-2_consensus_vsearch	2791	G	*/-CC	346	9	1.99%	2	1	93	93	0.0018554195176113948	1	1	186	160	9	0	-C
E7_BC55.191219_FM1-2_consensus_vsearch	2791	G	*/-CCC	346	9	1.99%	2	1	93	93	0.0018554195176113948	1	1	186	160	9	0	-C
E7_BC55.191219_FM1-2_consensus_vsearch	2795	C	*/-G	424	8	1.76%	2	2	93	93	0.0037806132981311326	1	1	263	161	5	3	-G
E7_BC55.191219_FM1-2_consensus_vsearch	2797	C	*/-T	435	9	1.99%	2	1	93	93	0.0018747919330438447	1	1	264	171	0	9	-T
E7_BC55.191219_FM1-2_consensus_vsearch	2799	C	*/-T	435	8	1.77%	2	1	93	93	0.0037837097715777354	1	1	267	168	0	8	-T
E7_BC55.191219_FM1-2_consensus_vsearch	2804	T	*/-G	432	10	2.21%	2	2	93	93	9.275806861447792E-4	1	1	259	173	5	5	-G
E7_BC55.191219_FM1-2_consensus_vsearch	2806	G	*/+A	418	19	4.19%	2	1	93	93	1.5617633199588545E-6	1	1	247	171	19	0	+A
E7_BC55.191219_FM1-2_consensus_vsearch	2807	G	*/-TG	435	14	3.08%	2	1	93	93	5.5067686315232855E-5	1	1	265	170	0	14	-TG
E7_BC55.191219_FM1-2_consensus_vsearch	2808	T	*/-GC	427	8	1.82%	2	1	93	93	0.0037814732031268648	1	1	267	160	0	8	-GC
E7_BC55.191219_FM1-2_consensus_vsearch	2811	A	*/-T	432	12	2.65%	2	2	93	93	2.2643156833193682E-4	1	1	260	172	3	9	-T
E7_BC55.191219_FM1-2_consensus_vsearch	2814	T	*/-C	373	73	16.08%	2	2	93	93	4.26853091983595E-24	1	1	222	151	46	27	-C
E7_BC55.191219_FM1-2_consensus_vsearch	2815	C	*/+A	369	7	1.84%	2	1	93	93	0.007595497661975396	1	1	213	156	7	0	+A
E7_BC55.191219_FM1-2_consensus_vsearch	2816	C	*/-T	430	18	3.97%	2	2	93	93	3.2049271265272453E-6	1	1	262	168	6	12	-T
E7_BC55.191219_FM1-2_consensus_vsearch	2817	T	*/+G	397	7	1.62%	2	2	93	93	0.00761046189928152	1	1	258	139	1	6	+G
E7_BC55.191219_FM1-2_consensus_vsearch	2817	T	*/-G	397	14	3.23%	2	1	93	93	5.453761990528223E-5	1	1	258	139	0	14	-G
E7_BC55.191219_FM1-2_consensus_vsearch	2824	C	*/-G	408	29	6.43%	2	2	93	93	1.1522511894782628E-9	1	1	262	146	3	26	-G
E7_BC55.191219_FM1-2_consensus_vsearch	2837	A	*/+T	340	17	3.82%	2	2	93	93	6.277729290076549E-6	1	1	161	179	16	1	+T
E7_BC55.191219_FM1-2_consensus_vsearch	2837	A	*/-T	340	68	15.28%	2	1	93	93	1.6085073123707868E-22	1	1	161	179	68	0	-T
E7_BC55.191219_FM1-2_consensus_vsearch	2837	A	*/-TT	340	10	2.25%	2	2	93	93	9.149473929364378E-4	1	1	161	179	9	1	-T
E7_BC55.191219_FM1-2_consensus_vsearch	2841	T	*/+G	423	8	1.77%	2	1	93	93	0.003780324023462628	1	1	255	168	0	8	+G
E7_BC55.191219_FM1-2_consensus_vsearch	2843	G	*/+C	437	10	2.21%	2	1	93	93	9.281205170584159E-4	1	1	254	183	10	0	+C
E7_BC55.191219_FM1-2_consensus_vsearch	2847	T	*/+C	430	8	1.77%	2	2	93	93	0.0037823214180042796	1	1	257	173	7	1	+C
E7_BC55.191219_FM1-2_consensus_vsearch	2848	C	*/-G	417	22	4.9%	2	2	93	93	1.8205291089323654E-7	1	1	244	173	19	3	-G
E7_BC55.191219_FM1-2_consensus_vsearch	2850	G	*/+A	329	11	2.43%	2	2	93	93	4.497704755708121E-4	1	1	166	163	6	5	+A
E7_BC55.191219_FM1-2_consensus_vsearch	2850	G	*/-A	329	81	17.88%	2	2	93	93	5.128663748251756E-27	1	1	166	163	70	11	-A
E7_BC55.191219_FM1-2_consensus_vsearch	2850	G	*/-AA	329	28	6.18%	2	2	93	93	2.1476595888266758E-9	1	1	166	163	25	3	-A
E7_BC55.191219_FM1-2_consensus_vsearch	2854	A	*/-G	433	11	2.43%	2	2	93	93	4.5861543978572406E-4	1	1	258	175	6	5	-G
E7_BC55.191219_FM1-2_consensus_vsearch	2858	C	*/-AGC	429	12	2.65%	2	1	93	93	2.2631406886309665E-4	1	1	250	179	12	0	-AGC
E7_BC55.191219_FM1-2_consensus_vsearch	2864	G	*/-A	430	15	3.35%	2	2	93	93	2.7068371529022044E-5	1	1	253	177	13	2	-A
E7_BC55.191219_FM1-2_consensus_vsearch	2867	T	*/+C	439	7	1.55%	2	2	93	93	0.00762940145447119	1	1	260	179	6	1	+C
E7_BC55.191219_FM1-2_consensus_vsearch	2868	G	*/-TG	410	26	5.73%	2	2	93	93	1.014973264952114E-8	1	1	248	162	8	18	-TG
E7_BC55.191219_FM1-2_consensus_vsearch	2872	C	*/-A	422	12	2.71%	2	2	93	93	2.2603374744065776E-4	1	1	250	172	10	2	-A
E7_BC55.191219_FM1-2_consensus_vsearch	2875	C	*/-T	413	33	7.3%	2	1	93	93	6.297307667870376E-11	1	1	267	146	0	33	-T
E7_BC55.191219_FM1-2_consensus_vsearch	2876	T	*/-C	408	7	1.67%	2	2	93	93	0.007615790966496023	1	1	260	148	6	1	-C
E7_BC55.191219_FM1-2_consensus_vsearch	2881	C	*/+TT	428	7	1.55%	2	1	93	93	0.007624792930600719	1	1	248	180	7	0	+TT
E7_BC55.191219_FM1-2_consensus_vsearch	2885	G	*/-T	418	14	3.1%	2	2	93	93	5.4841636470744183E-5	1	1	238	180	13	1	-T
E7_BC55.191219_FM1-2_consensus_vsearch	2892	C	*/+GC	431	12	2.65%	2	1	93	93	2.2639257424578987E-4	1	1	253	178	12	0	+GC
E7_BC55.191219_FM1-2_consensus_vsearch	2894	C	*/-G	429	7	1.57%	2	2	93	93	0.007625221451403564	1	1	255	174	5	2	-G
E7_BC55.191219_FM1-2_consensus_vsearch	2895	G	*/-CTG	423	17	3.8%	2	1	93	93	6.517562209625466E-6	1	1	260	163	0	17	-CTG
E7_BC55.191219_FM1-2_consensus_vsearch	2899	T	*/+C	434	10	2.2%	2	1	93	93	9.277980556005647E-4	1	1	253	181	10	0	+C
E7_BC55.191219_FM1-2_consensus_vsearch	2905	G	*/+C	439	7	1.55%	2	1	93	93	0.00762940145447119	1	1	267	172	0	7	+C
E7_BC55.191219_FM1-2_consensus_vsearch	2907	C	*/-T	429	20	4.41%	2	1	93	93	7.681820871873446E-7	1	1	267	162	0	20	-T
E7_BC55.191219_FM1-2_consensus_vsearch	2909	C	*/-G	441	7	1.56%	2	2	93	93	0.0076302151642897355	1	1	265	176	2	5	-G
E7_BC55.191219_FM1-2_consensus_vsearch	2911	G	*/-C	391	57	12.58%	2	2	93	93	1.035178345920716E-18	1	1	225	166	38	19	-C
E7_BC55.191219_FM1-2_consensus_vsearch	2913	C	*/+G	378	8	1.77%	2	2	93	93	0.00376576873622069	1	1	256	122	2	6	+G
E7_BC55.191219_FM1-2_consensus_vsearch	2913	C	*/-G	378	44	9.71%	2	2	93	93	1.7425894494523225E-14	1	1	256	122	3	41	-G
E7_BC55.191219_FM1-2_consensus_vsearch	2913	C	*/-GG	378	11	2.43%	2	1	93	93	4.5451373534606624E-4	1	1	256	122	0	11	-G
E7_BC55.191219_FM1-2_consensus_vsearch	2918	T	*/+G	435	7	1.55%	2	2	93	93	0.007627752045228881	1	1	265	170	1	6	+G
E7_BC55.191219_FM1-2_consensus_vsearch	2922	T	*/+C	420	15	3.35%	2	1	93	93	2.6992573667884224E-5	1	1	244	176	15	0	+C
E7_BC55.191219_FM1-2_consensus_vsearch	2933	G	*/-C	413	24	5.36%	2	2	93	93	4.3085104676575724E-8	1	1	235	178	17	7	-C
E7_BC55.191219_FM1-2_consensus_vsearch	2946	C	*/-T	431	15	3.3%	2	2	93	93	2.70757726321695E-5	1	1	261	170	2	13	-T
E7_BC55.191219_FM1-2_consensus_vsearch	2957	T	*/-A	427	9	2.03%	2	2	93	93	0.0018733704789343226	1	1	253	174	7	2	-A
E7_BC55.191219_FM1-2_consensus_vsearch	2963	C	*/+T	395	10	2.22%	2	2	93	93	9.231784868029211E-4	1	1	244	151	3	7	+T
E7_BC55.191219_FM1-2_consensus_vsearch	2963	C	*/-T	395	26	5.78%	2	2	93	93	1.0007493567740277E-8	1	1	244	151	8	18	-T
E7_BC55.191219_FM1-2_consensus_vsearch	2963	C	*/-TT	395	11	2.44%	2	1	93	93	4.558976374421885E-4	1	1	244	151	11	0	-T
E7_BC55.191219_FM1-2_consensus_vsearch	2966	T	*/-A	423	7	1.55%	2	2	93	93	0.007622620571895094	1	1	251	172	4	3	-A
E7_BC55.191219_FM1-2_consensus_vsearch	2971	G	*/-A	444	7	1.55%	2	1	93	93	0.007631422258539495	1	1	260	184	7	0	-A
E7_BC55.191219_FM1-2_consensus_vsearch	2972	A	*/+C	403	8	1.79%	2	2	93	93	0.0037742453123195243	1	1	221	182	7	1	+C
E7_BC55.191219_FM1-2_consensus_vsearch	2972	A	*/-C	403	20	4.47%	2	2	93	93	7.577972988312236E-7	1	1	221	182	18	2	-C
E7_BC55.191219_FM1-2_consensus_vsearch	2980	T	*/+G	433	9	1.99%	2	2	93	93	0.001874441340367089	1	1	259	174	3	6	+G
E7_BC55.191219_FM1-2_consensus_vsearch	2981	G	*/+A	438	9	1.99%	2	2	93	93	0.001875312003649851	1	1	263	175	2	7	+A
E7_BC55.191219_FM1-2_consensus_vsearch	2990	A	*/-C	434	15	3.3%	2	1	93	93	2.7097786818023924E-5	1	1	251	183	15	0	-C
E7_BC55.191219_FM1-2_consensus_vsearch	2992	C	*/-A	413	21	4.63%	2	2	93	93	3.721746994729156E-7	1	1	237	176	17	4	-A
E7_BC55.191219_FM1-2_consensus_vsearch	2994	A	*/+G	399	9	2.01%	2	1	93	93	0.001867961645486525	1	1	218	181	9	0	+G
E7_BC55.191219_FM1-2_consensus_vsearch	2994	A	*/-G	399	35	7.81%	2	2	93	93	1.4250740771115744E-11	1	1	218	181	33	2	-G
E7_BC55.191219_FM1-2_consensus_vsearch	2996	G	*/-A	430	10	2.21%	2	2	93	93	9.273613705492817E-4	1	1	246	184	9	1	-A
E7_BC55.191219_FM1-2_consensus_vsearch	2996	G	*/-AG	430	12	2.65%	2	1	93	93	2.263534081363424E-4	1	1	246	184	12	0	-AG
E7_BC55.191219_FM1-2_consensus_vsearch	3000	C	*/-T	440	10	2.21%	2	1	93	93	9.284387427353376E-4	1	1	266	174	0	10	-T
E7_BC55.191219_FM1-2_consensus_vsearch	3004	C	*/-T	438	9	1.99%	2	2	93	93	0.001875312003649851	1	1	265	173	2	7	-T
E7_BC55.191219_FM1-2_consensus_vsearch	3009	G	*/-TG	434	8	1.77%	2	2	93	93	0.0037834345948323136	1	1	259	175	1	7	-TG
E7_BC55.191219_FM1-2_consensus_vsearch	3017	C	*/+T	422	12	2.64%	2	2	93	93	2.2603374744065776E-4	1	1	263	159	2	10	+T
E7_BC55.191219_FM1-2_consensus_vsearch	3017	C	*/-T	422	17	3.74%	2	2	93	93	6.515179143868675E-6	1	1	263	159	2	15	-T
E7_BC55.191219_FM1-2_consensus_vsearch	3020	T	*/-G	414	28	6.17%	2	2	93	93	2.395850063378546E-9	1	1	248	166	19	9	-G
E7_BC55.191219_FM1-2_consensus_vsearch	3022	G	*/+A	414	27	5.99%	2	1	93	93	4.9428402008462044E-9	1	1	236	178	27	0	+A
E7_BC55.191219_FM1-2_consensus_vsearch	3024	T	*/-G	409	16	3.6%	2	2	93	93	1.32149501788179E-5	1	1	244	165	8	8	-G
E7_BC55.191219_FM1-2_consensus_vsearch	3026	G	*/+A	369	15	3.39%	2	2	93	93	2.6547739902969607E-5	1	1	229	140	8	7	+A
E7_BC55.191219_FM1-2_consensus_vsearch	3026	G	*/-A	369	55	12.42%	2	2	93	93	4.265280154864149E-18	1	1	229	140	21	34	-A
E7_BC55.191219_FM1-2_consensus_vsearch	3030	A	*/-C	425	10	2.2%	2	2	93	93	9.268043937944601E-4	1	1	248	177	5	5	-C
E7_BC55.191219_FM1-2_consensus_vsearch	3041	T	*/-A	429	11	2.43%	2	2	93	93	4.5835102222652706E-4	1	1	264	165	1	10	-A
E7_BC55.191219_FM1-2_consensus_vsearch	3045	G	*/-A	432	7	1.55%	2	2	93	93	0.0076264953547406375	1	1	255	177	6	1	-A
E7_BC55.191219_FM1-2_consensus_vsearch	3049	G	*/-T	439	11	2.43%	2	1	93	93	4.5900342337653016E-4	1	1	268	171	0	11	-T
E7_BC55.191219_FM1-2_consensus_vsearch	3050	T	*/+G	422	9	2.03%	2	1	93	93	0.0018724555760242295	1	1	261	161	0	9	+G
E7_BC55.191219_FM1-2_consensus_vsearch	3051	G	*/-A	426	14	3.12%	2	2	93	93	5.495010686777893E-5	1	1	247	179	11	3	-A
E7_BC55.191219_FM1-2_consensus_vsearch	3057	C	*/+A	391	20	4.42%	2	1	93	93	7.526037824373492E-7	1	1	225	166	20	0	+A
E7_BC55.191219_FM1-2_consensus_vsearch	3057	C	*/+G	391	8	1.77%	2	2	93	93	0.003770308015149166	1	1	225	166	7	1	+A
E7_BC55.191219_FM1-2_consensus_vsearch	3057	C	*/-G	391	29	6.42%	2	2	93	93	1.1292874421025119E-9	1	1	225	166	12	17	-G
E7_BC55.191219_FM1-2_consensus_vsearch	3060	G	*/-A	443	7	1.54%	2	2	93	93	0.00763102167395619	1	1	262	181	5	2	-A
E7_BC55.191219_FM1-2_consensus_vsearch	3063	T	*/-C	434	7	1.55%	2	1	93	93	0.007627335039353406	1	1	266	168	0	7	-C
E7_BC55.191219_FM1-2_consensus_vsearch	3063	T	*/-CT	434	7	1.55%	2	1	93	93	0.007627335039353406	1	1	266	168	0	7	-C
E7_BC55.191219_FM1-2_consensus_vsearch	3064	C	*/+T	326	33	7.53%	2	2	93	93	5.387330696983159E-11	1	1	256	70	8	25	+T
E7_BC55.191219_FM1-2_consensus_vsearch	3064	C	*/-T	326	70	15.98%	2	2	93	93	2.9785057168696045E-23	1	1	256	70	3	67	-T
E7_BC55.191219_FM1-2_consensus_vsearch	3064	C	*/-TT	326	7	1.6%	2	2	93	93	0.007567647220958338	1	1	256	70	1	6	-T
E7_BC55.191219_FM1-2_consensus_vsearch	3067	T	*/-AC	428	11	2.43%	2	2	93	93	4.5828417992626897E-4	1	1	254	174	10	1	-AC
E7_BC55.191219_FM1-2_consensus_vsearch	3069	C	*/-G	384	16	3.68%	2	2	93	93	1.309436672524504E-5	1	1	226	158	2	14	-G
E7_BC55.191219_FM1-2_consensus_vsearch	3069	C	*/-GG	384	18	4.14%	2	1	93	93	3.140282000063732E-6	1	1	226	158	18	0	-GG
E7_BC55.191219_FM1-2_consensus_vsearch	3071	G	*/-A	410	10	2.29%	2	2	93	93	9.250551591024766E-4	1	1	232	178	7	3	-A
E7_BC55.191219_FM1-2_consensus_vsearch	3072	A	*/+G	414	9	2.05%	2	2	93	93	0.0018709472608215796	1	1	239	175	7	2	+G
E7_BC55.191219_FM1-2_consensus_vsearch	3072	A	*/-G	414	12	2.74%	2	2	93	93	2.2570239286811238E-4	1	1	239	175	10	2	-G
E7_BC55.191219_FM1-2_consensus_vsearch	3073	G	*/+A	410	14	3.21%	2	1	93	93	5.472923269186134E-5	1	1	233	177	14	0	+A
E7_BC55.191219_FM1-2_consensus_vsearch	3082	G	*/+C	422	7	1.55%	2	1	93	93	0.007622180052576428	1	1	240	182	7	0	+C
E7_BC55.191219_FM1-2_consensus_vsearch	3082	G	*/-C	422	13	2.88%	2	2	93	93	1.1145622644220473E-4	1	1	240	182	12	1	-C
E7_BC55.191219_FM1-2_consensus_vsearch	3091	T	*/-G	408	9	2.05%	2	1	93	93	0.0018697784886581234	1	1	236	172	9	0	-G
E7_BC55.191219_FM1-2_consensus_vsearch	3092	G	*/-AA	385	26	5.99%	2	2	93	93	9.907920068350188E-9	1	1	211	174	24	2	-AA
E7_BC55.191219_FM1-2_consensus_vsearch	3094	A	*/-G	405	8	1.87%	2	1	93	93	0.003774879463209244	1	1	224	181	8	0	-G
E7_BC55.191219_FM1-2_consensus_vsearch	3095	G	*/-T	410	22	4.94%	2	2	93	93	1.812385707292981E-7	1	1	232	178	18	4	-T
E7_BC55.191219_FM1-2_consensus_vsearch	3112	A	*/-G	420	13	2.92%	2	2	93	93	1.1140871758939428E-4	1	1	242	178	12	1	-G
E7_BC55.191219_FM1-2_consensus_vsearch	3114	G	*/+C	426	8	1.77%	2	1	93	93	0.0037811878789100195	1	1	243	183	8	0	+C
E7_BC55.191219_FM1-2_consensus_vsearch	3116	A	*/+G	429	7	1.56%	2	2	93	93	0.007625221451403564	1	1	255	174	1	6	+G
E7_BC55.191219_FM1-2_consensus_vsearch	3122	T	*/+G	416	22	4.88%	2	2	93	93	1.8193798980659542E-7	1	1	257	159	1	21	+G
E7_BC55.191219_FM1-2_consensus_vsearch	3124	T	*/-A	397	21	4.82%	2	2	93	93	3.6857245024714237E-7	1	1	243	154	3	18	-A
E7_BC55.191219_FM1-2_consensus_vsearch	3129	T	*/-G	435	14	3.08%	2	2	93	93	5.5067686315232855E-5	1	1	266	169	2	12	-G
E7_BC55.191219_FM1-2_consensus_vsearch	3133	A	*/-C	425	7	1.54%	2	2	93	93	0.007623495521158642	1	1	242	183	5	2	-C
E7_BC55.191219_FM1-2_consensus_vsearch	3133	A	*/-CC	425	20	4.41%	2	1	93	93	7.666563733598089E-7	1	1	242	183	20	0	-CC
E7_BC55.191219_FM1-2_consensus_vsearch	3137	G	*/-A	385	49	10.94%	2	2	93	93	4.226144145045268E-16	1	1	210	175	48	1	-A
E7_BC55.191219_FM1-2_consensus_vsearch	3137	G	*/-AA	385	7	1.56%	2	2	93	93	0.007604309052101333	1	1	210	175	5	2	-A
E7_BC55.191219_FM1-2_consensus_vsearch	3146	T	*/+A	431	11	2.43%	2	2	93	93	4.584838174083158E-4	1	1	256	175	10	1	+A
E7_BC55.191219_FM1-2_consensus_vsearch	3147	G	*/-A	435	12	2.66%	2	1	93	93	2.2654752970435957E-4	1	1	255	180	12	0	-A
E7_BC55.191219_FM1-2_consensus_vsearch	3162	A	*/+G	390	9	2.02%	2	2	93	93	0.0018660638404102402	1	1	241	149	7	2	+G
E7_BC55.191219_FM1-2_consensus_vsearch	3162	A	*/-G	390	38	8.54%	2	2	93	93	1.5407043626190607E-12	1	1	241	149	8	30	-G
E7_BC55.191219_FM1-2_consensus_vsearch	3163	G	*/+A	386	14	3.41%	2	1	93	93	5.4366161181224727E-5	1	1	233	153	14	0	+A
E7_BC55.191219_FM1-2_consensus_vsearch	3164	G	*/+A	421	14	3.1%	2	1	93	93	5.4882762612112586E-5	1	1	238	183	14	0	+A
E7_BC55.191219_FM1-2_consensus_vsearch	3166	T	*/+G	429	10	2.21%	2	2	93	93	9.272509747675099E-4	1	1	258	171	5	5	+G
E7_BC55.191219_FM1-2_consensus_vsearch	3167	G	*/-AA	438	10	2.22%	2	2	93	93	9.282270587880905E-4	1	1	265	173	2	8	-AA
E7_BC55.191219_FM1-2_consensus_vsearch	3170	G	*/-C	432	8	1.78%	2	2	93	93	0.0037828805172695963	1	1	253	179	5	3	-C
E7_BC55.191219_FM1-2_consensus_vsearch	3172	C	*/-A	417	9	1.99%	2	2	93	93	0.0018715194418685113	1	1	244	173	7	2	-A
E7_BC55.191219_FM1-2_consensus_vsearch	3173	A	*/+G	201	127	29.4%	2	2	93	93	1.3896435302645055E-45	1	1	156	45	11	116	+G
E7_BC55.191219_FM1-2_consensus_vsearch	3173	A	*/-G	201	54	12.5%	2	2	93	93	2.3980408842051996E-18	1	1	156	45	48	6	+G
E7_BC55.191219_FM1-2_consensus_vsearch	3173	A	*/-GG	201	29	6.71%	2	1	93	93	7.264467881649699E-10	1	1	156	45	29	0	+G
E7_BC55.191219_FM1-2_consensus_vsearch	3180	C	*/-T	435	12	2.65%	2	2	93	93	2.2654752970435957E-4	1	1	265	170	2	10	-T
E7_BC55.191219_FM1-2_consensus_vsearch	3181	T	*/-C	424	9	2.04%	2	1	93	93	0.0018728240442215458	1	1	262	162	0	9	-C
E7_BC55.191219_FM1-2_consensus_vsearch	3183	T	*/-G	421	16	3.6%	2	1	93	93	1.3268190058544006E-5	1	1	262	159	0	16	-G
E7_BC55.191219_FM1-2_consensus_vsearch	3184	G	*/+A	413	12	2.76%	2	1	93	93	2.2566011930545864E-4	1	1	250	163	12	0	+A
E7_BC55.191219_FM1-2_consensus_vsearch	3186	T	*/-G	418	14	3.13%	2	2	93	93	5.4841636470744183E-5	1	1	259	159	5	9	-G
E7_BC55.191219_FM1-2_consensus_vsearch	3188	G	*/-AG	431	8	1.79%	2	1	93	93	0.003782601599602771	1	1	254	177	8	0	-AG
E7_BC55.191219_FM1-2_consensus_vsearch	3189	A	*/+G	421	7	1.58%	2	2	93	93	0.007621737484585097	1	1	245	176	3	4	+G
E7_BC55.191219_FM1-2_consensus_vsearch	3189	A	*/-G	421	11	2.49%	2	2	93	93	4.5780779436953333E-4	1	1	245	176	7	4	-G
E7_BC55.191219_FM1-2_consensus_vsearch	3191	G	*/-C	434	7	1.54%	2	1	93	93	0.007627335039353406	1	1	267	167	0	7	-C
E7_BC55.191219_FM1-2_consensus_vsearch	3193	T	*/-C	438	7	1.56%	2	1	93	93	0.007628991869306366	1	1	265	173	0	7	-C
E7_BC55.191219_FM1-2_consensus_vsearch	3194	C	*/-GT	423	11	2.46%	2	2	93	93	4.5794544103178105E-4	1	1	260	163	1	10	-GT
E7_BC55.191219_FM1-2_consensus_vsearch	3196	T	*/-A	389	22	4.98%	2	1	93	93	1.7864911812841163E-7	1	1	238	151	22	0	-A
E7_BC55.191219_FM1-2_consensus_vsearch	3199	C	*/+TT	412	11	2.47%	2	1	93	93	4.571726097283556E-4	1	1	240	172	11	0	+TT
E7_BC55.191219_FM1-2_consensus_vsearch	3200	G	*/-A	428	8	1.8%	2	1	93	93	0.0037817572285023734	1	1	249	179	8	0	-A
E7_BC55.191219_FM1-2_consensus_vsearch	3203	T	*/+C	424	15	3.3%	2	2	93	93	2.7023288595668283E-5	1	1	252	172	14	1	+C
E7_BC55.191219_FM1-2_consensus_vsearch	3203	T	*/-C	424	7	1.54%	2	1	93	93	0.007623059056742502	1	1	252	172	0	7	+C
E7_BC55.191219_FM1-2_consensus_vsearch	3204	C	*/+T	426	8	1.79%	2	1	93	93	0.0037811878789100195	1	1	258	168	0	8	+T
E7_BC55.191219_FM1-2_consensus_vsearch	3205	T	*/+G	429	11	2.46%	2	1	93	93	4.5835102222652706E-4	1	1	261	168	0	11	+G
E7_BC55.191219_FM1-2_consensus_vsearch	3209	G	*/+A	404	8	1.76%	2	1	93	93	0.0037745631511436058	1	1	251	153	8	0	+A
E7_BC55.191219_FM1-2_consensus_vsearch	3209	G	*/-TG	404	31	6.83%	2	1	93	93	2.675845786600224E-10	1	1	251	153	0	31	-TG
E7_BC55.191219_FM1-2_consensus_vsearch	3212	C	*/-A	404	41	9.07%	2	2	93	93	1.7314037740300128E-13	1	1	260	144	5	36	-A
E7_BC55.191219_FM1-2_consensus_vsearch	3224	C	*/+A	431	7	1.57%	2	1	93	93	0.007626072650234986	1	1	249	182	7	0	+A
E7_BC55.191219_FM1-2_consensus_vsearch	3229	G	*/-TG	425	13	2.88%	2	2	93	93	1.115267016392494E-4	1	1	256	169	1	12	-TG
E7_BC55.191219_FM1-2_consensus_vsearch	3230	T	*/+G	398	10	2.29%	2	2	93	93	9.235646797394348E-4	1	1	247	151	1	9	+G
E7_BC55.191219_FM1-2_consensus_vsearch	3230	T	*/-G	398	20	4.58%	2	2	93	93	7.556661291497999E-7	1	1	247	151	13	7	-G
E7_BC55.191219_FM1-2_consensus_vsearch	3237	A	*/+G	345	11	2.46%	2	2	93	93	4.514593200376986E-4	1	1	232	113	4	7	+G
E7_BC55.191219_FM1-2_consensus_vsearch	3237	A	*/-G	345	85	18.97%	2	2	93	93	2.565722347044382E-28	1	1	232	113	31	54	-G
E7_BC55.191219_FM1-2_consensus_vsearch	3243	G	*/+A	391	13	2.9%	2	2	93	93	1.1066876939038198E-4	1	1	218	173	10	3	+A
E7_BC55.191219_FM1-2_consensus_vsearch	3243	G	*/-A	391	31	6.92%	2	2	93	93	2.628860323558501E-10	1	1	218	173	28	3	-A
E7_BC55.191219_FM1-2_consensus_vsearch	3243	G	*/-AA	391	8	1.79%	2	2	93	93	0.003770308015149166	1	1	218	173	4	4	-A
E7_BC55.191219_FM1-2_consensus_vsearch	3253	T	*/+C	436	10	2.21%	2	1	93	93	9.280135047051926E-4	1	1	253	183	10	0	+C
E7_BC55.191219_FM1-2_consensus_vsearch	3254	C	*/+A	406	30	6.71%	2	1	93	93	5.556729380211432E-10	1	1	230	176	30	0	+A
E7_BC55.191219_FM1-2_consensus_vsearch	3255	G	*/-A	420	25	5.54%	2	1	93	93	2.1071463853107665E-8	1	1	238	182	25	0	-A
E7_BC55.191219_FM1-2_consensus_vsearch	3274	T	*/-C	427	20	4.42%	2	2	93	93	7.67422341324127E-7	1	1	255	172	11	9	-C
E7_BC55.191219_FM1-2_consensus_vsearch	3276	C	*/-T	437	11	2.43%	2	2	93	93	4.588752277082112E-4	1	1	259	178	5	6	-T
E7_BC55.191219_FM1-2_consensus_vsearch	3278	G	*/-C	435	8	1.78%	2	1	93	93	0.0037837097715777354	1	1	252	183	8	0	-C
E7_BC55.191219_FM1-2_consensus_vsearch	3280	C	*/-GA	412	22	4.88%	2	2	93	93	1.81473613792819E-7	1	1	240	172	14	8	-GA
E7_BC55.191219_FM1-2_consensus_vsearch	3281	G	*/-AA	401	7	1.65%	2	2	93	93	0.007612432822507446	1	1	234	167	3	4	-AA
E7_BC55.191219_FM1-2_consensus_vsearch	3283	A	*/-G	433	7	1.58%	2	2	93	93	0.0076269161468125015	1	1	256	177	6	1	-G
E7_BC55.191219_FM1-2_consensus_vsearch	3287	T	*/-C	294	111	24.72%	2	2	93	93	6.016904202903438E-38	1	1	225	69	35	76	-C
E7_BC55.191219_FM1-2_consensus_vsearch	3287	T	*/-CC	294	7	1.56%	2	2	93	93	0.0075417923062006415	1	1	225	69	1	6	-C
E7_BC55.191219_FM1-2_consensus_vsearch	3287	T	*/-CCCT	294	29	6.46%	2	1	93	93	9.649052188928189E-10	1	1	225	69	0	29	-CCCT
E7_BC55.191219_FM1-2_consensus_vsearch	3290	C	*/-T	397	13	3.06%	2	1	93	93	1.1083016322352594E-4	1	1	267	130	0	13	-T
E7_BC55.191219_FM1-2_consensus_vsearch	3290	C	*/-TC	397	12	2.82%	2	2	93	93	2.2495639078119352E-4	1	1	267	130	1	11	-T
E7_BC55.191219_FM1-2_consensus_vsearch	3291	T	*/-C	384	7	1.75%	2	2	93	93	0.007603779356567615	1	1	260	124	4	3	-C
E7_BC55.191219_FM1-2_consensus_vsearch	3292	C	*/+A	418	8	1.85%	2	1	93	93	0.003778857437644956	1	1	251	167	8	0	+A
E7_BC55.191219_FM1-2_consensus_vsearch	3293	A	*/-G	414	21	4.69%	2	1	93	93	3.7239194258898957E-7	1	1	258	156	0	21	-G
E7_BC55.191219_FM1-2_consensus_vsearch	3298	A	*/-GC	436	7	1.55%	2	2	93	93	0.007628167177128368	1	1	253	183	6	1	-GC
E7_BC55.191219_FM1-2_consensus_vsearch	3300	C	*/-A	407	27	6.07%	2	1	93	93	4.909199357037835E-9	1	1	225	182	27	0	-A
E7_BC55.191219_FM1-2_consensus_vsearch	3305	A	*/-T	437	10	2.2%	2	2	93	93	9.281205170584159E-4	1	1	266	171	1	9	-T
E7_BC55.191219_FM1-2_consensus_vsearch	3322	G	*/-TG	410	36	8.02%	2	2	93	93	6.972406966269475E-12	1	1	251	159	13	23	-TG
E7_BC55.191219_FM1-2_consensus_vsearch	3324	G	*/+TG	393	10	2.43%	2	2	93	93	9.229178835087009E-4	1	1	236	157	9	1	+TG
E7_BC55.191219_FM1-2_consensus_vsearch	3326	T	*/+A	417	11	2.43%	2	2	93	93	4.575287206333824E-4	1	1	246	171	8	3	+A
E7_BC55.191219_FM1-2_consensus_vsearch	3326	T	*/-A	417	15	3.32%	2	2	93	93	2.69691812291492E-5	1	1	246	171	12	3	-A
E7_BC55.191219_FM1-2_consensus_vsearch	3330	G	*/-C	421	16	3.54%	2	1	93	93	1.3268190058544006E-5	1	1	259	162	0	16	-C
E7_BC55.191219_FM1-2_consensus_vsearch	3331	C	*/+T	411	11	2.53%	2	2	93	93	4.5710039589920393E-4	1	1	260	151	2	9	+T
E7_BC55.191219_FM1-2_consensus_vsearch	3339	T	*/-A	442	10	2.2%	2	2	93	93	9.286485810021079E-4	1	1	262	180	6	4	-A
E7_BC55.191219_FM1-2_consensus_vsearch	3340	A	*/+G	424	12	2.71%	2	1	93	93	2.2611473442214893E-4	1	1	261	163	0	12	+G
E7_BC55.191219_FM1-2_consensus_vsearch	3341	G	*/-A	440	8	1.77%	2	2	93	93	0.0037850673649748043	1	1	260	180	6	2	-A
E7_BC55.191219_FM1-2_consensus_vsearch	3342	A	*/+GG	421	7	1.58%	2	1	93	93	0.007621737484585097	1	1	258	163	0	7	+GG
E7_BC55.191219_FM1-2_consensus_vsearch	3342	A	*/-G	421	7	1.58%	2	2	93	93	0.007621737484585097	1	1	258	163	3	4	+GG
E7_BC55.191219_FM1-2_consensus_vsearch	3344	G	*/-C	436	10	2.21%	2	1	93	93	9.280135047051926E-4	1	1	252	184	10	0	-C
E7_BC55.191219_FM1-2_consensus_vsearch	3347	T	*/-A	410	16	3.56%	2	1	93	93	1.321949517328872E-5	1	1	247	163	16	0	-A
E7_BC55.191219_FM1-2_consensus_vsearch	3348	A	*/-G	315	101	23.17%	2	2	93	93	3.874919713758828E-34	1	1	221	94	22	79	-G
E7_BC55.191219_FM1-2_consensus_vsearch	3348	A	*/-GG	315	10	2.29%	2	2	93	93	9.103040047076643E-4	1	1	221	94	5	5	-G
E7_BC55.191219_FM1-2_consensus_vsearch	3354	C	*/+A	401	25	5.53%	2	1	93	93	2.0738579890833378E-8	1	1	219	182	25	0	+A
E7_BC55.191219_FM1-2_consensus_vsearch	3354	C	*/+G	401	8	1.77%	2	2	93	93	0.0037736050099275447	1	1	219	182	7	1	+A
E7_BC55.191219_FM1-2_consensus_vsearch	3354	C	*/-G	401	9	1.99%	2	1	93	93	0.0018683721996632116	1	1	219	182	9	0	-G
E7_BC55.191219_FM1-2_consensus_vsearch	3355	G	*/-A	424	9	2.03%	2	2	93	93	0.0018728240442215458	1	1	250	174	6	3	-A
E7_BC55.191219_FM1-2_consensus_vsearch	3360	G	*/-T	443	7	1.55%	2	2	93	93	0.00763102167395619	1	1	267	176	1	6	-T
E7_BC55.191219_FM1-2_consensus_vsearch	3361	T	*/+C	419	16	3.6%	2	2	93	93	1.3259509871934923E-5	1	1	248	171	15	1	+C
E7_BC55.191219_FM1-2_consensus_vsearch	3362	C	*/+G	419	22	4.93%	2	1	93	93	1.8228136523728208E-7	1	1	240	179	22	0	+G
E7_BC55.191219_FM1-2_consensus_vsearch	3363	C	*/-T	388	31	6.84%	2	2	93	93	2.617710804246128E-10	1	1	240	148	4	27	-T
E7_BC55.191219_FM1-2_consensus_vsearch	3363	C	*/-TT	388	19	4.19%	2	2	93	93	1.5383889014355306E-6	1	1	240	148	18	1	-T
E7_BC55.191219_FM1-2_consensus_vsearch	3367	A	*/-C	436	9	1.99%	2	2	93	93	0.0018749660605302289	1	1	253	183	8	1	-C
E7_BC55.191219_FM1-2_consensus_vsearch	3380	C	*/+T	417	12	2.66%	2	2	93	93	2.2582806164226E-4	1	1	252	165	7	5	+T
E7_BC55.191219_FM1-2_consensus_vsearch	3380	C	*/+TT	417	8	1.77%	2	2	93	93	0.003778560011928581	1	1	252	165	5	3	+T
E7_BC55.191219_FM1-2_consensus_vsearch	3380	C	*/-T	417	11	2.44%	2	2	93	93	4.575287206333824E-4	1	1	252	165	3	8	-T
E7_BC55.191219_FM1-2_consensus_vsearch	3383	T	*/-A	425	10	2.21%	2	2	93	93	9.268043937944601E-4	1	1	253	172	4	6	-A
E7_BC55.191219_FM1-2_consensus_vsearch	3404	G	*/+T	394	9	1.98%	2	1	93	93	0.0018669176476072253	1	1	209	185	9	0	+T
E7_BC55.191219_FM1-2_consensus_vsearch	3404	G	*/-T	394	29	6.39%	2	1	93	93	1.1334443368296105E-9	1	1	209	185	29	0	-T
E7_BC55.191219_FM1-2_consensus_vsearch	3407	T	*/-CTT	422	15	3.31%	2	2	93	93	2.7007998247201884E-5	1	1	260	162	3	12	-CTT
E7_BC55.191219_FM1-2_consensus_vsearch	3408	C	*/-T	420	9	2.07%	2	1	93	93	0.0018720837112055043	1	1	262	158	0	9	-T
E7_BC55.191219_FM1-2_consensus_vsearch	3410	T	*/+G	378	44	10.11%	2	1	93	93	1.7425894494523225E-14	1	1	215	163	44	0	+G
E7_BC55.191219_FM1-2_consensus_vsearch	3411	A	*/-G	388	12	2.67%	2	1	93	93	2.2453648907484584E-4	1	1	208	180	12	0	-G
E7_BC55.191219_FM1-2_consensus_vsearch	3412	G	*/+A	345	53	11.99%	2	1	93	93	1.7370836210520953E-17	1	1	168	177	53	0	+A
E7_BC55.191219_FM1-2_consensus_vsearch	3425	C	*/+A	407	15	3.31%	2	2	93	93	2.688891654781441E-5	1	1	258	149	2	13	+A
E7_BC55.191219_FM1-2_consensus_vsearch	3425	C	*/-A	407	27	5.96%	2	2	93	93	4.909199357037835E-9	1	1	258	149	8	19	-A
E7_BC55.191219_FM1-2_consensus_vsearch	3433	G	*/+A	433	9	2%	2	1	93	93	0.001874441340367089	1	1	251	182	9	0	+A
E7_BC55.191219_FM1-2_consensus_vsearch	3435	G	*/+AG	420	10	2.2%	2	1	93	93	9.262346650300045E-4	1	1	239	181	10	0	+AG
E7_BC55.191219_FM1-2_consensus_vsearch	3435	G	*/+T	420	14	3.08%	2	2	93	93	5.486911466049066E-5	1	1	239	181	10	4	+T
E7_BC55.191219_FM1-2_consensus_vsearch	3440	T	*/+A	430	7	1.58%	2	1	93	93	0.007625648020175149	1	1	259	171	7	0	+A
E7_BC55.191219_FM1-2_consensus_vsearch	3449	A	*/+T	282	33	7.3%	2	2	93	93	4.808867048844375E-11	1	1	168	114	6	27	+T
E7_BC55.191219_FM1-2_consensus_vsearch	3449	A	*/-T	282	128	28.32%	2	2	93	93	2.1956985302376677E-44	1	1	168	114	92	36	-T
E7_BC55.191219_FM1-2_consensus_vsearch	3449	A	*/-TT	282	7	1.55%	2	2	93	93	0.007530631093034971	1	1	168	114	1	6	-T
E7_BC55.191219_FM1-2_consensus_vsearch	3454	T	*/-G	424	23	5.08%	2	2	93	93	8.916998245724882E-8	1	1	264	160	2	21	-G
E7_BC55.191219_FM1-2_consensus_vsearch	3457	T	*/+A	415	8	1.76%	2	2	93	93	0.003777960974854116	1	1	249	166	7	1	+A
E7_BC55.191219_FM1-2_consensus_vsearch	3457	T	*/-A	415	10	2.2%	2	2	93	93	9.256517413502841E-4	1	1	249	166	8	2	-A
E7_BC55.191219_FM1-2_consensus_vsearch	3466	C	*/-T	435	15	3.32%	2	1	93	93	2.7105062507766323E-5	1	1	252	183	15	0	-T
E7_BC55.191219_FM1-2_consensus_vsearch	3471	G	*/-A	421	33	7.27%	2	1	93	93	6.368454101522375E-11	1	1	236	185	33	0	-A
E7_BC55.191219_FM1-2_consensus_vsearch	3474	G	*/-CG	429	13	2.86%	2	2	93	93	1.1161922648910357E-4	1	1	260	169	2	11	-CG
E7_BC55.191219_FM1-2_consensus_vsearch	3475	C	*/+G	374	19	4.36%	2	1	93	93	1.5263684541229892E-6	1	1	261	113	0	19	+G
E7_BC55.191219_FM1-2_consensus_vsearch	3475	C	*/-G	374	26	5.96%	2	2	93	93	9.79368641896108E-9	1	1	261	113	3	23	-G
E7_BC55.191219_FM1-2_consensus_vsearch	3475	C	*/-GG	374	8	1.83%	2	1	93	93	0.003764310420345661	1	1	261	113	0	8	-G
E7_BC55.191219_FM1-2_consensus_vsearch	3483	A	*/-C	440	8	1.76%	2	1	93	93	0.0037850673649748043	1	1	257	183	8	0	-C
E7_BC55.191219_FM1-2_consensus_vsearch	3493	A	*/-G	409	27	6.09%	2	2	93	93	4.918901165835106E-9	1	1	229	180	26	1	-G
E7_BC55.191219_FM1-2_consensus_vsearch	3497	T	*/+A	392	7	1.55%	2	1	93	93	0.007607942959128091	1	1	218	174	7	0	+A
E7_BC55.191219_FM1-2_consensus_vsearch	3497	T	*/-A	392	46	10.18%	2	2	93	93	4.08427904379602E-15	1	1	218	174	36	10	-A
E7_BC55.191219_FM1-2_consensus_vsearch	3499	A	*/-G	429	8	1.77%	2	2	93	93	0.0037820399638697363	1	1	255	174	4	4	-G
E7_BC55.191219_FM1-2_consensus_vsearch	3503	G	*/+C	403	25	5.54%	2	1	93	93	2.0774795674191712E-8	1	1	225	178	25	0	+C
E7_BC55.191219_FM1-2_consensus_vsearch	3503	G	*/-C	403	17	3.77%	2	2	93	93	6.4678823522925845E-6	1	1	225	178	12	5	+C
E7_BC55.191219_FM1-2_consensus_vsearch	3505	C	*/-G	422	14	3.11%	2	2	93	93	5.489635033716498E-5	1	1	253	169	5	9	-G
E7_BC55.191219_FM1-2_consensus_vsearch	3512	C	*/-AC	404	37	8.26%	2	2	93	93	3.3089513479144664E-12	1	1	234	170	30	7	-AC
E7_BC55.191219_FM1-2_consensus_vsearch	3515	G	*/-C	429	8	1.81%	2	1	93	93	0.0037820399638697363	1	1	259	170	0	8	-C
E7_BC55.191219_FM1-2_consensus_vsearch	3520	T	*/+C	423	22	4.88%	2	1	93	93	1.827327995963688E-7	1	1	242	181	22	0	+C
E7_BC55.191219_FM1-2_consensus_vsearch	3529	A	*/-CA	430	8	1.78%	2	1	93	93	0.0037823214180042796	1	1	261	169	0	8	-CA
E7_BC55.191219_FM1-2_consensus_vsearch	3530	C	*/+A	293	19	4.34%	2	2	93	93	1.4380084950862756E-6	1	1	148	145	15	4	+A
E7_BC55.191219_FM1-2_consensus_vsearch	3530	C	*/+AA	293	10	2.28%	2	2	93	93	9.055980531669402E-4	1	1	148	145	8	2	+A
E7_BC55.191219_FM1-2_consensus_vsearch	3530	C	*/-A	293	93	21.23%	2	2	93	93	1.8258725395570985E-31	1	1	148	145	74	19	-A
E7_BC55.191219_FM1-2_consensus_vsearch	3530	C	*/-AA	293	16	3.65%	2	1	93	93	1.2502938907159318E-5	1	1	148	145	16	0	-A
E7_BC55.191219_FM1-2_consensus_vsearch	3542	G	*/+T	431	8	1.77%	2	1	93	93	0.003782601599602771	1	1	252	179	8	0	+T
E7_BC55.191219_FM1-2_consensus_vsearch	3547	T	*/+C	437	12	2.65%	2	1	93	93	2.266239976305489E-4	1	1	256	181	12	0	+C
E7_BC55.191219_FM1-2_consensus_vsearch	3548	C	*/-T	444	9	1.99%	2	2	93	93	0.0018763317016516773	1	1	267	177	2	7	-T
E7_BC55.191219_FM1-2_consensus_vsearch	3549	T	*/+G	410	24	5.41%	2	2	93	93	4.298584353902719E-8	1	1	239	171	22	2	+G
E7_BC55.191219_FM1-2_consensus_vsearch	3550	A	*/-G	414	23	5.12%	2	1	93	93	8.856382627956532E-8	1	1	235	179	23	0	-G
E7_BC55.191219_FM1-2_consensus_vsearch	3557	A	*/-G	417	9	2%	2	2	93	93	0.0018715194418685113	1	1	249	168	1	8	-G
E7_BC55.191219_FM1-2_consensus_vsearch	3566	G	*/-C	440	9	1.99%	2	2	93	93	0.0018756548982491606	1	1	263	177	5	4	-C
E7_BC55.191219_FM1-2_consensus_vsearch	3570	T	*/-G	401	29	6.52%	2	2	93	93	1.142967504476336E-9	1	1	240	161	19	10	-G
E7_BC55.191219_FM1-2_consensus_vsearch	3572	G	*/-A	421	19	4.24%	2	2	93	93	1.5639394759467178E-6	1	1	250	171	15	4	-A
E7_BC55.191219_FM1-2_consensus_vsearch	3576	T	*/+C	429	7	1.55%	2	1	93	93	0.007625221451403564	1	1	254	175	7	0	+C
E7_BC55.191219_FM1-2_consensus_vsearch	3576	T	*/-C	429	8	1.77%	2	2	93	93	0.0037820399638697363	1	1	254	175	4	4	-C
E7_BC55.191219_FM1-2_consensus_vsearch	3577	C	*/-G	424	11	2.47%	2	2	93	93	4.580137992598773E-4	1	1	257	167	3	8	-G
E7_BC55.191219_FM1-2_consensus_vsearch	3581	A	*/-C	425	21	4.65%	2	2	93	93	3.747237380449946E-7	1	1	251	174	12	9	-C
E7_BC55.191219_FM1-2_consensus_vsearch	3587	T	*/-A	414	12	2.68%	2	2	93	93	2.2570239286811238E-4	1	1	252	162	7	5	-A
E7_BC55.191219_FM1-2_consensus_vsearch	3589	A	*/+G	404	10	2.23%	2	2	93	93	9.24320545706363E-4	1	1	232	172	7	3	+G
E7_BC55.191219_FM1-2_consensus_vsearch	3589	A	*/-G	404	12	2.67%	2	2	93	93	2.2527075525117761E-4	1	1	232	172	8	4	-G
E7_BC55.191219_FM1-2_consensus_vsearch	3589	A	*/-GG	404	9	2%	2	1	93	93	0.0018689806633249517	1	1	232	172	9	0	-G
E7_BC55.191219_FM1-2_consensus_vsearch	3589	A	*/-GGA	404	8	1.78%	2	1	93	93	0.0037745631511436058	1	1	232	172	8	0	-G
E7_BC55.191219_FM1-2_consensus_vsearch	3591	G	*/-A	402	17	3.91%	2	2	93	93	6.465281837282248E-6	1	1	223	179	14	3	-A
E7_BC55.191219_FM1-2_consensus_vsearch	3594	T	*/+A	424	12	2.7%	2	1	93	93	2.2611473442214893E-4	1	1	252	172	12	0	+A
E7_BC55.191219_FM1-2_consensus_vsearch	3596	T	*/-GT	360	67	15.09%	2	2	93	93	4.0757178292204346E-22	1	1	252	108	6	61	-GT
E7_BC55.191219_FM1-2_consensus_vsearch	3613	C	*/+A	430	9	1.99%	2	2	93	93	0.0018739095280781474	1	1	256	174	8	1	+A
E7_BC55.191219_FM1-2_consensus_vsearch	3614	G	*/-A	437	9	2%	2	2	93	93	0.0018751394156906677	1	1	258	179	5	4	-A
E7_BC55.191219_FM1-2_consensus_vsearch	3617	T	*/+A	429	7	1.56%	2	1	93	93	0.007625221451403564	1	1	256	173	7	0	+A
E7_BC55.191219_FM1-2_consensus_vsearch	3624	G	*/+C	406	19	4.21%	2	2	93	93	1.5527767946243955E-6	1	1	234	172	9	10	+C
E7_BC55.191219_FM1-2_consensus_vsearch	3624	G	*/-C	406	21	4.66%	2	1	93	93	3.7062847039343943E-7	1	1	234	172	21	0	-C
E7_BC55.191219_FM1-2_consensus_vsearch	3629	G	*/+A	376	7	1.55%	2	1	93	93	0.007599442747600996	1	1	260	116	0	7	+A
E7_BC55.191219_FM1-2_consensus_vsearch	3629	G	*/-A	376	62	13.69%	2	2	93	93	2.1227169540733513E-20	1	1	260	116	3	59	-A
E7_BC55.191219_FM1-2_consensus_vsearch	3645	C	*/-A	417	16	3.54%	2	2	93	93	1.3250753783082343E-5	1	1	261	156	4	12	-A
E7_BC55.191219_FM1-2_consensus_vsearch	3645	C	*/-AA	417	11	2.43%	2	1	93	93	4.575287206333824E-4	1	1	261	156	0	11	-A
E7_BC55.191219_FM1-2_consensus_vsearch	3646	A	*/+GA	409	7	1.64%	2	1	93	93	0.007616261521057028	1	1	252	157	7	0	+GA
E7_BC55.191219_FM1-2_consensus_vsearch	3649	C	*/+T	420	16	3.6%	2	2	93	93	1.3263859391341419E-5	1	1	263	157	2	14	+T
E7_BC55.191219_FM1-2_consensus_vsearch	3651	T	*/+A	391	19	4.19%	2	2	93	93	1.5408670957132326E-6	1	1	245	146	18	1	+A
E7_BC55.191219_FM1-2_consensus_vsearch	3651	T	*/-GT	391	15	3.31%	2	1	93	93	2.6752668166960817E-5	1	1	245	146	0	15	+A
E7_BC55.191219_FM1-2_consensus_vsearch	3652	G	*/-T	387	9	2.08%	2	2	93	93	0.0018654123049784304	1	1	222	165	8	1	-T
E7_BC55.191219_FM1-2_consensus_vsearch	3655	A	*/-C	424	10	2.22%	2	2	93	93	9.266914820866851E-4	1	1	247	177	4	6	-C
E7_BC55.191219_FM1-2_consensus_vsearch	3657	C	*/+T	432	12	2.66%	2	1	93	93	2.2643156833193682E-4	1	1	265	167	0	12	+T
E7_BC55.191219_FM1-2_consensus_vsearch	3661	A	*/-C	424	13	2.92%	2	2	93	93	1.115033140535145E-4	1	1	258	166	1	12	-C
E7_BC55.191219_FM1-2_consensus_vsearch	3663	C	*/-T	379	45	9.93%	2	1	93	93	8.284726757731458E-15	1	1	265	114	0	45	-T
E7_BC55.191219_FM1-2_consensus_vsearch	3663	C	*/-TC	379	18	3.97%	2	2	93	93	3.1324226947568682E-6	1	1	265	114	1	17	-T
E7_BC55.191219_FM1-2_consensus_vsearch	3674	C	*/-GC	440	7	1.55%	2	2	93	93	0.007629809215418646	1	1	261	179	3	4	-GC
E7_BC55.191219_FM1-2_consensus_vsearch	3675	G	*/-CTTG	436	7	1.57%	2	1	93	93	0.007628167177128368	1	1	256	180	7	0	-CTTG
E7_BC55.191219_FM1-2_consensus_vsearch	3676	C	*/-T	414	10	2.28%	2	2	93	93	9.255335328018615E-4	1	1	243	171	7	3	-T
E7_BC55.191219_FM1-2_consensus_vsearch	3684	G	*/-CG	434	17	3.75%	2	2	93	93	6.543119972731843E-6	1	1	263	171	3	14	-CG
E7_BC55.191219_FM1-2_consensus_vsearch	3686	G	*/+CG	416	10	2.32%	2	1	93	93	9.257694036262042E-4	1	1	252	164	10	0	+CG
E7_BC55.191219_FM1-2_consensus_vsearch	3691	C	*/-G	425	22	4.86%	2	1	93	93	1.82955822830081E-7	1	1	244	181	22	0	-G
E7_BC55.191219_FM1-2_consensus_vsearch	3692	G	*/-A	401	23	5.32%	2	2	93	93	8.773859969684443E-8	1	1	222	179	22	1	-A
E7_BC55.191219_FM1-2_consensus_vsearch	3696	A	*/+G	430	9	2.01%	2	2	93	93	0.0018739095280781474	1	1	259	171	1	8	+G
E7_BC55.191219_FM1-2_consensus_vsearch	3699	C	*/+G	380	62	13.72%	2	1	93	93	2.1713354626857178E-20	1	1	195	185	62	0	+G
E7_BC55.191219_FM1-2_consensus_vsearch	3700	A	*/-G	369	55	12.25%	2	1	93	93	4.265280154864149E-18	1	1	187	182	55	0	-G
E7_BC55.191219_FM1-2_consensus_vsearch	3704	G	*/-TG	418	21	4.65%	2	1	93	93	3.732520206596134E-7	1	1	261	157	0	21	-TG
E7_BC55.191219_FM1-2_consensus_vsearch	3705	T	*/-G	403	13	3.05%	2	2	93	93	1.1098705502596942E-4	1	1	260	143	3	10	-G
E7_BC55.191219_FM1-2_consensus_vsearch	3708	A	*/+G	423	12	2.69%	2	1	93	93	2.2607433164831964E-4	1	1	241	182	12	0	+G
E7_BC55.191219_FM1-2_consensus_vsearch	3708	A	*/-G	423	10	2.24%	2	2	93	93	9.26578056881533E-4	1	1	241	182	9	1	+G
E7_BC55.191219_FM1-2_consensus_vsearch	3711	T	*/-C	442	9	1.98%	2	2	93	93	0.0018759947844450028	1	1	258	184	8	1	-C
E7_BC55.191219_FM1-2_consensus_vsearch	3714	C	*/-G	402	7	1.58%	2	2	93	93	0.0076129195598281015	1	1	248	154	1	6	-G
E7_BC55.191219_FM1-2_consensus_vsearch	3714	C	*/-GGA	402	12	2.71%	2	1	93	93	2.2518199251181446E-4	1	1	248	154	12	0	-GGA
E7_BC55.191219_FM1-2_consensus_vsearch	3716	G	*/-A	415	12	2.74%	2	2	93	93	2.2574447356982284E-4	1	1	235	180	11	1	-A
E7_BC55.191219_FM1-2_consensus_vsearch	3717	A	*/-GA	385	25	5.87%	2	1	93	93	2.043819692488892E-8	1	1	210	175	25	0	-GA
E7_BC55.191219_FM1-2_consensus_vsearch	3721	G	*/-C	419	21	4.7%	2	1	93	93	3.7346484366063784E-7	1	1	237	182	21	0	-C
E7_BC55.191219_FM1-2_consensus_vsearch	3723	C	*/-T	410	21	4.65%	2	2	93	93	3.7151754522449287E-7	1	1	248	162	5	16	-T
E7_BC55.191219_FM1-2_consensus_vsearch	3723	C	*/-TT	410	14	3.1%	2	2	93	93	5.472923269186134E-5	1	1	248	162	13	1	-T
E7_BC55.191219_FM1-2_consensus_vsearch	3725	T	*/-G	420	7	1.59%	2	2	93	93	0.007621292853586086	1	1	250	170	2	5	-G
E7_BC55.191219_FM1-2_consensus_vsearch	3728	C	*/+G	427	7	1.56%	2	1	93	93	0.007624362444354587	1	1	248	179	7	0	+G
E7_BC55.191219_FM1-2_consensus_vsearch	3735	G	*/-C	422	14	3.1%	2	2	93	93	5.489635033716498E-5	1	1	253	169	7	7	-C
E7_BC55.191219_FM1-2_consensus_vsearch	3735	G	*/-CCG	422	7	1.55%	2	2	93	93	0.007622180052576428	1	1	253	169	1	6	-C
E7_BC55.191219_FM1-2_consensus_vsearch	3737	C	*/+G	381	11	2.47%	2	2	93	93	4.547664803982017E-4	1	1	258	123	1	10	+G
E7_BC55.191219_FM1-2_consensus_vsearch	3737	C	*/-G	381	24	5.39%	2	2	93	93	4.196179786620246E-8	1	1	258	123	8	16	-G
E7_BC55.191219_FM1-2_consensus_vsearch	3738	G	*/+A	386	9	2.16%	2	1	93	93	0.0018651929543866046	1	1	235	151	9	0	+A
E7_BC55.191219_FM1-2_consensus_vsearch	3739	G	*/+A	411	15	3.35%	2	1	93	93	2.6921453674127367E-5	1	1	249	162	15	0	+A
E7_BC55.191219_FM1-2_consensus_vsearch	3740	G	*/-TG	428	16	3.56%	2	1	93	93	1.3297986993183741E-5	1	1	262	166	0	16	-TG
E7_BC55.191219_FM1-2_consensus_vsearch	3741	T	*/-G	408	13	2.99%	2	2	93	93	1.1111449338120726E-4	1	1	264	144	1	12	-G
E7_BC55.191219_FM1-2_consensus_vsearch	3743	G	*/-A	390	59	13.05%	2	1	93	93	2.256157933412032E-19	1	1	210	180	59	0	-A
E7_BC55.191219_FM1-2_consensus_vsearch	3744	A	*/-G	385	7	1.78%	2	2	93	93	0.007604309052101333	1	1	205	180	5	2	-G
E7_BC55.191219_FM1-2_consensus_vsearch	3749	C	*/-GC	436	8	1.78%	2	2	93	93	0.003783983718069795	1	1	254	182	7	1	-GC
E7_BC55.191219_FM1-2_consensus_vsearch	3751	C	*/-T	409	27	6.09%	2	1	93	93	4.918901165835106E-9	1	1	258	151	0	27	-T
E7_BC55.191219_FM1-2_consensus_vsearch	3752	T	*/+C	410	7	1.64%	2	1	93	93	0.007616729829810889	1	1	257	153	7	0	+C
E7_BC55.191219_FM1-2_consensus_vsearch	3753	C	*/-T	434	9	2%	2	2	93	93	0.0018746170280654298	1	1	263	171	1	8	-T
E7_BC55.191219_FM1-2_consensus_vsearch	3754	T	*/+G	407	18	4.06%	2	1	93	93	3.1742267644279673E-6	1	1	236	171	18	0	+G
E7_BC55.191219_FM1-2_consensus_vsearch	3755	A	*/+G	417	8	1.77%	2	2	93	93	0.003778560011928581	1	1	240	177	7	1	+G
E7_BC55.191219_FM1-2_consensus_vsearch	3756	G	*/-TG	434	9	2%	2	1	93	93	0.0018746170280654298	1	1	262	172	0	9	-TG
E7_BC55.191219_FM1-2_consensus_vsearch	3759	C	*/+G	413	24	5.39%	2	1	93	93	4.3085104676575724E-8	1	1	234	179	24	0	+G
E7_BC55.191219_FM1-2_consensus_vsearch	3760	A	*/-G	413	28	6.19%	2	1	93	93	2.3933752551442304E-9	1	1	234	179	28	0	-G
E7_BC55.191219_FM1-2_consensus_vsearch	3764	C	*/-T	435	15	3.31%	2	2	93	93	2.7105062507766323E-5	1	1	265	170	2	13	-T
E7_BC55.191219_FM1-2_consensus_vsearch	3766	T	*/-G	431	9	1.99%	2	1	93	93	0.0018740875957096264	1	1	265	166	0	9	-G
E7_BC55.191219_FM1-2_consensus_vsearch	3767	G	*/+A	413	7	1.59%	2	1	93	93	0.007618121440992818	1	1	243	170	7	0	+A
E7_BC55.191219_FM1-2_consensus_vsearch	3769	T	*/-GGT	428	10	2.23%	2	2	93	93	9.271400825692105E-4	1	1	264	164	1	9	-GGT
E7_BC55.191219_FM1-2_consensus_vsearch	3774	G	*/-TAG	436	7	1.55%	2	2	93	93	0.007628167177128368	1	1	258	178	2	5	-TAG
E7_BC55.191219_FM1-2_consensus_vsearch	3778	C	*/-A	422	17	3.76%	2	2	93	93	6.515179143868675E-6	1	1	264	158	2	15	-A
E7_BC55.191219_FM1-2_consensus_vsearch	3786	C	*/-A	413	25	5.51%	2	2	93	93	2.0951670902732397E-8	1	1	239	174	21	4	-A
E7_BC55.191219_FM1-2_consensus_vsearch	3786	C	*/-AA	413	10	2.2%	2	2	93	93	9.254147741675464E-4	1	1	239	174	4	6	-A
E7_BC55.191219_FM1-2_consensus_vsearch	3795	T	*/-C	433	16	3.53%	2	2	93	93	1.3318731006810023E-5	1	1	253	180	15	1	-C
E7_BC55.191219_FM1-2_consensus_vsearch	3797	C	*/+T	409	21	4.63%	2	2	93	93	3.712966667784702E-7	1	1	262	147	1	20	+T
E7_BC55.191219_FM1-2_consensus_vsearch	3797	C	*/-T	409	18	3.96%	2	2	93	93	3.17701818350145E-6	1	1	262	147	3	15	+T
E7_BC55.191219_FM1-2_consensus_vsearch	3806	T	*/+G	430	7	1.55%	2	2	93	93	0.007625648020175149	1	1	261	169	3	4	+G
E7_BC55.191219_FM1-2_consensus_vsearch	3810	G	*/-TG	442	7	1.54%	2	2	93	93	0.007630619313173879	1	1	267	175	1	6	-TG
E7_BC55.191219_FM1-2_consensus_vsearch	3811	T	*/-G	413	16	3.61%	2	2	93	93	1.3233009888966535E-5	1	1	261	152	3	13	-G
E7_BC55.191219_FM1-2_consensus_vsearch	3822	T	*/+C	434	10	2.21%	2	1	93	93	9.277980556005647E-4	1	1	258	176	10	0	+C
E7_BC55.191219_FM1-2_consensus_vsearch	3839	T	*/-G	403	44	9.69%	2	1	93	93	1.868140330774533E-14	1	1	265	138	0	44	-G
E7_BC55.191219_FM1-2_consensus_vsearch	3845	T	*/-G	428	11	2.46%	2	2	93	93	4.5828417992626897E-4	1	1	255	173	6	5	-G
E7_BC55.191219_FM1-2_consensus_vsearch	3849	T	*/+C	439	7	1.55%	2	1	93	93	0.00762940145447119	1	1	258	181	7	0	+C
E7_BC55.191219_FM1-2_consensus_vsearch	3854	C	*/+G	420	7	1.54%	2	1	93	93	0.007621292853586086	1	1	259	161	0	7	+G
E7_BC55.191219_FM1-2_consensus_vsearch	3857	T	*/+C	372	7	1.55%	2	2	93	93	0.007597206160798333	1	1	191	181	6	1	+C
E7_BC55.191219_FM1-2_consensus_vsearch	3857	T	*/-C	372	70	15.49%	2	1	93	93	4.3515759934616056E-23	1	1	191	181	70	0	-C
E7_BC55.191219_FM1-2_consensus_vsearch	3859	C	*/-T	443	8	1.76%	2	2	93	93	0.003785867578538486	1	1	267	176	1	7	-T
E7_BC55.191219_FM1-2_consensus_vsearch	3860	T	*/-A	405	27	6.07%	2	2	93	93	4.899424238601493E-9	1	1	237	168	26	1	-A
E7_BC55.191219_FM1-2_consensus_vsearch	3861	A	*/+G	408	7	1.65%	2	1	93	93	0.007615790966496023	1	1	230	178	7	0	+G
E7_BC55.191219_FM1-2_consensus_vsearch	3864	A	*/-G	433	12	2.67%	2	1	93	93	2.2647039152581312E-4	1	1	253	180	12	0	-G
E7_BC55.191219_FM1-2_consensus_vsearch	3867	T	*/-A	424	8	1.77%	2	2	93	93	0.0037806132981311326	1	1	242	182	7	1	-A
E7_BC55.191219_FM1-2_consensus_vsearch	3867	T	*/-AGG	424	8	1.77%	2	1	93	93	0.0037806132981311326	1	1	242	182	8	0	-A
E7_BC55.191219_FM1-2_consensus_vsearch	3868	A	*/-G	260	149	34.02%	2	2	93	93	8.59613875943052E-53	1	1	156	104	75	74	-G
E7_BC55.191219_FM1-2_consensus_vsearch	3868	A	*/-GG	260	21	4.79%	2	2	93	93	3.235232908899636E-7	1	1	156	104	19	2	-G
E7_BC55.191219_FM1-2_consensus_vsearch	3871	G	*/-A	383	59	13.02%	2	2	93	93	2.1793190156624804E-19	1	1	206	177	58	1	-A
E7_BC55.191219_FM1-2_consensus_vsearch	3874	G	*/-C	430	11	2.47%	2	1	93	93	4.584175673957473E-4	1	1	265	165	0	11	-C
E7_BC55.191219_FM1-2_consensus_vsearch	3875	C	*/-T	416	20	4.52%	2	2	93	93	7.631304417463694E-7	1	1	266	150	1	19	-T
E7_BC55.191219_FM1-2_consensus_vsearch	3876	T	*/-C	418	10	2.3%	2	2	93	93	9.260031044371504E-4	1	1	254	164	8	2	-C
E7_BC55.191219_FM1-2_consensus_vsearch	3879	G	+T/+T	15	418	93.1%	2	2	93	93	2.6590994731443522E-232	1	1	7	8	254	164	+T
E7_BC55.191219_FM1-2_consensus_vsearch	3881	T	*/+C	435	14	3.09%	2	2	93	93	5.5067686315232855E-5	1	1	260	175	9	5	+C
E7_BC55.191219_FM1-2_consensus_vsearch	3882	C	*/-A	395	11	2.43%	2	2	93	93	4.558976374421885E-4	1	1	250	145	7	4	-A
E7_BC55.191219_FM1-2_consensus_vsearch	3882	C	*/-AA	395	34	7.51%	2	2	93	93	2.947131933187433E-11	1	1	250	145	4	30	-AA
E7_BC55.191219_FM1-2_consensus_vsearch	3891	C	*/-GC	422	20	4.45%	2	2	93	93	7.654955875708403E-7	1	1	248	174	13	7	-GC
E7_BC55.191219_FM1-2_consensus_vsearch	3892	G	*/+C	393	31	7.24%	2	1	93	93	2.636228268670054E-10	1	1	250	143	0	31	+C
E7_BC55.191219_FM1-2_consensus_vsearch	3894	T	*/-C	415	32	7.08%	2	1	93	93	1.3098871698245664E-10	1	1	266	149	0	32	-C
E7_BC55.191219_FM1-2_consensus_vsearch	3899	C	*/+G	436	7	1.55%	2	2	93	93	0.007628167177128368	1	1	264	172	1	6	+G
E7_BC55.191219_FM1-2_consensus_vsearch	3900	G	*/-CG	434	7	1.55%	2	2	93	93	0.007627335039353406	1	1	256	178	4	3	-CG
E7_BC55.191219_FM1-2_consensus_vsearch	3906	C	*/+T	429	12	2.69%	2	1	93	93	2.2631406886309665E-4	1	1	261	168	0	12	+T
E7_BC55.191219_FM1-2_consensus_vsearch	3907	C	*/-T	433	13	2.87%	2	1	93	93	1.1171014262094148E-4	1	1	264	169	0	13	-T
E7_BC55.191219_FM1-2_consensus_vsearch	3912	G	*/+A	374	24	5.35%	2	2	93	93	4.169565799654493E-8	1	1	196	178	23	1	+A
E7_BC55.191219_FM1-2_consensus_vsearch	3912	G	*/-A	374	13	2.9%	2	2	93	93	1.1018527269038747E-4	1	1	196	178	10	3	+A
E7_BC55.191219_FM1-2_consensus_vsearch	3912	G	*/-AA	374	30	6.68%	2	2	93	93	5.325651881867443E-10	1	1	196	178	28	2	-AA
E7_BC55.191219_FM1-2_consensus_vsearch	3915	A	*/-G	271	162	36.16%	2	2	93	93	1.3242963489731112E-57	1	1	121	150	132	30	-G
E7_BC55.191219_FM1-2_consensus_vsearch	3915	A	*/-GG	271	10	2.23%	2	2	93	93	9.001728969026303E-4	1	1	121	150	9	1	-G
E7_BC55.191219_FM1-2_consensus_vsearch	3918	G	*/-A	432	7	1.55%	2	2	93	93	0.0076264953547406375	1	1	256	176	6	1	-A
E7_BC55.191219_FM1-2_consensus_vsearch	3927	T	*/+A	379	11	2.46%	2	2	93	93	4.5459840602315744E-4	1	1	205	174	10	1	+A
E7_BC55.191219_FM1-2_consensus_vsearch	3927	T	*/-A	379	50	11.16%	2	2	93	93	1.950144799857367E-16	1	1	205	174	49	1	-A
E7_BC55.191219_FM1-2_consensus_vsearch	3939	G	*/-C	438	9	2%	2	2	93	93	0.001875312003649851	1	1	260	178	5	4	-C
E7_BC55.191219_FM1-2_consensus_vsearch	3941	C	*/+G	394	10	2.21%	2	2	93	93	9.230485023476184E-4	1	1	252	142	7	3	+G
E7_BC55.191219_FM1-2_consensus_vsearch	3941	C	*/-G	394	27	5.97%	2	2	93	93	4.844313675552528E-9	1	1	252	142	2	25	-G
E7_BC55.191219_FM1-2_consensus_vsearch	3941	C	*/-GG	394	8	1.77%	2	1	93	93	0.0037713141940397903	1	1	252	142	0	8	-G
E7_BC55.191219_FM1-2_consensus_vsearch	3944	G	*/-A	433	11	2.43%	2	2	93	93	4.5861543978572406E-4	1	1	255	178	10	1	-A
E7_BC55.191219_FM1-2_consensus_vsearch	3950	G	*/+A	427	8	1.77%	2	1	93	93	0.0037814732031268648	1	1	257	170	0	8	+A
E7_BC55.191219_FM1-2_consensus_vsearch	3950	G	*/-A	427	7	1.55%	2	1	93	93	0.007624362444354587	1	1	257	170	7	0	+A
E7_BC55.191219_FM1-2_consensus_vsearch	3951	A	*/+G	430	7	1.58%	2	1	93	93	0.007625648020175149	1	1	249	181	7	0	+G
E7_BC55.191219_FM1-2_consensus_vsearch	3954	G	*/-CT	424	18	3.98%	2	1	93	93	3.1972048803076152E-6	1	1	239	185	18	0	-CT
E7_BC55.191219_FM1-2_consensus_vsearch	3955	C	*/-T	403	8	1.86%	2	2	93	93	0.0037742453123195243	1	1	236	167	4	4	-T
E7_BC55.191219_FM1-2_consensus_vsearch	3968	C	*/+A	409	11	2.42%	2	2	93	93	4.5695495811152217E-4	1	1	257	152	4	7	+A
E7_BC55.191219_FM1-2_consensus_vsearch	3968	C	*/-A	409	32	7.05%	2	2	93	93	1.2992947576298126E-10	1	1	257	152	7	25	-A
E7_BC55.191219_FM1-2_consensus_vsearch	3975	A	*/+T	413	31	6.84%	2	1	93	93	2.707159952571074E-10	1	1	264	149	0	31	+T
E7_BC55.191219_FM1-2_consensus_vsearch	3976	C	*/-T	423	20	4.44%	2	2	93	93	7.658841069212707E-7	1	1	264	159	2	18	-T
E7_BC55.191219_FM1-2_consensus_vsearch	3977	T	*/+C	381	18	4.17%	2	2	93	93	3.1355882207983647E-6	1	1	250	131	12	6	+C
E7_BC55.191219_FM1-2_consensus_vsearch	3978	C	*/-G	370	68	15.32%	2	2	93	93	2.0178231967949755E-22	1	1	265	105	1	67	-G
E7_BC55.191219_FM1-2_consensus_vsearch	3993	C	*/-A	416	21	4.67%	2	2	93	93	3.7282374960453956E-7	1	1	236	180	20	1	-A
E7_BC55.191219_FM1-2_consensus_vsearch	3994	A	*/-G	417	7	1.62%	2	2	93	93	0.007619946437356769	1	1	238	179	2	5	-G
E7_BC55.191219_FM1-2_consensus_vsearch	3998	C	*/+G	380	7	1.57%	2	2	93	93	0.007601633344865528	1	1	237	143	4	3	+G
E7_BC55.191219_FM1-2_consensus_vsearch	3998	C	*/-G	380	48	10.79%	2	2	93	93	8.796179439336058E-16	1	1	237	143	17	31	-G
E7_BC55.191219_FM1-2_consensus_vsearch	4002	G	*/-A	437	14	3.08%	2	2	93	93	5.5093201188592644E-5	1	1	253	184	13	1	-A
E7_BC55.191219_FM1-2_consensus_vsearch	4012	C	*/+T	357	26	5.75%	2	2	93	93	9.606692118482961E-9	1	1	217	140	19	7	+T
E7_BC55.191219_FM1-2_consensus_vsearch	4012	C	*/-T	357	63	13.94%	2	2	93	93	8.770610446064677E-21	1	1	217	140	31	32	-T
E7_BC55.191219_FM1-2_consensus_vsearch	4020	C	*/-T	435	13	2.88%	2	2	93	93	1.1175501046296811E-4	1	1	262	173	4	9	-T
E7_BC55.191219_FM1-2_consensus_vsearch	4026	C	*/-GCC	429	7	1.55%	2	2	93	93	0.007625221451403564	1	1	258	171	6	1	-GCC
E7_BC55.191219_FM1-2_consensus_vsearch	4027	G	*/-C	432	9	2.03%	2	1	93	93	0.001874264864679625	1	1	248	184	9	0	-C
E7_BC55.191219_FM1-2_consensus_vsearch	4036	C	*/-T	430	12	2.66%	2	2	93	93	2.263534081363424E-4	1	1	259	171	2	10	-T
E7_BC55.191219_FM1-2_consensus_vsearch	4038	T	*/-G	419	21	4.68%	2	2	93	93	3.7346484366063784E-7	1	1	256	163	3	18	-G
E7_BC55.191219_FM1-2_consensus_vsearch	4043	T	*/+C	424	15	3.31%	2	1	93	93	2.7023288595668283E-5	1	1	244	180	15	0	+C
E7_BC55.191219_FM1-2_consensus_vsearch	4043	T	*/+CC	424	8	1.77%	2	1	93	93	0.0037806132981311326	1	1	244	180	8	0	+C
E7_BC55.191219_FM1-2_consensus_vsearch	4044	C	*/+A	425	21	4.64%	2	1	93	93	3.747237380449946E-7	1	1	243	182	21	0	+A
E7_BC55.191219_FM1-2_consensus_vsearch	4046	G	*/+T	396	17	3.74%	2	1	93	93	6.449431495208312E-6	1	1	216	180	17	0	+T
E7_BC55.191219_FM1-2_consensus_vsearch	4046	G	*/-T	396	12	2.64%	2	2	93	93	2.249106249509881E-4	1	1	216	180	10	2	+T
E7_BC55.191219_FM1-2_consensus_vsearch	4051	T	*/-C	429	21	4.64%	2	2	93	93	3.7554619278994695E-7	1	1	245	184	20	1	-C
E7_BC55.191219_FM1-2_consensus_vsearch	4053	C	*/+G	415	7	1.54%	2	2	93	93	0.007619038242851565	1	1	262	153	3	4	+G
E7_BC55.191219_FM1-2_consensus_vsearch	4053	C	*/-G	415	28	6.17%	2	2	93	93	2.398315875980072E-9	1	1	262	153	2	26	-G
E7_BC55.191219_FM1-2_consensus_vsearch	4056	A	*/-G	427	17	3.79%	2	1	93	93	6.526993615927746E-6	1	1	245	182	17	0	-G
E7_BC55.191219_FM1-2_consensus_vsearch	4059	T	*/+A	386	8	1.77%	2	1	93	93	0.003768597288121233	1	1	208	178	8	0	+A
E7_BC55.191219_FM1-2_consensus_vsearch	4059	T	*/+G	386	15	3.31%	2	1	93	93	2.6707970567795604E-5	1	1	208	178	15	0	+G
E7_BC55.191219_FM1-2_consensus_vsearch	4059	T	*/-A	386	29	6.4%	2	2	93	93	1.1222558507500718E-9	1	1	208	178	24	5	-A
E7_BC55.191219_FM1-2_consensus_vsearch	4061	A	*/-G	406	34	7.54%	2	2	93	93	2.9997536609291965E-11	1	1	228	178	33	1	-G
E7_BC55.191219_FM1-2_consensus_vsearch	4065	T	*/-C	443	7	1.54%	2	1	93	93	0.00763102167395619	1	1	267	176	0	7	-C
E7_BC55.191219_FM1-2_consensus_vsearch	4075	C	*/+A	418	7	1.56%	2	2	93	93	0.007620397344640596	1	1	245	173	5	2	+A
E7_BC55.191219_FM1-2_consensus_vsearch	4075	C	*/-A	418	17	3.78%	2	2	93	93	6.505544070653668E-6	1	1	245	173	15	2	-A
E7_BC55.191219_FM1-2_consensus_vsearch	4080	T	*/+C	442	7	1.54%	2	2	93	93	0.007630619313173879	1	1	264	178	5	2	+C
E7_BC55.191219_FM1-2_consensus_vsearch	4081	C	*/-TC	429	13	2.9%	2	1	93	93	1.1161922648910357E-4	1	1	256	173	13	0	-TC
E7_BC55.191219_FM1-2_consensus_vsearch	4083	C	*/-G	426	9	2.05%	2	2	93	93	0.001873189162106254	1	1	246	180	6	3	-G
E7_BC55.191219_FM1-2_consensus_vsearch	4086	C	*/-A	426	7	1.55%	2	1	93	93	0.007623929979105209	1	1	243	183	7	0	-A
E7_BC55.191219_FM1-2_consensus_vsearch	4088	C	*/-T	427	11	2.47%	2	2	93	93	4.5821703849988575E-4	1	1	251	176	6	5	-T
E7_BC55.191219_FM1-2_consensus_vsearch	4095	C	*/-G	436	8	1.78%	2	2	93	93	0.003783983718069795	1	1	256	180	4	4	-G
E7_BC55.191219_FM1-2_consensus_vsearch	4096	G	*/+A	415	7	1.57%	2	1	93	93	0.007619038242851565	1	1	238	177	7	0	+A
E7_BC55.191219_FM1-2_consensus_vsearch	4099	T	*/-C	414	27	5.96%	2	2	93	93	4.9428402008462044E-9	1	1	238	176	21	6	-C
E7_BC55.191219_FM1-2_consensus_vsearch	4099	T	*/-CC	414	8	1.77%	2	1	93	93	0.00377765934383424	1	1	238	176	8	0	-C
E7_BC55.191219_FM1-2_consensus_vsearch	4103	G	*/-A	441	9	1.99%	2	1	93	93	0.0018758252149176666	1	1	258	183	9	0	-A
E7_BC55.191219_FM1-2_consensus_vsearch	4106	C	*/-A	435	10	2.23%	2	1	93	93	9.279060186061013E-4	1	1	252	183	10	0	-A
E7_BC55.191219_FM1-2_consensus_vsearch	4108	C	*/-T	429	11	2.48%	2	2	93	93	4.5835102222652706E-4	1	1	254	175	6	5	-T
E7_BC55.191219_FM1-2_consensus_vsearch	4111	T	*/+C	436	7	1.56%	2	1	93	93	0.007628167177128368	1	1	254	182	7	0	+C
E7_BC55.191219_FM1-2_consensus_vsearch	4118	T	*/+C	431	10	2.2%	2	2	93	93	9.274712732448419E-4	1	1	249	182	8	2	+C
E7_BC55.191219_FM1-2_consensus_vsearch	4118	T	*/-C	431	12	2.64%	2	1	93	93	2.2639257424578987E-4	1	1	249	182	12	0	-C
E7_BC55.191219_FM1-2_consensus_vsearch	4120	C	*/-T	391	56	12.33%	2	2	93	93	2.2085449811618566E-18	1	1	262	129	3	53	-T
E7_BC55.191219_FM1-2_consensus_vsearch	4127	C	*/-T	400	46	10.29%	2	1	93	93	4.181773866903017E-15	1	1	267	133	0	46	-T
E7_BC55.191219_FM1-2_consensus_vsearch	4128	T	*/+C	346	10	2.46%	2	1	93	93	9.159665973031879E-4	1	1	223	123	10	0	+C
E7_BC55.191219_FM1-2_consensus_vsearch	4128	T	*/-C	346	46	11.33%	2	2	93	93	3.4960344793831906E-15	1	1	223	123	34	12	-C
E7_BC55.191219_FM1-2_consensus_vsearch	4130	C	*/+A	375	11	2.45%	2	1	93	93	4.5425715087818366E-4	1	1	249	126	11	0	+A
E7_BC55.191219_FM1-2_consensus_vsearch	4130	C	*/+G	375	11	2.45%	2	2	93	93	4.5425715087818366E-4	1	1	249	126	1	10	+A
E7_BC55.191219_FM1-2_consensus_vsearch	4131	G	*/-A	424	18	3.98%	2	2	93	93	3.1972048803076152E-6	1	1	241	183	17	1	-A
E7_BC55.191219_FM1-2_consensus_vsearch	4132	A	*/+G	105	273	62.76%	2	2	93	93	2.7017971116065926E-118	1	1	78	27	118	155	+G
E7_BC55.191219_FM1-2_consensus_vsearch	4132	A	*/+GG	105	23	5.29%	2	2	93	93	4.027342138666381E-8	1	1	78	27	22	1	+G
E7_BC55.191219_FM1-2_consensus_vsearch	4134	G	*/-A	440	9	1.98%	2	2	93	93	0.0018756548982491606	1	1	261	179	6	3	-A
E7_BC55.191219_FM1-2_consensus_vsearch	4137	C	*/+T	391	35	7.73%	2	2	93	93	1.4052849282761793E-11	1	1	226	165	25	10	+T
E7_BC55.191219_FM1-2_consensus_vsearch	4137	C	*/+TT	391	9	1.99%	2	2	93	93	0.0018662788735768444	1	1	226	165	7	2	+T
E7_BC55.191219_FM1-2_consensus_vsearch	4137	C	*/-T	391	9	1.99%	2	2	93	93	0.0018662788735768444	1	1	226	165	4	5	+T
E7_BC55.191219_FM1-2_consensus_vsearch	4137	C	*/-TT	391	7	1.55%	2	2	93	93	0.007607431615374521	1	1	226	165	5	2	+T
E7_BC55.191219_FM1-2_consensus_vsearch	4141	T	*/+G	362	76	16.74%	2	2	93	93	3.74293897116696E-25	1	1	237	125	22	54	+G
E7_BC55.191219_FM1-2_consensus_vsearch	4142	T	*/-G	357	88	19.38%	2	2	93	93	2.714011460293558E-29	1	1	237	120	29	59	-G
E7_BC55.191219_FM1-2_consensus_vsearch	4143	G	+T/+T	52	283	77.96%	2	2	93	93	8.253772834833488E-136	1	1	39	13	184	99	+T
E7_BC55.191219_FM1-2_consensus_vsearch	4143	G	*/+TT	52	11	3.03%	2	2	93	93	3.0309718975429843E-4	1	1	39	13	10	1	+T
E7_BC55.191219_FM1-2_consensus_vsearch	4146	T	*/+C	436	13	2.86%	2	2	93	93	1.1177729905704128E-4	1	1	259	177	10	3	+C
E7_BC55.191219_FM1-2_consensus_vsearch	4150	G	*/-C	398	8	1.76%	2	1	93	93	0.003772632825065396	1	1	213	185	8	0	-C
E7_BC55.191219_FM1-2_consensus_vsearch	4150	G	*/-CC	398	35	7.71%	2	1	93	93	1.422627177942685E-11	1	1	213	185	35	0	-CC
E7_BC55.191219_FM1-2_consensus_vsearch	4162	A	*/-CA	397	49	10.86%	2	2	93	93	4.4025772465833457E-16	1	1	242	155	23	26	-CA
E7_BC55.191219_FM1-2_consensus_vsearch	4164	A	*/+CA	380	9	2.25%	2	2	93	93	0.0018638534646934156	1	1	225	155	7	2	+CA
E7_BC55.191219_FM1-2_consensus_vsearch	4167	A	*/-C	433	11	2.43%	2	1	93	93	4.5861543978572406E-4	1	1	249	184	11	0	-C
E7_BC55.191219_FM1-2_consensus_vsearch	4169	C	*/-GC	431	13	2.87%	2	2	93	93	1.1166488301300728E-4	1	1	253	178	12	1	-GC
E7_BC55.191219_FM1-2_consensus_vsearch	4175	A	*/-G	434	7	1.55%	2	2	93	93	0.007627335039353406	1	1	261	173	4	3	-G
E7_BC55.191219_FM1-2_consensus_vsearch	4178	T	*/-C	438	9	2%	2	1	93	93	0.001875312003649851	1	1	269	169	0	9	-C
E7_BC55.191219_FM1-2_consensus_vsearch	4180	T	*/-C	370	78	17.29%	2	2	93	93	8.392391315148138E-26	1	1	195	175	74	4	-C
E7_BC55.191219_FM1-2_consensus_vsearch	4182	C	*/+A	420	9	1.98%	2	1	93	93	0.0018720837112055043	1	1	241	179	9	0	+A
E7_BC55.191219_FM1-2_consensus_vsearch	4182	C	*/-A	420	19	4.19%	2	2	93	93	1.5632171313242003E-6	1	1	241	179	16	3	-A
E7_BC55.191219_FM1-2_consensus_vsearch	4187	T	*/+A	437	10	2.21%	2	2	93	93	9.281205170584159E-4	1	1	258	179	9	1	+A
E7_BC55.191219_FM1-2_consensus_vsearch	4188	G	*/-A	439	9	1.98%	2	1	93	93	0.0018754838294876201	1	1	257	182	9	0	-A
E7_BC55.191219_FM1-2_consensus_vsearch	4195	C	*/-T	438	10	2.2%	2	1	93	93	9.282270587880905E-4	1	1	268	170	0	10	-T
E7_BC55.191219_FM1-2_consensus_vsearch	4196	T	*/+C	433	8	1.8%	2	2	93	93	0.003783158179516694	1	1	262	171	6	2	+C
E7_BC55.191219_FM1-2_consensus_vsearch	4197	C	*/-T	425	20	4.42%	2	1	93	93	7.666563733598089E-7	1	1	266	159	0	20	-T
E7_BC55.191219_FM1-2_consensus_vsearch	4219	T	*/-A	413	28	6.19%	2	2	93	93	2.3933752551442304E-9	1	1	244	169	14	14	-A
E7_BC55.191219_FM1-2_consensus_vsearch	4221	A	*/+G	303	10	2.24%	2	2	93	93	9.078173651286913E-4	1	1	153	150	8	2	+G
E7_BC55.191219_FM1-2_consensus_vsearch	4221	A	*/-G	303	109	24.44%	2	2	93	93	3.992324401017083E-37	1	1	153	150	84	25	-G
E7_BC55.191219_FM1-2_consensus_vsearch	4221	A	*/-GG	303	10	2.24%	2	1	93	93	9.078173651286913E-4	1	1	153	150	10	0	-G
E7_BC55.191219_FM1-2_consensus_vsearch	4222	G	*/+T	302	7	2.15%	2	1	93	93	0.0075487547253543785	1	1	163	139	0	7	+T
E7_BC55.191219_FM1-2_consensus_vsearch	4232	C	*/+A	386	14	3.09%	2	2	93	93	5.4366161181224727E-5	1	1	239	147	11	3	+A
E7_BC55.191219_FM1-2_consensus_vsearch	4232	C	*/-A	386	41	9.05%	2	2	93	93	1.6589175019627335E-13	1	1	239	147	9	32	-A
E7_BC55.191219_FM1-2_consensus_vsearch	4238	A	*/+G	431	10	2.24%	2	1	93	93	9.274712732448419E-4	1	1	258	173	0	10	+G
E7_BC55.191219_FM1-2_consensus_vsearch	4241	T	*/-C	439	9	1.99%	2	1	93	93	0.0018754838294876201	1	1	255	184	9	0	-C
E7_BC55.191219_FM1-2_consensus_vsearch	4248	C	*/-T	430	12	2.66%	2	2	93	93	2.263534081363424E-4	1	1	256	174	5	7	-T
E7_BC55.191219_FM1-2_consensus_vsearch	4250	T	*/+C	425	10	2.25%	2	2	93	93	9.268043937944601E-4	1	1	244	181	9	1	+C
E7_BC55.191219_FM1-2_consensus_vsearch	4251	C	*/+A	74	31	6.92%	2	1	93	93	3.44787019668832E-11	1	1	50	24	31	0	+A
E7_BC55.191219_FM1-2_consensus_vsearch	4251	C	*/+AG	74	9	2.01%	2	1	93	93	0.001553873485760156	1	1	50	24	9	0	+A
E7_BC55.191219_FM1-2_consensus_vsearch	4251	C	*/+G	74	305	68.08%	2	2	93	93	4.435042381813613E-141	1	1	50	24	161	144	+G
E7_BC55.191219_FM1-2_consensus_vsearch	4251	C	*/+GG	74	7	1.56%	2	2	93	93	0.0068253188632208485	1	1	50	24	6	1	+G
E7_BC55.191219_FM1-2_consensus_vsearch	4251	C	*/-G	74	8	1.79%	2	2	93	93	0.003266103505100527	1	1	50	24	1	7	-G
E7_BC55.191219_FM1-2_consensus_vsearch	4253	G	*/+A	418	14	3.11%	2	2	93	93	5.4841636470744183E-5	1	1	244	174	8	6	+A
E7_BC55.191219_FM1-2_consensus_vsearch	4253	G	*/-A	418	12	2.67%	2	2	93	93	2.2586957161051062E-4	1	1	244	174	10	2	+A
E7_BC55.191219_FM1-2_consensus_vsearch	4257	A	*/-G	412	31	6.86%	2	2	93	93	2.70372799208316E-10	1	1	237	175	28	3	-G
E7_BC55.191219_FM1-2_consensus_vsearch	4258	G	*/+A	380	11	2.62%	2	1	93	93	4.546826533185083E-4	1	1	204	176	11	0	+A
E7_BC55.191219_FM1-2_consensus_vsearch	4259	G	*/-A	385	64	14.19%	2	2	93	93	4.8293592219576765E-21	1	1	202	183	63	1	-A
E7_BC55.191219_FM1-2_consensus_vsearch	4268	T	*/+G	399	41	9.21%	2	2	93	93	1.7115871232317524E-13	1	1	260	139	1	40	+G
E7_BC55.191219_FM1-2_consensus_vsearch	4270	A	*/-G	369	74	16.52%	2	2	93	93	1.897041924685235E-24	1	1	189	180	72	2	-G
E7_BC55.191219_FM1-2_consensus_vsearch	4275	T	*/-G	417	17	3.78%	2	2	93	93	6.503109267247564E-6	1	1	257	160	5	12	-G
E7_BC55.191219_FM1-2_consensus_vsearch	4277	G	*/+A	426	8	1.8%	2	1	93	93	0.0037811878789100195	1	1	257	169	8	0	+A
E7_BC55.191219_FM1-2_consensus_vsearch	4279	C	*/+A	378	8	1.79%	2	1	93	93	0.00376576873622069	1	1	225	153	0	8	+A
E7_BC55.191219_FM1-2_consensus_vsearch	4279	C	*/-AC	378	39	8.71%	2	1	93	93	7.163602453311779E-13	1	1	225	153	39	0	-AC
E7_BC55.191219_FM1-2_consensus_vsearch	4283	T	*/-C	430	7	1.58%	2	2	93	93	0.007625648020175149	1	1	261	169	2	5	-C
E7_BC55.191219_FM1-2_consensus_vsearch	4289	C	*/-T	435	12	2.65%	2	2	93	93	2.2654752970435957E-4	1	1	262	173	1	11	-T
E7_BC55.191219_FM1-2_consensus_vsearch	4291	T	*/-G	421	14	3.12%	2	1	93	93	5.4882762612112586E-5	1	1	262	159	0	14	-G
E7_BC55.191219_FM1-2_consensus_vsearch	4293	G	*/+T	431	13	2.88%	2	1	93	93	1.1166488301300728E-4	1	1	251	180	13	0	+T
E7_BC55.191219_FM1-2_consensus_vsearch	4294	T	*/+C	427	16	3.54%	2	1	93	93	1.3293784930690262E-5	1	1	266	161	0	16	+C
E7_BC55.191219_FM1-2_consensus_vsearch	4295	T	*/+C	397	29	6.42%	2	1	93	93	1.1375555891866163E-9	1	1	234	163	29	0	+C
E7_BC55.191219_FM1-2_consensus_vsearch	4295	T	*/-C	397	19	4.2%	2	2	93	93	1.5457253320374264E-6	1	1	234	163	3	16	+C
E7_BC55.191219_FM1-2_consensus_vsearch	4296	C	*/-G	380	22	5.08%	2	1	93	93	1.774667349739489E-7	1	1	222	158	22	0	-G
E7_BC55.191219_FM1-2_consensus_vsearch	4296	C	*/-GA	380	16	3.7%	2	2	93	93	1.3073743141806742E-5	1	1	222	158	12	4	-G
E7_BC55.191219_FM1-2_consensus_vsearch	4297	G	*/+A	386	14	3.39%	2	2	93	93	5.4366161181224727E-5	1	1	208	178	13	1	+A
E7_BC55.191219_FM1-2_consensus_vsearch	4299	A	*/-G	436	8	1.79%	2	1	93	93	0.003783983718069795	1	1	254	182	8	0	-G
E7_BC55.191219_FM1-2_consensus_vsearch	4302	C	*/-T	352	97	21.56%	2	2	93	93	1.866797538320325E-32	1	1	265	87	1	96	-T
E7_BC55.191219_FM1-2_consensus_vsearch	4303	T	*/+C	337	7	1.97%	2	2	93	93	0.0075754305431544305	1	1	254	83	6	1	+C
E7_BC55.191219_FM1-2_consensus_vsearch	4304	C	*/-G	400	9	2.02%	2	2	93	93	0.0018681674184966828	1	1	259	141	2	7	-G
E7_BC55.191219_FM1-2_consensus_vsearch	4304	C	*/-GG	400	31	6.95%	2	1	93	93	2.661614223554998E-10	1	1	259	141	0	31	-GG
E7_BC55.191219_FM1-2_consensus_vsearch	4308	A	*/-C	435	12	2.67%	2	1	93	93	2.2654752970435957E-4	1	1	251	184	12	0	-C
E7_BC55.191219_FM1-2_consensus_vsearch	4315	T	*/-G	417	14	3.12%	2	2	93	93	5.4827805419876506E-5	1	1	261	156	2	12	-G
E7_BC55.191219_FM1-2_consensus_vsearch	4315	T	*/-GG	417	14	3.12%	2	1	93	93	5.4827805419876506E-5	1	1	261	156	0	14	-G
E7_BC55.191219_FM1-2_consensus_vsearch	4322	G	*/-T	391	46	10.22%	2	2	93	93	4.0719918381074775E-15	1	1	211	180	44	2	-T
E7_BC55.191219_FM1-2_consensus_vsearch	4325	T	*/+A	386	11	2.44%	2	1	93	93	4.551794212032011E-4	1	1	231	155	11	0	+A
E7_BC55.191219_FM1-2_consensus_vsearch	4325	T	*/+G	386	15	3.33%	2	2	93	93	2.6707970567795604E-5	1	1	231	155	8	7	+G
E7_BC55.191219_FM1-2_consensus_vsearch	4325	T	*/-G	386	21	4.66%	2	2	93	93	3.6594953326677066E-7	1	1	231	155	7	14	-G
E7_BC55.191219_FM1-2_consensus_vsearch	4325	T	*/-GG	386	7	1.55%	2	2	93	93	0.0076048360660226225	1	1	231	155	2	5	-G
E7_BC55.191219_FM1-2_consensus_vsearch	4328	G	*/+A	402	30	6.7%	2	1	93	93	5.529276015204028E-10	1	1	224	178	30	0	+A
E7_BC55.191219_FM1-2_consensus_vsearch	4330	C	*/+A	409	7	1.58%	2	1	93	93	0.007616261521057028	1	1	237	172	0	7	+A
E7_BC55.191219_FM1-2_consensus_vsearch	4330	C	*/-A	409	17	3.84%	2	2	93	93	6.483245240504738E-6	1	1	237	172	16	1	-A
E7_BC55.191219_FM1-2_consensus_vsearch	4332	A	*/-C	364	38	8.46%	2	2	93	93	1.4534013733701695E-12	1	1	198	166	23	15	-C
E7_BC55.191219_FM1-2_consensus_vsearch	4332	A	*/-CC	364	17	3.79%	2	1	93	93	6.357058602775765E-6	1	1	198	166	17	0	-C
E7_BC55.191219_FM1-2_consensus_vsearch	4333	C	*/+T	374	8	2.03%	2	1	93	93	0.003764310420345661	1	1	218	156	0	8	+T
E7_BC55.191219_FM1-2_consensus_vsearch	4335	C	*/-G	395	29	6.43%	2	2	93	93	1.1348197897367633E-9	1	1	258	137	1	28	-G
E7_BC55.191219_FM1-2_consensus_vsearch	4339	T	*/-G	436	9	2%	2	1	93	93	0.0018749660605302289	1	1	266	170	0	9	-G
E7_BC55.191219_FM1-2_consensus_vsearch	4344	C	*/-T	429	8	1.81%	2	2	93	93	0.0037820399638697363	1	1	254	175	3	5	-T
E7_BC55.191219_FM1-2_consensus_vsearch	4347	G	*/-C	426	12	2.68%	2	2	93	93	2.2619500050778872E-4	1	1	245	181	10	2	-C
E7_BC55.191219_FM1-2_consensus_vsearch	4350	A	*/-G	401	35	7.78%	2	1	93	93	1.429945268035913E-11	1	1	258	143	0	35	-G
E7_BC55.191219_FM1-2_consensus_vsearch	4354	C	*/+T	434	10	2.23%	2	1	93	93	9.277980556005647E-4	1	1	259	175	0	10	+T
E7_BC55.191219_FM1-2_consensus_vsearch	4355	C	*/-T	438	10	2.22%	2	2	93	93	9.282270587880905E-4	1	1	262	176	2	8	-T
E7_BC55.191219_FM1-2_consensus_vsearch	4359	T	*/-G	429	9	2.02%	2	1	93	93	0.0018737306563855328	1	1	262	167	0	9	-G
E7_BC55.191219_FM1-2_consensus_vsearch	4370	C	*/-T	423	18	4%	2	2	93	93	3.195898836048293E-6	1	1	256	167	4	14	-T
E7_BC55.191219_FM1-2_consensus_vsearch	4372	T	*/-G	411	30	6.71%	2	2	93	93	5.590506572954871E-10	1	1	256	155	4	26	-G
E7_BC55.191219_FM1-2_consensus_vsearch	4377	G	*/+C	427	7	1.56%	2	1	93	93	0.007624362444354587	1	1	248	179	7	0	+C
E7_BC55.191219_FM1-2_consensus_vsearch	4377	G	*/-C	427	8	1.78%	2	2	93	93	0.0037814732031268648	1	1	248	179	4	4	-C
E7_BC55.191219_FM1-2_consensus_vsearch	4378	C	*/+T	423	9	2.05%	2	2	93	93	0.0018726402317850155	1	1	253	170	1	8	+T
E7_BC55.191219_FM1-2_consensus_vsearch	4379	C	*/+T	399	23	5.12%	2	1	93	93	8.76077164584334E-8	1	1	257	142	0	23	+T
E7_BC55.191219_FM1-2_consensus_vsearch	4379	C	*/-T	399	20	4.45%	2	2	93	93	7.560960467294479E-7	1	1	257	142	5	15	+T
E7_BC55.191219_FM1-2_consensus_vsearch	4381	T	*/+C	408	23	5.15%	2	1	93	93	8.818834884570627E-8	1	1	230	178	23	0	+C
E7_BC55.191219_FM1-2_consensus_vsearch	4381	T	*/-C	408	10	2.24%	2	2	93	93	9.248125937902505E-4	1	1	230	178	7	3	+C
E7_BC55.191219_FM1-2_consensus_vsearch	4382	C	*/-G	403	8	1.83%	2	2	93	93	0.0037742453123195243	1	1	248	155	4	4	-G
E7_BC55.191219_FM1-2_consensus_vsearch	4382	C	*/-GG	403	18	4.11%	2	2	93	93	3.168570189223664E-6	1	1	248	155	1	17	-GG
E7_BC55.191219_FM1-2_consensus_vsearch	4388	T	*/-C	415	29	6.44%	2	2	93	93	1.1613040233734709E-9	1	1	233	182	28	1	-C
E7_BC55.191219_FM1-2_consensus_vsearch	4394	G	*/-TG	406	20	4.47%	2	2	93	93	7.590542262785938E-7	1	1	255	151	1	19	-TG
E7_BC55.191219_FM1-2_consensus_vsearch	4394	G	*/-TGCG	406	7	1.57%	2	1	93	93	0.007614843055105977	1	1	255	151	0	7	-TG
E7_BC55.191219_FM1-2_consensus_vsearch	4397	C	*/+A	401	20	4.55%	2	2	93	93	7.56950332781708E-7	1	1	226	175	19	1	+A
E7_BC55.191219_FM1-2_consensus_vsearch	4397	C	*/+G	401	7	1.59%	2	1	93	93	0.007612432822507446	1	1	226	175	7	0	+A
E7_BC55.191219_FM1-2_consensus_vsearch	4399	C	*/-T	384	17	3.9%	2	2	93	93	6.4164031706101775E-6	1	1	219	165	3	14	-T
E7_BC55.191219_FM1-2_consensus_vsearch	4399	C	*/-TT	384	31	7.11%	2	2	93	93	2.602659831150514E-10	1	1	219	165	30	1	-TT
E7_BC55.191219_FM1-2_consensus_vsearch	4404	C	*/+A	427	16	3.55%	2	1	93	93	1.3293784930690262E-5	1	1	259	168	0	16	+A
E7_BC55.191219_FM1-2_consensus_vsearch	4412	T	*/+C	425	21	4.67%	2	2	93	93	3.747237380449946E-7	1	1	248	177	17	4	+C
E7_BC55.191219_FM1-2_consensus_vsearch	4413	C	*/+A	421	27	6.01%	2	1	93	93	4.9756167082862284E-9	1	1	238	183	27	0	+A
E7_BC55.191219_FM1-2_consensus_vsearch	4419	T	*/+G	431	7	1.56%	2	1	93	93	0.007626072650234986	1	1	253	178	7	0	+G
E7_BC55.191219_FM1-2_consensus_vsearch	4424	C	*/-G	429	10	2.24%	2	1	93	93	9.272509747675099E-4	1	1	261	168	0	10	-G
E7_BC55.191219_FM1-2_consensus_vsearch	4428	C	*/+A	420	11	2.47%	2	1	93	93	4.5773850170834535E-4	1	1	238	182	11	0	+A
E7_BC55.191219_FM1-2_consensus_vsearch	4428	C	*/-A	420	11	2.47%	2	2	93	93	4.5773850170834535E-4	1	1	238	182	10	1	+A
E7_BC55.191219_FM1-2_consensus_vsearch	4430	A	*/+G	245	8	1.8%	2	2	93	93	0.003692882342347513	1	1	102	143	7	1	+G
E7_BC55.191219_FM1-2_consensus_vsearch	4430	A	*/-G	245	166	37.3%	2	2	93	93	7.428277040378658E-60	1	1	102	143	137	29	-G
E7_BC55.191219_FM1-2_consensus_vsearch	4430	A	*/-GG	245	18	4.04%	2	2	93	93	2.8233306503124774E-6	1	1	102	143	9	9	-G
E7_BC55.191219_FM1-2_consensus_vsearch	4437	T	*/+C	420	16	3.59%	2	2	93	93	1.3263859391341419E-5	1	1	246	174	15	1	+C
E7_BC55.191219_FM1-2_consensus_vsearch	4438	C	*/-T	423	21	4.7%	2	2	93	93	3.743075088511932E-7	1	1	250	173	13	8	-T
E7_BC55.191219_FM1-2_consensus_vsearch	4444	G	*/+T	430	9	2.03%	2	1	93	93	0.0018739095280781474	1	1	256	174	0	9	+T
E7_BC55.191219_FM1-2_consensus_vsearch	4446	C	*/-T	426	12	2.73%	2	2	93	93	2.2619500050778872E-4	1	1	250	176	3	9	-T
E7_BC55.191219_FM1-2_consensus_vsearch	4451	T	*/+A	344	8	2.01%	2	1	93	93	0.003752326609186822	1	1	210	134	0	8	+A
E7_BC55.191219_FM1-2_consensus_vsearch	4451	T	*/-A	344	42	10.55%	2	2	93	93	6.991749309380831E-14	1	1	210	134	2	40	-A
