Chrom	Position	Ref	Cons	Reads1	Reads2	VarFreq	Strands1	Strands2	Qual1	Qual2	Pvalue	MapQual1	MapQual2	Reads1Plus	Reads1Minus	Reads2Plus	Reads2Minus	VarAllele
G1_BC73.191219_FM1-2_consensus_vsearch	41	A	*/-G	176	12	6.32%	2	1	93	93	2.0369927796885998E-4	1	1	58	118	12	0	-G
G1_BC73.191219_FM1-2_consensus_vsearch	42	G	*/-AG	123	57	31.49%	2	2	93	93	3.5004015642871464E-20	1	1	13	110	49	8	-AG
G1_BC73.191219_FM1-2_consensus_vsearch	47	C	*/+A	175	12	6.19%	2	1	93	93	2.0349578218661617E-4	1	1	62	113	12	0	+A
G1_BC73.191219_FM1-2_consensus_vsearch	54	C	*/-T	177	7	3.61%	2	2	93	93	0.007371570136883838	1	1	73	104	1	6	-T
G1_BC73.191219_FM1-2_consensus_vsearch	112	C	*/-G	171	17	8.95%	2	1	93	93	5.225618764261991E-6	1	1	54	117	17	0	-G
G1_BC73.191219_FM1-2_consensus_vsearch	115	A	*/+T	158	8	4.17%	2	2	93	93	0.0035832986795768713	1	1	66	92	4	4	+T
G1_BC73.191219_FM1-2_consensus_vsearch	115	A	*/-T	158	23	11.98%	2	2	93	93	5.6549849625911147E-8	1	1	66	92	2	21	-T
G1_BC73.191219_FM1-2_consensus_vsearch	145	A	*/-G	167	16	8.38%	2	2	93	93	1.0833863733569022E-5	1	1	67	100	1	15	-G
G1_BC73.191219_FM1-2_consensus_vsearch	153	A	*/+C	176	7	3.65%	2	1	93	93	0.007369187819667051	1	1	61	115	7	0	+C
G1_BC73.191219_FM1-2_consensus_vsearch	176	C	*/-A	177	10	5.21%	2	2	93	93	8.631325337656354E-4	1	1	63	114	9	1	-A
G1_BC73.191219_FM1-2_consensus_vsearch	182	T	*/-G	171	11	5.88%	2	1	93	93	4.179166713235648E-4	1	1	74	97	0	11	-G
G1_BC73.191219_FM1-2_consensus_vsearch	187	G	*/-TG	174	15	7.73%	2	2	93	93	2.285953945782884E-5	1	1	71	103	1	14	-TG
G1_BC73.191219_FM1-2_consensus_vsearch	199	T	*/-C	162	26	13.4%	2	1	93	93	5.890700015067377E-9	1	1	44	118	26	0	-C
G1_BC73.191219_FM1-2_consensus_vsearch	204	A	*/-C	159	27	13.92%	2	1	93	93	2.6949429879321714E-9	1	1	75	84	0	27	-C
G1_BC73.191219_FM1-2_consensus_vsearch	223	C	*/-A	173	11	5.82%	2	2	93	93	4.186451412907242E-4	1	1	70	103	5	6	-A
G1_BC73.191219_FM1-2_consensus_vsearch	245	T	*/+C	177	8	4.12%	2	2	93	93	0.0036158650264919274	1	1	67	110	7	1	+C
G1_BC73.191219_FM1-2_consensus_vsearch	246	C	*/-G	141	44	23.53%	2	2	93	93	3.1089303204093452E-15	1	1	74	67	1	43	-G
G1_BC73.191219_FM1-2_consensus_vsearch	252	G	*/+C	183	7	3.65%	2	2	93	93	0.007385343252869138	1	1	71	112	2	5	+C
G1_BC73.191219_FM1-2_consensus_vsearch	253	C	+T/+T	14	175	90.67%	2	2	93	93	5.796184867197708E-92	1	1	3	11	69	106	+T
G1_BC73.191219_FM1-2_consensus_vsearch	255	A	*/+G	145	30	15.71%	2	1	93	93	2.3923164833017047E-10	1	1	68	77	0	30	+G
G1_BC73.191219_FM1-2_consensus_vsearch	257	G	*/+C	165	17	8.81%	2	1	93	93	5.15772369585134E-6	1	1	71	94	0	17	+C
G1_BC73.191219_FM1-2_consensus_vsearch	258	C	*/+T	70	113	58.85%	2	2	93	93	5.6927535514342174E-46	1	1	1	69	72	41	+T
G1_BC73.191219_FM1-2_consensus_vsearch	259	T	*/+C	167	9	4.66%	2	1	93	93	0.001758773553282941	1	1	74	93	0	9	+C
G1_BC73.191219_FM1-2_consensus_vsearch	259	T	*/-C	167	14	7.25%	2	1	93	93	4.700557594367257E-5	1	1	74	93	0	14	-C
G1_BC73.191219_FM1-2_consensus_vsearch	273	C	*/-T	168	11	5.82%	2	2	93	93	4.167949943022952E-4	1	1	64	104	6	5	-T
G1_BC73.191219_FM1-2_consensus_vsearch	275	T	*/+C	176	8	4.19%	2	2	93	93	0.0036143155518784634	1	1	61	115	6	2	+C
G1_BC73.191219_FM1-2_consensus_vsearch	315	T	*/-G	140	52	26.8%	2	1	93	93	4.0504131480863576E-18	1	1	74	66	0	52	-G
G1_BC73.191219_FM1-2_consensus_vsearch	327	C	*/-G	184	7	3.61%	2	1	93	93	0.007387555568979833	1	1	75	109	0	7	-G
G1_BC73.191219_FM1-2_consensus_vsearch	334	C	*/-G	171	17	8.81%	2	2	93	93	5.225618764261991E-6	1	1	72	99	2	15	-G
G1_BC73.191219_FM1-2_consensus_vsearch	341	C	*/-G	145	39	20.21%	2	2	93	93	1.9095453124458372E-13	1	1	47	98	22	17	-G
G1_BC73.191219_FM1-2_consensus_vsearch	345	G	*/-A	181	10	5.15%	2	1	93	93	8.654248463553992E-4	1	1	62	119	10	0	-A
G1_BC73.191219_FM1-2_consensus_vsearch	347	A	*/-T	179	7	3.65%	2	2	93	93	0.007376258791632204	1	1	64	115	4	3	-T
G1_BC73.191219_FM1-2_consensus_vsearch	350	A	*/+G	174	11	5.85%	2	1	93	93	4.190037601545019E-4	1	1	69	105	0	11	+G
G1_BC73.191219_FM1-2_consensus_vsearch	360	T	*/-C	168	24	12.37%	2	2	93	93	2.7704330991445054E-8	1	1	58	110	17	7	-C
G1_BC73.191219_FM1-2_consensus_vsearch	362	C	*/-G	158	35	18.04%	2	1	93	93	5.340931440678929E-12	1	1	75	83	0	35	-G
G1_BC73.191219_FM1-2_consensus_vsearch	366	G	*/-A	161	26	13.54%	2	1	93	93	5.859353678517802E-9	1	1	46	115	26	0	-A
G1_BC73.191219_FM1-2_consensus_vsearch	385	C	*/-T	186	7	3.63%	2	1	93	93	0.007391912172859777	1	1	74	112	0	7	-T
G1_BC73.191219_FM1-2_consensus_vsearch	387	C	*/-T	154	29	15.34%	2	1	93	93	5.58558430316331E-10	1	1	73	81	0	29	-T
G1_BC73.191219_FM1-2_consensus_vsearch	393	T	*/-C	181	7	3.65%	2	2	93	93	0.007380848803681321	1	1	67	114	6	1	-C
G1_BC73.191219_FM1-2_consensus_vsearch	395	C	*/-A	166	15	7.73%	2	2	93	93	2.2557273513193727E-5	1	1	67	99	3	12	-A
G1_BC73.191219_FM1-2_consensus_vsearch	397	A	*/-G	172	8	4.15%	2	2	93	93	0.0036079487687097848	1	1	68	104	4	4	-G
G1_BC73.191219_FM1-2_consensus_vsearch	399	G	*/+A	176	7	3.66%	2	1	93	93	0.007369187819667051	1	1	64	112	7	0	+A
G1_BC73.191219_FM1-2_consensus_vsearch	413	C	*/-GC	170	13	6.77%	2	2	93	93	9.789554903605308E-5	1	1	69	101	5	8	-GC
G1_BC73.191219_FM1-2_consensus_vsearch	415	C	*/-A	141	24	13.87%	2	1	93	93	2.420024043377823E-8	1	1	67	74	0	24	-A
G1_BC73.191219_FM1-2_consensus_vsearch	420	T	*/-AC	182	10	5.15%	2	1	93	93	8.659835374014541E-4	1	1	65	117	10	0	-AC
G1_BC73.191219_FM1-2_consensus_vsearch	438	G	*/+TG	98	75	38.66%	2	2	93	93	8.440992736919496E-28	1	1	37	61	33	42	+TG
G1_BC73.191219_FM1-2_consensus_vsearch	438	G	*/-A	98	13	6.7%	2	1	93	93	8.410478277658822E-5	1	1	37	61	0	13	+TG
G1_BC73.191219_FM1-2_consensus_vsearch	440	G	*/+TA	175	18	9.28%	2	2	93	93	2.51811159354104E-6	1	1	69	106	5	13	+TA
G1_BC73.191219_FM1-2_consensus_vsearch	441	G	+TAG/+TAG	23	155	79.9%	2	2	93	93	1.5854620207600806E-76	1	1	8	15	62	93	+TAG
G1_BC73.191219_FM1-2_consensus_vsearch	465	C	*/+A	174	8	4.21%	2	1	93	93	0.003611166483247444	1	1	70	104	0	8	+A
G1_BC73.191219_FM1-2_consensus_vsearch	475	G	*/-TG	177	12	6.19%	2	1	93	93	2.0390075187582733E-4	1	1	73	104	0	12	-TG
G1_BC73.191219_FM1-2_consensus_vsearch	481	T	*/-A	163	22	11.58%	2	1	93	93	1.2282586383314992E-7	1	1	50	113	22	0	-A
G1_BC73.191219_FM1-2_consensus_vsearch	485	T	*/-G	146	42	21.76%	2	1	93	93	1.72181890660445E-14	1	1	72	74	0	42	-G
G1_BC73.191219_FM1-2_consensus_vsearch	493	G	*/-C	176	8	4.19%	2	2	93	93	0.0036143155518784634	1	1	61	115	7	1	-C
G1_BC73.191219_FM1-2_consensus_vsearch	494	C	*/+T	165	16	8.65%	2	1	93	93	1.0791087617257083E-5	1	1	67	98	0	16	+T
G1_BC73.191219_FM1-2_consensus_vsearch	495	C	*/-T	160	13	6.7%	2	2	93	93	9.660784741618469E-5	1	1	72	88	1	12	-T
G1_BC73.191219_FM1-2_consensus_vsearch	496	T	*/+C	164	10	5.52%	2	1	93	93	8.549835212479261E-4	1	1	72	92	0	10	+C
G1_BC73.191219_FM1-2_consensus_vsearch	506	C	*/-T	183	9	4.64%	2	1	93	93	0.0017745564291022078	1	1	75	108	0	9	-T
G1_BC73.191219_FM1-2_consensus_vsearch	509	T	*/+G	178	8	4.19%	2	1	93	93	0.0036173981471315664	1	1	71	107	0	8	+G
G1_BC73.191219_FM1-2_consensus_vsearch	510	G	*/-A	181	10	5.21%	2	1	93	93	8.654248463553992E-4	1	1	63	118	10	0	-A
G1_BC73.191219_FM1-2_consensus_vsearch	512	G	*/-T	182	9	4.66%	2	1	93	93	0.001773645426870732	1	1	74	108	0	9	-T
G1_BC73.191219_FM1-2_consensus_vsearch	524	T	*/+G	74	114	58.76%	2	2	93	93	4.640899271738838E-46	1	1	4	70	68	46	+G
G1_BC73.191219_FM1-2_consensus_vsearch	526	A	*/-G	172	11	5.76%	2	2	93	93	4.1828279774789115E-4	1	1	56	116	8	3	-G
G1_BC73.191219_FM1-2_consensus_vsearch	528	G	*/+A	167	18	9.28%	2	1	93	93	2.4710454132783846E-6	1	1	49	118	18	0	+A
G1_BC73.191219_FM1-2_consensus_vsearch	536	T	*/-G	160	26	13.47%	2	1	93	93	5.827814211402979E-9	1	1	73	87	0	26	-G
G1_BC73.191219_FM1-2_consensus_vsearch	563	C	*/-T	184	8	4.15%	2	1	93	93	0.0036262674855563662	1	1	74	110	0	8	-T
G1_BC73.191219_FM1-2_consensus_vsearch	576	T	*/-AT	176	11	5.73%	2	2	93	93	4.1971005075956745E-4	1	1	72	104	3	8	-AT
G1_BC73.191219_FM1-2_consensus_vsearch	594	T	*/-A	171	13	6.7%	2	2	93	93	9.80172223605813E-5	1	1	71	100	1	12	-A
G1_BC73.191219_FM1-2_consensus_vsearch	600	G	*/-TG	177	10	5.15%	2	2	93	93	8.631325337656354E-4	1	1	70	107	1	9	-TG
G1_BC73.191219_FM1-2_consensus_vsearch	617	A	*/+G	130	9	4.64%	2	2	93	93	0.0017088631591672273	1	1	55	75	1	8	+G
G1_BC73.191219_FM1-2_consensus_vsearch	617	A	*/-G	130	45	23.2%	2	2	93	93	1.0996769287161943E-15	1	1	55	75	17	28	-G
G1_BC73.191219_FM1-2_consensus_vsearch	627	C	*/+T	178	8	4.28%	2	1	93	93	0.0036173981471315664	1	1	72	106	0	8	+T
G1_BC73.191219_FM1-2_consensus_vsearch	639	A	*/-C	161	23	12.11%	2	2	93	93	5.728804349454061E-8	1	1	69	92	4	19	-C
G1_BC73.191219_FM1-2_consensus_vsearch	642	C	*/-T	165	15	7.77%	2	1	93	93	2.2517818669553618E-5	1	1	74	91	0	15	-T
G1_BC73.191219_FM1-2_consensus_vsearch	645	C	*/+G	159	8	4.32%	2	1	93	93	0.0035851936379921044	1	1	68	91	0	8	+G
G1_BC73.191219_FM1-2_consensus_vsearch	645	C	*/-G	159	8	4.32%	2	2	93	93	0.0035851936379921044	1	1	68	91	2	6	+G
G1_BC73.191219_FM1-2_consensus_vsearch	653	A	*/+T	173	11	5.7%	2	1	93	93	4.186451412907242E-4	1	1	73	100	0	11	+T
G1_BC73.191219_FM1-2_consensus_vsearch	654	C	*/-T	173	9	4.81%	2	2	93	93	0.001765008337317725	1	1	71	102	2	7	-T
G1_BC73.191219_FM1-2_consensus_vsearch	666	G	*/-C	156	18	9.73%	2	1	93	93	2.4005815851883153E-6	1	1	40	116	18	0	-C
G1_BC73.191219_FM1-2_consensus_vsearch	667	C	*/+T	151	10	5.99%	2	1	93	93	8.455751061324735E-4	1	1	46	105	0	10	+T
G1_BC73.191219_FM1-2_consensus_vsearch	678	G	*/-TG	183	7	3.66%	2	1	93	93	0.007385343252869138	1	1	73	110	0	7	-TG
G1_BC73.191219_FM1-2_consensus_vsearch	685	T	*/-C	176	10	5.24%	2	2	93	93	8.625446222228462E-4	1	1	71	105	1	9	-C
G1_BC73.191219_FM1-2_consensus_vsearch	686	C	*/+G	157	11	5.98%	2	1	93	93	4.1235800097779135E-4	1	1	72	85	0	11	+G
G1_BC73.191219_FM1-2_consensus_vsearch	686	C	*/+T	157	10	5.43%	2	1	93	93	8.500918789390323E-4	1	1	72	85	0	10	+G
G1_BC73.191219_FM1-2_consensus_vsearch	688	G	*/-C	182	7	3.63%	2	2	93	93	0.007383107786177688	1	1	68	114	3	4	-C
G1_BC73.191219_FM1-2_consensus_vsearch	699	G	*/+A	181	7	3.68%	2	1	93	93	0.007380848803681321	1	1	63	118	7	0	+A
G1_BC73.191219_FM1-2_consensus_vsearch	717	A	*/+G	182	9	4.64%	2	1	93	93	0.001773645426870732	1	1	64	118	9	0	+G
G1_BC73.191219_FM1-2_consensus_vsearch	718	G	*/+A	156	11	5.7%	2	2	93	93	4.119272376341463E-4	1	1	51	105	9	2	+A
G1_BC73.191219_FM1-2_consensus_vsearch	718	G	*/+AA	156	13	6.74%	2	2	93	93	9.605371832867716E-5	1	1	51	105	2	11	+AA
G1_BC73.191219_FM1-2_consensus_vsearch	718	G	*/-A	156	9	4.66%	2	2	93	93	0.001746201408139757	1	1	51	105	8	1	+AA
G1_BC73.191219_FM1-2_consensus_vsearch	719	A	*/+G	168	7	3.87%	2	1	93	93	0.007349160919077469	1	1	55	113	7	0	+G
G1_BC73.191219_FM1-2_consensus_vsearch	720	G	*/-C	172	15	7.89%	2	1	93	93	2.2786128332551297E-5	1	1	71	101	0	15	-C
G1_BC73.191219_FM1-2_consensus_vsearch	721	C	*/+G	161	8	4.49%	2	1	93	93	0.0035889176506417294	1	1	74	87	0	8	+G
G1_BC73.191219_FM1-2_consensus_vsearch	768	A	*/-CA	179	9	4.64%	2	2	93	93	0.0017708558237889195	1	1	67	112	6	3	-CA
G1_BC73.191219_FM1-2_consensus_vsearch	771	T	*/-G	182	8	4.15%	2	2	93	93	0.003623372158916335	1	1	73	109	1	7	-G
G1_BC73.191219_FM1-2_consensus_vsearch	806	G	*/-CA	178	14	7.22%	2	1	93	93	4.774059764537521E-5	1	1	74	104	0	14	-CA
G1_BC73.191219_FM1-2_consensus_vsearch	821	A	*/+G	140	7	3.65%	2	1	93	93	0.00726214740331066	1	1	60	80	0	7	+G
G1_BC73.191219_FM1-2_consensus_vsearch	821	A	*/-G	140	28	14.58%	2	2	93	93	1.0922470090094814E-9	1	1	60	80	11	17	-G
G1_BC73.191219_FM1-2_consensus_vsearch	821	A	*/-GG	140	13	6.77%	2	2	93	93	9.35746600239174E-5	1	1	60	80	1	12	-G
G1_BC73.191219_FM1-2_consensus_vsearch	828	C	*/+T	179	11	5.67%	2	1	93	93	4.2074294006989865E-4	1	1	74	105	0	11	+T
G1_BC73.191219_FM1-2_consensus_vsearch	829	T	*/-C	141	28	14.66%	2	1	93	93	1.1009358860308572E-9	1	1	70	71	0	28	-C
G1_BC73.191219_FM1-2_consensus_vsearch	829	T	*/-CG	141	10	5.24%	2	1	93	93	8.372862978827083E-4	1	1	70	71	0	10	-C
G1_BC73.191219_FM1-2_consensus_vsearch	830	C	*/-G	132	8	5.33%	2	2	93	93	0.0035247621832004156	1	1	71	61	1	7	-G
G1_BC73.191219_FM1-2_consensus_vsearch	844	C	*/-T	174	20	10.31%	2	2	93	93	5.693404765760249E-7	1	1	74	100	1	19	-T
G1_BC73.191219_FM1-2_consensus_vsearch	847	T	*/+G	177	7	3.7%	2	1	93	93	0.007371570136883838	1	1	74	103	0	7	+G
G1_BC73.191219_FM1-2_consensus_vsearch	854	A	*/+G	92	13	6.81%	2	2	93	93	8.222006512210814E-5	1	1	39	53	4	9	+G
G1_BC73.191219_FM1-2_consensus_vsearch	854	A	*/-G	92	58	30.37%	2	2	93	93	3.560626925673649E-21	1	1	39	53	26	32	-G
G1_BC73.191219_FM1-2_consensus_vsearch	854	A	*/-GG	92	16	8.38%	2	2	93	93	8.381766790753578E-6	1	1	39	53	3	13	-G
G1_BC73.191219_FM1-2_consensus_vsearch	854	A	*/-GGG	92	12	6.28%	2	1	93	93	1.7445678792407803E-4	1	1	39	53	0	12	-G
G1_BC73.191219_FM1-2_consensus_vsearch	863	A	*/-T	170	11	5.67%	2	1	93	93	4.1754670259895105E-4	1	1	73	97	0	11	-T
G1_BC73.191219_FM1-2_consensus_vsearch	864	T	*/-C	165	9	5.06%	2	2	93	93	0.0017566025072910298	1	1	71	94	2	7	-C
G1_BC73.191219_FM1-2_consensus_vsearch	866	C	*/-T	179	7	3.61%	2	1	93	93	0.007376258791632204	1	1	70	109	0	7	-T
G1_BC73.191219_FM1-2_consensus_vsearch	868	G	*/-TG	161	10	5.21%	2	2	93	93	8.529341483590452E-4	1	1	63	98	3	7	-TG
G1_BC73.191219_FM1-2_consensus_vsearch	871	A	*/+C	147	7	3.61%	2	1	93	93	0.007286826295699635	1	1	69	78	0	7	+C
G1_BC73.191219_FM1-2_consensus_vsearch	871	A	*/-C	147	35	18.04%	2	2	93	93	4.767368229031787E-12	1	1	69	78	3	32	-C
G1_BC73.191219_FM1-2_consensus_vsearch	876	C	*/-A	180	9	4.66%	2	1	93	93	0.001771795269848945	1	1	65	115	9	0	-A
G1_BC73.191219_FM1-2_consensus_vsearch	893	C	*/+A	177	9	4.76%	2	2	93	93	0.0017689474455757383	1	1	65	112	8	1	+A
G1_BC73.191219_FM1-2_consensus_vsearch	900	A	*/-G	181	7	3.63%	2	2	93	93	0.007380848803681321	1	1	66	115	4	3	-G
G1_BC73.191219_FM1-2_consensus_vsearch	907	T	*/+G	171	7	3.65%	2	1	93	93	0.007356879467164792	1	1	59	112	7	0	+G
G1_BC73.191219_FM1-2_consensus_vsearch	908	A	*/+G	84	89	47.59%	2	2	93	93	2.931735740356471E-34	1	1	30	54	28	61	+G
G1_BC73.191219_FM1-2_consensus_vsearch	910	G	*/+AG	178	10	5.15%	2	1	93	93	8.637144208672183E-4	1	1	60	118	10	0	+AG
G1_BC73.191219_FM1-2_consensus_vsearch	924	C	*/-A	180	10	5.15%	2	1	93	93	8.648604879212406E-4	1	1	73	107	0	10	-A
G1_BC73.191219_FM1-2_consensus_vsearch	926	A	*/-G	181	10	5.21%	2	1	93	93	8.654248463553992E-4	1	1	75	106	0	10	-G
G1_BC73.191219_FM1-2_consensus_vsearch	933	A	*/-G	179	7	3.65%	2	2	93	93	0.007376258791632204	1	1	67	112	6	1	-G
G1_BC73.191219_FM1-2_consensus_vsearch	937	T	*/+G	85	77	40.53%	2	2	93	93	3.993413496842995E-29	1	1	25	60	29	48	+G
G1_BC73.191219_FM1-2_consensus_vsearch	937	T	*/+GG	85	8	4.21%	2	2	93	93	0.0033389965937982964	1	1	25	60	1	7	+G
G1_BC73.191219_FM1-2_consensus_vsearch	937	T	*/-G	85	14	7.37%	2	1	93	93	3.725507904804453E-5	1	1	25	60	14	0	-G
G1_BC73.191219_FM1-2_consensus_vsearch	943	G	*/+T	159	20	10.42%	2	1	93	93	5.438714652175536E-7	1	1	74	85	0	20	+T
G1_BC73.191219_FM1-2_consensus_vsearch	944	C	*/-A	140	15	8.02%	2	2	93	93	2.1388028693665143E-5	1	1	68	72	7	8	-A
G1_BC73.191219_FM1-2_consensus_vsearch	969	T	*/-C	187	7	3.61%	2	2	93	93	0.007394057154213738	1	1	69	118	6	1	-C
G1_BC73.191219_FM1-2_consensus_vsearch	972	C	*/-A	185	8	4.12%	2	1	93	93	0.003627693045256358	1	1	67	118	8	0	-A
G1_BC73.191219_FM1-2_consensus_vsearch	999	C	*/+G	170	7	3.66%	2	1	93	93	0.007354335343249384	1	1	67	103	0	7	+G
G1_BC73.191219_FM1-2_consensus_vsearch	999	C	*/-G	170	10	5.24%	2	2	93	93	8.588852401034393E-4	1	1	67	103	3	7	-G
G1_BC73.191219_FM1-2_consensus_vsearch	1008	G	*/-T	177	10	5.21%	2	2	93	93	8.631325337656354E-4	1	1	71	106	1	9	-T
G1_BC73.191219_FM1-2_consensus_vsearch	1022	C	*/+G	161	14	7.33%	2	2	93	93	4.656956567290606E-5	1	1	63	98	7	7	+G
G1_BC73.191219_FM1-2_consensus_vsearch	1022	C	*/-G	161	11	5.76%	2	2	93	93	4.1403363178339287E-4	1	1	63	98	4	7	+G
G1_BC73.191219_FM1-2_consensus_vsearch	1034	G	*/-A	174	8	4.35%	2	1	93	93	0.003611166483247444	1	1	58	116	8	0	-A
G1_BC73.191219_FM1-2_consensus_vsearch	1037	A	*/-T	174	11	5.73%	2	2	93	93	4.190037601545019E-4	1	1	60	114	10	1	-T
G1_BC73.191219_FM1-2_consensus_vsearch	1039	T	*/+C	163	13	6.84%	2	1	93	93	9.700826914365912E-5	1	1	64	99	0	13	+C
G1_BC73.191219_FM1-2_consensus_vsearch	1040	A	*/+G	132	22	11.46%	2	1	93	93	1.0637701669317639E-7	1	1	47	85	0	22	+G
G1_BC73.191219_FM1-2_consensus_vsearch	1040	A	*/+GG	132	7	3.65%	2	1	93	93	0.007230945949356827	1	1	47	85	0	7	+G
G1_BC73.191219_FM1-2_consensus_vsearch	1040	A	*/-G	132	22	11.46%	2	1	93	93	1.0637701669317639E-7	1	1	47	85	22	0	-G
G1_BC73.191219_FM1-2_consensus_vsearch	1045	C	*/-T	171	15	7.77%	2	1	93	93	2.2748896676102235E-5	1	1	74	97	0	15	-T
G1_BC73.191219_FM1-2_consensus_vsearch	1048	T	*/-G	161	27	13.99%	2	1	93	93	2.7265525784039436E-9	1	1	73	88	0	27	-G
G1_BC73.191219_FM1-2_consensus_vsearch	1052	C	*/-T	176	14	7.25%	2	1	93	93	4.7612708551473615E-5	1	1	74	102	0	14	-T
G1_BC73.191219_FM1-2_consensus_vsearch	1055	T	*/+G	123	17	8.85%	2	2	93	93	4.5518957996669666E-6	1	1	48	75	2	15	+G
G1_BC73.191219_FM1-2_consensus_vsearch	1055	T	*/-G	123	34	17.71%	2	2	93	93	7.840030278544591E-12	1	1	48	75	10	24	-G
G1_BC73.191219_FM1-2_consensus_vsearch	1055	T	*/-GG	123	9	4.69%	2	2	93	93	0.00169639444902621	1	1	48	75	7	2	-G
G1_BC73.191219_FM1-2_consensus_vsearch	1061	A	*/-G	181	7	3.7%	2	2	93	93	0.007380848803681321	1	1	66	115	6	1	-G
G1_BC73.191219_FM1-2_consensus_vsearch	1100	A	*/-G	173	16	8.29%	2	2	93	93	1.0957465194659251E-5	1	1	69	104	4	12	-G
G1_BC73.191219_FM1-2_consensus_vsearch	1104	C	*/+A	172	14	7.29%	2	1	93	93	4.734944773282747E-5	1	1	73	99	0	14	+A
G1_BC73.191219_FM1-2_consensus_vsearch	1106	C	*/-A	167	8	4.19%	2	2	93	93	0.003599589021589525	1	1	71	96	2	6	-A
G1_BC73.191219_FM1-2_consensus_vsearch	1115	G	*/-TG	175	15	7.85%	2	2	93	93	2.2895728702355452E-5	1	1	73	102	1	14	-TG
G1_BC73.191219_FM1-2_consensus_vsearch	1123	T	*/+G	175	7	3.68%	2	1	93	93	0.007366779625824957	1	1	72	103	0	7	+G
G1_BC73.191219_FM1-2_consensus_vsearch	1128	C	*/-TT	149	25	12.95%	2	1	93	93	1.1779295243171498E-8	1	1	43	106	25	0	-TT
G1_BC73.191219_FM1-2_consensus_vsearch	1132	A	*/-T	171	11	5.88%	2	1	93	93	4.179166713235648E-4	1	1	53	118	11	0	-T
G1_BC73.191219_FM1-2_consensus_vsearch	1145	C	*/-G	143	38	19.9%	2	2	93	93	4.14856164766513E-13	1	1	41	102	24	14	-G
G1_BC73.191219_FM1-2_consensus_vsearch	1156	A	*/+C	176	8	4.19%	2	1	93	93	0.0036143155518784634	1	1	59	117	8	0	+C
G1_BC73.191219_FM1-2_consensus_vsearch	1175	A	*/+G	152	17	8.95%	2	1	93	93	4.996844843643187E-6	1	1	68	84	0	17	+G
G1_BC73.191219_FM1-2_consensus_vsearch	1175	A	*/-G	152	14	7.37%	2	2	93	93	4.586264512871195E-5	1	1	68	84	2	12	+G
G1_BC73.191219_FM1-2_consensus_vsearch	1197	C	*/-T	181	11	5.7%	2	1	93	93	4.214144486820526E-4	1	1	75	106	0	11	-T
G1_BC73.191219_FM1-2_consensus_vsearch	1207	C	*/-TC	182	8	4.15%	2	1	93	93	0.003623372158916335	1	1	66	116	8	0	-TC
G1_BC73.191219_FM1-2_consensus_vsearch	1220	G	*/-TG	179	9	4.76%	2	1	93	93	0.0017708558237889195	1	1	73	106	0	9	-TG
G1_BC73.191219_FM1-2_consensus_vsearch	1233	C	*/-T	181	10	5.24%	2	2	93	93	8.654248463553992E-4	1	1	74	107	1	9	-T
G1_BC73.191219_FM1-2_consensus_vsearch	1242	T	*/-G	155	27	14.06%	2	2	93	93	2.630630026649035E-9	1	1	66	89	4	23	-G
G1_BC73.191219_FM1-2_consensus_vsearch	1264	T	*/-C	181	12	6.19%	2	2	93	93	2.0468701793138264E-4	1	1	66	115	9	3	-C
G1_BC73.191219_FM1-2_consensus_vsearch	1266	C	*/+G	176	7	3.61%	2	1	93	93	0.007369187819667051	1	1	74	102	0	7	+G
G1_BC73.191219_FM1-2_consensus_vsearch	1282	C	*/+G	169	8	4.12%	2	1	93	93	0.0036029884966937457	1	1	75	94	0	8	+G
G1_BC73.191219_FM1-2_consensus_vsearch	1286	A	*/-C	169	19	9.84%	2	2	93	93	1.1819668031703979E-6	1	1	71	98	2	17	-C
G1_BC73.191219_FM1-2_consensus_vsearch	1289	C	*/-A	149	7	3.61%	2	2	93	93	0.007293476159710952	1	1	67	82	3	4	-A
G1_BC73.191219_FM1-2_consensus_vsearch	1289	C	*/-AA	149	15	7.73%	2	2	93	93	2.1829365358467202E-5	1	1	67	82	1	14	-AA
G1_BC73.191219_FM1-2_consensus_vsearch	1295	T	*/-G	181	10	5.15%	2	2	93	93	8.654248463553992E-4	1	1	74	107	1	9	-G
G1_BC73.191219_FM1-2_consensus_vsearch	1305	T	*/+C	74	90	46.39%	2	2	93	93	2.7093793585664825E-35	1	1	10	64	60	30	+C
G1_BC73.191219_FM1-2_consensus_vsearch	1305	T	*/-CCT	74	17	8.76%	2	1	93	93	3.3497921610147527E-6	1	1	10	64	0	17	+C
G1_BC73.191219_FM1-2_consensus_vsearch	1307	C	*/-T	158	9	5.08%	2	1	93	93	0.0017486067130074762	1	1	73	85	0	9	-T
G1_BC73.191219_FM1-2_consensus_vsearch	1315	C	*/-T	151	36	18.56%	2	1	93	93	2.254996625877826E-12	1	1	75	76	0	36	-T
G1_BC73.191219_FM1-2_consensus_vsearch	1319	C	*/+G	161	9	4.74%	2	1	93	93	0.0017521117144003763	1	1	73	88	0	9	+G
G1_BC73.191219_FM1-2_consensus_vsearch	1319	C	*/-GG	161	11	5.79%	2	1	93	93	4.1403363178339287E-4	1	1	73	88	0	11	-GG
G1_BC73.191219_FM1-2_consensus_vsearch	1325	T	*/-C	179	10	5.18%	2	2	93	93	8.642903755365361E-4	1	1	71	108	1	9	-C
G1_BC73.191219_FM1-2_consensus_vsearch	1328	A	*/-G	170	12	6.42%	2	2	93	93	2.024468861085566E-4	1	1	57	113	10	2	-G
G1_BC73.191219_FM1-2_consensus_vsearch	1332	C	*/-GGC	179	7	3.63%	2	2	93	93	0.007376258791632204	1	1	69	110	5	2	-GGC
G1_BC73.191219_FM1-2_consensus_vsearch	1337	C	*/-T	177	10	5.18%	2	1	93	93	8.631325337656354E-4	1	1	73	104	0	10	-T
G1_BC73.191219_FM1-2_consensus_vsearch	1339	C	*/+T	176	7	3.66%	2	2	93	93	0.007369187819667051	1	1	74	102	1	6	+T
G1_BC73.191219_FM1-2_consensus_vsearch	1342	C	*/-T	168	13	6.84%	2	2	93	93	9.764848812103054E-5	1	1	70	98	2	11	-T
G1_BC73.191219_FM1-2_consensus_vsearch	1349	C	*/-T	177	8	4.12%	2	2	93	93	0.0036158650264919274	1	1	67	110	1	7	-T
G1_BC73.191219_FM1-2_consensus_vsearch	1351	T	*/-G	145	19	10.05%	2	1	93	93	1.0973325697996261E-6	1	1	62	83	0	19	-G
G1_BC73.191219_FM1-2_consensus_vsearch	1351	T	*/-GG	145	7	3.7%	2	1	93	93	0.0072800038812266725	1	1	62	83	0	7	-G
G1_BC73.191219_FM1-2_consensus_vsearch	1369	T	*/-A	176	16	8.25%	2	2	93	93	1.1016738221751668E-5	1	1	63	113	11	5	-A
G1_BC73.191219_FM1-2_consensus_vsearch	1372	G	*/+A	174	7	3.72%	2	1	93	93	0.007364345131566664	1	1	65	109	7	0	+A
G1_BC73.191219_FM1-2_consensus_vsearch	1385	C	*/-T	166	13	6.99%	2	2	93	93	9.739634822135725E-5	1	1	60	106	8	5	-T
G1_BC73.191219_FM1-2_consensus_vsearch	1390	C	*/-A	172	15	7.73%	2	2	93	93	2.2786128332551297E-5	1	1	67	105	4	11	-A
G1_BC73.191219_FM1-2_consensus_vsearch	1411	C	*/+T	178	8	4.12%	2	2	93	93	0.0036173981471315664	1	1	74	104	1	7	+T
G1_BC73.191219_FM1-2_consensus_vsearch	1414	A	*/+G	181	7	3.65%	2	1	93	93	0.007380848803681321	1	1	73	108	0	7	+G
G1_BC73.191219_FM1-2_consensus_vsearch	1419	T	*/-C	179	11	5.7%	2	1	93	93	4.2074294006989865E-4	1	1	62	117	11	0	-C
G1_BC73.191219_FM1-2_consensus_vsearch	1430	A	*/+T	175	12	6.32%	2	1	93	93	2.0349578218661617E-4	1	1	72	103	0	12	+T
G1_BC73.191219_FM1-2_consensus_vsearch	1435	C	*/-GC	109	52	28.42%	2	2	93	93	1.6012953610547789E-18	1	1	39	70	23	29	-GC
G1_BC73.191219_FM1-2_consensus_vsearch	1443	T	*/+G	184	7	3.63%	2	1	93	93	0.007387555568979833	1	1	73	111	0	7	+G
G1_BC73.191219_FM1-2_consensus_vsearch	1455	T	*/-G	178	14	7.25%	2	2	93	93	4.774059764537521E-5	1	1	74	104	1	13	-G
G1_BC73.191219_FM1-2_consensus_vsearch	1466	C	*/-T	184	10	5.15%	2	1	93	93	8.670842550026666E-4	1	1	75	109	0	10	-T
G1_BC73.191219_FM1-2_consensus_vsearch	1469	T	*/-C	172	13	6.74%	2	2	93	93	9.813768217245088E-5	1	1	57	115	12	1	-C
G1_BC73.191219_FM1-2_consensus_vsearch	1472	C	*/+G	153	13	6.7%	2	2	93	93	9.56221163141673E-5	1	1	69	84	5	8	+G
G1_BC73.191219_FM1-2_consensus_vsearch	1474	A	*/-G	176	12	6.32%	2	2	93	93	2.0369927796885998E-4	1	1	60	116	11	1	-G
G1_BC73.191219_FM1-2_consensus_vsearch	1475	G	*/-AG	172	7	3.85%	2	2	93	93	0.007359395499810914	1	1	57	115	4	3	-AG
G1_BC73.191219_FM1-2_consensus_vsearch	1476	A	*/-G	173	11	5.91%	2	2	93	93	4.186451412907242E-4	1	1	60	113	9	2	-G
G1_BC73.191219_FM1-2_consensus_vsearch	1481	T	*/-GG	179	7	3.63%	2	1	93	93	0.007376258791632204	1	1	75	104	0	7	-GG
G1_BC73.191219_FM1-2_consensus_vsearch	1495	A	*/-G	178	11	5.73%	2	2	93	93	4.204021120137521E-4	1	1	62	116	9	2	-G
G1_BC73.191219_FM1-2_consensus_vsearch	1507	G	*/-C	182	9	4.71%	2	1	93	93	0.001773645426870732	1	1	75	107	0	9	-C
G1_BC73.191219_FM1-2_consensus_vsearch	1509	T	*/-G	159	30	15.54%	2	2	93	93	2.669088430744984E-10	1	1	63	96	11	19	-G
G1_BC73.191219_FM1-2_consensus_vsearch	1516	C	*/+G	183	8	4.15%	2	1	93	93	0.003624827265843605	1	1	74	109	0	8	+G
G1_BC73.191219_FM1-2_consensus_vsearch	1523	T	*/-G	168	19	9.9%	2	1	93	93	1.1787861730236885E-6	1	1	74	94	0	19	-G
G1_BC73.191219_FM1-2_consensus_vsearch	1532	G	*/-C	181	8	4.19%	2	2	93	93	0.0036219019328410066	1	1	72	109	2	6	-C
G1_BC73.191219_FM1-2_consensus_vsearch	1546	A	*/+G	175	9	4.74%	2	2	93	93	0.0017669987142516655	1	1	63	112	8	1	+G
G1_BC73.191219_FM1-2_consensus_vsearch	1551	C	*/+T	178	7	3.65%	2	1	93	93	0.007373926992228167	1	1	72	106	0	7	+T
G1_BC73.191219_FM1-2_consensus_vsearch	1587	T	*/+C	150	10	5.24%	2	2	93	93	8.447908106466188E-4	1	1	43	107	5	5	+C
G1_BC73.191219_FM1-2_consensus_vsearch	1587	T	*/-C	150	30	15.71%	2	2	93	93	2.4930283269386194E-10	1	1	43	107	26	4	-C
G1_BC73.191219_FM1-2_consensus_vsearch	1589	C	*/+T	181	9	4.64%	2	1	93	93	0.0017727250885016482	1	1	71	110	0	9	+T
G1_BC73.191219_FM1-2_consensus_vsearch	1590	C	*/-T	178	14	7.22%	2	2	93	93	4.774059764537521E-5	1	1	74	104	1	13	-T
G1_BC73.191219_FM1-2_consensus_vsearch	1595	C	*/-T	124	63	32.47%	2	2	93	93	1.966386368486572E-22	1	1	69	55	2	61	-T
G1_BC73.191219_FM1-2_consensus_vsearch	1604	C	*/-AC	166	21	10.94%	2	2	93	93	2.6316563117976456E-7	1	1	58	108	15	6	-AC
G1_BC73.191219_FM1-2_consensus_vsearch	1621	T	*/-C	183	8	4.15%	2	2	93	93	0.003624827265843605	1	1	68	115	5	3	-C
G1_BC73.191219_FM1-2_consensus_vsearch	1623	C	*/+T	173	8	4.12%	2	1	93	93	0.003609566346175535	1	1	73	100	0	8	+T
G1_BC73.191219_FM1-2_consensus_vsearch	1641	A	*/-G	94	61	31.77%	2	2	93	93	2.62908813638302E-22	1	1	20	74	30	31	-G
G1_BC73.191219_FM1-2_consensus_vsearch	1641	A	*/-GG	94	27	14.06%	2	2	93	93	1.4555765804288974E-9	1	1	20	74	22	5	-G
G1_BC73.191219_FM1-2_consensus_vsearch	1648	A	*/+G	155	8	4.3%	2	1	93	93	0.0035774772495738992	1	1	67	88	0	8	+G
G1_BC73.191219_FM1-2_consensus_vsearch	1648	A	*/-G	155	19	10.22%	2	2	93	93	1.1348203857257847E-6	1	1	67	88	1	18	-G
G1_BC73.191219_FM1-2_consensus_vsearch	1653	C	*/-T	153	34	17.89%	2	2	93	93	1.1176079768602298E-11	1	1	74	79	1	33	-T
G1_BC73.191219_FM1-2_consensus_vsearch	1656	C	*/-G	169	7	3.63%	2	2	93	93	0.007351762655103386	1	1	71	98	3	4	-G
G1_BC73.191219_FM1-2_consensus_vsearch	1662	C	*/-GC	144	44	23.4%	2	2	93	93	3.2773108065718573E-15	1	1	47	97	25	19	-GC
G1_BC73.191219_FM1-2_consensus_vsearch	1680	G	*/-A	176	14	7.29%	2	1	93	93	4.7612708551473615E-5	1	1	61	115	14	0	-A
G1_BC73.191219_FM1-2_consensus_vsearch	1684	C	*/-G	170	14	7.25%	2	1	93	93	4.721392964410002E-5	1	1	71	99	0	14	-G
G1_BC73.191219_FM1-2_consensus_vsearch	1687	G	*/+A	181	8	4.15%	2	1	93	93	0.0036219019328410066	1	1	65	116	8	0	+A
G1_BC73.191219_FM1-2_consensus_vsearch	1690	G	*/+A	178	11	5.7%	2	1	93	93	4.204021120137521E-4	1	1	70	108	0	11	+A
G1_BC73.191219_FM1-2_consensus_vsearch	1696	C	*/-T	177	11	5.76%	2	2	93	93	4.200578330993431E-4	1	1	70	107	1	10	-T
G1_BC73.191219_FM1-2_consensus_vsearch	1698	T	*/-C	180	7	3.65%	2	2	93	93	0.007378565932456183	1	1	67	113	2	5	-C
G1_BC73.191219_FM1-2_consensus_vsearch	1713	T	*/+A	173	10	5.15%	2	1	93	93	8.60743791896823E-4	1	1	54	119	10	0	+A
G1_BC73.191219_FM1-2_consensus_vsearch	1716	A	*/-G	174	7	3.72%	2	2	93	93	0.007364345131566664	1	1	58	116	6	1	-G
G1_BC73.191219_FM1-2_consensus_vsearch	1721	G	*/+C	165	7	3.63%	2	2	93	93	0.007341176420737498	1	1	55	110	6	1	+C
G1_BC73.191219_FM1-2_consensus_vsearch	1721	G	*/-TA	165	9	4.66%	2	2	93	93	0.0017566025072910298	1	1	55	110	2	7	-TA
G1_BC73.191219_FM1-2_consensus_vsearch	1731	T	*/+A	173	10	5.26%	2	1	93	93	8.60743791896823E-4	1	1	72	101	0	10	+A
G1_BC73.191219_FM1-2_consensus_vsearch	1734	C	*/+A	170	9	4.66%	2	1	93	93	0.001761941721127389	1	1	63	107	9	0	+A
G1_BC73.191219_FM1-2_consensus_vsearch	1778	C	*/-T	185	7	3.61%	2	2	93	93	0.007389745092191117	1	1	74	111	1	6	-T
G1_BC73.191219_FM1-2_consensus_vsearch	1792	T	*/+C	175	10	5.15%	2	2	93	93	8.619505923183497E-4	1	1	65	110	8	2	+C
G1_BC73.191219_FM1-2_consensus_vsearch	1801	C	*/-T	177	13	6.7%	2	1	93	93	9.872239569714929E-5	1	1	74	103	0	13	-T
G1_BC73.191219_FM1-2_consensus_vsearch	1803	C	*/-G	145	24	12.57%	2	1	93	93	2.476259306040327E-8	1	1	75	70	0	24	-G
G1_BC73.191219_FM1-2_consensus_vsearch	1803	C	*/-GG	145	20	10.47%	2	1	93	93	5.169803900269403E-7	1	1	75	70	0	20	-G
G1_BC73.191219_FM1-2_consensus_vsearch	1811	T	*/-A	179	11	5.7%	2	2	93	93	4.2074294006989865E-4	1	1	62	117	10	1	-A
G1_BC73.191219_FM1-2_consensus_vsearch	1827	A	*/-G	169	14	7.45%	2	2	93	93	4.7145165258180184E-5	1	1	58	111	9	5	-G
G1_BC73.191219_FM1-2_consensus_vsearch	1837	A	*/-C	101	69	36.7%	2	2	93	93	2.7251758980160696E-25	1	1	51	50	6	63	-C
G1_BC73.191219_FM1-2_consensus_vsearch	1850	A	*/-G	155	30	16.04%	2	1	93	93	2.591670626926571E-10	1	1	38	117	30	0	-G
G1_BC73.191219_FM1-2_consensus_vsearch	1866	G	*/-CTG	185	7	3.61%	2	2	93	93	0.007389745092191117	1	1	73	112	1	6	-CTG
G1_BC73.191219_FM1-2_consensus_vsearch	1878	C	*/-T	168	20	10.42%	2	2	93	93	5.595305034619689E-7	1	1	72	96	1	19	-T
G1_BC73.191219_FM1-2_consensus_vsearch	1881	T	*/-C	182	10	5.15%	2	2	93	93	8.659835374014541E-4	1	1	67	115	7	3	-C
G1_BC73.191219_FM1-2_consensus_vsearch	1883	C	*/-G	182	7	3.61%	2	1	93	93	0.007383107786177688	1	1	67	115	7	0	-G
G1_BC73.191219_FM1-2_consensus_vsearch	1884	G	*/-A	177	8	4.28%	2	1	93	93	0.0036158650264919274	1	1	60	117	8	0	-A
G1_BC73.191219_FM1-2_consensus_vsearch	1890	C	*/-AC	167	16	8.33%	2	2	93	93	1.0833863733569022E-5	1	1	58	109	15	1	-AC
G1_BC73.191219_FM1-2_consensus_vsearch	1895	T	*/+A	181	7	3.61%	2	2	93	93	0.007380848803681321	1	1	67	114	5	2	+A
G1_BC73.191219_FM1-2_consensus_vsearch	1912	T	*/-G	178	7	3.65%	2	1	93	93	0.007373926992228167	1	1	74	104	0	7	-G
G1_BC73.191219_FM1-2_consensus_vsearch	1914	T	*/+G	156	13	6.84%	2	2	93	93	9.605371832867716E-5	1	1	60	96	10	3	+G
G1_BC73.191219_FM1-2_consensus_vsearch	1935	C	*/+T	48	100	51.81%	2	2	93	93	2.713584560388029E-42	1	1	12	36	59	41	+T
G1_BC73.191219_FM1-2_consensus_vsearch	1935	C	*/-T	48	35	18.13%	2	2	93	93	2.9904719547892266E-13	1	1	12	36	2	33	+T
G1_BC73.191219_FM1-2_consensus_vsearch	1935	C	*/-TT	48	7	3.63%	2	1	93	93	0.006377004201320391	1	1	12	36	0	7	+T
G1_BC73.191219_FM1-2_consensus_vsearch	1952	G	*/-C	182	8	4.21%	2	1	93	93	0.003623372158916335	1	1	73	109	0	8	-C
G1_BC73.191219_FM1-2_consensus_vsearch	1958	T	*/-C	160	24	12.5%	2	2	93	93	2.673442029746125E-8	1	1	58	102	14	10	-C
G1_BC73.191219_FM1-2_consensus_vsearch	1961	C	*/+T	161	16	8.25%	2	1	93	93	1.070303573670079E-5	1	1	74	87	0	16	+T
G1_BC73.191219_FM1-2_consensus_vsearch	1961	C	*/-T	161	13	6.7%	2	2	93	93	9.67427286895422E-5	1	1	74	87	1	12	+T
G1_BC73.191219_FM1-2_consensus_vsearch	1966	C	*/-AC	176	14	7.25%	2	1	93	93	4.7612708551473615E-5	1	1	59	117	14	0	-AC
G1_BC73.191219_FM1-2_consensus_vsearch	2009	G	*/-TG	174	9	4.64%	2	1	93	93	0.0017660088144097936	1	1	73	101	0	9	-TG
G1_BC73.191219_FM1-2_consensus_vsearch	2010	T	*/+G	160	13	7.22%	2	1	93	93	9.660784741618469E-5	1	1	73	87	0	13	+G
G1_BC73.191219_FM1-2_consensus_vsearch	2069	G	*/+C	164	11	5.7%	2	2	93	93	4.1524271304166165E-4	1	1	50	114	7	4	+C
G1_BC73.191219_FM1-2_consensus_vsearch	2069	G	*/-C	164	17	8.81%	2	2	93	93	5.146038892622666E-6	1	1	50	114	16	1	-C
G1_BC73.191219_FM1-2_consensus_vsearch	2090	G	*/+C	149	7	3.66%	2	1	93	93	0.007293476159710952	1	1	57	92	0	7	+C
G1_BC73.191219_FM1-2_consensus_vsearch	2090	G	*/-C	149	22	11.52%	2	2	93	93	1.1590136686992058E-7	1	1	57	92	4	18	-C
G1_BC73.191219_FM1-2_consensus_vsearch	2090	G	*/-CC	149	9	4.71%	2	2	93	93	0.0017373186708144468	1	1	57	92	8	1	-C
G1_BC73.191219_FM1-2_consensus_vsearch	2094	C	*/-T	138	45	23.2%	2	2	93	93	1.2942584034416247E-15	1	1	65	73	1	44	-T
G1_BC73.191219_FM1-2_consensus_vsearch	2112	T	*/-C	177	8	4.12%	2	2	93	93	0.0036158650264919274	1	1	72	105	1	7	-C
G1_BC73.191219_FM1-2_consensus_vsearch	2117	C	*/-G	149	13	6.7%	2	2	93	93	9.502399457163291E-5	1	1	60	89	9	4	-G
G1_BC73.191219_FM1-2_consensus_vsearch	2117	C	*/-GG	149	24	12.37%	2	2	93	93	2.5309073989952782E-8	1	1	60	89	1	23	-GG
G1_BC73.191219_FM1-2_consensus_vsearch	2124	C	*/+T	168	20	10.36%	2	1	93	93	5.595305034619689E-7	1	1	73	95	0	20	+T
G1_BC73.191219_FM1-2_consensus_vsearch	2127	T	*/+C	40	143	74.09%	2	2	93	93	4.036647486217019E-65	1	1	1	39	71	72	+C
G1_BC73.191219_FM1-2_consensus_vsearch	2128	C	*/+T	46	136	71.58%	2	2	93	93	2.5758391522855694E-60	1	1	1	45	72	64	+T
G1_BC73.191219_FM1-2_consensus_vsearch	2129	T	*/-G	162	10	5.18%	2	1	93	93	8.536248951582895E-4	1	1	74	88	0	10	-G
G1_BC73.191219_FM1-2_consensus_vsearch	2131	C	*/+A	146	12	6.38%	2	2	93	93	1.9655548349622453E-4	1	1	70	76	3	9	+A
G1_BC73.191219_FM1-2_consensus_vsearch	2132	G	*/-A	173	7	3.7%	2	1	93	93	0.007361883903780164	1	1	62	111	7	0	-A
G1_BC73.191219_FM1-2_consensus_vsearch	2140	C	*/+G	161	16	8.25%	2	2	93	93	1.070303573670079E-5	1	1	70	91	2	14	+G
G1_BC73.191219_FM1-2_consensus_vsearch	2146	C	*/-G	121	61	32.11%	2	2	93	93	1.0020952258745401E-21	1	1	47	74	23	38	-G
G1_BC73.191219_FM1-2_consensus_vsearch	2148	G	*/+A	177	7	3.65%	2	1	93	93	0.007371570136883838	1	1	61	116	7	0	+A
G1_BC73.191219_FM1-2_consensus_vsearch	2159	C	*/-T	166	19	9.84%	2	1	93	93	1.1723425682321694E-6	1	1	75	91	0	19	-T
G1_BC73.191219_FM1-2_consensus_vsearch	2162	T	*/-G	158	35	18.04%	2	1	93	93	5.340931440678929E-12	1	1	75	83	0	35	-G
G1_BC73.191219_FM1-2_consensus_vsearch	2170	G	*/-T	179	8	4.26%	2	1	93	93	0.0036189151712300786	1	1	74	105	0	8	-T
G1_BC73.191219_FM1-2_consensus_vsearch	2174	T	*/-C	169	15	7.85%	2	1	93	93	2.2673356043783E-5	1	1	75	94	0	15	-C
G1_BC73.191219_FM1-2_consensus_vsearch	2176	T	*/+C	177	9	4.81%	2	2	93	93	0.0017689474455757383	1	1	66	111	8	1	+C
G1_BC73.191219_FM1-2_consensus_vsearch	2208	C	*/-T	176	13	6.7%	2	1	93	93	9.860774066125673E-5	1	1	75	101	0	13	-T
G1_BC73.191219_FM1-2_consensus_vsearch	2218	T	*/+G	179	8	4.12%	2	1	93	93	0.0036189151712300786	1	1	72	107	0	8	+G
G1_BC73.191219_FM1-2_consensus_vsearch	2224	T	*/-G	180	9	4.71%	2	2	93	93	0.001771795269848945	1	1	70	110	4	5	-G
G1_BC73.191219_FM1-2_consensus_vsearch	2231	C	*/-T	173	12	6.19%	2	2	93	93	2.0308260241471053E-4	1	1	73	100	1	11	-T
G1_BC73.191219_FM1-2_consensus_vsearch	2236	T	*/+G	47	136	71.2%	2	2	93	93	3.9542246619314E-60	1	1	24	23	47	89	+G
G1_BC73.191219_FM1-2_consensus_vsearch	2238	G	*/+AG	169	9	4.66%	2	1	93	93	0.0017608971948629478	1	1	54	115	9	0	+AG
G1_BC73.191219_FM1-2_consensus_vsearch	2238	G	*/+T	169	7	3.63%	2	2	93	93	0.007351762655103386	1	1	54	115	6	1	+AG
G1_BC73.191219_FM1-2_consensus_vsearch	2247	G	*/-TG	158	27	13.92%	2	1	93	93	2.67900222303805E-9	1	1	68	90	0	27	-TG
G1_BC73.191219_FM1-2_consensus_vsearch	2266	G	*/+C	178	11	5.67%	2	1	93	93	4.204021120137521E-4	1	1	75	103	0	11	+C
G1_BC73.191219_FM1-2_consensus_vsearch	2268	T	*/-C	176	13	6.74%	2	1	93	93	9.860774066125673E-5	1	1	74	102	0	13	-C
G1_BC73.191219_FM1-2_consensus_vsearch	2274	C	*/-A	184	7	3.63%	2	1	93	93	0.007387555568979833	1	1	67	117	7	0	-A
G1_BC73.191219_FM1-2_consensus_vsearch	2289	C	*/-T	167	17	8.76%	2	2	93	93	5.180771349429004E-6	1	1	67	100	2	15	-T
G1_BC73.191219_FM1-2_consensus_vsearch	2289	C	*/-TT	167	7	3.61%	2	2	93	93	0.007346529640553612	1	1	67	100	6	1	-T
G1_BC73.191219_FM1-2_consensus_vsearch	2308	C	*/+A	176	14	7.25%	2	1	93	93	4.7612708551473615E-5	1	1	73	103	0	14	+A
G1_BC73.191219_FM1-2_consensus_vsearch	2311	C	*/-GC	183	10	5.15%	2	1	93	93	8.665366458993966E-4	1	1	64	119	10	0	-GC
G1_BC73.191219_FM1-2_consensus_vsearch	2324	C	*/+A	73	18	9.28%	2	2	93	93	1.5023310297886385E-6	1	1	15	58	17	1	+A
G1_BC73.191219_FM1-2_consensus_vsearch	2324	C	*/+G	73	88	45.36%	2	2	93	93	1.7600296826456912E-34	1	1	15	58	38	50	+G
G1_BC73.191219_FM1-2_consensus_vsearch	2324	C	*/-G	73	8	4.12%	2	1	93	93	0.003258539328248754	1	1	15	58	0	8	+G
G1_BC73.191219_FM1-2_consensus_vsearch	2329	A	*/+G	157	18	9.57%	2	1	93	93	2.4072847951339005E-6	1	1	70	87	0	18	+G
G1_BC73.191219_FM1-2_consensus_vsearch	2329	A	*/-G	157	8	4.26%	2	2	93	93	0.0035813812319797343	1	1	70	87	1	7	+G
G1_BC73.191219_FM1-2_consensus_vsearch	2333	C	*/+A	176	9	4.66%	2	1	93	93	0.001767978203561041	1	1	69	107	0	9	+A
G1_BC73.191219_FM1-2_consensus_vsearch	2341	T	*/+G	149	7	3.65%	2	1	93	93	0.007293476159710952	1	1	67	82	7	0	+G
G1_BC73.191219_FM1-2_consensus_vsearch	2341	T	*/-A	149	8	4.17%	2	1	93	93	0.0035651816371754363	1	1	67	82	0	8	-A
G1_BC73.191219_FM1-2_consensus_vsearch	2342	A	*/-G	170	7	3.76%	2	1	93	93	0.007354335343249384	1	1	66	104	7	0	-G
G1_BC73.191219_FM1-2_consensus_vsearch	2361	A	*/-G	180	8	4.19%	2	1	93	93	0.00362041635085765	1	1	71	109	0	8	-G
G1_BC73.191219_FM1-2_consensus_vsearch	2368	G	*/+A	168	9	4.69%	2	2	93	93	0.0017598412021421013	1	1	57	111	7	2	+A
G1_BC73.191219_FM1-2_consensus_vsearch	2368	G	*/-A	168	11	5.73%	2	2	93	93	4.167949943022952E-4	1	1	57	111	7	4	-A
G1_BC73.191219_FM1-2_consensus_vsearch	2373	G	*/+A	174	7	3.72%	2	1	93	93	0.007364345131566664	1	1	67	107	0	7	+A
G1_BC73.191219_FM1-2_consensus_vsearch	2373	G	*/-A	174	7	3.72%	2	2	93	93	0.007364345131566664	1	1	67	107	3	4	+A
G1_BC73.191219_FM1-2_consensus_vsearch	2383	A	*/-G	167	19	9.9%	2	1	93	93	1.1755782087428476E-6	1	1	72	95	0	19	-G
G1_BC73.191219_FM1-2_consensus_vsearch	2386	A	*/-T	181	7	3.72%	2	2	93	93	0.007380848803681321	1	1	68	113	1	6	-T
G1_BC73.191219_FM1-2_consensus_vsearch	2388	T	*/-C	170	22	11.34%	2	2	93	93	1.2601661617205748E-7	1	1	60	110	14	8	-C
G1_BC73.191219_FM1-2_consensus_vsearch	2402	C	*/-G	174	12	6.19%	2	1	93	93	2.0329023403729924E-4	1	1	62	112	12	0	-G
G1_BC73.191219_FM1-2_consensus_vsearch	2411	T	*/-G	145	26	13.98%	2	2	93	93	5.3306441085865605E-9	1	1	73	72	1	25	-G
G1_BC73.191219_FM1-2_consensus_vsearch	2411	T	*/-GG	145	12	6.45%	2	1	93	93	1.9627381201126417E-4	1	1	73	72	0	12	-G
G1_BC73.191219_FM1-2_consensus_vsearch	2422	C	*/-A	186	7	3.63%	2	1	93	93	0.007391912172859777	1	1	75	111	0	7	-A
G1_BC73.191219_FM1-2_consensus_vsearch	2428	G	*/-TG	170	19	9.79%	2	2	93	93	1.1851204359271555E-6	1	1	64	106	8	11	-TG
G1_BC73.191219_FM1-2_consensus_vsearch	2440	T	*/-G	156	29	15.03%	2	2	93	93	5.665126178094745E-10	1	1	67	89	4	25	-G
G1_BC73.191219_FM1-2_consensus_vsearch	2445	T	*/+A	176	8	4.12%	2	1	93	93	0.0036143155518784634	1	1	73	103	0	8	+A
G1_BC73.191219_FM1-2_consensus_vsearch	2449	C	*/+T	178	8	4.21%	2	1	93	93	0.0036173981471315664	1	1	71	107	0	8	+T
G1_BC73.191219_FM1-2_consensus_vsearch	2455	T	*/-C	169	17	8.99%	2	1	93	93	5.203399319974215E-6	1	1	56	113	17	0	-C
G1_BC73.191219_FM1-2_consensus_vsearch	2457	C	*/+G	182	7	3.61%	2	1	93	93	0.007383107786177688	1	1	72	110	0	7	+G
G1_BC73.191219_FM1-2_consensus_vsearch	2480	C	*/+T	163	19	9.95%	2	1	93	93	1.1624660859369758E-6	1	1	75	88	0	19	+T
G1_BC73.191219_FM1-2_consensus_vsearch	2525	C	*/-TC	183	9	4.64%	2	1	93	93	0.0017745564291022078	1	1	75	108	0	9	-TC
G1_BC73.191219_FM1-2_consensus_vsearch	2530	A	*/-G	163	24	12.7%	2	2	93	93	2.7104447922086554E-8	1	1	50	113	18	6	-G
G1_BC73.191219_FM1-2_consensus_vsearch	2538	A	*/-G	180	9	4.66%	2	1	93	93	0.001771795269848945	1	1	63	117	9	0	-G
G1_BC73.191219_FM1-2_consensus_vsearch	2540	T	*/-C	176	9	4.64%	2	1	93	93	0.001767978203561041	1	1	62	114	9	0	-C
G1_BC73.191219_FM1-2_consensus_vsearch	2549	A	*/+C	179	7	3.66%	2	2	93	93	0.007376258791632204	1	1	68	111	2	5	+C
G1_BC73.191219_FM1-2_consensus_vsearch	2550	C	*/+T	178	7	3.7%	2	1	93	93	0.007373926992228167	1	1	71	107	0	7	+T
G1_BC73.191219_FM1-2_consensus_vsearch	2560	C	*/-T	179	7	3.65%	2	1	93	93	0.007376258791632204	1	1	73	106	0	7	-T
G1_BC73.191219_FM1-2_consensus_vsearch	2567	C	*/-A	120	63	32.64%	2	2	93	93	1.6610071552163807E-22	1	1	72	48	1	62	-A
G1_BC73.191219_FM1-2_consensus_vsearch	2570	T	*/+C	118	29	15.34%	2	1	93	93	4.024692445642469E-10	1	1	72	46	0	29	+C
G1_BC73.191219_FM1-2_consensus_vsearch	2579	C	*/-T	168	17	8.76%	2	1	93	93	5.192137088615319E-6	1	1	75	93	0	17	-T
G1_BC73.191219_FM1-2_consensus_vsearch	2579	C	*/-TC	168	7	3.61%	2	1	93	93	0.007349160919077469	1	1	75	93	0	7	-T
G1_BC73.191219_FM1-2_consensus_vsearch	2595	G	*/+T	167	16	8.29%	2	2	93	93	1.0833863733569022E-5	1	1	55	112	14	2	+T
G1_BC73.191219_FM1-2_consensus_vsearch	2595	G	*/-T	167	7	3.63%	2	2	93	93	0.007346529640553612	1	1	55	112	4	3	+T
G1_BC73.191219_FM1-2_consensus_vsearch	2630	C	*/-T	171	17	8.76%	2	1	93	93	5.225618764261991E-6	1	1	74	97	0	17	-T
G1_BC73.191219_FM1-2_consensus_vsearch	2664	C	*/+A	179	10	5.21%	2	1	93	93	8.642903755365361E-4	1	1	75	104	0	10	+A
G1_BC73.191219_FM1-2_consensus_vsearch	2667	A	*/-CA	174	17	8.81%	2	2	93	93	5.258205410644831E-6	1	1	70	104	2	15	-CA
G1_BC73.191219_FM1-2_consensus_vsearch	2679	A	*/+G	137	8	4.19%	2	2	93	93	0.003537610524775318	1	1	40	97	5	3	+G
G1_BC73.191219_FM1-2_consensus_vsearch	2679	A	*/-G	137	38	19.9%	2	2	93	93	3.815187426743107E-13	1	1	40	97	21	17	-G
G1_BC73.191219_FM1-2_consensus_vsearch	2679	A	*/-GG	137	7	3.66%	2	1	93	93	0.0072508471039682155	1	1	40	97	7	0	-G
G1_BC73.191219_FM1-2_consensus_vsearch	2682	G	*/-A	175	16	8.29%	2	2	93	93	1.0997161030255734E-5	1	1	64	111	10	6	-A
G1_BC73.191219_FM1-2_consensus_vsearch	2689	G	*/+A	162	12	6.28%	2	2	93	93	2.00651585430069E-4	1	1	69	93	1	11	+A
G1_BC73.191219_FM1-2_consensus_vsearch	2689	G	*/-A	162	14	7.33%	2	2	93	93	4.6644094013034604E-5	1	1	69	93	4	10	-A
G1_BC73.191219_FM1-2_consensus_vsearch	2695	C	*/+A	177	12	6.22%	2	1	93	93	2.0390075187582733E-4	1	1	73	104	0	12	+A
G1_BC73.191219_FM1-2_consensus_vsearch	2702	G	*/+A	83	89	46.11%	2	2	93	93	2.5827365562837204E-34	1	1	10	73	61	28	+A
G1_BC73.191219_FM1-2_consensus_vsearch	2702	G	*/+AA	83	14	7.25%	2	2	93	93	3.684899556155924E-5	1	1	10	73	1	13	+A
G1_BC73.191219_FM1-2_consensus_vsearch	2707	T	*/-G	186	7	3.61%	2	1	93	93	0.007391912172859777	1	1	75	111	0	7	-G
G1_BC73.191219_FM1-2_consensus_vsearch	2724	G	*/-AAA	172	7	3.78%	2	1	93	93	0.007359395499810914	1	1	59	113	7	0	-AAA
G1_BC73.191219_FM1-2_consensus_vsearch	2733	T	*/-C	165	13	6.74%	2	1	93	93	9.726832470999452E-5	1	1	59	106	13	0	-C
G1_BC73.191219_FM1-2_consensus_vsearch	2735	C	*/-G	163	14	7.45%	2	1	93	93	4.671786332695625E-5	1	1	73	90	0	14	-G
G1_BC73.191219_FM1-2_consensus_vsearch	2735	C	*/-GG	163	10	5.32%	2	1	93	93	8.543079772296276E-4	1	1	73	90	0	10	-G
G1_BC73.191219_FM1-2_consensus_vsearch	2742	A	*/+G	162	9	4.64%	2	1	93	93	0.001753253527181243	1	1	71	91	0	9	+G
G1_BC73.191219_FM1-2_consensus_vsearch	2742	A	*/-G	162	12	6.19%	2	2	93	93	2.00651585430069E-4	1	1	71	91	4	8	-G
G1_BC73.191219_FM1-2_consensus_vsearch	2764	C	*/-T	142	37	19.27%	2	2	93	93	9.126238687978967E-13	1	1	70	72	1	36	-T
G1_BC73.191219_FM1-2_consensus_vsearch	2764	C	*/-TT	142	7	3.65%	2	2	93	93	0.007269431750257196	1	1	70	72	2	5	-T
G1_BC73.191219_FM1-2_consensus_vsearch	2772	G	*/-TG	181	8	4.17%	2	1	93	93	0.0036219019328410066	1	1	75	106	0	8	-TG
G1_BC73.191219_FM1-2_consensus_vsearch	2773	T	*/-G	170	7	3.78%	2	2	93	93	0.007354335343249384	1	1	71	99	3	4	-G
G1_BC73.191219_FM1-2_consensus_vsearch	2775	C	*/+T	157	8	4.23%	2	2	93	93	0.0035813812319797343	1	1	68	89	1	7	+T
G1_BC73.191219_FM1-2_consensus_vsearch	2775	C	*/-T	157	9	4.76%	2	2	93	93	0.0017474110844853488	1	1	68	89	1	8	-T
G1_BC73.191219_FM1-2_consensus_vsearch	2785	A	*/-C	156	28	14.51%	2	2	93	93	1.226059565815956E-9	1	1	67	89	2	26	-C
G1_BC73.191219_FM1-2_consensus_vsearch	2790	C	*/+G	164	10	5.35%	2	1	93	93	8.549835212479261E-4	1	1	64	100	10	0	+G
G1_BC73.191219_FM1-2_consensus_vsearch	2790	C	*/-G	164	12	6.42%	2	1	93	93	2.0111470432217958E-4	1	1	64	100	0	12	-G
G1_BC73.191219_FM1-2_consensus_vsearch	2798	G	*/-C	178	7	3.63%	2	1	93	93	0.007373926992228167	1	1	60	118	7	0	-C
G1_BC73.191219_FM1-2_consensus_vsearch	2805	C	*/-G	172	11	5.85%	2	1	93	93	4.1828279774789115E-4	1	1	69	103	0	11	-G
G1_BC73.191219_FM1-2_consensus_vsearch	2816	T	*/-G	167	12	6.22%	2	2	93	93	2.0179123643446653E-4	1	1	69	98	1	11	-G
G1_BC73.191219_FM1-2_consensus_vsearch	2816	T	*/-GG	167	7	3.63%	2	2	93	93	0.007346529640553612	1	1	69	98	1	6	-G
G1_BC73.191219_FM1-2_consensus_vsearch	2825	A	*/+G	176	10	5.21%	2	1	93	93	8.625446222228462E-4	1	1	71	105	0	10	+G
G1_BC73.191219_FM1-2_consensus_vsearch	2830	C	*/-GC	180	13	6.7%	2	2	93	93	9.905976001490834E-5	1	1	73	107	1	12	-GC
G1_BC73.191219_FM1-2_consensus_vsearch	2842	T	*/+C	178	9	4.64%	2	1	93	93	0.0017699066001378024	1	1	64	114	9	0	+C
G1_BC73.191219_FM1-2_consensus_vsearch	2850	C	*/-T	177	11	5.76%	2	1	93	93	4.200578330993431E-4	1	1	75	102	0	11	-T
G1_BC73.191219_FM1-2_consensus_vsearch	2853	C	*/-G	172	12	6.35%	2	1	93	93	2.0287285558348591E-4	1	1	74	98	0	12	-G
G1_BC73.191219_FM1-2_consensus_vsearch	2869	C	*/-T	175	10	5.18%	2	1	93	93	8.619505923183497E-4	1	1	74	101	0	10	-T
G1_BC73.191219_FM1-2_consensus_vsearch	2894	C	*/+T	177	10	5.15%	2	2	93	93	8.631325337656354E-4	1	1	70	107	2	8	+T
G1_BC73.191219_FM1-2_consensus_vsearch	2899	G	*/-TG	178	13	6.74%	2	2	93	93	9.88359399902161E-5	1	1	65	113	8	5	-TG
G1_BC73.191219_FM1-2_consensus_vsearch	2906	C	*/-G	180	7	3.65%	2	1	93	93	0.007378565932456183	1	1	72	108	0	7	-G
G1_BC73.191219_FM1-2_consensus_vsearch	2913	T	*/-G	183	8	4.12%	2	1	93	93	0.003624827265843605	1	1	74	109	0	8	-G
G1_BC73.191219_FM1-2_consensus_vsearch	2942	C	*/-G	185	7	3.61%	2	1	93	93	0.007389745092191117	1	1	74	111	0	7	-G
G1_BC73.191219_FM1-2_consensus_vsearch	2945	A	*/-C	185	8	4.12%	2	2	93	93	0.003627693045256358	1	1	68	117	7	1	-C
G1_BC73.191219_FM1-2_consensus_vsearch	2951	G	*/-A	169	14	7.33%	2	1	93	93	4.7145165258180184E-5	1	1	52	117	14	0	-A
G1_BC73.191219_FM1-2_consensus_vsearch	2959	C	*/+T	168	11	5.7%	2	1	93	93	4.167949943022952E-4	1	1	72	96	0	11	+T
G1_BC73.191219_FM1-2_consensus_vsearch	2959	C	*/-T	168	11	5.7%	2	1	93	93	4.167949943022952E-4	1	1	72	96	0	11	+T
G1_BC73.191219_FM1-2_consensus_vsearch	2973	G	*/-A	177	7	3.68%	2	2	93	93	0.007371570136883838	1	1	64	113	6	1	-A
G1_BC73.191219_FM1-2_consensus_vsearch	2975	A	*/-G	146	39	20.42%	2	2	93	93	1.935809801373947E-13	1	1	52	94	19	20	-G
G1_BC73.191219_FM1-2_consensus_vsearch	2978	G	*/-AAT	178	10	5.18%	2	1	93	93	8.637144208672183E-4	1	1	60	118	10	0	-AAT
G1_BC73.191219_FM1-2_consensus_vsearch	2983	G	*/+A	175	12	6.25%	2	1	93	93	2.0349578218661617E-4	1	1	73	102	0	12	+A
G1_BC73.191219_FM1-2_consensus_vsearch	2988	C	*/-T	185	9	4.64%	2	1	93	93	0.0017763509872760243	1	1	75	110	0	9	-T
G1_BC73.191219_FM1-2_consensus_vsearch	2989	T	*/-G	132	34	18.38%	2	1	93	93	8.852155823607345E-12	1	1	75	57	0	34	-G
G1_BC73.191219_FM1-2_consensus_vsearch	3012	T	*/-G	161	22	11.34%	2	2	93	93	1.2188238818843247E-7	1	1	59	102	8	14	-G
G1_BC73.191219_FM1-2_consensus_vsearch	3023	C	*/+T	150	10	5.15%	2	2	93	93	8.447908106466188E-4	1	1	70	80	2	8	+T
G1_BC73.191219_FM1-2_consensus_vsearch	3023	C	*/-T	150	30	15.46%	2	2	93	93	2.4930283269386194E-10	1	1	70	80	1	29	-T
G1_BC73.191219_FM1-2_consensus_vsearch	3030	C	*/-A	159	14	7.33%	2	2	93	93	4.6418184944691E-5	1	1	65	94	3	11	-A
G1_BC73.191219_FM1-2_consensus_vsearch	3035	A	*/-C	179	9	4.66%	2	2	93	93	0.0017708558237889195	1	1	65	114	6	3	-C
G1_BC73.191219_FM1-2_consensus_vsearch	3041	A	*/-C	179	12	6.22%	2	2	93	93	2.0429775305230596E-4	1	1	65	114	9	3	-C
G1_BC73.191219_FM1-2_consensus_vsearch	3054	G	*/-A	181	8	4.17%	2	1	93	93	0.0036219019328410066	1	1	64	117	8	0	-A
G1_BC73.191219_FM1-2_consensus_vsearch	3067	T	*/+A	175	8	4.21%	2	1	93	93	0.0036127494603351348	1	1	71	104	0	8	+A
G1_BC73.191219_FM1-2_consensus_vsearch	3080	G	*/-A	167	20	10.47%	2	2	93	93	5.57848104416719E-7	1	1	52	115	19	1	-A
G1_BC73.191219_FM1-2_consensus_vsearch	3097	G	*/-C	174	16	8.29%	2	2	93	93	1.0977404172357244E-5	1	1	65	109	6	10	-C
G1_BC73.191219_FM1-2_consensus_vsearch	3100	C	*/-G	159	13	6.7%	2	1	93	93	9.647152895130946E-5	1	1	74	85	0	13	-G
G1_BC73.191219_FM1-2_consensus_vsearch	3100	C	*/-GG	159	8	4.12%	2	1	93	93	0.0035851936379921044	1	1	74	85	0	8	-G
G1_BC73.191219_FM1-2_consensus_vsearch	3104	T	*/+A	138	13	6.81%	2	1	93	93	9.323137606824358E-5	1	1	41	97	13	0	+A
G1_BC73.191219_FM1-2_consensus_vsearch	3104	T	*/-A	138	18	9.42%	2	2	93	93	2.268303658938995E-6	1	1	41	97	17	1	-A
G1_BC73.191219_FM1-2_consensus_vsearch	3106	A	*/-G	173	9	4.71%	2	2	93	93	0.001765008337317725	1	1	66	107	8	1	-G
G1_BC73.191219_FM1-2_consensus_vsearch	3107	G	*/+A	166	8	4.42%	2	1	93	93	0.0035978605571022945	1	1	55	111	8	0	+A
G1_BC73.191219_FM1-2_consensus_vsearch	3118	T	*/-G	176	8	4.28%	2	2	93	93	0.0036143155518784634	1	1	72	104	3	5	-G
G1_BC73.191219_FM1-2_consensus_vsearch	3147	T	*/-C	178	8	4.15%	2	1	93	93	0.0036173981471315664	1	1	71	107	0	8	-C
G1_BC73.191219_FM1-2_consensus_vsearch	3149	T	*/+G	185	7	3.61%	2	1	93	93	0.007389745092191117	1	1	74	111	0	7	+G
G1_BC73.191219_FM1-2_consensus_vsearch	3153	G	*/-TG	163	23	11.98%	2	1	93	93	5.777119471395887E-8	1	1	70	93	0	23	-TG
G1_BC73.191219_FM1-2_consensus_vsearch	3156	C	*/-A	166	21	10.82%	2	2	93	93	2.6316563117976456E-7	1	1	68	98	3	18	-A
G1_BC73.191219_FM1-2_consensus_vsearch	3166	G	*/-CG	183	7	3.63%	2	1	93	93	0.007385343252869138	1	1	65	118	7	0	-CG
G1_BC73.191219_FM1-2_consensus_vsearch	3174	T	*/-GG	178	7	3.63%	2	1	93	93	0.007373926992228167	1	1	73	105	0	7	-GG
G1_BC73.191219_FM1-2_consensus_vsearch	3181	A	*/-G	126	45	23.56%	2	2	93	93	1.0069357709011317E-15	1	1	58	68	11	34	-G
G1_BC73.191219_FM1-2_consensus_vsearch	3181	A	*/-GGG	126	8	4.19%	2	1	93	93	0.003508111428269705	1	1	58	68	0	8	-G
G1_BC73.191219_FM1-2_consensus_vsearch	3187	G	*/-A	173	11	5.79%	2	1	93	93	4.186451412907242E-4	1	1	58	115	11	0	-A
G1_BC73.191219_FM1-2_consensus_vsearch	3192	A	*/+C	180	7	3.65%	2	1	93	93	0.007378565932456183	1	1	62	118	7	0	+C
G1_BC73.191219_FM1-2_consensus_vsearch	3218	T	*/+C	68	110	56.7%	2	2	93	93	8.839059854453827E-45	1	1	24	44	49	61	+C
G1_BC73.191219_FM1-2_consensus_vsearch	3218	T	*/-C	68	7	3.61%	2	1	93	93	0.006748603167255938	1	1	24	44	0	7	+C
G1_BC73.191219_FM1-2_consensus_vsearch	3221	T	*/-C	161	28	14.43%	2	2	93	93	1.2656411172962698E-9	1	1	44	117	27	1	-C
G1_BC73.191219_FM1-2_consensus_vsearch	3223	C	*/+G	169	9	4.64%	2	1	93	93	0.0017608971948629478	1	1	72	97	0	9	+G
G1_BC73.191219_FM1-2_consensus_vsearch	3230	T	*/-C	125	54	27.98%	2	2	93	93	4.929288066068799E-19	1	1	60	65	15	39	-C
G1_BC73.191219_FM1-2_consensus_vsearch	3236	A	*/-G	172	13	6.7%	2	1	93	93	9.813768217245088E-5	1	1	73	99	0	13	-G
G1_BC73.191219_FM1-2_consensus_vsearch	3248	T	*/+GT	179	9	4.69%	2	1	93	93	0.0017708558237889195	1	1	75	104	0	9	+GT
G1_BC73.191219_FM1-2_consensus_vsearch	3249	T	*/-C	172	17	8.76%	2	2	93	93	5.236578670378071E-6	1	1	68	104	5	12	-C
G1_BC73.191219_FM1-2_consensus_vsearch	3290	A	*/+G	161	15	7.81%	2	1	93	93	2.2356045059508273E-5	1	1	69	92	0	15	+G
G1_BC73.191219_FM1-2_consensus_vsearch	3290	A	*/-G	161	11	5.73%	2	1	93	93	4.1403363178339287E-4	1	1	69	92	0	11	+G
G1_BC73.191219_FM1-2_consensus_vsearch	3298	C	*/-G	178	7	3.63%	2	1	93	93	0.007373926992228167	1	1	73	105	0	7	-G
G1_BC73.191219_FM1-2_consensus_vsearch	3313	C	*/-T	181	7	3.61%	2	1	93	93	0.007380848803681321	1	1	74	107	0	7	-T
G1_BC73.191219_FM1-2_consensus_vsearch	3330	C	*/-T	173	20	10.36%	2	1	93	93	5.677385530695072E-7	1	1	75	98	0	20	-T
G1_BC73.191219_FM1-2_consensus_vsearch	3331	T	*/-C	163	8	4.6%	2	2	93	93	0.0035925563072326206	1	1	69	94	6	2	-C
G1_BC73.191219_FM1-2_consensus_vsearch	3347	T	*/-C	169	20	10.31%	2	2	93	93	5.611990922218554E-7	1	1	56	113	18	2	-C
G1_BC73.191219_FM1-2_consensus_vsearch	3362	C	*/+T	180	10	5.15%	2	2	93	93	8.648604879212406E-4	1	1	74	106	1	9	+T
G1_BC73.191219_FM1-2_consensus_vsearch	3378	C	*/+A	147	38	19.59%	2	2	93	93	4.3720330207890863E-13	1	1	72	75	1	37	+A
G1_BC73.191219_FM1-2_consensus_vsearch	3386	A	*/-G	171	13	6.74%	2	1	93	93	9.80172223605813E-5	1	1	72	99	0	13	-G
G1_BC73.191219_FM1-2_consensus_vsearch	3395	G	*/-TG	176	11	5.7%	2	1	93	93	4.1971005075956745E-4	1	1	71	105	0	11	-TG
G1_BC73.191219_FM1-2_consensus_vsearch	3403	G	*/+T	153	11	5.67%	2	2	93	93	4.106051869833816E-4	1	1	48	105	7	4	+T
G1_BC73.191219_FM1-2_consensus_vsearch	3403	G	*/-T	153	24	12.37%	2	2	93	93	2.5840222677882734E-8	1	1	48	105	17	7	-T
G1_BC73.191219_FM1-2_consensus_vsearch	3407	T	*/-G	158	27	13.92%	2	1	93	93	2.67900222303805E-9	1	1	73	85	0	27	-G
G1_BC73.191219_FM1-2_consensus_vsearch	3410	T	*/-A	151	10	5.35%	2	2	93	93	8.455751061324735E-4	1	1	70	81	1	9	-A
G1_BC73.191219_FM1-2_consensus_vsearch	3427	G	*/-C	175	10	5.24%	2	2	93	93	8.619505923183497E-4	1	1	69	106	2	8	-C
G1_BC73.191219_FM1-2_consensus_vsearch	3428	C	*/-G	139	21	11.73%	2	2	93	93	2.3638461245380278E-7	1	1	63	76	1	20	-G
G1_BC73.191219_FM1-2_consensus_vsearch	3456	G	*/-C	175	14	7.25%	2	1	93	93	4.754784207226191E-5	1	1	56	119	14	0	-C
G1_BC73.191219_FM1-2_consensus_vsearch	3466	A	*/-G	166	21	10.88%	2	1	93	93	2.6316563117976456E-7	1	1	72	94	0	21	-G
G1_BC73.191219_FM1-2_consensus_vsearch	3479	T	*/+A	116	12	6.38%	2	2	93	93	1.8636506095184423E-4	1	1	35	81	4	8	+A
G1_BC73.191219_FM1-2_consensus_vsearch	3479	T	*/-A	116	36	19.15%	2	2	93	93	1.383309958945018E-12	1	1	35	81	19	17	-A
G1_BC73.191219_FM1-2_consensus_vsearch	3479	T	*/-AA	116	11	5.85%	2	2	93	93	3.895335290384688E-4	1	1	35	81	9	2	-A
G1_BC73.191219_FM1-2_consensus_vsearch	3507	A	*/-G	173	8	4.28%	2	1	93	93	0.003609566346175535	1	1	69	104	0	8	-G
G1_BC73.191219_FM1-2_consensus_vsearch	3520	T	*/-G	158	19	10.11%	2	2	93	93	1.14541820123917E-6	1	1	59	99	9	10	-G
G1_BC73.191219_FM1-2_consensus_vsearch	3522	G	*/-A	176	7	3.68%	2	2	93	93	0.007369187819667051	1	1	68	108	3	4	-A
G1_BC73.191219_FM1-2_consensus_vsearch	3531	A	*/-C	175	17	8.76%	2	2	93	93	5.268874801705308E-6	1	1	70	105	3	14	-C
G1_BC73.191219_FM1-2_consensus_vsearch	3539	A	*/-GA	176	11	5.73%	2	1	93	93	4.1971005075956745E-4	1	1	58	118	11	0	-GA
G1_BC73.191219_FM1-2_consensus_vsearch	3546	T	*/-GT	145	38	20.11%	2	1	93	93	4.2602013961544284E-13	1	1	74	71	0	38	-GT
G1_BC73.191219_FM1-2_consensus_vsearch	3554	C	*/-T	166	12	6.22%	2	1	93	93	2.0156809457974717E-4	1	1	64	102	0	12	-T
G1_BC73.191219_FM1-2_consensus_vsearch	3554	C	*/-TT	166	11	5.7%	2	1	93	93	4.160271719522368E-4	1	1	64	102	11	0	-T
G1_BC73.191219_FM1-2_consensus_vsearch	3574	G	*/+C	175	8	4.12%	2	2	93	93	0.0036127494603351348	1	1	64	111	3	5	+C
G1_BC73.191219_FM1-2_consensus_vsearch	3574	G	*/-C	175	7	3.61%	2	2	93	93	0.007366779625824957	1	1	64	111	6	1	+C
G1_BC73.191219_FM1-2_consensus_vsearch	3579	G	*/+A	166	8	4.15%	2	1	93	93	0.0035978605571022945	1	1	71	95	0	8	+A
G1_BC73.191219_FM1-2_consensus_vsearch	3579	G	*/-A	166	17	8.81%	2	2	93	93	5.169300695732747E-6	1	1	71	95	4	13	-A
G1_BC73.191219_FM1-2_consensus_vsearch	3593	C	*/-T	169	18	9.33%	2	2	93	93	2.483123536072931E-6	1	1	72	97	1	17	-T
G1_BC73.191219_FM1-2_consensus_vsearch	3599	C	*/+T	179	8	4.21%	2	1	93	93	0.0036189151712300786	1	1	72	107	0	8	+T
G1_BC73.191219_FM1-2_consensus_vsearch	3600	C	*/-T	176	11	5.67%	2	2	93	93	4.1971005075956745E-4	1	1	73	103	1	10	-T
G1_BC73.191219_FM1-2_consensus_vsearch	3623	T	*/-C	180	12	6.19%	2	1	93	93	2.0449333836859826E-4	1	1	62	118	12	0	-C
G1_BC73.191219_FM1-2_consensus_vsearch	3640	G	*/-A	179	13	6.7%	2	1	93	93	9.894838953322904E-5	1	1	60	119	13	0	-A
G1_BC73.191219_FM1-2_consensus_vsearch	3647	A	*/-G	173	9	4.76%	2	2	93	93	0.001765008337317725	1	1	58	115	8	1	-G
G1_BC73.191219_FM1-2_consensus_vsearch	3649	G	*/+A	168	14	7.41%	2	1	93	93	4.707571741372927E-5	1	1	50	118	14	0	+A
G1_BC73.191219_FM1-2_consensus_vsearch	3652	G	*/-TG	172	16	8.33%	2	1	93	93	1.0937341599623022E-5	1	1	75	97	0	16	-TG
G1_BC73.191219_FM1-2_consensus_vsearch	3655	G	*/-AG	182	7	3.65%	2	1	93	93	0.007383107786177688	1	1	67	115	7	0	-AG
G1_BC73.191219_FM1-2_consensus_vsearch	3668	T	*/+G	163	25	12.89%	2	1	93	93	1.2684881627546497E-8	1	1	73	90	0	25	+G
G1_BC73.191219_FM1-2_consensus_vsearch	3670	A	*/-GA	171	19	9.79%	2	2	93	93	1.1882474027768591E-6	1	1	54	117	18	1	-GA
G1_BC73.191219_FM1-2_consensus_vsearch	3675	G	*/-C	181	10	5.18%	2	1	93	93	8.654248463553992E-4	1	1	73	108	0	10	-C
G1_BC73.191219_FM1-2_consensus_vsearch	3677	T	*/-G	177	14	7.25%	2	1	93	93	4.76769575020497E-5	1	1	75	102	0	14	-G
G1_BC73.191219_FM1-2_consensus_vsearch	3695	T	*/-G	172	19	9.79%	2	1	93	93	1.1913480300411024E-6	1	1	74	98	0	19	-G
G1_BC73.191219_FM1-2_consensus_vsearch	3706	C	*/-T	180	11	5.7%	2	2	93	93	4.2108036879098717E-4	1	1	73	107	1	10	-T
G1_BC73.191219_FM1-2_consensus_vsearch	3719	T	*/-G	181	9	4.69%	2	1	93	93	0.0017727250885016482	1	1	74	107	0	9	-G
G1_BC73.191219_FM1-2_consensus_vsearch	3731	C	*/-A	172	10	5.18%	2	1	93	93	8.601308235378474E-4	1	1	69	103	0	10	-A
G1_BC73.191219_FM1-2_consensus_vsearch	3741	C	*/+AA	175	9	4.76%	2	1	93	93	0.0017669987142516655	1	1	71	104	0	9	+AA
G1_BC73.191219_FM1-2_consensus_vsearch	3744	G	*/-C	180	7	3.63%	2	1	93	93	0.007378565932456183	1	1	73	107	0	7	-C
G1_BC73.191219_FM1-2_consensus_vsearch	3750	C	*/-G	174	11	5.67%	2	2	93	93	4.190037601545019E-4	1	1	71	103	2	9	-G
G1_BC73.191219_FM1-2_consensus_vsearch	3759	T	*/+G	172	16	8.29%	2	1	93	93	1.0937341599623022E-5	1	1	74	98	0	16	+G
G1_BC73.191219_FM1-2_consensus_vsearch	3764	T	*/-G	166	8	4.4%	2	1	93	93	0.0035978605571022945	1	1	72	94	0	8	-G
G1_BC73.191219_FM1-2_consensus_vsearch	3775	T	*/-C	169	19	9.79%	2	2	93	93	1.1819668031703979E-6	1	1	61	108	14	5	-C
G1_BC73.191219_FM1-2_consensus_vsearch	3777	C	*/-T	180	11	5.67%	2	2	93	93	4.2108036879098717E-4	1	1	73	107	2	9	-T
G1_BC73.191219_FM1-2_consensus_vsearch	3797	C	*/-G	174	8	4.17%	2	2	93	93	0.003611166483247444	1	1	66	108	6	2	-G
G1_BC73.191219_FM1-2_consensus_vsearch	3810	T	*/-C	172	15	7.81%	2	1	93	93	2.2786128332551297E-5	1	1	57	115	15	0	-C
G1_BC73.191219_FM1-2_consensus_vsearch	3811	C	*/+T	164	7	3.93%	2	1	93	93	0.007338453432453804	1	1	60	104	0	7	+T
G1_BC73.191219_FM1-2_consensus_vsearch	3812	C	*/-T	175	9	4.64%	2	1	93	93	0.0017669987142516655	1	1	74	101	0	9	-T
G1_BC73.191219_FM1-2_consensus_vsearch	3816	G	*/-CG	180	7	3.66%	2	1	93	93	0.007378565932456183	1	1	73	107	0	7	-CG
G1_BC73.191219_FM1-2_consensus_vsearch	3822	G	*/+C	178	8	4.15%	2	2	93	93	0.0036173981471315664	1	1	62	116	6	2	+C
G1_BC73.191219_FM1-2_consensus_vsearch	3831	C	*/-TT	156	18	9.38%	2	1	93	93	2.4005815851883153E-6	1	1	46	110	18	0	-TT
G1_BC73.191219_FM1-2_consensus_vsearch	3834	G	*/-A	173	11	5.88%	2	2	93	93	4.186451412907242E-4	1	1	58	115	9	2	-A
G1_BC73.191219_FM1-2_consensus_vsearch	3840	C	*/+A	163	7	3.7%	2	1	93	93	0.007335698806984051	1	1	64	99	7	0	+A
G1_BC73.191219_FM1-2_consensus_vsearch	3840	C	*/-A	163	11	5.82%	2	2	93	93	4.148440753983004E-4	1	1	64	99	3	8	-A
G1_BC73.191219_FM1-2_consensus_vsearch	3841	A	*/+T	154	9	5.23%	2	1	93	93	0.0017437389109563706	1	1	69	85	0	9	+T
G1_BC73.191219_FM1-2_consensus_vsearch	3842	A	*/-G	166	8	4.32%	2	2	93	93	0.0035978605571022945	1	1	72	94	3	5	-G
G1_BC73.191219_FM1-2_consensus_vsearch	3844	G	*/-CG	183	8	4.15%	2	1	93	93	0.003624827265843605	1	1	75	108	0	8	-CG
G1_BC73.191219_FM1-2_consensus_vsearch	3847	T	*/-C	162	22	11.52%	2	1	93	93	1.2235594474766907E-7	1	1	75	87	0	22	-C
G1_BC73.191219_FM1-2_consensus_vsearch	3854	G	*/-CG	172	13	6.7%	2	2	93	93	9.813768217245088E-5	1	1	68	104	1	12	-CG
G1_BC73.191219_FM1-2_consensus_vsearch	3857	T	*/-C	181	9	4.64%	2	1	93	93	0.0017727250885016482	1	1	63	118	9	0	-C
G1_BC73.191219_FM1-2_consensus_vsearch	3859	C	*/-T	161	24	12.37%	2	2	93	93	2.685862201776044E-8	1	1	72	89	1	23	-T
G1_BC73.191219_FM1-2_consensus_vsearch	3869	G	*/-A	171	10	5.21%	2	1	93	93	8.595113410222558E-4	1	1	59	112	10	0	-A
G1_BC73.191219_FM1-2_consensus_vsearch	3869	G	*/-AA	171	7	3.65%	2	2	93	93	0.007356879467164792	1	1	59	112	2	5	-A
G1_BC73.191219_FM1-2_consensus_vsearch	3872	A	*/-G	134	53	27.32%	2	2	93	93	1.4982978951472807E-18	1	1	45	89	26	27	-G
G1_BC73.191219_FM1-2_consensus_vsearch	3875	G	*/-AA	168	9	4.66%	2	2	93	93	0.0017598412021421013	1	1	62	106	2	7	-AA
G1_BC73.191219_FM1-2_consensus_vsearch	3884	T	*/-A	163	10	5.35%	2	2	93	93	8.543079772296276E-4	1	1	62	101	9	1	-A
G1_BC73.191219_FM1-2_consensus_vsearch	3891	C	*/-G	182	9	4.69%	2	2	93	93	0.001773645426870732	1	1	74	108	1	8	-G
G1_BC73.191219_FM1-2_consensus_vsearch	3904	A	*/+G	174	9	4.64%	2	1	93	93	0.0017660088144097936	1	1	69	105	0	9	+G
G1_BC73.191219_FM1-2_consensus_vsearch	3933	A	*/-C	167	8	4.19%	2	2	93	93	0.003599589021589525	1	1	52	115	6	2	-C
G1_BC73.191219_FM1-2_consensus_vsearch	3933	A	*/-CC	167	10	5.24%	2	1	93	93	8.569661506081246E-4	1	1	52	115	10	0	-CC
G1_BC73.191219_FM1-2_consensus_vsearch	3936	C	*/-A	162	10	5.26%	2	2	93	93	8.536248951582895E-4	1	1	61	101	7	3	-A
G1_BC73.191219_FM1-2_consensus_vsearch	3938	A	*/-G	153	26	13.54%	2	2	93	93	5.601518425294196E-9	1	1	62	91	10	16	-G
G1_BC73.191219_FM1-2_consensus_vsearch	3949	A	*/-C	179	7	3.65%	2	2	93	93	0.007376258791632204	1	1	67	112	3	4	-C
G1_BC73.191219_FM1-2_consensus_vsearch	3952	A	*/-G	145	41	21.47%	2	1	93	93	3.809005808632524E-14	1	1	73	72	0	41	-G
G1_BC73.191219_FM1-2_consensus_vsearch	3970	T	*/-CT	175	11	5.7%	2	2	93	93	4.1935871135675344E-4	1	1	73	102	2	9	-CT
G1_BC73.191219_FM1-2_consensus_vsearch	3981	C	*/-A	174	11	5.73%	2	2	93	93	4.190037601545019E-4	1	1	73	101	1	10	-A
G1_BC73.191219_FM1-2_consensus_vsearch	3992	A	*/+G	180	8	4.12%	2	1	93	93	0.00362041635085765	1	1	71	109	0	8	+G
G1_BC73.191219_FM1-2_consensus_vsearch	3998	C	*/-G	154	31	16.4%	2	2	93	93	1.1814969034519657E-10	1	1	57	97	16	15	-G
G1_BC73.191219_FM1-2_consensus_vsearch	4017	G	*/-AG	155	16	8.25%	2	2	93	93	1.056433857412907E-5	1	1	44	111	9	7	-AG
G1_BC73.191219_FM1-2_consensus_vsearch	4017	G	*/-AGG	155	10	5.15%	2	2	93	93	8.486212450770172E-4	1	1	44	111	9	1	-AG
G1_BC73.191219_FM1-2_consensus_vsearch	4017	G	*/-AGGG	155	9	4.64%	2	1	93	93	0.0017449774351898418	1	1	44	111	9	0	-AG
G1_BC73.191219_FM1-2_consensus_vsearch	4018	A	*/-G	100	33	21.29%	2	2	93	93	1.204411626813556E-11	1	1	13	87	13	20	-G
G1_BC73.191219_FM1-2_consensus_vsearch	4018	A	*/-GG	100	16	10.32%	2	2	93	93	8.761894482920407E-6	1	1	13	87	15	1	-G
G1_BC73.191219_FM1-2_consensus_vsearch	4035	A	*/-GGA	163	9	4.74%	2	2	93	93	0.0017543824532390317	1	1	50	113	8	1	-GGA
G1_BC73.191219_FM1-2_consensus_vsearch	4037	G	*/+A	163	16	8.74%	2	2	93	93	1.0747486205302928E-5	1	1	46	117	15	1	+A
G1_BC73.191219_FM1-2_consensus_vsearch	4041	G	*/-C	164	19	10.05%	2	1	93	93	1.1657868627616437E-6	1	1	49	115	19	0	-C
G1_BC73.191219_FM1-2_consensus_vsearch	4049	G	*/-CG	184	8	4.15%	2	1	93	93	0.0036262674855563662	1	1	74	110	0	8	-CG
G1_BC73.191219_FM1-2_consensus_vsearch	4059	C	*/-T	176	14	7.29%	2	2	93	93	4.7612708551473615E-5	1	1	73	103	1	13	-T
G1_BC73.191219_FM1-2_consensus_vsearch	4069	G	*/+C	157	11	5.79%	2	2	93	93	4.1235800097779135E-4	1	1	65	92	3	8	+C
G1_BC73.191219_FM1-2_consensus_vsearch	4069	G	*/-C	157	19	10%	2	2	93	93	1.1419171464102655E-6	1	1	65	92	3	16	-C
G1_BC73.191219_FM1-2_consensus_vsearch	4070	C	*/+T	161	7	4.17%	2	1	93	93	0.007330092413737525	1	1	68	93	0	7	+T
G1_BC73.191219_FM1-2_consensus_vsearch	4073	C	*/-T	172	10	5.15%	2	2	93	93	8.601308235378474E-4	1	1	71	101	1	9	-T
G1_BC73.191219_FM1-2_consensus_vsearch	4076	G	*/-A	157	28	14.58%	2	2	93	93	1.2340593330609966E-9	1	1	66	91	6	22	-A
G1_BC73.191219_FM1-2_consensus_vsearch	4082	C	*/-T	180	12	6.19%	2	2	93	93	2.0449333836859826E-4	1	1	74	106	1	11	-T
G1_BC73.191219_FM1-2_consensus_vsearch	4090	T	*/+C	184	7	3.63%	2	1	93	93	0.007387555568979833	1	1	67	117	7	0	+C
G1_BC73.191219_FM1-2_consensus_vsearch	4120	C	*/-T	179	9	4.69%	2	1	93	93	0.0017708558237889195	1	1	73	106	0	9	-T
G1_BC73.191219_FM1-2_consensus_vsearch	4139	T	*/-C	159	25	13.09%	2	2	93	93	1.2434614091848803E-8	1	1	53	106	17	8	-C
G1_BC73.191219_FM1-2_consensus_vsearch	4143	A	*/+G	176	9	4.74%	2	1	93	93	0.001767978203561041	1	1	69	107	0	9	+G
G1_BC73.191219_FM1-2_consensus_vsearch	4150	C	*/+A	180	12	6.22%	2	1	93	93	2.0449333836859826E-4	1	1	74	106	0	12	+A
G1_BC73.191219_FM1-2_consensus_vsearch	4154	C	*/-T	177	16	8.25%	2	2	93	93	1.1036138156984275E-5	1	1	74	103	1	15	-T
G1_BC73.191219_FM1-2_consensus_vsearch	4156	C	*/-T	182	8	4.12%	2	1	93	93	0.003623372158916335	1	1	75	107	0	8	-T
G1_BC73.191219_FM1-2_consensus_vsearch	4174	G	*/-TG	181	8	4.12%	2	2	93	93	0.0036219019328410066	1	1	73	108	1	7	-TG
G1_BC73.191219_FM1-2_consensus_vsearch	4175	T	*/-G	159	13	7.14%	2	2	93	93	9.647152895130946E-5	1	1	70	89	3	10	-G
G1_BC73.191219_FM1-2_consensus_vsearch	4177	G	*/+A	183	7	3.68%	2	2	93	93	0.007385343252869138	1	1	69	114	6	1	+A
G1_BC73.191219_FM1-2_consensus_vsearch	4179	T	*/-A	171	10	5.24%	2	2	93	93	8.595113410222558E-4	1	1	60	111	7	3	-A
G1_BC73.191219_FM1-2_consensus_vsearch	4181	A	*/-G	143	29	15.26%	2	2	93	93	5.134509769865614E-10	1	1	51	92	15	14	-G
G1_BC73.191219_FM1-2_consensus_vsearch	4200	C	*/-T	174	15	7.89%	2	1	93	93	2.285953945782884E-5	1	1	74	100	0	15	-T
G1_BC73.191219_FM1-2_consensus_vsearch	4209	C	*/-T	184	8	4.12%	2	2	93	93	0.0036262674855563662	1	1	74	110	1	7	-T
G1_BC73.191219_FM1-2_consensus_vsearch	4211	A	*/-G	160	23	11.98%	2	1	93	93	5.704379214634594E-8	1	1	70	90	0	23	-G
G1_BC73.191219_FM1-2_consensus_vsearch	4216	T	*/-A	183	8	4.12%	2	2	93	93	0.003624827265843605	1	1	67	116	6	2	-A
G1_BC73.191219_FM1-2_consensus_vsearch	4218	A	*/+G	149	11	5.7%	2	2	93	93	4.0876974708722375E-4	1	1	46	103	9	2	+G
G1_BC73.191219_FM1-2_consensus_vsearch	4218	A	*/-G	149	16	8.29%	2	2	93	93	1.041705276983795E-5	1	1	46	103	13	3	-G
G1_BC73.191219_FM1-2_consensus_vsearch	4218	A	*/-GG	149	8	4.15%	2	1	93	93	0.0035651816371754363	1	1	46	103	0	8	-G
G1_BC73.191219_FM1-2_consensus_vsearch	4231	A	*/+G	162	7	3.65%	2	1	93	93	0.007332911989892741	1	1	57	105	7	0	+G
G1_BC73.191219_FM1-2_consensus_vsearch	4231	A	*/-G	162	22	11.46%	2	2	93	93	1.2235594474766907E-7	1	1	57	105	11	11	-G
G1_BC73.191219_FM1-2_consensus_vsearch	4236	T	*/+G	180	7	3.63%	2	2	93	93	0.007378565932456183	1	1	72	108	1	6	+G
G1_BC73.191219_FM1-2_consensus_vsearch	4251	C	*/-G	139	45	23.2%	2	2	93	93	1.3193758405539542E-15	1	1	58	81	12	33	-G
G1_BC73.191219_FM1-2_consensus_vsearch	4273	C	*/-G	173	8	4.17%	2	1	93	93	0.003609566346175535	1	1	66	107	0	8	-G
G1_BC73.191219_FM1-2_consensus_vsearch	4280	C	*/-TT	176	11	5.7%	2	2	93	93	4.1971005075956745E-4	1	1	72	104	2	9	-TT
G1_BC73.191219_FM1-2_consensus_vsearch	4283	T	*/+C	174	9	4.66%	2	1	93	93	0.0017660088144097936	1	1	65	109	9	0	+C
G1_BC73.191219_FM1-2_consensus_vsearch	4283	T	*/-C	174	9	4.66%	2	1	93	93	0.0017660088144097936	1	1	65	109	0	9	+C
G1_BC73.191219_FM1-2_consensus_vsearch	4288	C	*/-G	166	20	10.53%	2	2	93	93	5.561517304816399E-7	1	1	71	95	2	18	-G
G1_BC73.191219_FM1-2_consensus_vsearch	4307	C	*/-T	166	21	10.99%	2	1	93	93	2.6316563117976456E-7	1	1	74	92	0	21	-T
G1_BC73.191219_FM1-2_consensus_vsearch	4333	G	*/+T	176	12	6.25%	2	1	93	93	2.0369927796885998E-4	1	1	73	103	0	12	+T
G1_BC73.191219_FM1-2_consensus_vsearch	4335	C	*/-T	176	13	6.77%	2	2	93	93	9.860774066125673E-5	1	1	69	107	1	12	-T
G1_BC73.191219_FM1-2_consensus_vsearch	4346	T	*/+C	172	15	7.81%	2	2	93	93	2.2786128332551297E-5	1	1	70	102	4	11	+C
G1_BC73.191219_FM1-2_consensus_vsearch	4358	C	*/-G	174	10	5.18%	2	1	93	93	8.613503481727668E-4	1	1	72	102	0	10	-G
G1_BC73.191219_FM1-2_consensus_vsearch	4364	T	*/-G	150	28	14.74%	2	2	93	93	1.1771722924026547E-9	1	1	47	103	16	12	-G
G1_BC73.191219_FM1-2_consensus_vsearch	4385	T	*/+A	152	10	5.52%	2	2	93	93	8.463501362726399E-4	1	1	62	90	1	9	+A
G1_BC73.191219_FM1-2_consensus_vsearch	4385	T	*/-A	152	18	9.94%	2	1	93	93	2.373132801848004E-6	1	1	62	90	0	18	-A
